date,home_team,away_team,home_score,away_score,goal_difference,home_result,away_result,home_current_elo,away_current_elo
1872-11-30,Scotland,England,0,0,0,0.5,0.5,1500,1500
1873-03-08,England,Scotland,4,2,2,1.0,0.0,1508,1492
1874-03-07,Scotland,England,2,1,1,1.0,0.0,1501,1500
1875-03-06,England,Scotland,2,2,0,0.5,0.5,1501,1501
1876-03-04,Scotland,England,3,0,3,1.0,0.0,1509,1493
1876-03-25,Scotland,Wales,4,0,4,1.0,0.0,1517,1493
1877-03-03,England,Scotland,1,3,2,0.0,1.0,1486,1525
1877-03-05,Wales,Scotland,0,2,2,0.0,1.0,1486,1533
1878-03-02,Scotland,England,7,2,5,1.0,0.0,1540,1480
1878-03-23,Scotland,Wales,9,0,9,1.0,0.0,1547,1480
1879-01-18,England,Wales,2,1,1,1.0,0.0,1488,1472
1879-04-05,England,Scotland,5,4,1,1.0,0.0,1498,1538
1879-04-07,Wales,Scotland,0,3,3,0.0,1.0,1466,1545
1880-03-13,Scotland,England,5,4,1,1.0,0.0,1552,1492
1880-03-15,Wales,England,2,3,1,0.0,1.0,1459,1500
1880-03-27,Scotland,Wales,5,1,4,1.0,0.0,1558,1454
1881-02-26,England,Wales,0,1,1,0.0,1.0,1491,1464
1881-03-12,England,Scotland,1,6,5,0.0,1.0,1485,1565
1881-03-14,Wales,Scotland,1,5,4,0.0,1.0,1459,1571
1882-02-18,Northern Ireland,England,0,13,13,0.0,1.0,1492,1494
1882-02-25,Wales,Northern Ireland,7,1,6,1.0,0.0,1468,1484
1882-03-11,Scotland,England,5,1,4,1.0,0.0,1578,1488
1882-03-13,Wales,England,5,3,2,1.0,0.0,1477,1480
1882-03-25,Scotland,Wales,5,0,5,1.0,0.0,1584,1472
1883-02-03,England,Wales,5,0,5,1.0,0.0,1488,1465
1883-02-24,England,Northern Ireland,7,0,7,1.0,0.0,1496,1477
1883-03-10,England,Scotland,2,3,1,0.0,1.0,1490,1591
1883-03-12,Wales,Scotland,0,3,3,0.0,1.0,1460,1597
1883-03-17,Northern Ireland,Wales,1,1,0,0.5,0.5,1477,1461
1884-01-26,Northern Ireland,Scotland,0,5,5,0.0,1.0,1472,1603
1884-02-09,Wales,Northern Ireland,6,0,6,1.0,0.0,1470,1464
1884-02-23,Northern Ireland,England,1,8,7,0.0,1.0,1457,1498
1884-03-15,Scotland,England,1,0,1,1.0,0.0,1609,1493
1884-03-17,Wales,England,0,4,4,0.0,1.0,1463,1501
1884-03-29,Scotland,Wales,4,1,3,1.0,0.0,1614,1459
1885-02-28,England,Northern Ireland,4,0,4,1.0,0.0,1508,1451
1885-03-14,England,Wales,1,1,0,0.5,0.5,1507,1461
1885-03-14,Scotland,Northern Ireland,8,2,6,1.0,0.0,1619,1447
1885-03-21,England,Scotland,1,1,0,0.5,0.5,1510,1617
1885-03-23,Wales,Scotland,1,8,7,0.0,1.0,1457,1622
1885-04-11,Northern Ireland,Wales,2,8,6,0.0,1.0,1440,1465
1885-11-28,United States,Canada,0,1,1,0.0,1.0,1492,1508
1886-02-27,Wales,Northern Ireland,5,0,5,1.0,0.0,1473,1433
1886-03-13,Northern Ireland,England,1,6,5,0.0,1.0,1427,1517
1886-03-20,Northern Ireland,Scotland,2,7,5,0.0,1.0,1424,1626
1886-03-27,Scotland,England,1,1,0,0.5,0.5,1624,1520
1886-03-29,Wales,England,1,3,2,0.0,1.0,1467,1527
1886-04-10,Scotland,Wales,4,1,3,1.0,0.0,1629,1463
1886-11-25,United States,Canada,3,2,1,1.0,0.0,1501,1500
1887-02-05,England,Northern Ireland,7,0,7,1.0,0.0,1533,1419
1887-02-19,Scotland,Northern Ireland,4,1,3,1.0,0.0,1633,1416
1887-02-26,England,Wales,4,0,4,1.0,0.0,1540,1457
1887-03-12,Northern Ireland,Wales,4,1,3,1.0,0.0,1425,1449
1887-03-19,England,Scotland,2,3,1,0.0,1.0,1535,1639
1887-03-21,Wales,Scotland,0,2,2,0.0,1.0,1445,1644
1888-02-04,England,Wales,5,1,4,1.0,0.0,1541,1440
1888-03-03,Wales,Northern Ireland,11,0,11,1.0,0.0,1448,1418
1888-03-10,Scotland,Wales,5,1,4,1.0,0.0,1648,1445
1888-03-17,Scotland,England,0,5,5,0.0,1.0,1638,1552
1888-03-24,Northern Ireland,Scotland,2,10,8,0.0,1.0,1415,1642
1888-04-07,Northern Ireland,England,1,5,4,0.0,1.0,1411,1557
1888-09-19,Scotland,Canada,4,0,4,1.0,0.0,1647,1496
1889-02-23,England,Wales,4,1,3,1.0,0.0,1563,1440
1889-03-02,England,Northern Ireland,6,1,5,1.0,0.0,1568,1407
1889-03-09,Scotland,Northern Ireland,7,0,7,1.0,0.0,1651,1404
1889-04-13,England,Scotland,2,3,1,0.0,1.0,1562,1658
1889-04-15,Wales,Scotland,0,0,0,0.5,0.5,1445,1654
1889-04-27,Northern Ireland,Wales,1,3,2,0.0,1.0,1397,1453
1890-02-08,Wales,Northern Ireland,5,2,3,1.0,0.0,1460,1391
1890-03-15,Northern Ireland,England,1,9,8,0.0,1.0,1387,1567
1890-03-15,Wales,England,1,3,2,0.0,1.0,1455,1573
1890-03-22,Scotland,Wales,5,0,5,1.0,0.0,1658,1452
1890-03-29,Northern Ireland,Scotland,1,4,3,0.0,1.0,1385,1661
1890-04-05,Scotland,England,1,1,0,0.5,0.5,1660,1575
1891-02-07,Northern Ireland,Wales,7,2,5,1.0,0.0,1395,1443
1891-03-07,England,Wales,4,1,3,1.0,0.0,1581,1438
1891-03-07,England,Northern Ireland,6,1,5,1.0,0.0,1586,1391
1891-03-21,Wales,Scotland,3,4,1,0.0,1.0,1435,1664
1891-03-28,Scotland,Northern Ireland,2,1,1,1.0,0.0,1667,1389
1891-04-04,England,Scotland,2,1,1,1.0,0.0,1596,1658
1892-02-27,Wales,Northern Ireland,1,1,0,0.5,0.5,1434,1391
1892-03-05,Northern Ireland,England,0,2,2,0.0,1.0,1388,1600
1892-03-05,Wales,England,0,2,2,0.0,1.0,1430,1605
1892-03-19,Northern Ireland,Scotland,2,3,1,0.0,1.0,1386,1661
1892-03-26,Scotland,Wales,6,1,5,1.0,0.0,1665,1427
1892-04-02,Scotland,England,1,4,3,0.0,1.0,1656,1615
1893-02-25,England,Northern Ireland,6,1,5,1.0,0.0,1619,1383
1893-03-13,England,Wales,6,0,6,1.0,0.0,1623,1424
1893-03-18,Wales,Scotland,0,8,8,0.0,1.0,1421,1660
1893-03-25,Scotland,Northern Ireland,6,1,5,1.0,0.0,1663,1381
1893-04-01,England,Scotland,5,2,3,1.0,0.0,1632,1655
1894-02-24,Wales,Northern Ireland,4,1,3,1.0,0.0,1429,1374
1894-03-03,Northern Ireland,England,2,2,0,0.5,0.5,1380,1627
1894-03-12,Wales,England,1,5,4,0.0,1.0,1426,1631
1894-03-24,Scotland,Wales,5,2,3,1.0,0.0,1659,1423
1894-03-31,Northern Ireland,Scotland,1,2,1,0.0,1.0,1378,1662
1894-04-07,Scotland,England,2,2,0,0.5,0.5,1662,1632
1895-03-09,England,Northern Ireland,9,0,9,1.0,0.0,1636,1375
1895-03-16,Northern Ireland,Wales,2,2,0,0.5,0.5,1377,1422
1895-03-18,England,Wales,1,1,0,0.5,0.5,1632,1427
1895-03-23,Wales,Scotland,2,2,0,0.5,0.5,1432,1658
1895-03-30,Scotland,Northern Ireland,3,1,2,1.0,0.0,1661,1375
1895-04-06,England,Scotland,3,0,3,1.0,0.0,1641,1653
1896-02-29,Wales,Northern Ireland,6,1,5,1.0,0.0,1439,1369
1896-03-07,Northern Ireland,England,0,2,2,0.0,1.0,1367,1644
1896-03-16,Wales,England,1,9,8,0.0,1.0,1436,1648
1896-03-21,Scotland,Wales,4,0,4,1.0,0.0,1657,1433
1896-03-28,Northern Ireland,Scotland,3,3,0,0.5,0.5,1373,1652
1896-04-04,Scotland,England,2,1,1,1.0,0.0,1660,1641
1897-02-20,England,Northern Ireland,6,0,6,1.0,0.0,1644,1371
1897-03-06,Northern Ireland,Wales,4,3,1,1.0,0.0,1381,1424
1897-03-20,Wales,Scotland,2,2,0,0.5,0.5,1429,1656
1897-03-27,Scotland,Northern Ireland,5,1,4,1.0,0.0,1659,1379
1897-03-29,England,Wales,4,0,4,1.0,0.0,1648,1426
1897-04-03,England,Scotland,1,2,1,0.0,1.0,1641,1667
1898-02-19,Wales,Northern Ireland,0,1,1,0.0,1.0,1417,1389
1898-03-05,Northern Ireland,England,2,3,1,0.0,1.0,1386,1645
1898-03-19,Scotland,Wales,5,2,3,1.0,0.0,1671,1414
1898-03-26,Northern Ireland,Scotland,0,3,3,0.0,1.0,1384,1674
1898-03-28,Wales,England,0,3,3,0.0,1.0,1411,1649
1898-04-02,Scotland,England,1,3,2,0.0,1.0,1666,1658
1899-02-18,England,Northern Ireland,13,2,11,1.0,0.0,1661,1382
1899-03-04,Northern Ireland,Wales,1,0,1,1.0,0.0,1391,1403
1899-03-18,Wales,Scotland,0,6,6,0.0,1.0,1401,1669
1899-03-20,England,Wales,4,0,4,1.0,0.0,1664,1399
1899-03-25,Scotland,Northern Ireland,9,1,8,1.0,0.0,1672,1389
1899-04-08,England,Scotland,2,1,1,1.0,0.0,1673,1664
1900-02-03,Scotland,Wales,5,2,3,1.0,0.0,1667,1397
1900-02-24,Wales,Northern Ireland,2,0,2,1.0,0.0,1405,1382
1900-03-03,Northern Ireland,Scotland,0,3,3,0.0,1.0,1380,1670
1900-03-17,Northern Ireland,England,0,2,2,0.0,1.0,1378,1676
1900-03-26,Wales,England,1,1,0,0.5,0.5,1411,1671
1900-04-07,Scotland,England,4,1,3,1.0,0.0,1679,1663
1901-02-23,Scotland,Northern Ireland,11,0,11,1.0,0.0,1682,1376
1901-03-02,Wales,Scotland,1,1,0,0.5,0.5,1417,1677
1901-03-09,England,Northern Ireland,3,0,3,1.0,0.0,1666,1374
1901-03-18,England,Wales,6,0,6,1.0,0.0,1670,1414
1901-03-23,Northern Ireland,Wales,0,1,1,0.0,1.0,1367,1422
1901-03-30,England,Scotland,2,2,0,0.5,0.5,1671,1677
1902-02-22,Wales,Northern Ireland,0,3,3,0.0,1.0,1413,1377
1902-03-01,Northern Ireland,Scotland,1,5,4,0.0,1.0,1375,1680
1902-03-03,Wales,England,0,0,0,0.5,0.5,1419,1666
1902-03-15,Scotland,Wales,5,1,4,1.0,0.0,1683,1417
1902-03-22,Northern Ireland,England,0,1,1,0.0,1.0,1373,1669
1902-05-03,England,Scotland,2,2,0,0.5,0.5,1670,1683
1902-07-20,Uruguay,Argentina,0,6,6,0.0,1.0,1492,1508
1902-10-12,Austria,Hungary,5,0,5,1.0,0.0,1508,1492
1903-02-14,England,Northern Ireland,4,0,4,1.0,0.0,1673,1371
1903-03-02,England,Wales,2,1,1,1.0,0.0,1676,1415
1903-03-09,Wales,Scotland,0,1,1,0.0,1.0,1413,1686
1903-03-21,Scotland,Northern Ireland,0,2,2,0.0,1.0,1673,1385
1903-03-28,Northern Ireland,Wales,2,0,2,1.0,0.0,1394,1405
1903-04-04,England,Scotland,1,2,1,0.0,1.0,1668,1682
1903-04-05,Hungary,Czechoslovakia,2,1,1,1.0,0.0,1501,1492
1903-06-11,Hungary,Austria,3,2,1,1.0,0.0,1510,1500
1903-09-13,Argentina,Uruguay,2,3,1,0.0,1.0,1500,1501
1903-10-11,Austria,Hungary,4,2,2,1.0,0.0,1509,1502
1904-02-29,Wales,England,2,2,0,0.5,0.5,1411,1663
1904-03-12,Northern Ireland,England,1,3,2,0.0,1.0,1392,1666
1904-03-12,Scotland,Wales,1,1,0,0.5,0.5,1677,1417
1904-03-21,Wales,Northern Ireland,0,1,1,0.0,1.0,1409,1401
1904-03-26,Northern Ireland,Scotland,1,1,0,0.5,0.5,1407,1672
1904-04-09,Scotland,England,0,1,1,0.0,1.0,1664,1675
1904-05-01,Belgium,France,3,3,0,0.5,0.5,1500,1500
1904-06-02,Hungary,Austria,3,0,3,1.0,0.0,1511,1501
1904-10-09,Austria,Hungary,5,4,1,1.0,0.0,1510,1503
1905-02-12,France,Switzerland,1,0,1,1.0,0.0,1508,1492
1905-02-25,England,Northern Ireland,1,1,0,0.5,0.5,1670,1413
1905-03-06,Wales,Scotland,3,1,2,1.0,0.0,1423,1651
1905-03-18,Scotland,Northern Ireland,4,0,4,1.0,0.0,1655,1410
1905-03-27,England,Wales,3,1,2,1.0,0.0,1674,1420
1905-04-01,England,Scotland,1,0,1,1.0,0.0,1682,1648
1905-04-08,Northern Ireland,Wales,2,2,0,0.5,0.5,1411,1420
1905-04-09,Hungary,Austria,0,0,0,0.5,0.5,1504,1510
1905-04-17,Guernsey,Alderney,6,0,6,1.0,0.0,1508,1492
1905-04-27,Jersey,Guernsey,0,1,1,0.0,1.0,1493,1516
1905-04-30,Belgium,Netherlands,1,4,3,0.0,1.0,1492,1508
1905-05-07,Belgium,France,7,0,7,1.0,0.0,1501,1500
1905-05-14,Netherlands,Belgium,4,0,4,1.0,0.0,1516,1494
1905-08-15,Argentina,Uruguay,0,0,0,0.5,0.5,1501,1501
1906-02-17,Northern Ireland,England,0,5,5,0.0,1.0,1409,1685
1906-03-03,Scotland,Wales,0,2,2,0.0,1.0,1636,1433
1906-03-17,Northern Ireland,Scotland,0,1,1,0.0,1.0,1406,1640
1906-03-19,Wales,England,0,1,1,0.0,1.0,1430,1689
1906-03-29,Jersey,Guernsey,1,2,1,0.0,1.0,1486,1524
1906-04-01,Hungary,Czechoslovakia,1,1,0,0.5,0.5,1504,1493
1906-04-02,Wales,Northern Ireland,4,4,0,0.5,0.5,1430,1407
1906-04-02,Guernsey,Alderney,1,0,1,1.0,0.0,1532,1485
1906-04-07,Scotland,England,2,1,1,1.0,0.0,1650,1680
1906-04-22,France,Belgium,0,5,5,0.0,1.0,1492,1503
1906-04-29,Belgium,Netherlands,5,0,5,1.0,0.0,1512,1508
1906-05-13,Netherlands,Belgium,2,3,1,0.0,1.0,1501,1520
1906-08-15,Uruguay,Argentina,0,2,2,0.0,1.0,1493,1509
1906-10-07,Czechoslovakia,Hungary,4,4,0,0.5,0.5,1494,1504
1906-10-21,Argentina,Uruguay,2,1,1,1.0,0.0,1517,1486
1906-11-04,Hungary,Austria,3,1,2,1.0,0.0,1513,1502
1907-02-16,England,Northern Ireland,1,0,1,1.0,0.0,1683,1405
1907-02-23,Northern Ireland,Wales,2,3,1,0.0,1.0,1398,1438
1907-03-04,Wales,Scotland,1,0,1,1.0,0.0,1451,1638
1907-03-16,Scotland,Northern Ireland,3,0,3,1.0,0.0,1642,1395
1907-03-18,England,Wales,1,1,0,0.5,0.5,1679,1456
1907-03-21,Alderney,Jersey,1,2,1,0.0,1.0,1478,1494
1907-04-04,Jersey,Guernsey,2,3,1,0.0,1.0,1487,1540
1907-04-06,England,Scotland,1,1,0,0.5,0.5,1679,1643
1907-04-07,Hungary,Czechoslovakia,5,2,3,1.0,0.0,1521,1487
1907-04-14,Belgium,Netherlands,1,3,2,0.0,1.0,1512,1510
1907-04-21,Belgium,France,1,2,1,0.0,1.0,1504,1501
1907-05-05,Austria,Hungary,3,1,2,1.0,0.0,1511,1513
1907-05-09,Netherlands,Belgium,1,2,1,0.0,1.0,1502,1513
1907-10-06,Czechoslovakia,Hungary,5,3,2,1.0,0.0,1496,1505
1907-11-03,Hungary,Austria,4,1,3,1.0,0.0,1514,1503
1908-02-15,Northern Ireland,England,1,3,2,0.0,1.0,1393,1682
1908-03-07,Scotland,Wales,2,1,1,1.0,0.0,1648,1452
1908-03-08,Switzerland,France,1,2,1,0.0,1.0,1485,1509
1908-03-14,Northern Ireland,Scotland,0,5,5,0.0,1.0,1391,1651
1908-03-16,Wales,England,1,7,6,0.0,1.0,1449,1686
1908-03-29,Belgium,Netherlands,1,4,3,0.0,1.0,1505,1511
1908-04-02,Guernsey,Alderney,3,0,3,1.0,0.0,1547,1472
1908-04-04,Scotland,England,1,1,0,0.5,0.5,1652,1686
1908-04-05,Hungary,Czechoslovakia,5,2,3,1.0,0.0,1522,1489
1908-04-05,Switzerland,Germany,5,3,2,1.0,0.0,1494,1492
1908-04-09,Guernsey,Jersey,0,4,4,0.0,1.0,1538,1497
1908-04-11,Wales,Northern Ireland,0,1,1,0.0,1.0,1440,1401
1908-04-12,France,Belgium,1,2,1,0.0,1.0,1501,1514
1908-04-26,Netherlands,Belgium,3,1,2,1.0,0.0,1520,1506
1908-05-03,Austria,Hungary,4,0,4,1.0,0.0,1512,1514
1908-05-10,Netherlands,France,4,1,3,1.0,0.0,1528,1494
1908-06-06,Austria,England,1,6,5,0.0,1.0,1508,1691
1908-06-07,Austria,Germany,3,2,1,1.0,0.0,1516,1485
1908-06-08,Austria,England,1,11,10,0.0,1.0,1512,1696
1908-06-10,Hungary,England,0,7,7,0.0,1.0,1510,1701
1908-06-13,Czechoslovakia,England,0,4,4,0.0,1.0,1486,1705
1908-07-12,Sweden,Norway,11,3,8,1.0,0.0,1508,1492
1908-08-15,Uruguay,Argentina,2,2,0,0.5,0.5,1487,1517
1908-09-13,Argentina,Uruguay,2,1,1,1.0,0.0,1525,1480
1908-10-04,Argentina,Uruguay,0,1,1,0.0,1.0,1516,1490
1908-10-25,Netherlands,Sweden,5,3,2,1.0,0.0,1536,1501
1908-10-26,Belgium,Sweden,2,1,1,1.0,0.0,1514,1494
1908-11-01,Hungary,Austria,5,3,2,1.0,0.0,1519,1504
1909-02-13,England,Northern Ireland,4,0,4,1.0,0.0,1708,1399
1909-03-01,Wales,Scotland,3,2,1,1.0,0.0,1453,1640
1909-03-15,England,Wales,2,0,2,1.0,0.0,1711,1451
1909-03-15,Scotland,Northern Ireland,5,0,5,1.0,0.0,1644,1396
1909-03-18,Guernsey,Jersey,3,0,3,1.0,0.0,1546,1490
1909-03-20,Northern Ireland,Wales,2,3,1,0.0,1.0,1390,1458
1909-03-21,Belgium,Netherlands,1,4,3,0.0,1.0,1507,1544
1909-03-25,Guernsey,Alderney,2,0,2,1.0,0.0,1553,1466
1909-04-03,England,Scotland,2,0,2,1.0,0.0,1718,1638
1909-04-04,Germany,Switzerland,1,0,1,1.0,0.0,1494,1486
1909-04-04,Hungary,Germany,3,3,0,0.5,0.5,1519,1495
1909-04-25,Netherlands,Belgium,4,1,3,1.0,0.0,1552,1500
1909-05-02,Austria,Hungary,3,4,1,0.0,1.0,1497,1527
1909-05-09,Belgium,France,5,2,3,1.0,0.0,1508,1487
1909-05-29,Hungary,England,2,4,2,0.0,1.0,1524,1722
1909-05-30,Hungary,Austria,1,1,0,0.5,0.5,1524,1498
1909-05-31,Hungary,England,2,8,6,0.0,1.0,1521,1726
1909-06-01,Austria,England,1,8,7,0.0,1.0,1495,1730
1909-08-15,Argentina,Uruguay,2,1,1,1.0,0.0,1524,1483
1909-09-19,Uruguay,Argentina,2,2,0,0.5,0.5,1484,1524
1909-10-10,Argentina,Uruguay,3,1,2,1.0,0.0,1532,1477
1909-11-07,Hungary,Austria,2,2,0,0.5,0.5,1521,1496
1910-02-12,Northern Ireland,England,1,1,0,0.5,0.5,1397,1724
1910-03-05,Scotland,Wales,1,0,1,1.0,0.0,1643,1454
1910-03-13,Belgium,Netherlands,3,2,1,1.0,0.0,1518,1543
1910-03-14,Wales,England,0,1,1,0.0,1.0,1452,1727
1910-03-19,Northern Ireland,Scotland,1,0,1,1.0,0.0,1410,1631
1910-04-02,Scotland,England,2,0,2,1.0,0.0,1642,1717
1910-04-03,France,Belgium,0,4,4,0.0,1.0,1480,1526
1910-04-03,Switzerland,Germany,2,3,1,0.0,1.0,1479,1503
1910-04-07,Jersey,Alderney,7,1,6,1.0,0.0,1498,1459
1910-04-10,Netherlands,Belgium,7,0,7,1.0,0.0,1551,1519
1910-04-11,Wales,Northern Ireland,4,1,3,1.0,0.0,1460,1403
1910-04-21,Guernsey,Jersey,2,3,1,0.0,1.0,1544,1508
1910-04-24,Netherlands,Germany,4,2,2,1.0,0.0,1558,1497
1910-05-01,Austria,Hungary,2,1,1,1.0,0.0,1505,1513
1910-05-15,Italy,France,6,2,4,1.0,0.0,1508,1473
1910-05-16,Germany,Belgium,0,3,3,0.0,1.0,1490,1527
1910-05-26,Hungary,Italy,6,1,5,1.0,0.0,1521,1501
1910-05-27,Argentina,Chile,3,1,2,1.0,0.0,1540,1493
1910-05-29,Chile,Uruguay,0,3,3,0.0,1.0,1485,1486
1910-06-05,Argentina,Chile,5,1,4,1.0,0.0,1547,1479
1910-06-12,Argentina,Uruguay,4,1,3,1.0,0.0,1554,1480
1910-08-15,Uruguay,Argentina,3,1,2,1.0,0.0,1490,1545
1910-09-11,Chile,Argentina,0,3,3,0.0,1.0,1473,1552
1910-09-11,Norway,Sweden,0,4,4,0.0,1.0,1485,1502
1910-10-16,Germany,Netherlands,1,2,1,0.0,1.0,1484,1565
1910-11-06,Hungary,Austria,3,0,3,1.0,0.0,1529,1498
1910-11-13,Argentina,Uruguay,1,1,0,0.5,0.5,1551,1492
1910-11-27,Argentina,Uruguay,2,6,4,0.0,1.0,1542,1502
1911-01-01,France,Hungary,0,3,3,0.0,1.0,1467,1536
1911-01-06,Italy,Hungary,0,1,1,0.0,1.0,1494,1544
1911-01-08,Switzerland,Hungary,2,0,2,1.0,0.0,1489,1535
1911-01-28,Northern Ireland,Wales,1,2,1,0.0,1.0,1397,1467
1911-02-11,England,Northern Ireland,2,1,1,1.0,0.0,1720,1395
1911-03-06,Wales,Scotland,2,2,0,0.5,0.5,1471,1639
1911-03-13,England,Wales,3,0,3,1.0,0.0,1724,1468
1911-03-18,Scotland,Northern Ireland,2,0,2,1.0,0.0,1643,1392
1911-03-19,Belgium,Netherlands,1,5,4,0.0,1.0,1520,1573
1911-03-26,Germany,Switzerland,6,2,4,1.0,0.0,1493,1481
1911-04-01,England,Scotland,1,1,0,0.5,0.5,1723,1645
1911-04-02,Netherlands,Belgium,3,1,2,1.0,0.0,1580,1514
1911-04-09,France,Italy,2,2,0,0.5,0.5,1468,1494
1911-04-20,Guernsey,Alderney,2,1,1,1.0,0.0,1551,1453
1911-04-23,Belgium,Germany,2,1,1,1.0,0.0,1522,1486
1911-04-23,Switzerland,France,5,2,3,1.0,0.0,1489,1461
1911-04-27,Jersey,Guernsey,4,1,3,1.0,0.0,1517,1543
1911-04-30,Belgium,France,7,1,6,1.0,0.0,1529,1455
1911-05-07,Austria,Hungary,3,1,2,1.0,0.0,1507,1527
1911-05-07,Italy,Switzerland,2,2,0,0.5,0.5,1494,1490
1911-05-21,Switzerland,Italy,3,0,3,1.0,0.0,1499,1486
1911-06-18,Sweden,Germany,2,4,2,0.0,1.0,1494,1495
1911-08-15,Argentina,Uruguay,0,2,2,0.0,1.0,1534,1511
1911-09-17,Sweden,Norway,4,1,3,1.0,0.0,1502,1478
1911-09-17,Uruguay,Argentina,2,3,1,0.0,1.0,1504,1542
1911-10-08,Uruguay,Argentina,1,1,0,0.5,0.5,1505,1542
1911-10-09,Germany,Austria,1,2,1,0.0,1.0,1488,1515
1911-10-22,Argentina,Uruguay,2,0,2,1.0,0.0,1550,1498
1911-10-22,Finland,Sweden,2,5,3,0.0,1.0,1493,1510
1911-10-29,Germany,Sweden,1,3,2,0.0,1.0,1481,1518
1911-10-29,Hungary,Switzerland,9,0,9,1.0,0.0,1535,1492
1911-10-29,Luxembourg,France,1,4,3,0.0,1.0,1491,1465
1911-10-29,Uruguay,Argentina,3,0,3,1.0,0.0,1508,1541
1911-11-05,Hungary,Austria,2,0,2,1.0,0.0,1543,1508
1911-12-17,Germany,Hungary,1,4,3,0.0,1.0,1475,1550
1912-01-28,France,Belgium,1,1,0,0.5,0.5,1467,1528
1912-02-10,Northern Ireland,England,1,6,5,0.0,1.0,1390,1726
1912-02-10,France,Catalonia,7,0,7,1.0,0.0,1476,1492
1912-02-18,France,Switzerland,4,1,3,1.0,0.0,1485,1484
1912-02-20,Belgium,Switzerland,9,2,7,1.0,0.0,1535,1478
1912-03-02,Scotland,Wales,1,0,1,1.0,0.0,1650,1464
1912-03-10,Belgium,Netherlands,1,2,1,0.0,1.0,1529,1587
1912-03-11,Wales,England,0,2,2,0.0,1.0,1462,1729
1912-03-16,Northern Ireland,Scotland,1,4,3,0.0,1.0,1388,1653
1912-03-17,Italy,France,3,4,1,0.0,1.0,1478,1494
1912-03-23,Scotland,England,1,1,0,0.5,0.5,1655,1728
1912-03-24,Netherlands,Germany,5,5,0,0.5,0.5,1585,1478
1912-04-13,Wales,Northern Ireland,2,3,1,0.0,1.0,1453,1398
1912-04-14,Hungary,Germany,4,4,0,0.5,0.5,1549,1480
1912-04-18,Jersey,Guernsey,3,3,0,0.5,0.5,1518,1543
1912-04-19,Jersey,Guernsey,2,5,3,0.0,1.0,1511,1551
1912-04-25,Guernsey,Alderney,4,0,4,1.0,0.0,1557,1448
1912-04-28,Netherlands,Belgium,4,3,1,1.0,0.0,1592,1523
1912-05-05,Austria,Hungary,1,1,0,0.5,0.5,1509,1549
1912-05-05,Switzerland,Germany,1,2,1,0.0,1.0,1471,1488
1912-06-16,Norway,Sweden,1,2,1,0.0,1.0,1471,1526
1912-06-20,Sweden,Hungary,2,2,0,0.5,0.5,1527,1549
1912-06-23,Norway,Hungary,0,6,6,0.0,1.0,1465,1556
1912-06-27,Sweden,Finland,7,1,6,1.0,0.0,1535,1486
1912-06-30,Austria,Italy,5,1,4,1.0,0.0,1517,1471
1912-07-01,Austria,Norway,1,1,0,0.5,0.5,1516,1467
1912-07-03,Hungary,Austria,3,0,3,1.0,0.0,1564,1509
1912-07-03,Norway,Russia,2,1,1,1.0,0.0,1476,1492
1912-07-05,Netherlands,Austria,3,1,2,1.0,0.0,1599,1503
1912-07-12,Russia,Hungary,0,9,9,0.0,1.0,1486,1571
1912-07-14,Russia,Hungary,0,12,12,0.0,1.0,1480,1578
1912-08-15,Uruguay,Argentina,2,0,2,1.0,0.0,1517,1533
1912-08-25,Uruguay,Argentina,3,0,3,1.0,0.0,1526,1525
1912-09-22,Argentina,Uruguay,0,1,1,0.0,1.0,1518,1534
1912-10-06,Argentina,Uruguay,3,3,0,0.5,0.5,1519,1534
1912-10-06,Denmark,Germany,3,1,2,1.0,0.0,1508,1481
1912-11-03,Hungary,Austria,4,0,4,1.0,0.0,1585,1497
1912-11-03,Sweden,Norway,4,2,2,1.0,0.0,1542,1470
1912-11-17,Germany,Netherlands,2,3,1,0.0,1.0,1476,1605
1912-12-01,Uruguay,Argentina,1,3,2,0.0,1.0,1526,1528
1912-12-01,Catalonia,France,1,0,1,1.0,0.0,1501,1486
1912-12-22,Italy,Austria,1,3,2,0.0,1.0,1464,1505
1913-01-12,France,Italy,1,0,1,1.0,0.0,1494,1457
1913-01-18,Northern Ireland,Wales,0,1,1,0.0,1.0,1392,1460
1913-02-04,Philippines,China PR,2,1,1,1.0,0.0,1508,1492
1913-02-15,Northern Ireland,England,2,1,1,1.0,0.0,1406,1715
1913-02-16,Belgium,France,3,0,3,1.0,0.0,1531,1487
1913-03-03,Wales,Scotland,0,0,0,0.5,0.5,1465,1651
1913-03-09,Belgium,Netherlands,3,3,0,0.5,0.5,1533,1604
1913-03-09,Switzerland,France,1,4,3,0.0,1.0,1464,1495
1913-03-15,Northern Ireland,Scotland,1,2,1,0.0,1.0,1403,1655
1913-03-17,England,Wales,4,3,1,1.0,0.0,1719,1462
1913-04-03,Jersey,Alderney,5,2,3,1.0,0.0,1518,1442
1913-04-05,England,Scotland,1,0,1,1.0,0.0,1726,1649
1913-04-17,Jersey,Guernsey,2,4,2,0.0,1.0,1511,1565
1913-04-20,France,Luxembourg,8,0,8,1.0,0.0,1503,1484
1913-04-20,Netherlands,Belgium,2,4,2,0.0,1.0,1595,1543
1913-04-27,Austria,Hungary,1,4,3,0.0,1.0,1499,1592
1913-05-01,Italy,Belgium,1,0,1,1.0,0.0,1467,1534
1913-05-04,Russia,Sweden,1,4,3,0.0,1.0,1474,1549
1913-05-04,Switzerland,Belgium,1,2,1,0.0,1.0,1458,1541
1913-05-18,Germany,Switzerland,1,2,1,0.0,1.0,1468,1467
1913-05-18,Hungary,Sweden,2,0,2,1.0,0.0,1600,1542
1913-05-25,Denmark,Sweden,8,0,8,1.0,0.0,1517,1534
1913-06-08,Sweden,Norway,9,0,9,1.0,0.0,1541,1464
1913-06-15,Argentina,Uruguay,1,1,0,0.5,0.5,1528,1527
1913-06-15,Austria,Italy,2,0,2,1.0,0.0,1507,1460
1913-07-09,Argentina,Uruguay,2,1,1,1.0,0.0,1536,1520
1913-08-15,Argentina,Uruguay,4,0,4,1.0,0.0,1544,1513
1913-08-31,Argentina,Uruguay,2,0,2,1.0,0.0,1552,1506
1913-09-14,Russia,Norway,1,1,0,0.5,0.5,1474,1465
1913-09-21,Chile,Argentina,0,2,2,0.0,1.0,1467,1559
1913-10-05,Sweden,Denmark,0,10,10,0.0,1.0,1533,1526
1913-10-05,Uruguay,Argentina,1,0,1,1.0,0.0,1516,1550
1913-10-26,Germany,Denmark,1,4,3,0.0,1.0,1462,1533
1913-10-26,Hungary,Austria,4,3,1,1.0,0.0,1606,1502
1913-10-26,Norway,Sweden,1,1,0,0.5,0.5,1467,1532
1913-10-26,Uruguay,Argentina,1,0,1,1.0,0.0,1525,1542
1913-11-02,Belgium,Switzerland,2,0,2,1.0,0.0,1548,1461
1913-11-23,Belgium,Germany,6,2,4,1.0,0.0,1555,1456
1914-01-11,Italy,Austria,0,0,0,0.5,0.5,1461,1502
1914-01-19,Wales,Northern Ireland,1,2,1,0.0,1.0,1453,1413
1914-01-25,France,Belgium,4,3,1,1.0,0.0,1513,1546
1914-02-08,Luxembourg,France,5,4,1,1.0,0.0,1493,1505
1914-02-14,England,Northern Ireland,0,3,3,0.0,1.0,1713,1427
1914-02-28,Scotland,Wales,0,0,0,0.5,0.5,1645,1458
1914-03-08,France,Switzerland,2,2,0,0.5,0.5,1504,1463
1914-03-14,Northern Ireland,Scotland,1,1,0,0.5,0.5,1432,1641
1914-03-15,Belgium,Netherlands,2,4,2,0.0,1.0,1540,1602
1914-03-16,Wales,England,0,2,2,0.0,1.0,1456,1716
1914-03-29,Italy,France,2,0,2,1.0,0.0,1470,1496
1914-04-02,Guernsey,Alderney,4,0,4,1.0,0.0,1571,1437
1914-04-04,Scotland,England,3,1,2,1.0,0.0,1651,1707
1914-04-05,Italy,Switzerland,1,1,0,0.5,0.5,1470,1464
1914-04-05,Netherlands,Germany,4,4,0,0.5,0.5,1599,1460
1914-04-23,Guernsey,Jersey,2,1,1,1.0,0.0,1578,1505
1914-04-26,Netherlands,Belgium,4,2,2,1.0,0.0,1606,1534
1914-05-03,Austria,Hungary,2,0,2,1.0,0.0,1513,1596
1914-05-17,Denmark,Netherlands,4,3,1,1.0,0.0,1543,1597
1914-05-17,Switzerland,Italy,0,1,1,0.0,1.0,1457,1478
1914-05-24,Sweden,Finland,4,3,1,1.0,0.0,1539,1480
1914-05-31,Hungary,France,5,1,4,1.0,0.0,1602,1491
1914-06-21,Sweden,Hungary,1,1,0,0.5,0.5,1541,1601
1914-06-28,Norway,Sweden,0,1,1,0.0,1.0,1461,1548
1914-07-05,Sweden,Russia,2,2,0,0.5,0.5,1547,1476
1914-07-12,Norway,Russia,1,1,0,0.5,0.5,1462,1476
1914-08-30,Uruguay,Argentina,3,2,1,1.0,0.0,1534,1534
1914-09-13,Argentina,Uruguay,2,1,1,1.0,0.0,1542,1526
1914-09-20,Argentina,Brazil,3,0,3,1.0,0.0,1550,1493
1914-09-27,Argentina,Brazil,0,1,1,0.0,1.0,1541,1503
1914-10-04,Hungary,Austria,2,2,0,0.5,0.5,1600,1515
1914-10-25,Sweden,Norway,7,0,7,1.0,0.0,1554,1456
1914-11-08,Austria,Hungary,1,2,1,0.0,1.0,1509,1607
1915-01-03,Basque Country,Catalonia,6,1,5,1.0,0.0,1509,1493
1915-01-31,Italy,Switzerland,3,1,2,1.0,0.0,1486,1450
1915-02-07,Catalonia,Basque Country,2,2,0,0.5,0.5,1494,1509
1915-05-02,Hungary,Austria,2,5,3,0.0,1.0,1597,1520
1915-05-13,Basque Country,Catalonia,1,0,1,1.0,0.0,1517,1487
1915-05-18,China PR,Philippines,0,0,0,0.5,0.5,1493,1508
1915-05-19,China PR,Philippines,1,0,1,1.0,0.0,1502,1500
1915-05-30,Austria,Hungary,1,2,1,0.0,1.0,1514,1604
1915-06-06,Denmark,Sweden,2,0,2,1.0,0.0,1552,1546
1915-06-27,Norway,Sweden,1,1,0,0.5,0.5,1459,1544
1915-07-18,Uruguay,Argentina,2,3,1,0.0,1.0,1519,1549
1915-08-15,Argentina,Uruguay,2,1,1,1.0,0.0,1557,1512
1915-09-12,Uruguay,Argentina,2,0,2,1.0,0.0,1522,1548
1915-09-19,Denmark,Norway,8,1,7,1.0,0.0,1558,1454
1915-10-03,Austria,Hungary,4,2,2,1.0,0.0,1525,1594
1915-10-24,Sweden,Norway,5,2,3,1.0,0.0,1550,1449
1915-10-31,Sweden,Denmark,0,2,2,0.0,1.0,1543,1566
1915-11-07,Hungary,Austria,6,2,4,1.0,0.0,1601,1519
1916-05-07,Austria,Hungary,3,1,2,1.0,0.0,1529,1592
1916-05-21,Catalonia,Basque Country,1,3,2,0.0,1.0,1480,1525
1916-05-22,Catalonia,Basque Country,0,0,0,0.5,0.5,1482,1524
1916-06-04,Denmark,Sweden,2,0,2,1.0,0.0,1574,1536
1916-06-04,Hungary,Austria,2,1,1,1.0,0.0,1599,1523
1916-06-04,Basque Country,Catalonia,5,0,5,1.0,0.0,1532,1475
1916-06-25,Norway,Denmark,0,2,2,0.0,1.0,1444,1580
1916-07-02,Chile,Uruguay,0,4,4,0.0,1.0,1461,1529
1916-07-02,Sweden,Norway,6,0,6,1.0,0.0,1542,1439
1916-07-06,Argentina,Chile,6,1,5,1.0,0.0,1555,1455
1916-07-08,Brazil,Chile,1,1,0,0.5,0.5,1502,1457
1916-07-10,Argentina,Brazil,1,1,0,0.5,0.5,1554,1504
1916-07-12,Argentina,Chile,1,0,1,1.0,0.0,1560,1452
1916-07-12,Brazil,Uruguay,1,2,1,0.0,1.0,1497,1537
1916-07-14,Uruguay,Chile,4,1,3,1.0,0.0,1544,1446
1916-07-17,Argentina,Uruguay,0,0,0,0.5,0.5,1560,1545
1916-07-18,Uruguay,Brazil,0,1,1,0.0,1.0,1536,1507
1916-08-15,Argentina,Uruguay,3,1,2,1.0,0.0,1568,1529
1916-08-15,Uruguay,Argentina,1,2,1,0.0,1.0,1522,1576
1916-08-20,Sweden,United States,2,3,1,0.0,1.0,1534,1510
1916-09-03,Norway,United States,1,1,0,0.5,0.5,1441,1509
1916-10-01,Argentina,Uruguay,7,2,5,1.0,0.0,1583,1516
1916-10-01,Hungary,Austria,2,3,1,0.0,1.0,1590,1533
1916-10-01,Norway,Sweden,0,0,0,0.5,0.5,1444,1532
1916-10-01,Uruguay,Argentina,0,1,1,0.0,1.0,1510,1590
1916-10-08,Sweden,Denmark,4,0,4,1.0,0.0,1542,1571
1916-10-15,Denmark,Norway,8,0,8,1.0,0.0,1577,1439
1916-10-29,Uruguay,Argentina,3,1,2,1.0,0.0,1520,1581
1916-11-05,Austria,Hungary,3,3,0,0.5,0.5,1535,1589
1917-05-06,Austria,Hungary,1,1,0,0.5,0.5,1537,1588
1917-05-07,Japan,Philippines,2,15,13,0.0,1.0,1492,1508
1917-05-09,Japan,China PR,0,5,5,0.0,1.0,1485,1510
1917-05-10,Japan,Philippines,2,15,13,0.0,1.0,1478,1516
1917-05-11,China PR,Philippines,3,0,3,1.0,0.0,1519,1508
1917-06-03,Denmark,Sweden,1,1,0,0.5,0.5,1577,1543
1917-06-03,Hungary,Austria,6,2,4,1.0,0.0,1595,1531
1917-06-17,Norway,Denmark,1,2,1,0.0,1.0,1435,1582
1917-07-15,Austria,Hungary,1,4,3,0.0,1.0,1525,1602
1917-07-18,Uruguay,Argentina,0,2,2,0.0,1.0,1514,1588
1917-08-15,Argentina,Uruguay,1,0,1,1.0,0.0,1595,1508
1917-08-19,Sweden,Norway,3,3,0,0.5,0.5,1541,1438
1917-09-02,Uruguay,Argentina,1,0,1,1.0,0.0,1518,1586
1917-09-16,Norway,Sweden,0,2,2,0.0,1.0,1433,1547
1917-09-30,Uruguay,Chile,4,0,4,1.0,0.0,1525,1440
1917-10-03,Argentina,Brazil,4,2,2,1.0,0.0,1593,1501
1917-10-06,Argentina,Chile,1,0,1,1.0,0.0,1598,1436
1917-10-07,Denmark,Norway,12,0,12,1.0,0.0,1587,1429
1917-10-07,Hungary,Austria,2,1,1,1.0,0.0,1609,1519
1917-10-07,Uruguay,Brazil,4,0,4,1.0,0.0,1533,1494
1917-10-12,Brazil,Chile,5,0,5,1.0,0.0,1501,1430
1917-10-14,Sweden,Denmark,1,2,1,0.0,1.0,1540,1595
1917-10-14,Uruguay,Argentina,1,0,1,1.0,0.0,1543,1589
1917-10-16,Uruguay,Brazil,3,1,2,1.0,0.0,1551,1494
1917-11-04,Austria,Hungary,1,2,1,0.0,1.0,1514,1615
1917-12-23,Switzerland,Austria,0,1,1,0.0,1.0,1444,1521
1917-12-26,Switzerland,Austria,3,2,1,1.0,0.0,1454,1512
1918-04-14,Hungary,Austria,2,0,2,1.0,0.0,1621,1507
1918-05-09,Austria,Switzerland,5,1,4,1.0,0.0,1514,1448
1918-05-12,Hungary,Switzerland,2,1,1,1.0,0.0,1626,1444
1918-05-26,Sweden,Norway,2,0,2,1.0,0.0,1546,1424
1918-06-02,Austria,Hungary,0,2,2,0.0,1.0,1509,1632
1918-06-02,Denmark,Sweden,3,0,3,1.0,0.0,1602,1540
1918-06-16,Norway,Denmark,3,1,2,1.0,0.0,1436,1591
1918-07-18,Uruguay,Argentina,1,1,0,0.5,0.5,1552,1589
1918-07-28,Uruguay,Argentina,3,1,2,1.0,0.0,1561,1581
1918-08-15,Argentina,Uruguay,0,0,0,0.5,0.5,1581,1562
1918-08-25,Argentina,Uruguay,2,1,1,1.0,0.0,1589,1555
1918-09-15,Norway,Sweden,2,1,1,1.0,0.0,1447,1530
1918-09-20,Uruguay,Argentina,1,1,0,0.5,0.5,1556,1589
1918-09-29,Argentina,Uruguay,2,0,2,1.0,0.0,1597,1549
1918-10-06,Austria,Hungary,0,3,3,0.0,1.0,1504,1638
1918-10-06,Denmark,Norway,4,0,4,1.0,0.0,1596,1443
1918-10-20,Sweden,Denmark,1,2,1,0.0,1.0,1524,1603
1919-03-09,Belgium,France,2,2,0,0.5,0.5,1534,1492
1919-04-06,Hungary,Austria,2,1,1,1.0,0.0,1644,1499
1919-04-21,Guernsey,Jersey,2,0,2,1.0,0.0,1585,1499
1919-05-11,Brazil,Chile,6,0,6,1.0,0.0,1501,1424
1919-05-11,Paraguay,Argentina,1,5,4,0.0,1.0,1495,1603
1919-05-12,China PR,Philippines,2,0,2,1.0,0.0,1527,1501
1919-05-13,Argentina,Uruguay,2,3,1,0.0,1.0,1594,1559
1919-05-13,China PR,Philippines,1,2,1,0.0,1.0,1519,1510
1919-05-15,Paraguay,Argentina,0,3,3,0.0,1.0,1490,1600
1919-05-15,China PR,Philippines,2,1,1,1.0,0.0,1527,1503
1919-05-17,Chile,Uruguay,0,2,2,0.0,1.0,1419,1565
1919-05-18,Brazil,Argentina,3,1,2,1.0,0.0,1512,1590
1919-05-21,Paraguay,Argentina,1,2,1,0.0,1.0,1485,1596
1919-05-22,Argentina,Chile,4,1,3,1.0,0.0,1601,1415
1919-05-24,Paraguay,Argentina,1,2,1,0.0,1.0,1480,1607
1919-05-26,Brazil,Uruguay,2,2,0,0.5,0.5,1514,1564
1919-05-29,Brazil,Uruguay,1,0,1,1.0,0.0,1524,1555
1919-05-29,Sweden,Finland,1,0,1,1.0,0.0,1531,1474
1919-06-01,Brazil,Argentina,3,3,0,0.5,0.5,1526,1606
1919-06-05,Denmark,Sweden,3,0,3,1.0,0.0,1610,1525
1919-06-09,Netherlands,Sweden,3,1,2,1.0,0.0,1604,1519
1919-06-12,Denmark,Norway,5,1,4,1.0,0.0,1615,1439
1919-06-29,Norway,Sweden,4,3,1,1.0,0.0,1449,1510
1919-07-18,Uruguay,Argentina,4,1,3,1.0,0.0,1565,1597
1919-08-24,Sweden,Netherlands,4,1,3,1.0,0.0,1521,1594
1919-08-24,Uruguay,Argentina,2,1,1,1.0,0.0,1574,1589
1919-08-31,Norway,Netherlands,1,1,0,0.5,0.5,1453,1591
1919-09-07,Argentina,Uruguay,1,2,1,0.0,1.0,1581,1583
1919-09-14,Sweden,Norway,1,5,4,0.0,1.0,1512,1463
1919-09-21,Norway,Denmark,3,2,1,1.0,0.0,1475,1604
1919-09-28,Finland,Sweden,3,3,0,0.5,0.5,1475,1512
1919-10-05,Austria,Hungary,2,0,2,1.0,0.0,1511,1633
1919-10-12,Sweden,Denmark,3,0,3,1.0,0.0,1523,1594
1919-10-19,Argentina,Uruguay,6,1,5,1.0,0.0,1590,1575
1919-10-25,Northern Ireland,England,1,1,0,0.5,0.5,1438,1702
1919-11-09,Hungary,Austria,3,2,1,1.0,0.0,1639,1506
1919-12-07,Uruguay,Argentina,4,2,2,1.0,0.0,1584,1582
1920-01-18,Italy,France,9,4,5,1.0,0.0,1495,1484
1920-02-14,Northern Ireland,Wales,2,2,0,0.5,0.5,1439,1456
1920-02-26,Wales,Scotland,1,1,0,0.5,0.5,1461,1647
1920-02-29,Switzerland,France,0,2,2,0.0,1.0,1437,1492
1920-03-13,Scotland,Northern Ireland,3,0,3,1.0,0.0,1651,1436
1920-03-15,England,Wales,1,2,1,0.0,1.0,1690,1474
1920-03-28,France,Belgium,2,1,1,1.0,0.0,1501,1526
1920-03-28,Switzerland,Italy,3,0,3,1.0,0.0,1447,1486
1920-04-05,Netherlands,Denmark,2,0,2,1.0,0.0,1600,1586
1920-04-10,England,Scotland,5,4,1,1.0,0.0,1698,1644
1920-04-15,Guernsey,Jersey,1,0,1,1.0,0.0,1592,1493
1920-04-29,Alderney,Guernsey,1,0,1,1.0,0.0,1449,1581
1920-05-02,Austria,Hungary,2,2,0,0.5,0.5,1509,1637
1920-05-13,Italy,Netherlands,1,1,0,0.5,0.5,1489,1598
1920-05-16,Switzerland,Netherlands,2,1,1,1.0,0.0,1459,1587
1920-05-30,Sweden,Finland,4,0,4,1.0,0.0,1530,1469
1920-06-06,Sweden,Switzerland,0,1,1,0.0,1.0,1521,1469
1920-06-13,Norway,Denmark,1,1,0,0.5,0.5,1478,1584
1920-06-27,Norway,Sweden,0,3,3,0.0,1.0,1471,1529
1920-06-27,Switzerland,Germany,4,1,3,1.0,0.0,1477,1453
1920-07-18,Uruguay,Argentina,2,0,2,1.0,0.0,1592,1575
1920-07-25,Argentina,Uruguay,1,3,2,0.0,1.0,1568,1600
1920-08-08,Argentina,Uruguay,1,0,1,1.0,0.0,1577,1592
1920-09-11,Chile,Brazil,0,1,1,0.0,1.0,1410,1532
1920-09-12,Uruguay,Argentina,1,1,0,0.5,0.5,1592,1578
1920-09-18,Brazil,Uruguay,0,6,6,0.0,1.0,1526,1599
1920-09-19,Finland,Sweden,1,0,1,1.0,0.0,1479,1520
1920-09-20,Chile,Argentina,1,1,0,0.5,0.5,1414,1575
1920-09-25,Argentina,Brazil,2,0,2,1.0,0.0,1582,1520
1920-09-26,Austria,Germany,3,2,1,1.0,0.0,1516,1447
1920-09-26,Sweden,Norway,0,0,0,0.5,0.5,1519,1473
1920-10-03,Chile,Uruguay,1,2,1,0.0,1.0,1410,1604
1920-10-10,Sweden,Denmark,0,2,2,0.0,1.0,1513,1591
1920-10-17,Finland,Estonia,6,0,6,1.0,0.0,1488,1492
1920-10-23,England,Northern Ireland,2,0,2,1.0,0.0,1701,1434
1920-10-24,Germany,Hungary,1,0,1,1.0,0.0,1459,1626
1920-11-07,Hungary,Austria,1,2,1,0.0,1.0,1616,1527
1921-02-12,Scotland,Wales,2,1,1,1.0,0.0,1649,1470
1921-02-20,France,Italy,1,2,1,0.0,1.0,1493,1498
1921-02-26,Northern Ireland,Scotland,0,2,2,0.0,1.0,1431,1653
1921-03-06,Belgium,France,3,1,2,1.0,0.0,1534,1486
1921-03-06,Italy,Switzerland,2,1,1,1.0,0.0,1506,1470
1921-03-14,Wales,England,0,0,0,0.5,0.5,1475,1697
1921-03-26,Austria,Sweden,2,2,0,0.5,0.5,1527,1514
1921-03-28,Guernsey,Alderney,3,0,3,1.0,0.0,1587,1444
1921-04-03,Catalonia,Provence,4,0,4,1.0,0.0,1484,1492
1921-04-04,Catalonia,Provence,1,0,1,1.0,0.0,1493,1484
1921-04-07,Paraguay,Argentina,3,1,2,1.0,0.0,1491,1572
1921-04-07,Jersey,Alderney,2,0,2,1.0,0.0,1500,1438
1921-04-09,Scotland,England,3,0,3,1.0,0.0,1663,1688
1921-04-09,Wales,Northern Ireland,2,1,1,1.0,0.0,1482,1425
1921-04-14,Paraguay,Argentina,2,2,0,0.5,0.5,1493,1571
1921-04-24,Austria,Hungary,4,1,3,1.0,0.0,1538,1606
1921-04-28,Guernsey,Jersey,0,1,1,0.0,1.0,1578,1510
1921-05-01,Switzerland,Austria,2,2,0,0.5,0.5,1472,1537
1921-05-05,Belgium,Italy,2,3,1,0.0,1.0,1526,1515
1921-05-05,Germany,Austria,3,3,0,0.5,0.5,1461,1536
1921-05-08,Netherlands,Italy,2,2,0,0.5,0.5,1586,1517
1921-05-15,Belgium,Netherlands,1,1,0,0.5,0.5,1528,1585
1921-05-21,Belgium,England,0,2,2,0.0,1.0,1524,1693
1921-05-25,Norway,Finland,3,2,1,1.0,0.0,1482,1480
1921-05-29,Sweden,Finland,0,3,3,0.0,1.0,1506,1489
1921-05-30,Japan,Philippines,0,3,3,0.0,1.0,1471,1511
1921-05-30,Philippines,Japan,3,1,2,1.0,0.0,1519,1464
1921-05-31,China PR,Philippines,1,0,1,1.0,0.0,1535,1512
1921-06-01,China PR,Japan,4,0,4,1.0,0.0,1542,1458
1921-06-03,China PR,Japan,3,0,3,1.0,0.0,1549,1452
1921-06-05,Hungary,Germany,3,0,3,1.0,0.0,1611,1457
1921-06-12,Denmark,Netherlands,1,1,0,0.5,0.5,1591,1586
1921-06-19,Norway,Sweden,3,1,2,1.0,0.0,1491,1498
1921-07-09,Canada,Scotland,0,1,1,0.0,1.0,1492,1668
1921-07-22,Estonia,Sweden,0,0,0,0.5,0.5,1493,1498
1921-07-24,Sweden,Austria,1,3,2,0.0,1.0,1491,1544
1921-07-31,Finland,Austria,2,3,1,0.0,1.0,1483,1551
1921-08-28,Estonia,Finland,0,3,3,0.0,1.0,1485,1492
1921-09-14,Costa Rica,El Salvador,7,0,7,1.0,0.0,1508,1492
1921-09-18,Finland,Germany,3,3,0,0.5,0.5,1492,1458
1921-09-18,Guatemala,Costa Rica,0,6,6,0.0,1.0,1493,1516
1921-09-18,Sweden,Norway,0,3,3,0.0,1.0,1483,1499
1921-10-02,Argentina,Brazil,1,0,1,1.0,0.0,1578,1514
1921-10-02,Denmark,Norway,3,1,2,1.0,0.0,1597,1494
1921-10-09,Paraguay,Uruguay,2,1,1,1.0,0.0,1504,1594
1921-10-09,Sweden,Denmark,0,0,0,0.5,0.5,1486,1595
1921-10-12,Brazil,Paraguay,3,0,3,1.0,0.0,1522,1497
1921-10-16,Argentina,Paraguay,3,0,3,1.0,0.0,1585,1491
1921-10-22,Northern Ireland,England,1,1,0,0.5,0.5,1431,1688
1921-10-23,Brazil,Uruguay,1,2,1,0.0,1.0,1516,1601
1921-10-28,Czechoslovakia,Yugoslavia,6,1,5,1.0,0.0,1495,1492
1921-10-30,Argentina,Uruguay,1,0,1,1.0,0.0,1594,1593
1921-11-02,Uruguay,Paraguay,4,2,2,1.0,0.0,1599,1486
1921-11-06,Hungary,Sweden,4,2,2,1.0,0.0,1617,1481
1921-11-06,Switzerland,Italy,1,1,0,0.5,0.5,1474,1516
1921-11-13,Czechoslovakia,Sweden,2,2,0,0.5,0.5,1495,1482
1921-11-13,France,Netherlands,0,5,5,0.0,1.0,1481,1592
1921-12-18,Hungary,Poland,1,0,1,1.0,0.0,1623,1495
1921-12-18,Spain,Portugal,3,1,2,1.0,0.0,1508,1492
1922-01-15,France,Belgium,2,1,1,1.0,0.0,1490,1516
1922-01-15,Italy,Austria,3,3,0,0.5,0.5,1517,1551
1922-02-04,Wales,Scotland,2,1,1,1.0,0.0,1494,1657
1922-02-26,Italy,Czechoslovakia,1,1,0,0.5,0.5,1517,1496
1922-03-04,Scotland,Northern Ireland,2,1,1,1.0,0.0,1661,1428
1922-03-12,Brittany,Luxembourg,1,0,1,1.0,0.0,1508,1486
1922-03-13,England,Wales,1,0,1,1.0,0.0,1692,1491
1922-03-26,Belgium,Netherlands,4,0,4,1.0,0.0,1526,1583
1922-03-26,Germany,Switzerland,2,2,0,0.5,0.5,1459,1474
1922-04-06,Guernsey,Alderney,8,0,8,1.0,0.0,1583,1434
1922-04-08,England,Scotland,0,1,1,0.0,1.0,1684,1670
1922-04-15,Belgium,Denmark,0,0,0,0.5,0.5,1528,1594
1922-04-17,Netherlands,Denmark,2,0,2,1.0,0.0,1592,1586
1922-04-17,Guernsey,Alderney,3,1,2,1.0,0.0,1588,1430
1922-04-23,Austria,Germany,0,2,2,0.0,1.0,1541,1470
1922-04-27,Jersey,Guernsey,1,2,1,0.0,1.0,1504,1595
1922-04-30,France,Spain,0,4,4,0.0,1.0,1483,1516
1922-04-30,Hungary,Austria,1,1,0,0.5,0.5,1622,1543
1922-05-07,Netherlands,Belgium,1,2,1,0.0,1.0,1583,1538
1922-05-14,Poland,Hungary,0,3,3,0.0,1.0,1490,1628
1922-05-21,Italy,Belgium,4,2,2,1.0,0.0,1526,1530
1922-05-25,Norway,Northern Ireland,2,1,1,1.0,0.0,1501,1422
1922-05-28,Sweden,Poland,1,2,1,0.0,1.0,1475,1498
1922-06-05,Finland,Sweden,1,4,3,0.0,1.0,1484,1484
1922-06-08,Yugoslavia,Romania,1,2,1,0.0,1.0,1485,1508
1922-06-11,Austria,Switzerland,7,1,6,1.0,0.0,1550,1468
1922-06-11,Denmark,Czechoslovakia,0,3,3,0.0,1.0,1576,1507
1922-06-11,Norway,France,7,0,7,1.0,0.0,1509,1476
1922-06-15,Hungary,Switzerland,1,1,0,0.5,0.5,1625,1472
1922-06-17,New Zealand,Australia,3,1,2,1.0,0.0,1508,1492
1922-06-24,New Zealand,Australia,1,1,0,0.5,0.5,1508,1493
1922-06-28,Yugoslavia,Czechoslovakia,4,3,1,1.0,0.0,1494,1499
1922-07-02,Germany,Hungary,0,0,0,0.5,0.5,1474,1622
1922-07-08,New Zealand,Australia,3,1,2,1.0,0.0,1516,1486
1922-07-09,Sweden,Hungary,1,1,0,0.5,0.5,1488,1619
1922-07-13,Finland,Hungary,1,5,4,0.0,1.0,1479,1625
1922-08-11,Finland,Estonia,10,2,8,1.0,0.0,1488,1477
1922-08-13,Sweden,Czechoslovakia,0,2,2,0.0,1.0,1481,1507
1922-08-23,Sweden,Norway,0,0,0,0.5,0.5,1482,1509
1922-08-26,Finland,Norway,1,3,2,0.0,1.0,1481,1517
1922-09-03,Romania,Poland,1,1,0,0.5,0.5,1508,1499
1922-09-10,Norway,Denmark,3,3,0,0.5,0.5,1519,1575
1922-09-17,Brazil,Chile,1,1,0,0.5,0.5,1514,1413
1922-09-23,Chile,Uruguay,0,2,2,0.0,1.0,1409,1604
1922-09-24,Austria,Hungary,2,2,0,0.5,0.5,1552,1624
1922-09-24,Brazil,Paraguay,1,1,0,0.5,0.5,1514,1487
1922-09-24,Latvia,Estonia,1,1,0,0.5,0.5,1500,1478
1922-09-24,Norway,Sweden,0,5,5,0.0,1.0,1511,1491
1922-09-28,Argentina,Chile,4,0,4,1.0,0.0,1599,1405
1922-10-01,Brazil,Uruguay,0,0,0,0.5,0.5,1517,1602
1922-10-01,Denmark,Sweden,1,2,1,0.0,1.0,1566,1501
1922-10-01,Yugoslavia,Poland,1,3,2,0.0,1.0,1487,1507
1922-10-05,Chile,Paraguay,0,3,3,0.0,1.0,1399,1494
1922-10-08,Argentina,Uruguay,0,1,1,0.0,1.0,1592,1610
1922-10-12,Paraguay,Uruguay,1,0,1,1.0,0.0,1505,1600
1922-10-15,Brazil,Argentina,2,0,2,1.0,0.0,1527,1583
1922-10-18,Argentina,Paraguay,2,0,2,1.0,0.0,1590,1499
1922-10-21,England,Northern Ireland,2,0,2,1.0,0.0,1687,1420
1922-10-22,Argentina,Chile,1,0,1,1.0,0.0,1594,1396
1922-10-22,Brazil,Paraguay,3,0,3,1.0,0.0,1535,1492
1922-10-22,Brazil,Argentina,2,1,1,1.0,0.0,1545,1585
1922-10-29,Brazil,Paraguay,3,1,2,1.0,0.0,1552,1486
1922-11-12,Uruguay,Argentina,1,0,1,1.0,0.0,1608,1578
1922-11-19,Switzerland,Netherlands,5,0,5,1.0,0.0,1483,1573
1922-11-19,Galicia,Central Spain,4,1,3,1.0,0.0,1508,1492
1922-11-26,Hungary,Austria,1,2,1,0.0,1.0,1615,1562
1922-12-03,Italy,Switzerland,2,2,0,0.5,0.5,1526,1484
1922-12-10,Uruguay,Argentina,1,0,1,1.0,0.0,1616,1571
1922-12-17,Argentina,Uruguay,2,2,0,0.5,0.5,1573,1615
1922-12-17,Portugal,Spain,1,2,1,0.0,1.0,1485,1524
1923-01-01,Guatemala,Mexico,2,3,1,0.0,1.0,1486,1508
1923-01-01,Italy,Germany,3,1,2,1.0,0.0,1533,1468
1923-01-04,Guatemala,Mexico,3,1,2,1.0,0.0,1495,1500
1923-01-07,Guatemala,Mexico,1,4,3,0.0,1.0,1488,1508
1923-01-14,Andalusia,Galicia,1,4,3,0.0,1.0,1493,1516
1923-01-21,Switzerland,Austria,2,0,2,1.0,0.0,1494,1553
1923-01-28,Spain,France,3,0,3,1.0,0.0,1531,1470
1923-02-04,Belgium,Spain,1,0,1,1.0,0.0,1539,1523
1923-02-11,Luxembourg,Brittany,1,4,3,0.0,1.0,1479,1516
1923-02-25,Belgium,France,4,1,3,1.0,0.0,1546,1464
1923-02-25,Galicia,Asturias,1,3,2,0.0,1.0,1508,1509
1923-03-03,Northern Ireland,Scotland,0,1,1,0.0,1.0,1417,1674
1923-03-04,Italy,Hungary,0,0,0,0.5,0.5,1535,1614
1923-03-05,Wales,England,2,2,0,0.5,0.5,1496,1683
1923-03-11,Switzerland,Hungary,1,6,5,0.0,1.0,1489,1620
1923-03-17,Scotland,Wales,2,0,2,1.0,0.0,1679,1492
1923-03-19,England,Belgium,6,1,5,1.0,0.0,1688,1542
1923-04-02,Netherlands,France,8,1,7,1.0,0.0,1579,1459
1923-04-02,Guernsey,Alderney,2,1,1,1.0,0.0,1600,1426
1923-04-12,Jersey,Guernsey,0,1,1,0.0,1.0,1499,1606
1923-04-14,Scotland,England,2,2,0,0.5,0.5,1680,1688
1923-04-14,Wales,Northern Ireland,0,3,3,0.0,1.0,1483,1427
1923-04-15,Austria,Italy,0,0,0,0.5,0.5,1553,1536
1923-04-22,France,Switzerland,2,2,0,0.5,0.5,1460,1489
1923-04-26,Guernsey,Alderney,3,2,1,1.0,0.0,1611,1422
1923-04-29,Netherlands,Belgium,1,1,0,0.5,0.5,1579,1543
1923-05-06,Austria,Hungary,1,0,1,1.0,0.0,1563,1611
1923-05-06,Czechoslovakia,Denmark,2,0,2,1.0,0.0,1517,1557
1923-05-10,France,England,1,4,3,0.0,1.0,1457,1692
1923-05-10,Germany,Netherlands,0,0,0,0.5,0.5,1471,1577
1923-05-20,Argentina,Paraguay,0,2,2,0.0,1.0,1564,1496
1923-05-21,Sweden,England,2,4,2,0.0,1.0,1498,1696
1923-05-22,China PR,Philippines,3,0,3,1.0,0.0,1557,1505
1923-05-22,China PR,Philippines,3,0,3,1.0,0.0,1564,1499
1923-05-23,Japan,Philippines,1,2,1,0.0,1.0,1446,1506
1923-05-24,Japan,China PR,1,5,4,0.0,1.0,1441,1570
1923-05-24,Sweden,England,1,3,2,0.0,1.0,1495,1700
1923-05-24,Japan,China PR,1,5,4,0.0,1.0,1436,1576
1923-05-25,Argentina,Paraguay,1,0,1,1.0,0.0,1571,1490
1923-05-27,Czechoslovakia,Italy,5,1,4,1.0,0.0,1526,1528
1923-06-03,Poland,Yugoslavia,1,2,1,0.0,1.0,1499,1496
1923-06-03,Switzerland,Germany,1,2,1,0.0,1.0,1481,1480
1923-06-09,Australia,New Zealand,2,1,1,1.0,0.0,1495,1508
1923-06-10,Romania,Yugoslavia,1,2,1,0.0,1.0,1500,1505
1923-06-10,Sweden,Austria,4,2,2,1.0,0.0,1505,1554
1923-06-16,Australia,New Zealand,2,3,1,0.0,1.0,1488,1516
1923-06-17,Denmark,Switzerland,3,2,1,1.0,0.0,1564,1475
1923-06-17,Norway,Finland,3,0,3,1.0,0.0,1519,1474
1923-06-20,Sweden,Finland,5,4,1,1.0,0.0,1513,1467
1923-06-21,Norway,Switzerland,2,2,0,0.5,0.5,1518,1477
1923-06-24,Argentina,Uruguay,0,0,0,0.5,0.5,1573,1614
1923-06-24,Lithuania,Estonia,0,5,5,0.0,1.0,1492,1487
1923-06-29,Sweden,Germany,2,1,1,1.0,0.0,1521,1473
1923-06-30,Australia,New Zealand,1,4,3,0.0,1.0,1481,1524
1923-07-01,Romania,Czechoslovakia,0,6,6,0.0,1.0,1493,1534
1923-07-15,Argentina,Uruguay,2,2,0,0.5,0.5,1574,1614
1923-07-22,Uruguay,Argentina,2,2,0,0.5,0.5,1614,1575
1923-07-24,Estonia,Latvia,1,1,0,0.5,0.5,1488,1500
1923-08-12,Germany,Finland,1,2,1,0.0,1.0,1465,1476
1923-08-15,Austria,Finland,2,1,1,1.0,0.0,1561,1470
1923-08-19,Hungary,Finland,3,1,2,1.0,0.0,1616,1466
1923-09-02,Poland,Romania,1,1,0,0.5,0.5,1499,1494
1923-09-16,Norway,Sweden,2,3,1,0.0,1.0,1511,1529
1923-09-18,Estonia,Russia,2,4,2,0.0,1.0,1480,1485
1923-09-23,Finland,Poland,5,3,2,1.0,0.0,1475,1491
1923-09-23,Hungary,Austria,2,0,2,1.0,0.0,1623,1555
1923-09-25,Estonia,Poland,1,4,3,0.0,1.0,1473,1499
1923-09-30,Denmark,Norway,2,1,1,1.0,0.0,1571,1505
1923-09-30,Estonia,Finland,2,1,1,1.0,0.0,1482,1467
1923-09-30,Uruguay,Argentina,0,2,2,0.0,1.0,1606,1584
1923-10-14,Sweden,Denmark,1,3,2,0.0,1.0,1522,1579
1923-10-20,Northern Ireland,England,2,1,1,1.0,0.0,1441,1687
1923-10-26,Turkey,Romania,2,2,0,0.5,0.5,1500,1495
1923-10-28,Czechoslovakia,Yugoslavia,4,4,0,0.5,0.5,1534,1506
1923-10-28,France,Norway,0,2,2,0.0,1.0,1451,1512
1923-10-28,Hungary,Sweden,2,1,1,1.0,0.0,1629,1517
1923-10-29,Argentina,Paraguay,4,3,1,1.0,0.0,1590,1485
1923-11-01,Belgium,England,2,2,0,0.5,0.5,1547,1684
1923-11-01,Poland,Sweden,2,2,0,0.5,0.5,1500,1517
1923-11-01,Brittany,Norway,1,5,4,0.0,1.0,1508,1521
1923-11-04,Germany,Norway,1,0,1,1.0,0.0,1475,1512
1923-11-04,Uruguay,Paraguay,2,0,2,1.0,0.0,1612,1480
1923-11-11,Brazil,Paraguay,0,1,1,0.0,1.0,1543,1490
1923-11-18,Argentina,Brazil,2,1,1,1.0,0.0,1597,1537
1923-11-22,Brazil,Paraguay,2,0,2,1.0,0.0,1544,1484
1923-11-25,Netherlands,Switzerland,4,1,3,1.0,0.0,1583,1472
1923-11-25,Uruguay,Brazil,2,1,1,1.0,0.0,1619,1538
1923-11-25,Central Spain,Galicia,1,0,1,1.0,0.0,1501,1500
1923-12-02,Argentina,Brazil,0,2,2,0.0,1.0,1588,1548
1923-12-02,Uruguay,Argentina,2,0,2,1.0,0.0,1627,1581
1923-12-09,Argentina,Brazil,2,0,2,1.0,0.0,1589,1541
1923-12-09,Mexico,Guatemala,2,1,1,1.0,0.0,1516,1481
1923-12-12,Mexico,Guatemala,2,0,2,1.0,0.0,1524,1474
1923-12-16,Mexico,Guatemala,3,3,0,0.5,0.5,1523,1476
1923-12-16,Spain,Portugal,3,0,3,1.0,0.0,1531,1478
1924-01-13,France,Belgium,2,0,2,1.0,0.0,1462,1537
1924-01-13,Germany,Austria,4,3,1,1.0,0.0,1485,1546
1924-01-20,Italy,Austria,0,4,4,0.0,1.0,1521,1554
1924-02-10,Yugoslavia,Austria,1,4,3,0.0,1.0,1500,1561
1924-02-16,Wales,Scotland,2,0,2,1.0,0.0,1496,1668
1924-03-01,Scotland,Northern Ireland,2,0,2,1.0,0.0,1672,1438
1924-03-03,England,Wales,1,2,1,0.0,1.0,1673,1508
1924-03-09,Italy,Spain,0,0,0,0.5,0.5,1522,1531
1924-03-13,Catalonia,Spain,0,7,7,0.0,1.0,1486,1539
1924-03-15,Northern Ireland,Wales,0,1,1,0.0,1.0,1432,1515
1924-03-23,Netherlands,Belgium,1,1,0,0.5,0.5,1582,1539
1924-03-23,Switzerland,France,3,0,3,1.0,0.0,1480,1455
1924-03-23,Brittany,Luxembourg,1,1,0,0.5,0.5,1508,1480
1924-04-06,Aruba,Curaçao,0,4,4,0.0,1.0,1492,1508
1924-04-06,Hungary,Italy,7,1,6,1.0,0.0,1635,1517
1924-04-10,Jersey,Alderney,1,0,1,1.0,0.0,1506,1416
1924-04-12,England,Scotland,1,1,0,0.5,0.5,1673,1673
1924-04-21,Netherlands,Germany,0,1,1,0.0,1.0,1572,1496
1924-04-21,Switzerland,Denmark,2,0,2,1.0,0.0,1491,1569
1924-04-21,Guernsey,Alderney,1,2,1,0.0,1.0,1599,1429
1924-04-27,Belgium,Netherlands,1,1,0,0.5,0.5,1540,1572
1924-05-01,Jersey,Guernsey,1,0,1,1.0,0.0,1517,1589
1924-05-04,Hungary,Austria,2,2,0,0.5,0.5,1634,1563
1924-05-15,Paraguay,Argentina,1,3,2,0.0,1.0,1479,1595
1924-05-17,France,England,1,3,2,0.0,1.0,1452,1677
1924-05-18,Paraguay,Argentina,2,1,1,1.0,0.0,1490,1585
1924-05-18,Sweden,Poland,5,1,4,1.0,0.0,1525,1493
1924-05-18,Switzerland,Hungary,4,2,2,1.0,0.0,1503,1623
1924-05-20,Austria,Romania,4,1,3,1.0,0.0,1570,1489
1924-05-21,Austria,Bulgaria,6,0,6,1.0,0.0,1577,1494
1924-05-25,Argentina,Uruguay,4,0,4,1.0,0.0,1594,1619
1924-05-25,Uruguay,Argentina,2,0,2,1.0,0.0,1627,1587
1924-05-25,Italy,Spain,1,0,1,1.0,0.0,1526,1531
1924-05-25,Czechoslovakia,Turkey,5,2,3,1.0,0.0,1542,1493
1924-05-25,Switzerland,Lithuania,9,0,9,1.0,0.0,1511,1485
1924-05-25,United States,Estonia,1,0,1,1.0,0.0,1517,1475
1924-05-26,Uruguay,Yugoslavia,7,0,7,1.0,0.0,1633,1495
1924-05-26,Hungary,Poland,5,0,5,1.0,0.0,1629,1488
1924-05-27,Egypt,Lithuania,10,0,10,1.0,0.0,1508,1478
1924-05-27,France,Latvia,7,0,7,1.0,0.0,1462,1491
1924-05-27,Netherlands,Romania,6,0,6,1.0,0.0,1579,1483
1924-05-28,Switzerland,Czechoslovakia,1,1,0,0.5,0.5,1512,1542
1924-05-28,Republic of Ireland,Bulgaria,1,0,1,1.0,0.0,1508,1487
1924-05-29,Italy,Luxembourg,2,0,2,1.0,0.0,1533,1474
1924-05-29,Sweden,Belgium,8,1,7,1.0,0.0,1534,1532
1924-05-29,Egypt,Hungary,3,0,3,1.0,0.0,1519,1619
1924-05-29,Uruguay,United States,3,0,3,1.0,0.0,1639,1512
1924-05-30,Switzerland,Czechoslovakia,1,0,1,1.0,0.0,1521,1534
1924-06-01,France,Uruguay,1,5,4,0.0,1.0,1458,1644
1924-06-01,Sweden,Egypt,5,0,5,1.0,0.0,1542,1512
1924-06-02,Switzerland,Italy,2,1,1,1.0,0.0,1530,1525
1924-06-02,Netherlands,Republic of Ireland,2,1,1,1.0,0.0,1586,1502
1924-06-04,France,Hungary,0,1,1,0.0,1.0,1454,1624
1924-06-05,Switzerland,Sweden,2,1,1,1.0,0.0,1539,1534
1924-06-06,Uruguay,Netherlands,2,1,1,1.0,0.0,1651,1580
1924-06-07,Australia,Canada,3,2,1,1.0,0.0,1490,1484
1924-06-08,Sweden,Netherlands,1,1,0,0.5,0.5,1536,1579
1924-06-09,Sweden,Netherlands,3,1,2,1.0,0.0,1545,1571
1924-06-09,Uruguay,Switzerland,3,0,3,1.0,0.0,1657,1534
1924-06-10,Poland,United States,2,3,1,0.0,1.0,1481,1520
1924-06-14,Australia,Canada,0,1,1,0.0,1.0,1482,1493
1924-06-15,Denmark,Sweden,2,3,1,0.0,1.0,1561,1554
1924-06-15,Norway,Germany,0,2,2,0.0,1.0,1504,1505
1924-06-15,Catalonia,Basque Country,1,2,1,0.0,1.0,1480,1539
1924-06-17,Finland,Turkey,2,4,2,0.0,1.0,1460,1501
1924-06-19,Estonia,Turkey,1,4,3,0.0,1.0,1468,1509
1924-06-22,Austria,Egypt,3,1,2,1.0,0.0,1584,1506
1924-06-22,Latvia,Turkey,1,3,2,0.0,1.0,1484,1517
1924-06-23,Australia,Canada,4,1,3,1.0,0.0,1491,1485
1924-06-28,Australia,Canada,0,0,0,0.5,0.5,1491,1486
1924-06-29,Poland,Turkey,2,0,2,1.0,0.0,1490,1509
1924-06-29,Sweden,Egypt,5,0,5,1.0,0.0,1561,1500
1924-07-12,Australia,Canada,1,4,3,0.0,1.0,1483,1495
1924-07-25,Sweden,Estonia,5,2,3,1.0,0.0,1567,1463
1924-07-26,Australia,Canada,1,0,1,1.0,0.0,1492,1487
1924-07-28,Finland,Sweden,5,7,2,0.0,1.0,1455,1573
1924-08-10,Poland,Finland,1,0,1,1.0,0.0,1498,1448
1924-08-14,Latvia,Finland,0,2,2,0.0,1.0,1476,1457
1924-08-23,Finland,Norway,2,0,2,1.0,0.0,1467,1495
1924-08-24,Estonia,Lithuania,1,2,1,0.0,1.0,1456,1486
1924-08-31,Czechoslovakia,Romania,4,1,3,1.0,0.0,1541,1477
1924-08-31,Germany,Sweden,1,4,3,0.0,1.0,1499,1580
1924-08-31,Hungary,Poland,4,0,4,1.0,0.0,1630,1493
1924-09-14,Austria,Hungary,2,1,1,1.0,0.0,1594,1621
1924-09-14,Finland,Estonia,4,0,4,1.0,0.0,1475,1449
1924-09-14,Norway,Denmark,1,3,2,0.0,1.0,1489,1568
1924-09-21,Hungary,Germany,4,1,3,1.0,0.0,1627,1494
1924-09-21,Sweden,Norway,6,1,5,1.0,0.0,1586,1484
1924-09-21,Uruguay,Argentina,1,1,0,0.5,0.5,1656,1589
1924-09-24,Northern Ireland,South Africa,1,2,1,0.0,1.0,1426,1507
1924-09-28,Yugoslavia,Czechoslovakia,0,2,2,0.0,1.0,1489,1548
1924-10-02,Argentina,Uruguay,2,1,1,1.0,0.0,1599,1647
1924-10-05,Denmark,Belgium,2,1,1,1.0,0.0,1576,1525
1924-10-12,Argentina,Paraguay,0,0,0,0.5,0.5,1597,1493
1924-10-18,Latvia,Estonia,2,0,2,1.0,0.0,1484,1442
1924-10-19,Uruguay,Chile,5,0,5,1.0,0.0,1651,1393
1924-10-22,England,Northern Ireland,3,1,2,1.0,0.0,1681,1423
1924-10-25,Argentina,Chile,2,0,2,1.0,0.0,1601,1390
1924-10-26,Uruguay,Paraguay,3,1,2,1.0,0.0,1656,1489
1924-11-01,Chile,Paraguay,1,3,2,0.0,1.0,1385,1495
1924-11-02,Netherlands,South Africa,2,1,1,1.0,0.0,1578,1501
1924-11-02,Uruguay,Argentina,0,0,0,0.5,0.5,1655,1603
1924-11-09,Austria,Sweden,1,1,0,0.5,0.5,1594,1587
1924-11-11,Belgium,France,3,0,3,1.0,0.0,1532,1448
1924-11-16,Italy,Sweden,2,2,0,0.5,0.5,1527,1586
1924-11-16,Russia,Turkey,3,0,3,1.0,0.0,1494,1501
1924-11-23,Germany,Italy,0,1,1,0.0,1.0,1487,1535
1924-12-08,England,Belgium,4,0,4,1.0,0.0,1686,1528
1924-12-14,Germany,Switzerland,1,1,0,0.5,0.5,1489,1533
1924-12-21,Spain,Austria,2,1,1,1.0,0.0,1541,1585
1925-02-14,Scotland,Wales,3,1,2,1.0,0.0,1678,1511
1925-02-22,Luxembourg,Brittany,1,1,0,0.5,0.5,1475,1508
1925-02-28,Northern Ireland,Scotland,0,3,3,0.0,1.0,1421,1681
1925-02-28,Wales,England,1,2,1,0.0,1.0,1507,1691
1925-03-12,Guernsey,Alderney,3,0,3,1.0,0.0,1594,1425
1925-03-15,Belgium,Netherlands,0,1,1,0.0,1.0,1522,1585
1925-03-22,Austria,Switzerland,2,0,2,1.0,0.0,1592,1527
1925-03-22,Haiti,Jamaica,1,2,1,0.0,1.0,1492,1508
1925-03-22,Italy,France,7,0,7,1.0,0.0,1542,1442
1925-03-25,Hungary,Switzerland,5,0,5,1.0,0.0,1633,1522
1925-03-26,Haiti,Jamaica,0,3,3,0.0,1.0,1485,1516
1925-03-29,Haiti,Jamaica,0,1,1,0.0,1.0,1478,1524
1925-03-29,Netherlands,Germany,2,1,1,1.0,0.0,1591,1484
1925-04-02,Guernsey,Alderney,3,0,3,1.0,0.0,1599,1421
1925-04-04,Scotland,England,2,0,2,1.0,0.0,1690,1683
1925-04-10,Turkey,Bulgaria,2,1,1,1.0,0.0,1509,1480
1925-04-18,Wales,Northern Ireland,0,0,0,0.5,0.5,1506,1423
1925-04-19,France,Austria,0,4,4,0.0,1.0,1438,1597
1925-04-19,Switzerland,Netherlands,4,1,3,1.0,0.0,1532,1582
1925-04-30,Guernsey,Jersey,2,1,1,1.0,0.0,1606,1511
1925-05-01,Romania,Turkey,1,2,1,0.0,1.0,1470,1517
1925-05-03,Netherlands,Belgium,5,0,5,1.0,0.0,1589,1516
1925-05-05,Austria,Hungary,3,1,2,1.0,0.0,1606,1625
1925-05-15,Turkey,Russia,1,2,1,0.0,1.0,1509,1503
1925-05-18,Philippines,Japan,4,0,4,1.0,0.0,1513,1430
1925-05-20,China PR,Japan,2,0,2,1.0,0.0,1581,1426
1925-05-20,Japan,China PR,0,2,2,0.0,1.0,1422,1586
1925-05-21,France,England,2,3,1,0.0,1.0,1435,1687
1925-05-21,Hungary,Belgium,1,3,2,0.0,1.0,1615,1527
1925-05-22,Philippines,China PR,1,5,4,0.0,1.0,1507,1593
1925-05-22,Philippines,China PR,1,5,4,0.0,1.0,1501,1600
1925-05-24,Czechoslovakia,Austria,3,1,2,1.0,0.0,1558,1597
1925-05-24,Switzerland,Belgium,0,0,0,0.5,0.5,1532,1528
1925-05-31,Bulgaria,Romania,2,4,2,0.0,1.0,1472,1479
1925-06-01,Switzerland,Spain,0,3,3,0.0,1.0,1525,1549
1925-06-07,Norway,Finland,1,0,1,1.0,0.0,1492,1468
1925-06-09,Sweden,Finland,4,0,4,1.0,0.0,1592,1463
1925-06-14,Spain,Italy,1,0,1,1.0,0.0,1557,1535
1925-06-14,Sweden,Denmark,0,2,2,0.0,1.0,1584,1585
1925-06-18,Portugal,Italy,1,0,1,1.0,0.0,1488,1526
1925-06-21,Denmark,Norway,5,1,4,1.0,0.0,1591,1487
1925-06-21,Sweden,Germany,1,0,1,1.0,0.0,1590,1479
1925-06-26,Finland,Germany,3,5,2,0.0,1.0,1456,1487
1925-06-27,Canada,United States,1,0,1,1.0,0.0,1496,1512
1925-06-28,Lithuania,Estonia,0,1,1,0.0,1.0,1477,1452
1925-07-05,Estonia,Finland,2,0,2,1.0,0.0,1461,1448
1925-07-05,Sweden,Austria,2,4,2,0.0,1.0,1583,1605
1925-07-09,Argentina,Paraguay,1,1,0,0.5,0.5,1601,1498
1925-07-10,Finland,Austria,1,2,1,0.0,1.0,1444,1610
1925-07-12,Argentina,Paraguay,1,1,0,0.5,0.5,1599,1501
1925-07-12,Sweden,Hungary,6,2,4,1.0,0.0,1592,1607
1925-07-14,Uruguay,Paraguay,0,1,1,0.0,1.0,1644,1513
1925-07-18,Uruguay,Paraguay,0,1,1,0.0,1.0,1634,1524
1925-07-19,Poland,Hungary,0,2,2,0.0,1.0,1488,1613
1925-08-09,Finland,Latvia,3,1,2,1.0,0.0,1453,1476
1925-08-15,Paraguay,Uruguay,1,0,1,1.0,0.0,1535,1624
1925-08-19,Paraguay,Uruguay,0,1,1,0.0,1.0,1530,1630
1925-08-23,Norway,Sweden,3,7,4,0.0,1.0,1482,1598
1925-08-23,Paraguay,Uruguay,0,0,0,0.5,0.5,1533,1628
1925-08-26,Estonia,Latvia,2,2,0,0.5,0.5,1462,1476
1925-08-30,Finland,Poland,2,2,0,0.5,0.5,1454,1488
1925-09-02,Estonia,Poland,0,0,0,0.5,0.5,1463,1488
1925-09-20,Hungary,Austria,1,1,0,0.5,0.5,1613,1611
1925-09-20,Latvia,Lithuania,2,2,0,0.5,0.5,1477,1477
1925-09-27,Austria,Spain,0,1,1,0.0,1.0,1602,1567
1925-09-27,Denmark,Finland,3,3,0,0.5,0.5,1588,1458
1925-10-02,Turkey,Poland,1,2,1,0.0,1.0,1501,1497
1925-10-04,Hungary,Spain,0,1,1,0.0,1.0,1604,1577
1925-10-11,Czechoslovakia,Hungary,2,0,2,1.0,0.0,1568,1595
1925-10-24,Northern Ireland,England,0,0,0,0.5,0.5,1429,1682
1925-10-25,Netherlands,Denmark,4,2,2,1.0,0.0,1597,1581
1925-10-25,Switzerland,Germany,0,4,4,0.0,1.0,1517,1496
1925-10-28,Czechoslovakia,Yugoslavia,7,0,7,1.0,0.0,1575,1483
1925-10-31,Wales,Scotland,0,3,3,0.0,1.0,1502,1695
1925-11-01,Poland,Sweden,2,6,4,0.0,1.0,1492,1604
1925-11-04,Italy,Yugoslavia,2,1,1,1.0,0.0,1534,1476
1925-11-08,Hungary,Italy,1,1,0,0.5,0.5,1594,1536
1925-11-08,Switzerland,Austria,2,0,2,1.0,0.0,1527,1593
1925-11-08,United States,Canada,6,1,5,1.0,0.0,1520,1489
1925-11-29,Argentina,Paraguay,2,0,2,1.0,0.0,1606,1527
1925-12-06,Brazil,Paraguay,5,2,3,1.0,0.0,1549,1520
1925-12-10,Guernsey,Alderney,4,1,3,1.0,0.0,1611,1417
1925-12-13,Argentina,Brazil,4,1,3,1.0,0.0,1613,1543
1925-12-13,Belgium,Austria,3,4,1,0.0,1.0,1522,1600
1925-12-13,Catalonia,Czechoslovakia,2,1,1,1.0,0.0,1491,1565
1925-12-17,Brazil,Paraguay,3,1,2,1.0,0.0,1551,1513
1925-12-20,Argentina,Paraguay,3,1,2,1.0,0.0,1619,1508
1925-12-25,Argentina,Brazil,2,2,0,0.5,0.5,1618,1553
1926-01-17,Italy,Czechoslovakia,3,1,2,1.0,0.0,1545,1557
1926-01-24,Haiti,Curaçao,1,1,0,0.5,0.5,1479,1508
1926-01-31,Haiti,Curaçao,0,1,1,0.0,1.0,1472,1516
1926-02-07,Haiti,Curaçao,2,1,1,1.0,0.0,1482,1507
1926-02-13,Northern Ireland,Wales,3,0,3,1.0,0.0,1439,1493
1926-02-14,Belgium,Hungary,0,2,2,0.0,1.0,1516,1601
1926-02-14,Haiti,Curaçao,2,2,0,0.5,0.5,1483,1507
1926-02-27,Scotland,Northern Ireland,4,0,4,1.0,0.0,1698,1437
1926-03-01,England,Wales,1,3,2,0.0,1.0,1671,1505
1926-03-03,Jamaica,Curaçao,2,0,2,1.0,0.0,1532,1500
1926-03-14,Austria,Czechoslovakia,2,0,2,1.0,0.0,1608,1550
1926-03-14,Belgium,Netherlands,1,1,0,0.5,0.5,1518,1596
1926-03-21,Italy,Republic of Ireland,3,0,3,1.0,0.0,1553,1495
1926-03-28,Netherlands,Switzerland,5,0,5,1.0,0.0,1603,1521
1926-04-11,France,Belgium,4,3,1,1.0,0.0,1445,1509
1926-04-15,Guernsey,Jersey,1,5,4,0.0,1.0,1601,1522
1926-04-17,England,Scotland,0,1,1,0.0,1.0,1664,1706
1926-04-18,France,Portugal,4,2,2,1.0,0.0,1454,1480
1926-04-18,Germany,Netherlands,4,2,2,1.0,0.0,1507,1593
1926-04-18,Switzerland,Italy,1,1,0,0.5,0.5,1522,1553
1926-04-25,France,Switzerland,1,0,1,1.0,0.0,1464,1513
1926-04-25,Romania,Bulgaria,6,1,5,1.0,0.0,1487,1465
1926-04-29,Jersey,Alderney,7,1,6,1.0,0.0,1528,1412
1926-05-01,Kenya,Uganda,1,1,0,0.5,0.5,1500,1500
1926-05-02,Hungary,Austria,0,3,3,0.0,1.0,1594,1616
1926-05-02,Netherlands,Belgium,1,5,4,0.0,1.0,1584,1519
1926-05-03,Kenya,Uganda,2,1,1,1.0,0.0,1508,1492
1926-05-07,Turkey,Romania,1,3,2,0.0,1.0,1493,1496
1926-05-09,Italy,Switzerland,3,2,1,1.0,0.0,1561,1506
1926-05-24,Belgium,England,3,5,2,0.0,1.0,1515,1669
1926-05-29,Argentina,Paraguay,2,1,1,1.0,0.0,1624,1503
1926-05-30,Austria,France,4,1,3,1.0,0.0,1621,1460
1926-05-30,Yugoslavia,Bulgaria,3,1,2,1.0,0.0,1484,1458
1926-06-03,Argentina,Paraguay,2,1,1,1.0,0.0,1630,1498
1926-06-06,Finland,Norway,2,5,3,0.0,1.0,1451,1490
1926-06-06,Hungary,Czechoslovakia,2,1,1,1.0,0.0,1601,1544
1926-06-09,Sweden,Norway,3,2,1,1.0,0.0,1610,1485
1926-06-13,Denmark,Netherlands,4,1,3,1.0,0.0,1590,1576
1926-06-13,Estonia,Lithuania,3,1,2,1.0,0.0,1472,1469
1926-06-13,France,Yugoslavia,4,1,3,1.0,0.0,1469,1476
1926-06-13,Sweden,Czechoslovakia,2,2,0,0.5,0.5,1609,1546
1926-06-20,Belgium,France,2,2,0,0.5,0.5,1514,1471
1926-06-20,Finland,Denmark,3,2,1,1.0,0.0,1463,1579
1926-06-20,Germany,Sweden,3,3,0,0.5,0.5,1510,1607
1926-06-28,Yugoslavia,Czechoslovakia,2,6,4,0.0,1.0,1470,1553
1926-07-03,Czechoslovakia,Sweden,4,2,2,1.0,0.0,1563,1598
1926-07-04,Poland,Estonia,2,0,2,1.0,0.0,1500,1465
1926-07-07,Czechoslovakia,Catalonia,2,1,1,1.0,0.0,1570,1485
1926-07-18,Sweden,Italy,5,3,2,1.0,0.0,1606,1554
1926-07-20,Latvia,Sweden,4,1,3,1.0,0.0,1488,1596
1926-07-23,Estonia,Sweden,1,7,6,0.0,1.0,1460,1602
1926-07-26,Finland,Sweden,2,3,1,0.0,1.0,1459,1607
1926-08-08,Poland,Finland,7,1,6,1.0,0.0,1508,1452
1926-08-12,Latvia,Finland,1,4,3,0.0,1.0,1480,1461
1926-08-20,Hungary,Poland,4,1,3,1.0,0.0,1607,1503
1926-08-21,Lithuania,Latvia,2,3,1,0.0,1.0,1462,1488
1926-09-05,Finland,Estonia,1,1,0,0.5,0.5,1461,1461
1926-09-12,Poland,Turkey,6,1,5,1.0,0.0,1511,1486
1926-09-19,Austria,Hungary,2,3,1,0.0,1.0,1613,1616
1926-09-19,Latvia,Estonia,0,1,1,0.0,1.0,1480,1470
1926-09-19,Norway,Denmark,2,2,0,0.5,0.5,1488,1577
1926-09-28,Czechoslovakia,Austria,1,2,1,0.0,1.0,1563,1621
1926-10-03,Denmark,Sweden,2,0,2,1.0,0.0,1586,1599
1926-10-03,Sweden,Poland,3,1,2,1.0,0.0,1606,1505
1926-10-03,Yugoslavia,Romania,2,3,1,0.0,1.0,1463,1504
1926-10-10,Austria,Switzerland,7,1,6,1.0,0.0,1627,1501
1926-10-12,Chile,Bolivia,7,1,6,1.0,0.0,1396,1490
1926-10-16,Argentina,Bolivia,5,0,5,1.0,0.0,1635,1486
1926-10-17,Chile,Uruguay,1,3,2,0.0,1.0,1393,1632
1926-10-20,Argentina,Paraguay,8,0,8,1.0,0.0,1640,1494
1926-10-20,England,Northern Ireland,3,3,0,0.5,0.5,1665,1442
1926-10-23,Bolivia,Paraguay,1,6,5,0.0,1.0,1479,1502
1926-10-24,Argentina,Uruguay,0,2,2,0.0,1.0,1632,1641
1926-10-28,Bolivia,Uruguay,0,6,6,0.0,1.0,1475,1646
1926-10-28,Czechoslovakia,Italy,3,1,2,1.0,0.0,1571,1547
1926-10-30,Scotland,Wales,3,0,3,1.0,0.0,1710,1502
1926-10-31,Chile,Argentina,1,1,0,0.5,0.5,1398,1628
1926-10-31,Netherlands,Germany,2,3,1,0.0,1.0,1567,1520
1926-11-01,Paraguay,Uruguay,1,6,5,0.0,1.0,1498,1651
1926-11-03,Chile,Paraguay,5,1,4,1.0,0.0,1409,1488
1926-11-06,United States,Canada,6,2,4,1.0,0.0,1528,1482
1926-11-07,Austria,Sweden,3,1,2,1.0,0.0,1635,1599
1926-11-14,Hungary,Sweden,3,1,2,1.0,0.0,1624,1592
1926-11-20,Jamaica,Haiti,6,0,6,1.0,0.0,1539,1477
1926-12-12,Germany,Switzerland,2,3,1,0.0,1.0,1512,1510
1926-12-19,Spain,Hungary,4,2,2,1.0,0.0,1587,1615
1926-12-26,Portugal,Hungary,3,3,0,0.5,0.5,1483,1613
1927-01-02,Belgium,Czechoslovakia,2,3,1,0.0,1.0,1508,1578
1927-01-30,Switzerland,Italy,1,5,4,0.0,1.0,1503,1555
1927-02-12,Wales,England,3,3,0,0.5,0.5,1506,1662
1927-02-20,Italy,Czechoslovakia,2,2,0,0.5,0.5,1556,1578
1927-02-26,Northern Ireland,Scotland,0,2,2,0.0,1.0,1440,1713
1927-03-13,Belgium,Netherlands,2,0,2,1.0,0.0,1518,1558
1927-03-16,Portugal,France,4,0,4,1.0,0.0,1491,1464
1927-03-20,Austria,Czechoslovakia,1,2,1,0.0,1.0,1626,1588
1927-04-02,Scotland,England,1,2,1,0.0,1.0,1704,1672
1927-04-03,Belgium,Sweden,2,1,1,1.0,0.0,1528,1583
1927-04-07,Jersey,Alderney,3,0,3,1.0,0.0,1534,1407
1927-04-09,Wales,Northern Ireland,2,2,0,0.5,0.5,1505,1442
1927-04-10,Austria,Hungary,6,0,6,1.0,0.0,1634,1606
1927-04-10,Hungary,Yugoslavia,3,0,3,1.0,0.0,1611,1459
1927-04-17,Italy,Portugal,3,1,2,1.0,0.0,1563,1485
1927-04-17,Spain,Switzerland,1,0,1,1.0,0.0,1594,1497
1927-04-24,Czechoslovakia,Hungary,4,1,3,1.0,0.0,1597,1603
1927-04-24,France,Italy,3,3,0,0.5,0.5,1467,1561
1927-04-28,Guernsey,Jersey,1,0,1,1.0,0.0,1608,1528
1927-05-01,Netherlands,Belgium,3,2,1,1.0,0.0,1566,1521
1927-05-10,Romania,Yugoslavia,0,3,3,0.0,1.0,1495,1469
1927-05-11,Belgium,England,1,9,8,0.0,1.0,1517,1677
1927-05-15,Bulgaria,Yugoslavia,0,2,2,0.0,1.0,1451,1477
1927-05-21,Luxembourg,England,2,5,3,0.0,1.0,1472,1681
1927-05-22,Austria,Belgium,4,1,3,1.0,0.0,1640,1512
1927-05-22,France,Spain,1,4,3,0.0,1.0,1462,1600
1927-05-26,Czechoslovakia,Belgium,4,0,4,1.0,0.0,1604,1506
1927-05-26,France,England,0,6,6,0.0,1.0,1459,1685
1927-05-29,Italy,Spain,2,0,2,1.0,0.0,1570,1592
1927-05-29,Norway,Denmark,0,1,1,0.0,1.0,1483,1592
1927-05-29,Sweden,Latvia,12,0,12,1.0,0.0,1589,1475
1927-05-29,Switzerland,Austria,1,4,3,0.0,1.0,1493,1645
1927-06-12,Denmark,Netherlands,1,1,0,0.5,0.5,1592,1567
1927-06-12,Hungary,France,13,1,12,1.0,0.0,1608,1455
1927-06-12,Sweden,Finland,6,2,4,1.0,0.0,1595,1456
1927-06-15,Norway,Finland,3,1,2,1.0,0.0,1491,1449
1927-06-16,Estonia,Latvia,4,1,3,1.0,0.0,1479,1467
1927-06-19,Romania,Poland,3,3,0,0.5,0.5,1496,1505
1927-06-19,Sweden,Denmark,0,0,0,0.5,0.5,1595,1593
1927-06-25,New Zealand,Canada,2,2,0,0.5,0.5,1524,1483
1927-06-26,Norway,Sweden,3,5,2,0.0,1.0,1486,1601
1927-07-01,Sweden,Estonia,3,1,2,1.0,0.0,1607,1474
1927-07-02,New Zealand,Canada,1,2,1,0.0,1.0,1516,1492
1927-07-09,New Zealand,Canada,1,0,1,1.0,0.0,1524,1485
1927-07-14,Uruguay,Argentina,0,1,1,0.0,1.0,1643,1637
1927-07-17,Bulgaria,Turkey,3,3,0,0.5,0.5,1452,1486
1927-07-23,New Zealand,Canada,1,4,3,0.0,1.0,1516,1494
1927-07-27,Latvia,Lithuania,6,3,3,1.0,0.0,1475,1455
1927-08-10,Estonia,Finland,2,1,1,1.0,0.0,1482,1442
1927-08-13,Lithuania,Estonia,0,5,5,0.0,1.0,1448,1490
1927-08-27,China PR,Japan,5,1,4,1.0,0.0,1605,1418
1927-08-27,China PR,Japan,5,1,4,1.0,0.0,1610,1414
1927-08-29,Japan,Philippines,2,1,1,1.0,0.0,1424,1492
1927-08-29,Japan,Philippines,2,1,1,1.0,0.0,1434,1483
1927-08-30,Argentina,Uruguay,0,1,1,0.0,1.0,1630,1651
1927-08-31,China PR,Philippines,3,1,2,1.0,0.0,1616,1478
1927-08-31,China PR,Philippines,3,1,2,1.0,0.0,1621,1474
1927-09-04,Sweden,Belgium,7,0,7,1.0,0.0,1613,1501
1927-09-11,Finland,Latvia,3,1,2,1.0,0.0,1451,1467
1927-09-18,Czechoslovakia,Austria,2,0,2,1.0,0.0,1613,1637
1927-09-25,Hungary,Austria,5,3,2,1.0,0.0,1617,1629
1927-09-25,Latvia,Estonia,4,1,3,1.0,0.0,1476,1482
1927-10-02,Denmark,Germany,3,1,2,1.0,0.0,1600,1506
1927-10-09,Hungary,Czechoslovakia,1,2,1,0.0,1.0,1609,1622
1927-10-14,Turkey,Bulgaria,3,1,2,1.0,0.0,1494,1445
1927-10-22,Northern Ireland,England,2,0,2,1.0,0.0,1455,1673
1927-10-23,Czechoslovakia,Italy,2,2,0,0.5,0.5,1621,1572
1927-10-23,Germany,Norway,6,2,4,1.0,0.0,1514,1479
1927-10-28,Czechoslovakia,Yugoslavia,5,3,2,1.0,0.0,1626,1473
1927-10-29,Wales,Scotland,2,2,0,0.5,0.5,1510,1700
1927-10-30,Argentina,Bolivia,7,1,6,1.0,0.0,1635,1471
1927-10-30,Denmark,Norway,3,1,2,1.0,0.0,1606,1474
1927-11-01,Peru,Uruguay,0,4,4,0.0,1.0,1496,1656
1927-11-06,Bolivia,Uruguay,0,9,9,0.0,1.0,1467,1661
1927-11-06,Italy,Austria,0,1,1,0.0,1.0,1566,1636
1927-11-06,Switzerland,Sweden,2,2,0,0.5,0.5,1496,1611
1927-11-07,Honduras,El Salvador,1,0,1,1.0,0.0,1508,1485
1927-11-08,Honduras,El Salvador,0,0,0,0.5,0.5,1508,1486
1927-11-13,Netherlands,Sweden,1,0,1,1.0,0.0,1577,1602
1927-11-13,Peru,Bolivia,3,2,1,1.0,0.0,1504,1460
1927-11-20,Argentina,Uruguay,3,2,1,1.0,0.0,1644,1653
1927-11-20,Germany,Netherlands,2,2,0,0.5,0.5,1516,1576
1927-11-27,Peru,Argentina,1,5,4,0.0,1.0,1500,1649
1927-11-28,England,Wales,1,2,1,0.0,1.0,1662,1522
1927-12-10,Chile,Uruguay,2,3,1,0.0,1.0,1406,1657
1928-01-01,Italy,Switzerland,3,2,1,1.0,0.0,1573,1490
1928-01-08,Belgium,Austria,1,2,1,0.0,1.0,1496,1642
1928-01-08,Portugal,Spain,2,2,0,0.5,0.5,1488,1590
1928-02-04,Northern Ireland,Wales,1,2,1,0.0,1.0,1449,1529
1928-02-12,Belgium,Republic of Ireland,2,4,2,0.0,1.0,1488,1504
1928-02-21,France,Northern Ireland,4,0,4,1.0,0.0,1463,1442
1928-02-25,Scotland,Northern Ireland,0,1,1,0.0,1.0,1687,1456
1928-03-11,Netherlands,Belgium,1,1,0,0.5,0.5,1575,1490
1928-03-11,Switzerland,France,4,3,1,1.0,0.0,1498,1456
1928-03-16,Guyana,Trinidad and Tobago,1,1,0,0.5,0.5,1500,1500
1928-03-25,Italy,Hungary,4,3,1,1.0,0.0,1582,1601
1928-03-31,England,Scotland,1,5,4,0.0,1.0,1655,1695
1928-04-01,Austria,Czechoslovakia,0,1,1,0.0,1.0,1634,1635
1928-04-01,Belgium,Netherlands,1,0,1,1.0,0.0,1500,1566
1928-04-01,Portugal,Argentina,0,0,0,0.5,0.5,1492,1646
1928-04-08,Yugoslavia,Turkey,2,1,1,1.0,0.0,1482,1486
1928-04-15,France,Belgium,2,3,1,0.0,1.0,1450,1507
1928-04-15,Portugal,Italy,4,1,3,1.0,0.0,1503,1572
1928-04-15,Romania,Turkey,4,2,2,1.0,0.0,1504,1479
1928-04-15,Switzerland,Germany,2,3,1,0.0,1.0,1491,1524
1928-04-15,Uganda,Kenya,4,0,4,1.0,0.0,1501,1500
1928-04-19,Guernsey,Alderney,4,0,4,1.0,0.0,1612,1404
1928-04-22,Hungary,Czechoslovakia,2,0,2,1.0,0.0,1610,1627
1928-04-22,Netherlands,Denmark,2,0,2,1.0,0.0,1575,1598
1928-04-22,Spain,Italy,1,1,0,0.5,0.5,1590,1573
1928-04-29,France,Portugal,1,1,0,0.5,0.5,1452,1502
1928-05-03,Jersey,Guernsey,2,1,1,1.0,0.0,1538,1603
1928-05-06,Austria,Yugoslavia,3,0,3,1.0,0.0,1639,1478
1928-05-06,Hungary,Austria,5,5,0,0.5,0.5,1611,1639
1928-05-06,Switzerland,Netherlands,2,1,1,1.0,0.0,1501,1566
1928-05-06,Yugoslavia,Romania,3,1,2,1.0,0.0,1487,1496
1928-05-13,France,Czechoslovakia,0,2,2,0.0,1.0,1448,1632
1928-05-17,France,England,1,5,4,0.0,1.0,1445,1659
1928-05-19,Belgium,England,1,3,2,0.0,1.0,1503,1664
1928-05-27,Portugal,Chile,4,2,2,1.0,0.0,1508,1401
1928-05-27,Belgium,Luxembourg,5,3,2,1.0,0.0,1511,1465
1928-05-28,Germany,Switzerland,4,0,4,1.0,0.0,1532,1494
1928-05-28,Egypt,Turkey,7,1,6,1.0,0.0,1508,1472
1928-05-29,Italy,France,4,3,1,1.0,0.0,1579,1440
1928-05-29,Portugal,Yugoslavia,2,1,1,1.0,0.0,1516,1480
1928-05-29,Argentina,United States,11,2,9,1.0,0.0,1652,1523
1928-05-30,Spain,Mexico,7,1,6,1.0,0.0,1597,1517
1928-05-30,Netherlands,Uruguay,0,2,2,0.0,1.0,1561,1663
1928-06-01,Italy,Spain,1,1,0,0.5,0.5,1580,1597
1928-06-02,Argentina,Belgium,6,3,3,1.0,0.0,1657,1507
1928-06-03,Finland,Norway,0,6,6,0.0,1.0,1444,1482
1928-06-03,Uruguay,Germany,4,1,3,1.0,0.0,1669,1527
1928-06-04,Italy,Spain,7,1,6,1.0,0.0,1589,1589
1928-06-04,Egypt,Portugal,2,1,1,1.0,0.0,1517,1508
1928-06-05,Netherlands,Belgium,3,1,2,1.0,0.0,1568,1501
1928-06-05,Chile,Mexico,3,1,2,1.0,0.0,1412,1507
1928-06-06,Argentina,Egypt,6,0,6,1.0,0.0,1662,1513
1928-06-07,Sweden,Norway,6,1,5,1.0,0.0,1608,1477
1928-06-07,Uruguay,Italy,3,2,1,1.0,0.0,1676,1583
1928-06-08,Netherlands,Chile,2,2,0,0.5,0.5,1565,1416
1928-06-09,Italy,Egypt,11,3,8,1.0,0.0,1590,1507
1928-06-10,Poland,United States,3,3,0,0.5,0.5,1506,1523
1928-06-10,Uruguay,Argentina,1,1,0,0.5,0.5,1676,1663
1928-06-13,Uruguay,Argentina,2,1,1,1.0,0.0,1684,1656
1928-06-14,Netherlands,Egypt,1,2,1,0.0,1.0,1556,1517
1928-06-17,Norway,Denmark,2,3,1,0.0,1.0,1472,1604
1928-06-28,Luxembourg,Egypt,1,1,0,0.5,0.5,1467,1516
1928-07-01,Poland,Sweden,2,1,1,1.0,0.0,1517,1598
1928-07-06,Latvia,Sweden,0,4,4,0.0,1.0,1471,1604
1928-07-09,Estonia,Sweden,0,1,1,0.0,1.0,1477,1610
1928-07-25,Latvia,Lithuania,3,0,3,1.0,0.0,1479,1441
1928-07-26,Estonia,Lithuania,6,0,6,1.0,0.0,1485,1434
1928-07-27,Estonia,Latvia,0,1,1,0.0,1.0,1477,1488
1928-07-29,Sweden,Austria,2,3,1,0.0,1.0,1603,1647
1928-08-12,Finland,Estonia,2,2,0,0.5,0.5,1445,1477
1928-08-15,Paraguay,Uruguay,3,1,2,1.0,0.0,1501,1672
1928-08-17,Belarus,Switzerland,6,3,3,1.0,0.0,1508,1487
1928-08-19,Belarus,Ukraine,2,6,4,0.0,1.0,1500,1509
1928-08-19,Latvia,Finland,2,1,1,1.0,0.0,1496,1438
1928-08-19,Paraguay,Uruguay,1,1,0,0.5,0.5,1505,1669
1928-08-22,Belarus,Finland,1,2,1,0.0,1.0,1491,1448
1928-08-30,Argentina,Uruguay,1,0,1,1.0,0.0,1665,1661
1928-09-01,Lithuania,Latvia,1,1,0,0.5,0.5,1436,1495
1928-09-02,Finland,Sweden,2,3,1,0.0,1.0,1444,1608
1928-09-16,Germany,Denmark,2,1,1,1.0,0.0,1537,1595
1928-09-21,Uruguay,Argentina,2,2,0,0.5,0.5,1662,1665
1928-09-23,Czechoslovakia,Hungary,6,1,5,1.0,0.0,1640,1604
1928-09-23,Latvia,Estonia,1,1,0,0.5,0.5,1495,1478
1928-09-23,Norway,Germany,0,2,2,0.0,1.0,1466,1544
1928-09-30,Sweden,Germany,2,0,2,1.0,0.0,1615,1538
1928-10-07,Austria,Hungary,5,1,4,1.0,0.0,1655,1597
1928-10-07,Denmark,Sweden,3,1,2,1.0,0.0,1604,1607
1928-10-14,Switzerland,Italy,2,3,1,0.0,1.0,1482,1596
1928-10-22,England,Northern Ireland,2,1,1,1.0,0.0,1668,1453
1928-10-27,Czechoslovakia,Poland,3,2,1,1.0,0.0,1646,1512
1928-10-27,Scotland,Wales,4,2,2,1.0,0.0,1700,1525
1928-10-28,Austria,Switzerland,2,0,2,1.0,0.0,1660,1478
1928-10-28,Czechoslovakia,Yugoslavia,7,1,6,1.0,0.0,1651,1476
1928-11-01,Hungary,Switzerland,3,1,2,1.0,0.0,1603,1473
1928-11-04,Netherlands,Belgium,1,1,0,0.5,0.5,1555,1503
1928-11-11,Italy,Austria,2,2,0,0.5,0.5,1598,1659
1928-11-17,Wales,England,2,3,1,0.0,1.0,1521,1673
1928-12-02,Italy,Netherlands,3,2,1,1.0,0.0,1606,1548
1928-12-07,El Salvador,Honduras,5,0,5,1.0,0.0,1495,1500
1929-02-02,Wales,Northern Ireland,2,2,0,0.5,0.5,1520,1455
1929-02-10,Germany,Switzerland,7,1,6,1.0,0.0,1545,1467
1929-02-23,Northern Ireland,Scotland,3,7,4,0.0,1.0,1452,1704
1929-02-24,France,Hungary,3,0,3,1.0,0.0,1452,1592
1929-03-03,Italy,Czechoslovakia,4,2,2,1.0,0.0,1616,1642
1929-03-17,Czechoslovakia,Austria,3,3,0,0.5,0.5,1643,1659
1929-03-17,Netherlands,Switzerland,3,2,1,1.0,0.0,1555,1461
1929-03-17,Spain,Portugal,5,0,5,1.0,0.0,1596,1502
1929-03-24,France,Portugal,2,0,2,1.0,0.0,1462,1493
1929-04-07,Austria,Italy,3,0,3,1.0,0.0,1667,1609
1929-04-13,Scotland,England,1,0,1,1.0,0.0,1712,1666
1929-04-14,Spain,France,8,1,7,1.0,0.0,1602,1457
1929-04-14,Switzerland,Hungary,4,5,1,0.0,1.0,1456,1598
1929-04-18,Jersey,Guernsey,1,7,6,0.0,1.0,1532,1610
1929-04-20,Barbados,Trinidad and Tobago,3,0,3,1.0,0.0,1508,1492
1929-04-21,Romania,Bulgaria,3,0,3,1.0,0.0,1503,1439
1929-04-22,Barbados,Trinidad and Tobago,2,0,2,1.0,0.0,1516,1485
1929-04-24,Barbados,Trinidad and Tobago,2,1,1,1.0,0.0,1524,1478
1929-04-28,Italy,Germany,1,2,1,0.0,1.0,1600,1555
1929-04-30,Republic of Ireland,Belgium,4,0,4,1.0,0.0,1512,1496
1929-05-01,El Salvador,Nicaragua,9,0,9,1.0,0.0,1504,1492
1929-05-02,Guernsey,Alderney,5,0,5,1.0,0.0,1614,1401
1929-05-05,Austria,Hungary,2,2,0,0.5,0.5,1666,1600
1929-05-05,Belgium,Netherlands,3,1,2,1.0,0.0,1506,1546
1929-05-05,Switzerland,Czechoslovakia,1,4,3,0.0,1.0,1452,1648
1929-05-09,France,England,1,4,3,0.0,1.0,1454,1670
1929-05-10,Romania,Yugoslavia,2,3,1,0.0,1.0,1495,1485
1929-05-11,Belgium,England,1,5,4,0.0,1.0,1502,1675
1929-05-15,Kenya,Uganda,3,5,2,0.0,1.0,1493,1509
1929-05-15,Spain,England,4,3,1,1.0,0.0,1612,1666
1929-05-19,France,Yugoslavia,1,3,2,0.0,1.0,1447,1493
1929-05-26,Belgium,France,4,1,3,1.0,0.0,1509,1441
1929-05-26,Norway,Scotland,3,7,4,0.0,1.0,1463,1716
1929-06-01,Germany,Scotland,1,1,0,0.5,0.5,1559,1713
1929-06-04,Netherlands,Scotland,0,2,2,0.0,1.0,1542,1718
1929-06-09,Sweden,Netherlands,6,2,4,1.0,0.0,1614,1536
1929-06-12,Norway,Netherlands,4,4,0,0.5,0.5,1465,1535
1929-06-14,Sweden,Finland,3,1,2,1.0,0.0,1619,1440
1929-06-16,Argentina,Uruguay,2,0,2,1.0,0.0,1673,1655
1929-06-16,Sweden,Denmark,3,2,1,1.0,0.0,1627,1597
1929-06-16,Uruguay,Argentina,1,1,0,0.5,0.5,1656,1673
1929-06-18,Norway,Finland,4,0,4,1.0,0.0,1473,1433
1929-06-23,Denmark,Norway,2,5,3,0.0,1.0,1587,1484
1929-06-23,Germany,Sweden,3,0,3,1.0,0.0,1569,1618
1929-06-28,Yugoslavia,Czechoslovakia,3,3,0,0.5,0.5,1497,1645
1929-06-30,Bulgaria,Greece,1,1,0,0.5,0.5,1441,1499
1929-07-07,Sweden,Estonia,4,1,3,1.0,0.0,1623,1474
1929-07-25,Estonia,Finland,1,1,0,0.5,0.5,1474,1434
1929-07-28,Sweden,Latvia,10,0,10,1.0,0.0,1629,1490
1929-08-14,Latvia,Lithuania,3,1,2,1.0,0.0,1497,1430
1929-08-15,Latvia,Estonia,2,2,0,0.5,0.5,1497,1475
1929-08-16,Estonia,Lithuania,5,2,3,1.0,0.0,1482,1424
1929-08-27,Finland,Estonia,2,1,1,1.0,0.0,1444,1473
1929-09-08,Czechoslovakia,Hungary,1,1,0,0.5,0.5,1644,1602
1929-09-15,Austria,Czechoslovakia,2,1,1,1.0,0.0,1674,1637
1929-09-15,Bulgaria,Romania,2,3,1,0.0,1.0,1435,1502
1929-09-15,Finland,Latvia,3,1,2,1.0,0.0,1454,1488
1929-09-18,Estonia,Latvia,4,1,3,1.0,0.0,1482,1480
1929-09-20,Uruguay,Argentina,2,1,1,1.0,0.0,1665,1665
1929-09-28,Argentina,Uruguay,0,0,0,0.5,0.5,1665,1665
1929-09-29,Norway,Sweden,2,1,1,1.0,0.0,1496,1618
1929-10-06,Czechoslovakia,Switzerland,5,0,5,1.0,0.0,1642,1448
1929-10-06,Hungary,Austria,2,1,1,1.0,0.0,1612,1665
1929-10-06,Romania,Yugoslavia,2,1,1,1.0,0.0,1510,1490
1929-10-13,Denmark,Finland,8,0,8,1.0,0.0,1593,1449
1929-10-19,Northern Ireland,England,0,3,3,0.0,1.0,1449,1670
1929-10-20,Germany,Finland,4,0,4,1.0,0.0,1575,1444
1929-10-26,Trinidad and Tobago,Guyana,0,0,0,0.5,0.5,1479,1500
1929-10-26,Wales,Scotland,2,4,2,0.0,1.0,1517,1722
1929-10-27,Switzerland,Austria,1,3,2,0.0,1.0,1445,1669
1929-10-28,Czechoslovakia,Yugoslavia,4,3,1,1.0,0.0,1647,1486
1929-11-01,Paraguay,Uruguay,3,0,3,1.0,0.0,1517,1654
1929-11-02,Trinidad and Tobago,Guyana,0,1,1,0.0,1.0,1472,1508
1929-11-03,Argentina,Peru,3,0,3,1.0,0.0,1670,1496
1929-11-03,Netherlands,Norway,1,4,3,0.0,1.0,1527,1505
1929-11-03,Trinidad and Tobago,Guyana,3,1,2,1.0,0.0,1481,1500
1929-11-10,Argentina,Paraguay,4,1,3,1.0,0.0,1675,1513
1929-11-11,Peru,Uruguay,1,4,3,0.0,1.0,1492,1659
1929-11-11,Trinidad and Tobago,Guyana,1,1,0,0.5,0.5,1482,1500
1929-11-12,Trinidad and Tobago,Guyana,0,1,1,0.0,1.0,1475,1508
1929-11-16,Paraguay,Peru,5,0,5,1.0,0.0,1521,1485
1929-11-17,Argentina,Uruguay,2,0,2,1.0,0.0,1683,1652
1929-11-20,England,Wales,6,0,6,1.0,0.0,1675,1513
1929-12-01,Italy,Portugal,6,1,5,1.0,0.0,1606,1488
1930-01-01,Spain,Czechoslovakia,1,0,1,1.0,0.0,1621,1639
1930-01-12,Portugal,Czechoslovakia,1,0,1,1.0,0.0,1500,1628
1930-01-26,Greece,Yugoslavia,2,1,1,1.0,0.0,1507,1479
1930-02-01,Northern Ireland,Wales,7,0,7,1.0,0.0,1459,1504
1930-02-09,Italy,Switzerland,4,2,2,1.0,0.0,1611,1441
1930-02-16,Kenya,Uganda,0,0,0,0.5,0.5,1494,1509
1930-02-22,Scotland,Northern Ireland,3,1,2,1.0,0.0,1725,1457
1930-02-23,Portugal,France,2,0,2,1.0,0.0,1507,1435
1930-03-02,Germany,Italy,0,2,2,0.0,1.0,1568,1619
1930-03-16,Cuba,Jamaica,3,1,2,1.0,0.0,1509,1531
1930-03-17,Costa Rica,Guatemala,8,1,7,1.0,0.0,1524,1469
1930-03-18,Honduras,Jamaica,5,4,1,1.0,0.0,1509,1523
1930-03-19,El Salvador,Guatemala,8,2,6,1.0,0.0,1512,1462
1930-03-20,Cuba,Honduras,7,0,7,1.0,0.0,1517,1501
1930-03-22,Costa Rica,El Salvador,9,2,7,1.0,0.0,1532,1505
1930-03-23,Czechoslovakia,Austria,2,2,0,0.5,0.5,1629,1669
1930-03-23,France,Switzerland,3,3,0,0.5,0.5,1436,1441
1930-03-23,Cuba,Honduras,5,0,5,1.0,0.0,1525,1494
1930-03-26,Costa Rica,El Salvador,5,0,5,1.0,0.0,1540,1498
1930-03-29,El Salvador,Honduras,1,4,3,0.0,1.0,1490,1503
1930-03-30,Cuba,Costa Rica,2,1,1,1.0,0.0,1534,1532
1930-04-01,Cuba,El Salvador,5,2,3,1.0,0.0,1541,1484
1930-04-04,Costa Rica,Honduras,8,0,8,1.0,0.0,1540,1496
1930-04-05,England,Scotland,5,2,3,1.0,0.0,1685,1716
1930-04-06,Netherlands,Italy,1,1,0,0.5,0.5,1530,1617
1930-04-10,Jersey,Alderney,3,2,1,1.0,0.0,1538,1396
1930-04-13,France,Belgium,1,6,5,0.0,1.0,1430,1516
1930-04-13,Switzerland,Hungary,2,2,0,0.5,0.5,1445,1609
1930-04-13,Yugoslavia,Bulgaria,6,1,5,1.0,0.0,1486,1429
1930-04-20,Curaçao,Aruba,2,1,1,1.0,0.0,1508,1485
1930-05-01,Czechoslovakia,Hungary,1,1,0,0.5,0.5,1629,1610
1930-05-01,Uganda,Kenya,5,0,5,1.0,0.0,1517,1487
1930-05-01,Jersey,Guernsey,2,3,1,0.0,1.0,1532,1621
1930-05-04,Netherlands,Belgium,2,2,0,0.5,0.5,1530,1517
1930-05-04,Switzerland,Germany,0,5,5,0.0,1.0,1440,1574
1930-05-04,Yugoslavia,Romania,2,1,1,1.0,0.0,1495,1502
1930-05-10,Germany,England,3,3,0,0.5,0.5,1577,1683
1930-05-11,Belgium,Republic of Ireland,1,3,2,0.0,1.0,1509,1521
1930-05-11,France,Czechoslovakia,2,3,1,0.0,1.0,1427,1633
1930-05-11,Hungary,Italy,0,5,5,0.0,1.0,1603,1625
1930-05-14,Austria,England,0,0,0,0.5,0.5,1670,1683
1930-05-18,Belgium,Netherlands,3,1,2,1.0,0.0,1518,1522
1930-05-18,France,Scotland,0,2,2,0.0,1.0,1425,1719
1930-05-25,Argentina,Uruguay,1,1,0,0.5,0.5,1683,1653
1930-05-25,Belgium,France,1,2,1,0.0,1.0,1508,1436
1930-05-25,Romania,Greece,8,1,7,1.0,0.0,1511,1499
1930-05-25,Japan,Philippines,7,2,5,1.0,0.0,1443,1466
1930-05-27,China PR,Philippines,5,0,5,1.0,0.0,1626,1462
1930-05-27,China PR,Philippines,5,0,5,1.0,0.0,1631,1458
1930-05-29,Japan,China PR,3,3,0,0.5,0.5,1447,1628
1930-05-30,Japan,China PR,3,3,0,0.5,0.5,1451,1625
1930-06-01,Hungary,Austria,2,1,1,1.0,0.0,1613,1661
1930-06-01,Norway,Finland,6,2,4,1.0,0.0,1512,1438
1930-06-08,Belgium,Portugal,2,1,1,1.0,0.0,1516,1500
1930-06-08,Hungary,Netherlands,6,2,4,1.0,0.0,1619,1517
1930-06-08,Catalonia,Basque Country,0,1,1,0.0,1.0,1479,1546
1930-06-14,Czechoslovakia,Spain,2,0,2,1.0,0.0,1641,1614
1930-06-15,Bulgaria,Yugoslavia,2,2,0,0.5,0.5,1431,1494
1930-06-15,Sweden,Switzerland,1,0,1,1.0,0.0,1623,1436
1930-06-16,Finland,Denmark,1,6,5,0.0,1.0,1434,1598
1930-06-19,Norway,Switzerland,3,0,3,1.0,0.0,1519,1430
1930-06-22,Denmark,Sweden,6,1,5,1.0,0.0,1607,1615
1930-06-22,Italy,Spain,2,3,1,0.0,1.0,1617,1623
1930-06-27,Estonia,Latvia,1,1,0,0.5,0.5,1482,1481
1930-07-06,Sweden,Norway,6,3,3,1.0,0.0,1621,1514
1930-07-13,Belgium,United States,0,3,3,0.0,1.0,1509,1531
1930-07-13,France,Mexico,4,1,3,1.0,0.0,1446,1498
1930-07-14,Brazil,Yugoslavia,1,2,1,0.0,1.0,1544,1504
1930-07-14,Peru,Romania,1,3,2,0.0,1.0,1478,1519
1930-07-15,Argentina,France,1,0,1,1.0,0.0,1687,1443
1930-07-16,Chile,Mexico,3,0,3,1.0,0.0,1426,1489
1930-07-17,Bolivia,Yugoslavia,0,4,4,0.0,1.0,1454,1511
1930-07-17,Paraguay,United States,0,3,3,0.0,1.0,1514,1539
1930-07-18,Estonia,Sweden,1,5,4,0.0,1.0,1478,1626
1930-07-18,Uruguay,Peru,1,0,1,1.0,0.0,1658,1474
1930-07-19,Argentina,Mexico,6,3,3,1.0,0.0,1691,1486
1930-07-19,Chile,France,1,0,1,1.0,0.0,1435,1435
1930-07-20,Belgium,Paraguay,0,1,1,0.0,1.0,1502,1522
1930-07-20,Bolivia,Brazil,0,4,4,0.0,1.0,1449,1550
1930-07-21,Uruguay,Romania,4,0,4,1.0,0.0,1663,1515
1930-07-22,Argentina,Chile,3,1,2,1.0,0.0,1694,1433
1930-07-22,Latvia,Sweden,0,5,5,0.0,1.0,1477,1631
1930-07-26,Argentina,United States,6,1,5,1.0,0.0,1699,1535
1930-07-27,Uruguay,Yugoslavia,6,1,5,1.0,0.0,1668,1507
1930-07-30,Uruguay,Argentina,4,2,2,1.0,0.0,1677,1691
1930-08-01,Brazil,France,3,2,1,1.0,0.0,1556,1430
1930-08-03,Argentina,Yugoslavia,3,1,2,1.0,0.0,1696,1503
1930-08-04,Latvia,Finland,3,0,3,1.0,0.0,1485,1427
1930-08-06,Estonia,Finland,4,0,4,1.0,0.0,1485,1421
1930-08-10,Brazil,Yugoslavia,4,1,3,1.0,0.0,1563,1497
1930-08-15,Lithuania,Estonia,2,1,1,1.0,0.0,1434,1476
1930-08-16,Latvia,Estonia,3,2,1,1.0,0.0,1493,1469
1930-08-17,Brazil,United States,4,3,1,1.0,0.0,1571,1528
1930-08-17,Lithuania,Latvia,3,3,0,0.5,0.5,1436,1492
1930-09-07,Denmark,Germany,6,3,3,1.0,0.0,1615,1570
1930-09-13,Lithuania,Estonia,4,0,4,1.0,0.0,1445,1461
1930-09-21,Austria,Hungary,2,3,1,0.0,1.0,1653,1628
1930-09-21,Belgium,Czechoslovakia,2,3,1,0.0,1.0,1498,1646
1930-09-21,Norway,Denmark,1,0,1,1.0,0.0,1525,1605
1930-09-28,Belgium,Sweden,2,2,0,0.5,0.5,1501,1629
1930-09-28,Finland,Sweden,4,4,0,0.5,0.5,1426,1625
1930-09-28,Germany,Hungary,5,3,2,1.0,0.0,1580,1619
1930-09-28,Sweden,Poland,0,3,3,0.0,1.0,1615,1523
1930-10-12,Bulgaria,Romania,5,3,2,1.0,0.0,1441,1506
1930-10-20,England,Northern Ireland,5,1,4,1.0,0.0,1687,1454
1930-10-25,Scotland,Wales,1,1,0,0.5,0.5,1715,1509
1930-10-26,Hungary,Czechoslovakia,1,1,0,0.5,0.5,1620,1646
1930-10-26,Poland,Latvia,6,0,6,1.0,0.0,1531,1485
1930-11-02,Germany,Norway,1,1,0,0.5,0.5,1579,1527
1930-11-02,Switzerland,Netherlands,6,3,3,1.0,0.0,1440,1508
1930-11-16,Austria,Sweden,4,1,3,1.0,0.0,1661,1608
1930-11-16,Bulgaria,Yugoslavia,0,3,3,0.0,1.0,1435,1504
1930-11-22,Wales,England,0,4,4,0.0,1.0,1505,1692
1930-11-30,Portugal,Spain,0,1,1,0.0,1.0,1495,1629
1930-12-07,France,Belgium,2,2,0,0.5,0.5,1432,1500
1930-12-07,Greece,Bulgaria,6,1,5,1.0,0.0,1506,1429
1931-01-01,Basque Country,Catalonia,3,2,1,1.0,0.0,1553,1473
1931-01-25,Italy,France,5,0,5,1.0,0.0,1622,1428
1931-02-11,Barbados,Martinique,3,2,1,1.0,0.0,1532,1493
1931-02-12,Barbados,Martinique,0,0,0,0.5,0.5,1532,1494
1931-02-15,France,Czechoslovakia,1,2,1,0.0,1.0,1425,1650
1931-02-21,Northern Ireland,Scotland,0,0,0,0.5,0.5,1460,1710
1931-02-22,Italy,Austria,2,1,1,1.0,0.0,1631,1653
1931-02-28,Barbados,Martinique,1,2,1,0.0,1.0,1524,1503
1931-03-05,Guyana,Trinidad and Tobago,2,1,1,1.0,0.0,1516,1468
1931-03-06,Barbados,Trinidad and Tobago,1,5,4,0.0,1.0,1515,1478
1931-03-08,Guyana,Trinidad and Tobago,0,2,2,0.0,1.0,1508,1487
1931-03-09,Barbados,Trinidad and Tobago,1,7,6,0.0,1.0,1507,1496
1931-03-10,Guyana,Barbados,9,0,9,1.0,0.0,1516,1500
1931-03-14,Guyana,Barbados,7,0,7,1.0,0.0,1524,1493
1931-03-15,France,Germany,1,0,1,1.0,0.0,1437,1568
1931-03-15,Yugoslavia,Greece,4,1,3,1.0,0.0,1513,1498
1931-03-22,Czechoslovakia,Hungary,3,3,0,0.5,0.5,1650,1621
1931-03-28,Scotland,England,2,0,2,1.0,0.0,1718,1685
1931-03-29,Netherlands,Belgium,3,2,1,1.0,0.0,1516,1493
1931-03-29,Switzerland,Italy,1,1,0,0.5,0.5,1445,1627
1931-04-05,Curaçao,Aruba,1,0,1,1.0,0.0,1516,1478
1931-04-12,Austria,Czechoslovakia,2,1,1,1.0,0.0,1661,1643
1931-04-12,Hungary,Switzerland,6,2,4,1.0,0.0,1626,1441
1931-04-12,Portugal,Italy,0,2,2,0.0,1.0,1490,1633
1931-04-16,Guernsey,Alderney,1,0,1,1.0,0.0,1625,1393
1931-04-19,Paraguay,Argentina,0,1,1,0.0,1.0,1518,1701
1931-04-19,Spain,Italy,0,0,0,0.5,0.5,1630,1633
1931-04-19,Yugoslavia,Bulgaria,1,0,1,1.0,0.0,1520,1423
1931-04-22,Wales,Northern Ireland,3,2,1,1.0,0.0,1512,1454
1931-04-25,Paraguay,Argentina,1,1,0,0.5,0.5,1522,1698
1931-04-26,Netherlands,Germany,1,1,0,0.5,0.5,1518,1567
1931-04-26,Spain,Republic of Ireland,1,1,0,0.5,0.5,1628,1524
1931-04-30,Guernsey,Jersey,2,4,2,0.0,1.0,1615,1543
1931-05-03,Austria,Hungary,0,0,0,0.5,0.5,1661,1627
1931-05-03,Belgium,Netherlands,4,2,2,1.0,0.0,1502,1510
1931-05-10,Romania,Bulgaria,5,2,3,1.0,0.0,1513,1417
1931-05-14,France,England,5,2,3,1.0,0.0,1450,1673
1931-05-16,Austria,Scotland,5,0,5,1.0,0.0,1671,1709
1931-05-16,Belgium,England,1,4,3,0.0,1.0,1498,1678
1931-05-20,Italy,Scotland,3,0,3,1.0,0.0,1643,1700
1931-05-21,Yugoslavia,Hungary,3,2,1,1.0,0.0,1531,1617
1931-05-24,Germany,Austria,0,6,6,0.0,1.0,1562,1677
1931-05-24,Switzerland,Scotland,2,3,1,0.0,1.0,1439,1703
1931-05-25,Denmark,Norway,3,1,2,1.0,0.0,1612,1521
1931-05-28,Latvia,Estonia,0,1,1,0.0,1.0,1477,1470
1931-05-31,Portugal,Belgium,3,2,1,1.0,0.0,1499,1490
1931-06-09,Estonia,Lithuania,4,1,3,1.0,0.0,1478,1438
1931-06-13,Czechoslovakia,Switzerland,7,3,4,1.0,0.0,1647,1436
1931-06-14,Denmark,Netherlands,0,2,2,0.0,1.0,1602,1521
1931-06-14,Poland,Czechoslovakia,0,4,4,0.0,1.0,1526,1653
1931-06-16,Austria,Switzerland,2,0,2,1.0,0.0,1681,1433
1931-06-17,Finland,Estonia,3,1,2,1.0,0.0,1436,1469
1931-06-17,Sweden,Germany,0,0,0,0.5,0.5,1607,1564
1931-06-21,Norway,Germany,2,2,0,0.5,0.5,1522,1564
1931-06-28,Sweden,Denmark,3,1,2,1.0,0.0,1615,1595
1931-06-28,Yugoslavia,Romania,2,4,2,0.0,1.0,1523,1522
1931-06-30,Latvia,Lithuania,5,2,3,1.0,0.0,1485,1431
1931-07-03,Sweden,Finland,8,2,6,1.0,0.0,1620,1432
1931-07-04,Argentina,Paraguay,1,1,0,0.5,0.5,1695,1526
1931-07-08,Sweden,Estonia,3,1,2,1.0,0.0,1625,1465
1931-07-09,Argentina,Paraguay,3,1,2,1.0,0.0,1700,1522
1931-07-26,Sweden,Latvia,6,0,6,1.0,0.0,1630,1481
1931-08-02,Yugoslavia,Czechoslovakia,2,1,1,1.0,0.0,1534,1643
1931-08-19,Finland,Latvia,4,0,4,1.0,0.0,1442,1472
1931-08-23,Poland,Romania,2,3,1,0.0,1.0,1518,1531
1931-08-26,Lithuania,Romania,2,4,2,0.0,1.0,1426,1537
1931-08-30,Estonia,Lithuania,2,0,2,1.0,0.0,1473,1419
1931-08-31,Latvia,Lithuania,1,0,1,1.0,0.0,1479,1413
1931-09-01,Estonia,Latvia,3,1,2,1.0,0.0,1482,1471
1931-09-06,Brazil,Uruguay,2,0,2,1.0,0.0,1582,1667
1931-09-06,Finland,Norway,4,4,0,0.5,0.5,1444,1521
1931-09-13,Austria,Germany,5,0,5,1.0,0.0,1687,1559
1931-09-19,Scotland,Northern Ireland,3,1,2,1.0,0.0,1707,1451
1931-09-20,Hungary,Czechoslovakia,3,0,3,1.0,0.0,1626,1635
1931-09-27,Bulgaria,Turkey,5,1,4,1.0,0.0,1427,1463
1931-09-27,Germany,Denmark,4,2,2,1.0,0.0,1568,1587
1931-09-27,Latvia,Estonia,2,1,1,1.0,0.0,1480,1474
1931-09-27,Norway,Sweden,2,1,1,1.0,0.0,1532,1620
1931-10-02,Turkey,Yugoslavia,2,0,2,1.0,0.0,1473,1525
1931-10-04,Bulgaria,Yugoslavia,3,2,1,1.0,0.0,1438,1515
1931-10-04,Hungary,Austria,2,2,0,0.5,0.5,1628,1686
1931-10-11,Belgium,Poland,2,1,1,1.0,0.0,1499,1510
1931-10-11,Denmark,Finland,2,3,1,0.0,1.0,1576,1456
1931-10-17,Kenya,Uganda,2,1,1,1.0,0.0,1496,1509
1931-10-17,Northern Ireland,England,2,6,4,0.0,1.0,1448,1682
1931-10-25,Bulgaria,Greece,2,1,1,1.0,0.0,1448,1489
1931-10-25,Poland,Yugoslavia,6,3,3,1.0,0.0,1519,1507
1931-10-31,Wales,Scotland,2,3,1,0.0,1.0,1509,1711
1931-11-08,Hungary,Sweden,3,1,2,1.0,0.0,1636,1613
1931-11-15,Italy,Czechoslovakia,2,2,0,0.5,0.5,1643,1636
1931-11-18,England,Wales,3,1,2,1.0,0.0,1687,1505
1931-11-29,France,Netherlands,3,4,1,0.0,1.0,1444,1528
1931-11-29,Greece,Romania,2,4,2,0.0,1.0,1483,1544
1931-11-29,Switzerland,Austria,1,8,7,0.0,1.0,1430,1690
1931-12-05,Northern Ireland,Wales,4,0,4,1.0,0.0,1458,1496
1931-12-06,Belgium,Switzerland,2,1,1,1.0,0.0,1506,1424
1931-12-09,England,Spain,7,1,6,1.0,0.0,1694,1622
1931-12-13,Republic of Ireland,Spain,0,5,5,0.0,1.0,1519,1628
1931-12-13,Italy,Hungary,3,2,1,1.0,0.0,1651,1629
1932-02-14,Italy,Switzerland,3,0,3,1.0,0.0,1655,1421
1932-02-19,Egypt,Hungary,0,0,0,0.5,0.5,1519,1627
1932-03-06,Germany,Switzerland,2,0,2,1.0,0.0,1573,1417
1932-03-13,Haiti,Jamaica,4,1,3,1.0,0.0,1487,1514
1932-03-20,Austria,Italy,2,1,1,1.0,0.0,1698,1648
1932-03-20,Belgium,Netherlands,1,4,3,0.0,1.0,1499,1536
1932-03-20,Czechoslovakia,Hungary,1,3,2,0.0,1.0,1628,1636
1932-03-20,Haiti,Jamaica,0,1,1,0.0,1.0,1480,1522
1932-03-20,Switzerland,France,3,3,0,0.5,0.5,1418,1444
1932-03-23,Dominica,Martinique,1,0,1,1.0,0.0,1509,1495
1932-03-27,Greece,Bulgaria,1,2,1,0.0,1.0,1475,1457
1932-03-30,Greece,Bulgaria,2,2,0,0.5,0.5,1475,1458
1932-04-09,England,Scotland,3,0,3,1.0,0.0,1703,1703
1932-04-10,France,Italy,1,2,1,0.0,1.0,1441,1652
1932-04-14,Guernsey,Jersey,2,0,2,1.0,0.0,1622,1537
1932-04-15,Guyana,Trinidad and Tobago,1,0,1,1.0,0.0,1532,1489
1932-04-17,Barbados,Trinidad and Tobago,1,0,1,1.0,0.0,1501,1482
1932-04-17,Netherlands,Belgium,2,1,1,1.0,0.0,1544,1492
1932-04-17,Switzerland,Czechoslovakia,5,1,4,1.0,0.0,1431,1616
1932-04-19,Barbados,Guyana,0,1,1,0.0,1.0,1494,1540
1932-04-21,Barbados,Guyana,2,2,0,0.5,0.5,1496,1539
1932-04-23,Guyana,Trinidad and Tobago,1,2,1,0.0,1.0,1530,1492
1932-04-24,Austria,Hungary,8,2,6,1.0,0.0,1705,1630
1932-04-24,Spain,Yugoslavia,2,1,1,1.0,0.0,1634,1502
1932-04-26,Barbados,Trinidad and Tobago,1,3,2,0.0,1.0,1488,1501
1932-04-28,Guernsey,Alderney,4,2,2,1.0,0.0,1626,1390
1932-05-01,Belgium,France,5,2,3,1.0,0.0,1499,1435
1932-05-03,Portugal,Yugoslavia,3,2,1,1.0,0.0,1508,1494
1932-05-08,France,Scotland,1,3,2,0.0,1.0,1433,1706
1932-05-08,Hungary,Italy,1,1,0,0.5,0.5,1631,1652
1932-05-08,Netherlands,Republic of Ireland,0,2,2,0.0,1.0,1536,1528
1932-05-15,Argentina,Uruguay,2,0,2,1.0,0.0,1708,1660
1932-05-16,Sweden,Finland,7,1,6,1.0,0.0,1618,1452
1932-05-18,Uruguay,Argentina,1,0,1,1.0,0.0,1670,1699
1932-05-22,Czechoslovakia,Austria,1,1,0,0.5,0.5,1619,1703
1932-05-29,Netherlands,Czechoslovakia,1,2,1,0.0,1.0,1530,1626
1932-05-29,Yugoslavia,Poland,0,3,3,0.0,1.0,1487,1527
1932-06-01,Estonia,Latvia,3,0,3,1.0,0.0,1483,1472
1932-06-05,Denmark,Belgium,3,4,1,0.0,1.0,1567,1509
1932-06-05,Norway,Estonia,3,0,3,1.0,0.0,1539,1477
1932-06-05,Yugoslavia,France,2,1,1,1.0,0.0,1494,1427
1932-06-09,Bulgaria,France,3,5,2,0.0,1.0,1450,1436
1932-06-10,Finland,Sweden,1,3,2,0.0,1.0,1448,1623
1932-06-12,Romania,France,6,3,3,1.0,0.0,1550,1431
1932-06-12,Sweden,Belgium,3,1,2,1.0,0.0,1629,1504
1932-06-17,Norway,Finland,2,1,1,1.0,0.0,1545,1443
1932-06-19,Denmark,Sweden,3,1,2,1.0,0.0,1577,1620
1932-06-19,Switzerland,Hungary,3,1,2,1.0,0.0,1444,1619
1932-06-26,Bulgaria,Romania,2,0,2,1.0,0.0,1461,1540
1932-06-26,Yugoslavia,Greece,7,1,6,1.0,0.0,1502,1468
1932-06-28,Greece,Romania,0,3,3,0.0,1.0,1462,1547
1932-06-29,Lithuania,Latvia,2,3,1,0.0,1.0,1407,1479
1932-06-30,Yugoslavia,Bulgaria,2,3,1,0.0,1.0,1494,1470
1932-07-01,Finland,Germany,1,4,3,0.0,1.0,1438,1579
1932-07-01,Sweden,Norway,1,4,3,0.0,1.0,1611,1555
1932-07-02,Bulgaria,Greece,2,0,2,1.0,0.0,1478,1455
1932-07-03,Yugoslavia,Romania,3,1,2,1.0,0.0,1504,1538
1932-07-10,Poland,Sweden,2,0,2,1.0,0.0,1537,1602
1932-07-13,Latvia,Sweden,0,0,0,0.5,0.5,1482,1600
1932-07-15,Estonia,Sweden,1,3,2,0.0,1.0,1472,1606
1932-07-17,Sweden,Austria,3,4,1,0.0,1.0,1601,1709
1932-07-24,Latvia,Lithuania,2,1,1,1.0,0.0,1489,1401
1932-08-06,Lithuania,Estonia,1,0,1,1.0,0.0,1411,1463
1932-08-17,Estonia,Finland,0,3,3,0.0,1.0,1455,1447
1932-08-25,Uganda,Kenya,13,1,12,1.0,0.0,1517,1489
1932-08-28,Latvia,Lithuania,4,1,3,1.0,0.0,1496,1405
1932-08-29,Estonia,Lithuania,1,2,1,0.0,1.0,1446,1415
1932-08-30,Finland,Denmark,4,2,2,1.0,0.0,1458,1567
1932-08-30,Latvia,Estonia,1,0,1,1.0,0.0,1503,1440
1932-09-11,Lithuania,Latvia,1,0,1,1.0,0.0,1425,1494
1932-09-17,Northern Ireland,Scotland,0,4,4,0.0,1.0,1455,1710
1932-09-18,Hungary,Czechoslovakia,2,1,1,1.0,0.0,1628,1618
1932-09-25,Germany,Sweden,4,3,1,1.0,0.0,1588,1593
1932-09-25,Norway,Denmark,1,2,1,0.0,1.0,1548,1575
1932-09-25,Sweden,Lithuania,8,1,7,1.0,0.0,1598,1421
1932-10-02,Hungary,Austria,2,3,1,0.0,1.0,1622,1716
1932-10-02,Poland,Latvia,2,1,1,1.0,0.0,1545,1487
1932-10-02,Romania,Poland,0,5,5,0.0,1.0,1531,1553
1932-10-09,Czechoslovakia,Yugoslavia,2,1,1,1.0,0.0,1624,1499
1932-10-17,England,Northern Ireland,1,0,1,1.0,0.0,1707,1452
1932-10-23,Austria,Switzerland,3,1,2,1.0,0.0,1719,1442
1932-10-26,Scotland,Wales,2,5,3,0.0,1.0,1698,1509
1932-10-28,Czechoslovakia,Italy,2,1,1,1.0,0.0,1633,1644
1932-10-30,Hungary,Germany,2,1,1,1.0,0.0,1630,1581
1932-11-04,Turkey,Bulgaria,2,3,1,0.0,1.0,1466,1486
1932-11-06,Switzerland,Sweden,2,1,1,1.0,0.0,1454,1587
1932-11-16,Wales,England,0,0,0,0.5,0.5,1514,1703
1932-11-27,Italy,Hungary,4,2,2,1.0,0.0,1652,1623
1932-12-04,Germany,Netherlands,0,2,2,0.0,1.0,1572,1540
1932-12-04,Uruguay,Brazil,1,2,1,0.0,1.0,1661,1592
1932-12-07,England,Austria,4,3,1,1.0,0.0,1712,1711
1932-12-07,Wales,Northern Ireland,4,1,3,1.0,0.0,1521,1446
1932-12-11,Belgium,Austria,1,6,5,0.0,1.0,1501,1715
1933-01-01,Italy,Germany,3,1,2,1.0,0.0,1659,1566
1933-01-21,Uruguay,Argentina,2,1,1,1.0,0.0,1670,1691
1933-01-22,Netherlands,Switzerland,0,2,2,0.0,1.0,1531,1464
1933-01-29,Portugal,Hungary,1,0,1,1.0,0.0,1519,1613
1933-02-05,Argentina,Uruguay,4,1,3,1.0,0.0,1699,1663
1933-02-12,Belgium,Italy,2,3,1,0.0,1.0,1497,1664
1933-02-12,France,Austria,0,4,4,0.0,1.0,1429,1718
1933-03-05,Netherlands,Hungary,1,2,1,0.0,1.0,1525,1620
1933-03-12,Switzerland,Belgium,3,3,0,0.5,0.5,1465,1497
1933-03-19,Germany,France,3,3,0,0.5,0.5,1563,1433
1933-03-19,Hungary,Czechoslovakia,2,0,2,1.0,0.0,1629,1625
1933-03-26,France,Belgium,3,0,3,1.0,0.0,1443,1488
1933-04-01,Scotland,England,2,1,1,1.0,0.0,1707,1704
1933-04-02,Spain,Portugal,3,0,3,1.0,0.0,1640,1514
1933-04-02,Switzerland,Italy,0,3,3,0.0,1.0,1462,1668
1933-04-06,Jersey,Alderney,6,0,6,1.0,0.0,1542,1386
1933-04-09,Austria,Czechoslovakia,1,2,1,0.0,1.0,1708,1636
1933-04-09,Belgium,Netherlands,1,3,2,0.0,1.0,1481,1533
1933-04-23,France,Spain,1,0,1,1.0,0.0,1456,1628
1933-04-30,Hungary,Austria,1,1,0,0.5,0.5,1631,1707
1933-04-30,Yugoslavia,Spain,1,1,0,0.5,0.5,1502,1626
1933-05-04,Guernsey,Jersey,4,1,3,1.0,0.0,1633,1536
1933-05-07,Italy,Czechoslovakia,2,0,2,1.0,0.0,1676,1629
1933-05-07,Netherlands,Belgium,1,2,1,0.0,1.0,1524,1491
1933-05-07,Switzerland,Yugoslavia,4,1,3,1.0,0.0,1471,1494
1933-05-13,Italy,England,1,1,0,0.5,0.5,1677,1704
1933-05-20,Switzerland,England,0,4,4,0.0,1.0,1468,1708
1933-05-21,Spain,Bulgaria,13,0,13,1.0,0.0,1631,1482
1933-05-25,France,Wales,1,1,0,0.5,0.5,1458,1520
1933-05-28,Latvia,Estonia,2,0,2,1.0,0.0,1494,1434
1933-06-03,Greece,Yugoslavia,3,5,2,0.0,1.0,1448,1502
1933-06-04,Poland,Belgium,0,1,1,0.0,1.0,1544,1501
1933-06-04,Romania,Bulgaria,7,0,7,1.0,0.0,1538,1476
1933-06-05,Australia,New Zealand,4,2,2,1.0,0.0,1501,1508
1933-06-07,Bulgaria,Yugoslavia,0,4,4,0.0,1.0,1469,1510
1933-06-10,Bulgaria,Greece,2,0,2,1.0,0.0,1477,1441
1933-06-10,Czechoslovakia,France,4,0,4,1.0,0.0,1634,1454
1933-06-11,Austria,Belgium,4,1,3,1.0,0.0,1711,1498
1933-06-11,Denmark,Norway,2,2,0,0.5,0.5,1575,1549
1933-06-11,Romania,Yugoslavia,5,0,5,1.0,0.0,1546,1503
1933-06-11,Sweden,Estonia,6,2,4,1.0,0.0,1592,1430
1933-06-12,Latvia,Lithuania,6,2,4,1.0,0.0,1501,1415
1933-06-17,Australia,New Zealand,6,4,2,1.0,0.0,1510,1500
1933-06-18,Sweden,Denmark,2,3,1,0.0,1.0,1584,1584
1933-06-24,Australia,New Zealand,4,2,2,1.0,0.0,1518,1493
1933-06-29,Lithuania,Sweden,0,2,2,0.0,1.0,1411,1589
1933-07-02,Sweden,Hungary,5,2,3,1.0,0.0,1598,1623
1933-07-04,Latvia,Sweden,1,1,0,0.5,0.5,1504,1596
1933-07-14,Sweden,Finland,2,0,2,1.0,0.0,1601,1454
1933-07-20,Estonia,Lithuania,2,1,1,1.0,0.0,1438,1404
1933-08-06,Yugoslavia,Czechoslovakia,2,1,1,1.0,0.0,1514,1624
1933-08-09,Estonia,Latvia,2,1,1,1.0,0.0,1448,1495
1933-08-09,Finland,Lithuania,9,2,7,1.0,0.0,1461,1398
1933-08-16,Finland,Estonia,2,1,1,1.0,0.0,1469,1441
1933-09-02,Lithuania,Estonia,1,1,0,0.5,0.5,1399,1441
1933-09-03,Estonia,Latvia,0,1,1,0.0,1.0,1435,1502
1933-09-03,Finland,Norway,1,5,4,0.0,1.0,1463,1556
1933-09-04,Lithuania,Latvia,2,2,0,0.5,0.5,1402,1500
1933-09-05,Lithuania,Estonia,0,5,5,0.0,1.0,1395,1443
1933-09-10,Poland,Yugoslavia,4,3,1,1.0,0.0,1552,1507
1933-09-16,Scotland,Northern Ireland,1,2,1,0.0,1.0,1694,1460
1933-09-17,Czechoslovakia,Austria,3,3,0,0.5,0.5,1626,1710
1933-09-17,Hungary,Switzerland,3,0,3,1.0,0.0,1628,1464
1933-09-24,Norway,Sweden,0,1,1,0.0,1.0,1550,1608
1933-09-24,Yugoslavia,Switzerland,2,2,0,0.5,0.5,1507,1465
1933-10-01,Austria,Hungary,2,2,0,0.5,0.5,1709,1630
1933-10-04,Wales,Scotland,3,2,1,1.0,0.0,1532,1683
1933-10-04,Silesia,Poland,1,2,1,0.0,1.0,1494,1559
1933-10-08,Aruba,Curaçao,1,3,2,0.0,1.0,1471,1524
1933-10-08,Denmark,Finland,2,0,2,1.0,0.0,1590,1458
1933-10-11,Aruba,Curaçao,0,2,2,0.0,1.0,1465,1531
1933-10-14,Northern Ireland,England,0,3,3,0.0,1.0,1457,1712
1933-10-15,Poland,Czechoslovakia,1,2,1,0.0,1.0,1553,1633
1933-10-22,Germany,Belgium,8,1,7,1.0,0.0,1570,1492
1933-10-22,Hungary,Italy,0,1,1,0.0,1.0,1624,1684
1933-10-23,Trinidad and Tobago,Barbados,8,4,4,1.0,0.0,1509,1481
1933-10-24,Trinidad and Tobago,Guyana,2,0,2,1.0,0.0,1518,1522
1933-10-25,Barbados,Guyana,0,2,2,0.0,1.0,1474,1530
1933-10-27,Trinidad and Tobago,Guyana,1,1,0,0.5,0.5,1519,1530
1933-10-29,Switzerland,Romania,2,2,0,0.5,0.5,1467,1545
1933-10-30,Trinidad and Tobago,Barbados,3,1,2,1.0,0.0,1526,1468
1933-11-02,Trinidad and Tobago,Guyana,1,0,1,1.0,0.0,1535,1522
1933-11-03,Barbados,Guyana,2,5,3,0.0,1.0,1462,1529
1933-11-04,Northern Ireland,Wales,1,1,0,0.5,0.5,1459,1531
1933-11-05,Germany,Norway,2,2,0,0.5,0.5,1570,1551
1933-11-05,Trinidad and Tobago,Barbados,6,0,6,1.0,0.0,1542,1456
1933-11-15,England,Wales,1,2,1,0.0,1.0,1701,1543
1933-11-19,Switzerland,Germany,0,2,2,0.0,1.0,1462,1576
1933-11-26,Belgium,Denmark,2,2,0,0.5,0.5,1495,1588
1933-11-29,Scotland,Austria,2,2,0,0.5,0.5,1684,1709
1933-12-03,Germany,Poland,1,0,1,1.0,0.0,1584,1546
1933-12-03,Italy,Switzerland,5,2,3,1.0,0.0,1688,1459
1933-12-06,England,France,4,1,3,1.0,0.0,1705,1451
1933-12-10,Netherlands,Austria,0,1,1,0.0,1.0,1520,1714
1933-12-14,Uruguay,Argentina,0,1,1,0.0,1.0,1656,1707
1934-01-14,Germany,Hungary,3,1,2,1.0,0.0,1593,1616
1934-01-21,Belgium,France,2,3,1,0.0,1.0,1486,1461
1934-01-28,Haiti,Cuba,1,3,2,0.0,1.0,1474,1548
1934-02-01,Haiti,Cuba,1,1,0,0.5,0.5,1476,1547
1934-02-02,Catalonia,Spain,0,2,2,0.0,1.0,1469,1636
1934-02-04,Haiti,Cuba,0,6,6,0.0,1.0,1470,1554
1934-02-11,Italy,Austria,2,4,2,0.0,1.0,1681,1722
1934-02-25,Republic of Ireland,Belgium,4,4,0,0.5,0.5,1528,1487
1934-03-04,Mexico,Cuba,3,2,1,1.0,0.0,1496,1545
1934-03-11,France,Switzerland,0,1,1,0.0,1.0,1453,1468
1934-03-11,Luxembourg,Germany,1,9,8,0.0,1.0,1462,1599
1934-03-11,Mexico,Cuba,5,0,5,1.0,0.0,1506,1536
1934-03-11,Netherlands,Belgium,9,3,6,1.0,0.0,1528,1480
1934-03-11,Spain,Portugal,9,0,9,1.0,0.0,1642,1509
1934-03-13,Guadeloupe,Martinique,0,6,6,0.0,1.0,1492,1504
1934-03-16,Egypt,Israel,7,1,6,1.0,0.0,1527,1493
1934-03-18,Bulgaria,Yugoslavia,1,2,1,0.0,1.0,1470,1515
1934-03-18,Mexico,Cuba,4,1,3,1.0,0.0,1515,1528
1934-03-18,Portugal,Spain,1,2,1,0.0,1.0,1504,1648
1934-03-25,Bulgaria,Hungary,1,4,3,0.0,1.0,1466,1621
1934-03-25,France,Czechoslovakia,1,2,1,0.0,1.0,1449,1638
1934-03-25,Italy,Greece,4,0,4,1.0,0.0,1685,1438
1934-03-25,Switzerland,Austria,2,3,1,0.0,1.0,1465,1726
1934-04-01,Yugoslavia,Bulgaria,2,3,1,0.0,1.0,1506,1476
1934-04-06,Israel,Egypt,1,4,3,0.0,1.0,1486,1535
1934-04-08,Netherlands,Republic of Ireland,5,2,3,1.0,0.0,1536,1520
1934-04-12,Guernsey,Alderney,3,0,3,1.0,0.0,1637,1383
1934-04-14,England,Scotland,3,0,3,1.0,0.0,1713,1677
1934-04-15,Austria,Hungary,5,2,3,1.0,0.0,1732,1616
1934-04-15,Luxembourg,France,1,6,5,0.0,1.0,1454,1458
1934-04-25,Austria,Bulgaria,6,1,5,1.0,0.0,1735,1474
1934-04-26,Jersey,Guernsey,0,1,1,0.0,1.0,1531,1643
1934-04-29,Hungary,Bulgaria,4,1,3,1.0,0.0,1621,1470
1934-04-29,Belgium,Netherlands,2,4,2,0.0,1.0,1474,1543
1934-04-29,Czechoslovakia,Hungary,2,2,0,0.5,0.5,1638,1622
1934-04-29,Romania,Yugoslavia,2,1,1,1.0,0.0,1553,1499
1934-05-10,Hungary,England,2,1,1,1.0,0.0,1633,1703
1934-05-10,Netherlands,France,4,5,1,0.0,1.0,1534,1468
1934-05-12,Philippines,China PR,0,2,2,0.0,1.0,1454,1630
1934-05-12,Philippines,China PR,0,2,2,0.0,1.0,1450,1635
1934-05-13,Japan,Indonesia,1,7,6,0.0,1.0,1445,1507
1934-05-13,Japan,Indonesia,1,7,6,0.0,1.0,1439,1514
1934-05-14,China PR,Indonesia,2,0,2,1.0,0.0,1641,1509
1934-05-14,China PR,Indonesia,2,0,2,1.0,0.0,1647,1504
1934-05-15,Philippines,Japan,3,4,1,0.0,1.0,1442,1448
1934-05-16,Czechoslovakia,England,2,1,1,1.0,0.0,1648,1694
1934-05-19,Philippines,Indonesia,3,2,1,1.0,0.0,1452,1495
1934-05-19,Philippines,Indonesia,3,2,1,1.0,0.0,1461,1487
1934-05-20,China PR,Japan,4,3,1,1.0,0.0,1651,1445
1934-05-20,China PR,Japan,4,3,1,1.0,0.0,1655,1442
1934-05-21,Denmark,Poland,4,2,2,1.0,0.0,1596,1539
1934-05-23,Sweden,Poland,4,2,2,1.0,0.0,1615,1533
1934-05-24,Mexico,United States,2,4,2,0.0,1.0,1508,1536
1934-05-27,Argentina,Sweden,2,3,1,0.0,1.0,1697,1626
1934-05-27,Austria,France,3,2,1,1.0,0.0,1738,1466
1934-05-27,Belgium,Germany,2,5,3,0.0,1.0,1469,1605
1934-05-27,Brazil,Spain,1,3,2,0.0,1.0,1586,1655
1934-05-27,Czechoslovakia,Romania,2,1,1,1.0,0.0,1654,1548
1934-05-27,Egypt,Hungary,2,4,2,0.0,1.0,1530,1639
1934-05-27,Italy,United States,7,1,6,1.0,0.0,1690,1532
1934-05-27,Netherlands,Switzerland,2,3,1,0.0,1.0,1525,1475
1934-05-31,Austria,Hungary,2,1,1,1.0,0.0,1744,1634
1934-05-31,Czechoslovakia,Switzerland,3,2,1,1.0,0.0,1659,1471
1934-05-31,Germany,Sweden,2,1,1,1.0,0.0,1614,1618
1934-05-31,Italy,Spain,1,1,0,0.5,0.5,1690,1656
1934-06-01,Italy,Spain,1,0,1,1.0,0.0,1698,1649
1934-06-03,Czechoslovakia,Germany,3,1,2,1.0,0.0,1666,1608
1934-06-03,Italy,Austria,1,0,1,1.0,0.0,1708,1735
1934-06-03,Yugoslavia,Brazil,8,4,4,1.0,0.0,1509,1577
1934-06-07,Austria,Germany,2,3,1,0.0,1.0,1725,1619
1934-06-10,Italy,Czechoslovakia,2,1,1,1.0,0.0,1716,1659
1934-06-10,Lithuania,Latvia,2,0,2,1.0,0.0,1406,1490
1934-06-17,Denmark,Sweden,3,5,2,0.0,1.0,1589,1626
1934-06-17,Catalonia,Brazil,2,1,1,1.0,0.0,1480,1567
1934-06-24,Catalonia,Brazil,2,2,0,0.5,0.5,1482,1566
1934-06-29,Lithuania,Estonia,1,1,0,0.5,0.5,1407,1443
1934-07-01,Sweden,Norway,3,3,0,0.5,0.5,1625,1553
1934-07-03,Finland,Denmark,2,1,1,1.0,0.0,1469,1579
1934-07-18,Uruguay,Argentina,2,2,0,0.5,0.5,1657,1697
1934-07-22,Curaçao,Suriname,3,1,2,1.0,0.0,1539,1493
1934-07-25,Curaçao,Suriname,3,2,1,1.0,0.0,1546,1487
1934-07-29,Curaçao,Suriname,2,2,0,0.5,0.5,1545,1489
1934-07-31,Aruba,Suriname,1,1,0,0.5,0.5,1466,1489
1934-08-06,Suriname,Trinidad and Tobago,3,3,0,0.5,0.5,1491,1541
1934-08-08,Estonia,Finland,1,1,0,0.5,0.5,1444,1469
1934-08-10,Estonia,Hungary,2,2,0,0.5,0.5,1448,1631
1934-08-14,Latvia,Finland,1,1,0,0.5,0.5,1490,1470
1934-08-15,Argentina,Uruguay,1,0,1,1.0,0.0,1705,1650
1934-08-16,Lithuania,Finland,1,0,1,1.0,0.0,1417,1461
1934-08-26,Yugoslavia,Poland,4,1,3,1.0,0.0,1518,1525
1934-09-02,Czechoslovakia,Yugoslavia,3,1,2,1.0,0.0,1664,1514
1934-09-02,Norway,Finland,4,2,2,1.0,0.0,1559,1456
1934-09-09,Latvia,Lithuania,1,3,2,0.0,1.0,1481,1427
1934-09-09,Poland,Germany,2,5,3,0.0,1.0,1520,1625
1934-09-23,Austria,Czechoslovakia,2,2,0,0.5,0.5,1724,1666
1934-09-23,Finland,Sweden,5,4,1,1.0,0.0,1468,1614
1934-09-23,Norway,Denmark,3,1,2,1.0,0.0,1568,1571
1934-09-23,Sweden,Latvia,3,1,2,1.0,0.0,1620,1476
1934-09-29,Wales,England,0,4,4,0.0,1.0,1539,1699
1934-10-07,Denmark,Germany,2,5,3,0.0,1.0,1565,1632
1934-10-07,Hungary,Austria,3,1,2,1.0,0.0,1642,1714
1934-10-14,Latvia,Poland,2,6,4,0.0,1.0,1470,1527
1934-10-14,Poland,Romania,3,3,0,0.5,0.5,1528,1548
1934-10-14,Switzerland,Czechoslovakia,2,2,0,0.5,0.5,1476,1662
1934-10-20,Northern Ireland,Scotland,2,1,1,1.0,0.0,1472,1665
1934-11-04,Switzerland,Netherlands,2,4,2,0.0,1.0,1470,1532
1934-11-11,Austria,Switzerland,3,0,3,1.0,0.0,1718,1467
1934-11-14,England,Italy,3,2,1,1.0,0.0,1708,1708
1934-11-21,Scotland,Wales,3,2,1,1.0,0.0,1671,1534
1934-12-09,Italy,Hungary,4,2,2,1.0,0.0,1715,1636
1934-12-15,Republic of Ireland,Hungary,2,4,2,0.0,1.0,1515,1642
1934-12-16,France,Yugoslavia,3,2,1,1.0,0.0,1476,1505
1934-12-23,Greece,Yugoslavia,2,1,1,1.0,0.0,1448,1496
1934-12-25,Bulgaria,Yugoslavia,3,4,1,0.0,1.0,1463,1504
1934-12-27,Greece,Romania,2,2,0,0.5,0.5,1451,1546
1934-12-30,Bulgaria,Romania,2,3,1,0.0,1.0,1457,1553
1935-01-01,Greece,Bulgaria,1,2,1,0.0,1.0,1444,1465
1935-01-01,Romania,Yugoslavia,0,4,4,0.0,1.0,1544,1514
1935-01-06,Argentina,Chile,4,1,3,1.0,0.0,1708,1431
1935-01-13,Peru,Uruguay,0,1,1,0.0,1.0,1470,1655
1935-01-18,Chile,Uruguay,1,2,1,0.0,1.0,1428,1659
1935-01-20,Peru,Argentina,1,4,3,0.0,1.0,1467,1712
1935-01-24,Spain,France,2,0,2,1.0,0.0,1654,1472
1935-01-26,Peru,Chile,1,0,1,1.0,0.0,1475,1421
1935-01-27,Argentina,Uruguay,0,3,3,0.0,1.0,1703,1669
1935-01-27,Germany,Switzerland,4,0,4,1.0,0.0,1637,1463
1935-02-06,England,Northern Ireland,2,1,1,1.0,0.0,1712,1469
1935-02-17,Italy,France,2,1,1,1.0,0.0,1719,1469
1935-02-17,Netherlands,Germany,2,3,1,0.0,1.0,1527,1643
1935-02-22,Uganda,Kenya,5,1,4,1.0,0.0,1525,1482
1935-03-17,Czechoslovakia,Switzerland,3,1,2,1.0,0.0,1666,1460
1935-03-17,France,Germany,1,3,2,0.0,1.0,1465,1648
1935-03-23,Curaçao,Aruba,2,0,2,1.0,0.0,1552,1460
1935-03-24,Austria,Italy,0,2,2,0.0,1.0,1711,1727
1935-03-24,Curaçao,Aruba,4,0,4,1.0,0.0,1558,1455
1935-03-24,El Salvador,Cuba,4,1,3,1.0,0.0,1494,1519
1935-03-25,Costa Rica,Guatemala,4,3,1,1.0,0.0,1547,1456
1935-03-25,Cuba,Honduras,3,0,3,1.0,0.0,1527,1489
1935-03-27,Wales,Northern Ireland,3,1,2,1.0,0.0,1541,1463
1935-03-27,El Salvador,Mexico,1,8,7,0.0,1.0,1487,1516
1935-03-27,Cuba,Guatemala,2,1,1,1.0,0.0,1534,1450
1935-03-28,El Salvador,Honduras,3,4,1,0.0,1.0,1480,1497
1935-03-28,Mexico,Guatemala,5,1,4,1.0,0.0,1523,1444
1935-03-30,Mexico,Cuba,6,1,5,1.0,0.0,1532,1526
1935-03-30,El Salvador,Costa Rica,1,6,5,0.0,1.0,1474,1554
1935-03-31,Netherlands,Belgium,4,2,2,1.0,0.0,1534,1463
1935-03-31,Honduras,Guatemala,0,0,0,0.5,0.5,1496,1446
1935-03-31,Costa Rica,Cuba,2,1,1,1.0,0.0,1562,1519
1935-04-01,Mexico,Honduras,8,2,6,1.0,0.0,1540,1489
1935-04-02,Mexico,Costa Rica,2,0,2,1.0,0.0,1549,1554
1935-04-03,Costa Rica,Honduras,6,0,6,1.0,0.0,1561,1483
1935-04-03,El Salvador,Guatemala,6,1,5,1.0,0.0,1482,1439
1935-04-06,Scotland,England,2,0,2,1.0,0.0,1680,1704
1935-04-11,Jersey,Guernsey,0,1,1,0.0,1.0,1526,1649
1935-04-14,Belgium,France,1,1,0,0.5,0.5,1464,1465
1935-04-14,Czechoslovakia,Austria,0,0,0,0.5,0.5,1668,1710
1935-04-14,Switzerland,Hungary,6,2,4,1.0,0.0,1472,1631
1935-04-28,Belgium,Germany,1,6,5,0.0,1.0,1460,1653
1935-05-05,Portugal,Spain,3,3,0,0.5,0.5,1508,1651
1935-05-05,Switzerland,Republic of Ireland,1,0,1,1.0,0.0,1481,1507
1935-05-08,Germany,Republic of Ireland,3,1,2,1.0,0.0,1658,1503
1935-05-09,Guernsey,Alderney,5,0,5,1.0,0.0,1652,1381
1935-05-11,Kenya,Uganda,1,3,2,0.0,1.0,1475,1533
1935-05-12,Austria,Poland,5,2,3,1.0,0.0,1715,1524
1935-05-12,Belgium,Netherlands,0,2,2,0.0,1.0,1454,1541
1935-05-12,Germany,Spain,1,2,1,0.0,1.0,1650,1660
1935-05-12,Hungary,Austria,6,3,3,1.0,0.0,1641,1706
1935-05-18,Netherlands,England,0,1,1,0.0,1.0,1537,1709
1935-05-19,France,Hungary,2,0,2,1.0,0.0,1477,1630
1935-05-19,United States,Scotland,1,5,4,0.0,1.0,1528,1685
1935-05-20,Suriname,Curaçao,0,1,1,0.0,1.0,1485,1565
1935-05-22,Suriname,Curaçao,4,1,3,1.0,0.0,1495,1556
1935-05-24,Suriname,Curaçao,2,1,1,1.0,0.0,1505,1547
1935-05-26,Germany,Czechoslovakia,2,1,1,1.0,0.0,1659,1660
1935-05-30,Belgium,Switzerland,2,2,0,0.5,0.5,1455,1481
1935-05-30,Latvia,Lithuania,6,1,5,1.0,0.0,1478,1420
1935-06-09,United States,Scotland,1,4,3,0.0,1.0,1524,1690
1935-06-12,Latvia,Estonia,1,1,0,0.5,0.5,1478,1449
1935-06-12,Sweden,Finland,2,2,0,0.5,0.5,1617,1472
1935-06-16,Bulgaria,Greece,5,2,3,1.0,0.0,1473,1437
1935-06-16,Sweden,Denmark,3,1,2,1.0,0.0,1624,1559
1935-06-17,Romania,Yugoslavia,0,2,2,0.0,1.0,1536,1523
1935-06-19,Bulgaria,Romania,4,0,4,1.0,0.0,1483,1527
1935-06-19,Estonia,Lithuania,2,2,0,0.5,0.5,1449,1421
1935-06-21,Greece,Yugoslavia,1,6,5,0.0,1.0,1431,1530
1935-06-23,Denmark,Norway,1,0,1,1.0,0.0,1568,1560
1935-06-24,Bulgaria,Yugoslavia,3,3,0,0.5,0.5,1485,1529
1935-06-24,Greece,Romania,2,2,0,0.5,0.5,1434,1525
1935-06-27,Norway,Germany,1,1,0,0.5,0.5,1563,1657
1935-06-30,Sweden,Germany,3,1,2,1.0,0.0,1633,1649
1935-07-05,Latvia,Sweden,0,3,3,0.0,1.0,1474,1638
1935-07-09,Estonia,Sweden,1,2,1,0.0,1.0,1445,1643
1935-07-18,Uruguay,Argentina,1,1,0,0.5,0.5,1670,1703
1935-07-19,Suriname,Trinidad and Tobago,0,3,3,0.0,1.0,1498,1549
1935-08-07,Estonia,Finland,2,2,0,0.5,0.5,1446,1472
1935-08-15,Argentina,Uruguay,3,0,3,1.0,0.0,1711,1663
1935-08-18,Germany,Finland,6,0,6,1.0,0.0,1654,1468
1935-08-18,Luxembourg,Germany,0,1,1,0.0,1.0,1451,1658
1935-08-18,Poland,Yugoslavia,2,3,1,0.0,1.0,1517,1537
1935-08-20,Estonia,Lithuania,1,2,1,0.0,1.0,1438,1430
1935-08-21,Lithuania,Latvia,2,2,0,0.5,0.5,1432,1473
1935-08-22,Estonia,Latvia,1,1,0,0.5,0.5,1439,1473
1935-08-25,Germany,Romania,4,2,2,1.0,0.0,1664,1520
1935-09-01,Sweden,Romania,7,1,6,1.0,0.0,1649,1515
1935-09-06,Yugoslavia,Czechoslovakia,0,0,0,0.5,0.5,1540,1658
1935-09-08,Finland,Norway,1,5,4,0.0,1.0,1463,1569
1935-09-08,Lithuania,Latvia,2,2,0,0.5,0.5,1433,1473
1935-09-15,Germany,Estonia,5,0,5,1.0,0.0,1668,1436
1935-09-15,Germany,Poland,1,0,1,1.0,0.0,1673,1513
1935-09-15,Poland,Latvia,3,3,0,0.5,0.5,1513,1474
1935-09-18,Lithuania,Estonia,2,2,0,0.5,0.5,1434,1436
1935-09-20,Curaçao,Aruba,1,0,1,1.0,0.0,1553,1450
1935-09-22,Hungary,Czechoslovakia,1,0,1,1.0,0.0,1639,1650
1935-09-22,Norway,Sweden,0,2,2,0.0,1.0,1563,1656
1935-10-05,Wales,Scotland,1,1,0,0.5,0.5,1545,1687
1935-10-06,Austria,Hungary,4,4,0,0.5,0.5,1705,1641
1935-10-06,Denmark,Finland,5,1,4,1.0,0.0,1574,1458
1935-10-06,Poland,Austria,1,0,1,1.0,0.0,1526,1693
1935-10-13,Germany,Latvia,3,0,3,1.0,0.0,1677,1471
1935-10-19,Northern Ireland,England,1,3,2,0.0,1.0,1460,1713
1935-10-20,Germany,Bulgaria,4,2,2,1.0,0.0,1681,1482
1935-10-27,Czechoslovakia,Italy,2,1,1,1.0,0.0,1660,1718
1935-10-27,Switzerland,France,2,1,1,1.0,0.0,1489,1470
1935-11-03,Netherlands,Denmark,3,0,3,1.0,0.0,1546,1566
1935-11-03,Romania,Poland,4,1,3,1.0,0.0,1524,1518
1935-11-03,Switzerland,Norway,2,0,2,1.0,0.0,1499,1554
1935-11-10,France,Sweden,2,0,2,1.0,0.0,1482,1645
1935-11-10,Hungary,Switzerland,6,1,5,1.0,0.0,1646,1495
1935-11-13,Scotland,Northern Ireland,2,1,1,1.0,0.0,1691,1457
1935-11-17,Belgium,Sweden,5,1,4,1.0,0.0,1467,1634
1935-11-24,Italy,Hungary,2,2,0,0.5,0.5,1717,1648
1935-12-04,England,Germany,3,0,3,1.0,0.0,1721,1674
1935-12-08,Republic of Ireland,Netherlands,3,5,2,0.0,1.0,1496,1554
1935-12-15,Curaçao,Trinidad and Tobago,3,1,2,1.0,0.0,1561,1542
1935-12-28,Jamaica,Trinidad and Tobago,2,3,1,0.0,1.0,1515,1550
1936-01-01,French Guiana,Suriname,1,3,2,0.0,1.0,1492,1507
1936-01-04,Jamaica,Trinidad and Tobago,0,1,1,0.0,1.0,1508,1558
1936-01-11,Jamaica,Trinidad and Tobago,1,2,1,0.0,1.0,1502,1565
1936-01-12,France,Netherlands,1,6,5,0.0,1.0,1476,1561
1936-01-19,Spain,Austria,4,5,1,0.0,1.0,1653,1701
1936-01-26,Portugal,Austria,2,3,1,0.0,1.0,1505,1705
1936-01-30,Curaçao,Trinidad and Tobago,4,2,2,1.0,0.0,1570,1557
1936-02-05,England,Wales,1,2,1,0.0,1.0,1710,1557
1936-02-09,France,Czechoslovakia,0,3,3,0.0,1.0,1472,1665
1936-02-16,Belgium,Poland,0,2,2,0.0,1.0,1461,1525
1936-02-22,Trinidad and Tobago,Curaçao,3,0,3,1.0,0.0,1566,1562
1936-02-23,Spain,Germany,1,2,1,0.0,1.0,1646,1682
1936-02-27,Portugal,Germany,1,3,2,0.0,1.0,1501,1687
1936-03-08,France,Belgium,3,0,3,1.0,0.0,1480,1454
1936-03-11,Northern Ireland,Wales,3,2,1,1.0,0.0,1468,1547
1936-03-15,Hungary,Germany,3,2,1,1.0,0.0,1657,1679
1936-03-17,Republic of Ireland,Switzerland,1,0,1,1.0,0.0,1504,1488
1936-03-22,Austria,Czechoslovakia,1,1,0,0.5,0.5,1705,1666
1936-03-29,Netherlands,Belgium,8,0,8,1.0,0.0,1567,1449
1936-04-04,England,Scotland,1,1,0,0.5,0.5,1710,1692
1936-04-05,Austria,Hungary,3,5,2,0.0,1.0,1696,1667
1936-04-05,Switzerland,Italy,1,2,1,0.0,1.0,1485,1721
1936-04-23,Jersey,Alderney,9,0,9,1.0,0.0,1531,1377
1936-05-03,Belgium,Netherlands,1,1,0,0.5,0.5,1452,1565
1936-05-03,Hungary,Republic of Ireland,3,3,0,0.5,0.5,1664,1508
1936-05-03,Switzerland,Spain,0,2,2,0.0,1.0,1481,1651
1936-05-06,Austria,England,2,1,1,1.0,0.0,1705,1702
1936-05-07,Guernsey,Jersey,2,1,1,1.0,0.0,1658,1526
1936-05-09,Belgium,England,3,2,1,1.0,0.0,1465,1690
1936-05-09,Luxembourg,Republic of Ireland,1,5,4,0.0,1.0,1445,1515
1936-05-10,Romania,Yugoslavia,3,2,1,1.0,0.0,1533,1532
1936-05-17,Italy,Austria,2,2,0,0.5,0.5,1721,1706
1936-05-17,Romania,Greece,5,2,3,1.0,0.0,1539,1429
1936-05-21,Bulgaria,Greece,5,4,1,1.0,0.0,1489,1423
1936-05-24,Romania,Bulgaria,4,1,3,1.0,0.0,1546,1483
1936-05-24,Switzerland,Belgium,1,1,0,0.5,0.5,1481,1466
1936-05-28,Estonia,Latvia,3,4,1,0.0,1.0,1429,1479
1936-05-31,Hungary,Italy,1,2,1,0.0,1.0,1658,1728
1936-06-14,Denmark,Sweden,4,3,1,1.0,0.0,1576,1625
1936-06-14,Lithuania,Latvia,1,5,4,0.0,1.0,1428,1486
1936-06-18,Norway,Switzerland,1,2,1,0.0,1.0,1545,1491
1936-06-19,Egypt,Greece,3,1,2,1.0,0.0,1536,1418
1936-06-21,Sweden,Switzerland,5,2,3,1.0,0.0,1631,1486
1936-06-30,Finland,Denmark,1,4,3,0.0,1.0,1453,1582
1936-06-30,Lithuania,Estonia,2,0,2,1.0,0.0,1437,1421
1936-07-04,New Zealand,Australia,1,7,6,0.0,1.0,1486,1526
1936-07-05,Sweden,Norway,2,0,2,1.0,0.0,1638,1539
1936-07-11,New Zealand,Australia,0,10,10,0.0,1.0,1479,1534
1936-07-12,Turkey,Yugoslavia,3,3,0,0.5,0.5,1468,1531
1936-07-18,New Zealand,Australia,1,4,3,0.0,1.0,1473,1541
1936-07-26,Sweden,Norway,3,4,1,0.0,1.0,1628,1550
1936-08-09,Argentina,Uruguay,1,0,1,1.0,0.0,1718,1657
1936-08-20,Estonia,Finland,2,2,0,0.5,0.5,1422,1453
1936-08-29,Latvia,Lithuania,2,1,1,1.0,0.0,1493,1431
1936-08-30,Estonia,Lithuania,2,1,1,1.0,0.0,1431,1423
1936-08-31,Latvia,Estonia,2,1,1,1.0,0.0,1500,1425
1936-09-06,Latvia,Poland,3,3,0,0.5,0.5,1501,1525
1936-09-06,Norway,Finland,0,2,2,0.0,1.0,1540,1464
1936-09-06,Yugoslavia,Poland,9,3,6,1.0,0.0,1539,1518
1936-09-13,Poland,Germany,1,1,0,0.5,0.5,1522,1676
1936-09-20,Norway,Denmark,3,3,0,0.5,0.5,1541,1582
1936-09-20,Uruguay,Argentina,2,1,1,1.0,0.0,1667,1709
1936-09-27,Czechoslovakia,Germany,1,2,1,0.0,1.0,1659,1684
1936-09-27,Finland,Sweden,1,2,1,0.0,1.0,1460,1633
1936-09-27,Germany,Luxembourg,7,2,5,1.0,0.0,1688,1442
1936-09-27,Hungary,Austria,5,3,2,1.0,0.0,1668,1697
1936-10-04,Denmark,Poland,2,1,1,1.0,0.0,1589,1516
1936-10-04,Romania,Hungary,1,2,1,0.0,1.0,1541,1674
1936-10-14,Scotland,Germany,2,0,2,1.0,0.0,1700,1681
1936-10-17,Republic of Ireland,Germany,5,2,3,1.0,0.0,1527,1670
1936-10-17,Wales,England,2,1,1,1.0,0.0,1559,1679
1936-10-18,Czechoslovakia,Hungary,5,2,3,1.0,0.0,1668,1666
1936-10-25,Italy,Switzerland,4,2,2,1.0,0.0,1732,1483
1936-10-31,Northern Ireland,Scotland,1,3,2,0.0,1.0,1465,1704
1936-11-01,Netherlands,Norway,3,3,0,0.5,0.5,1565,1542
1936-11-08,Switzerland,Austria,1,3,2,0.0,1.0,1480,1701
1936-11-15,Germany,Italy,2,2,0,0.5,0.5,1672,1731
1936-11-18,England,Northern Ireland,3,1,2,1.0,0.0,1683,1462
1936-12-02,England,Hungary,6,2,4,1.0,0.0,1691,1659
1936-12-02,Scotland,Wales,1,2,1,0.0,1.0,1693,1571
1936-12-06,Republic of Ireland,Hungary,2,3,1,0.0,1.0,1522,1665
1936-12-13,France,Yugoslavia,1,0,1,1.0,0.0,1490,1530
1936-12-13,Italy,Czechoslovakia,2,0,2,1.0,0.0,1738,1662
1936-12-27,Brazil,Peru,3,2,1,1.0,0.0,1572,1470
1936-12-30,Argentina,Chile,2,1,1,1.0,0.0,1712,1419
1937-01-02,Paraguay,Uruguay,4,2,2,1.0,0.0,1534,1656
1937-01-03,Brazil,Chile,6,4,2,1.0,0.0,1577,1415
1937-01-04,Suriname,Guyana,8,0,8,1.0,0.0,1516,1521
1937-01-05,Guyana,Trinidad and Tobago,0,3,3,0.0,1.0,1515,1573
1937-01-06,Peru,Uruguay,2,4,2,0.0,1.0,1466,1661
1937-01-06,Suriname,Trinidad and Tobago,1,1,0,0.5,0.5,1518,1572
1937-01-08,Suriname,Trinidad and Tobago,3,3,0,0.5,0.5,1520,1571
1937-01-09,Argentina,Paraguay,6,1,5,1.0,0.0,1717,1530
1937-01-10,Chile,Uruguay,3,0,3,1.0,0.0,1428,1649
1937-01-10,Suriname,Trinidad and Tobago,2,2,0,0.5,0.5,1522,1570
1937-01-11,Guyana,Trinidad and Tobago,2,3,1,0.0,1.0,1509,1577
1937-01-13,Brazil,Paraguay,5,0,5,1.0,0.0,1584,1524
1937-01-16,Argentina,Peru,1,0,1,1.0,0.0,1721,1463
1937-01-17,Chile,Paraguay,2,3,1,0.0,1.0,1423,1530
1937-01-19,Brazil,Uruguay,3,2,1,1.0,0.0,1594,1640
1937-01-21,Chile,Peru,2,2,0,0.5,0.5,1424,1463
1937-01-23,Argentina,Uruguay,2,3,1,0.0,1.0,1712,1650
1937-01-24,France,Austria,1,2,1,0.0,1.0,1487,1705
1937-01-24,Paraguay,Peru,0,1,1,0.0,1.0,1521,1473
1937-01-30,Argentina,Brazil,1,0,1,1.0,0.0,1718,1589
1937-01-31,Germany,Netherlands,2,2,0,0.5,0.5,1670,1568
1937-02-01,Argentina,Brazil,2,0,2,1.0,0.0,1724,1584
1937-02-21,Belgium,France,3,1,2,1.0,0.0,1475,1479
1937-02-21,Czechoslovakia,Switzerland,5,3,2,1.0,0.0,1667,1476
1937-03-07,Netherlands,Switzerland,2,1,1,1.0,0.0,1574,1471
1937-03-17,Wales,Northern Ireland,4,1,3,1.0,0.0,1577,1457
1937-03-21,Germany,France,4,0,4,1.0,0.0,1674,1476
1937-03-21,Luxembourg,Germany,2,3,1,0.0,1.0,1439,1678
1937-04-04,Belgium,Netherlands,2,1,1,1.0,0.0,1486,1564
1937-04-11,Switzerland,Hungary,1,5,4,0.0,1.0,1468,1669
1937-04-15,Guernsey,Alderney,4,1,3,1.0,0.0,1661,1375
1937-04-17,Scotland,England,3,1,2,1.0,0.0,1701,1684
1937-04-18,Belgium,Switzerland,1,2,1,0.0,1.0,1478,1477
1937-04-18,Romania,Czechoslovakia,1,1,0,0.5,0.5,1544,1665
1937-04-25,Germany,Belgium,1,0,1,1.0,0.0,1682,1475
1937-04-25,Italy,Hungary,2,0,2,1.0,0.0,1745,1663
1937-04-29,Jersey,Guernsey,2,2,0,0.5,0.5,1529,1659
1937-05-01,Aruba,Curaçao,1,1,0,0.5,0.5,1453,1560
1937-05-02,Aruba,Curaçao,1,1,0,0.5,0.5,1456,1558
1937-05-02,Netherlands,Belgium,1,0,1,1.0,0.0,1570,1470
1937-05-02,Switzerland,Germany,0,1,1,0.0,1.0,1474,1686
1937-05-06,Czechoslovakia,Basque Country,3,2,1,1.0,0.0,1671,1548
1937-05-09,Austria,Scotland,1,1,0,0.5,0.5,1705,1702
1937-05-09,Hungary,Yugoslavia,1,1,0,0.5,0.5,1661,1533
1937-05-14,Norway,England,0,6,6,0.0,1.0,1538,1689
1937-05-16,Germany,Denmark,8,0,8,1.0,0.0,1692,1584
1937-05-17,Sweden,England,0,4,4,0.0,1.0,1627,1696
1937-05-17,Switzerland,Republic of Ireland,0,1,1,0.0,1.0,1468,1529
1937-05-17,Uganda,Kenya,9,5,4,1.0,0.0,1540,1469
1937-05-17,Guernsey,Jersey,3,3,0,0.5,0.5,1657,1532
1937-05-20,Finland,England,0,8,8,0.0,1.0,1457,1700
1937-05-23,Czechoslovakia,Italy,0,1,1,0.0,1.0,1665,1752
1937-05-23,France,Republic of Ireland,0,2,2,0.0,1.0,1470,1536
1937-05-23,Hungary,Austria,2,2,0,0.5,0.5,1663,1704
1937-05-27,Norway,Italy,1,3,2,0.0,1.0,1535,1756
1937-06-03,Lithuania,Estonia,1,2,1,0.0,1.0,1416,1433
1937-06-05,Czechoslovakia,Basque Country,2,1,1,1.0,0.0,1671,1543
1937-06-06,Yugoslavia,Belgium,1,1,0,0.5,0.5,1532,1472
1937-06-09,Silesia,Basque Country,3,4,1,0.0,1.0,1488,1550
1937-06-10,Romania,Belgium,2,1,1,1.0,0.0,1551,1466
1937-06-13,Denmark,Norway,5,1,4,1.0,0.0,1591,1529
1937-06-16,Sweden,Finland,4,0,4,1.0,0.0,1632,1453
1937-06-20,Sweden,Estonia,7,2,5,1.0,0.0,1636,1430
1937-06-23,Poland,Sweden,3,1,2,1.0,0.0,1527,1626
1937-06-25,Latvia,Germany,1,3,2,0.0,1.0,1498,1696
1937-06-27,Romania,Sweden,2,2,0,0.5,0.5,1553,1625
1937-06-29,Finland,Germany,0,2,2,0.0,1.0,1450,1700
1937-07-04,Poland,Romania,2,4,2,0.0,1.0,1520,1561
1937-07-14,Estonia,Romania,2,1,1,1.0,0.0,1441,1551
1937-07-29,Latvia,Lithuania,4,2,2,1.0,0.0,1505,1410
1937-08-01,Yugoslavia,Turkey,3,1,2,1.0,0.0,1539,1462
1937-08-19,Finland,Estonia,0,1,1,0.0,1.0,1442,1450
1937-08-22,Norway,Basque Country,1,3,2,0.0,1.0,1522,1558
1937-08-29,Germany,Estonia,4,1,3,1.0,0.0,1704,1447
1937-08-29,Denmark,Basque Country,1,11,10,0.0,1.0,1583,1567
1937-09-03,Lithuania,Latvia,1,5,4,0.0,1.0,1405,1511
1937-09-04,Latvia,Estonia,1,1,0,0.5,0.5,1510,1449
1937-09-05,Finland,Norway,0,2,2,0.0,1.0,1436,1529
1937-09-05,Lithuania,Estonia,0,4,4,0.0,1.0,1399,1456
1937-09-07,Estonia,Latvia,0,2,2,0.0,1.0,1450,1517
1937-09-12,Bulgaria,Poland,3,3,0,0.5,0.5,1484,1520
1937-09-12,Mexico,United States,7,2,5,1.0,0.0,1557,1517
1937-09-12,Poland,Denmark,3,1,2,1.0,0.0,1530,1574
1937-09-19,Austria,Switzerland,4,3,1,1.0,0.0,1708,1465
1937-09-19,Hungary,Czechoslovakia,8,3,5,1.0,0.0,1672,1663
1937-09-19,Latvia,Estonia,3,1,2,1.0,0.0,1524,1444
1937-09-19,Mexico,United States,7,3,4,1.0,0.0,1565,1510
1937-09-19,Norway,Sweden,3,2,1,1.0,0.0,1540,1615
1937-10-03,Czechoslovakia,Yugoslavia,5,4,1,1.0,0.0,1669,1534
1937-10-03,Sweden,Denmark,1,2,1,0.0,1.0,1607,1583
1937-10-05,Austria,Latvia,2,1,1,1.0,0.0,1713,1520
1937-10-10,Austria,Hungary,1,2,1,0.0,1.0,1705,1681
1937-10-10,France,Switzerland,2,1,1,1.0,0.0,1478,1458
1937-10-10,Norway,Republic of Ireland,3,2,1,1.0,0.0,1548,1529
1937-10-10,Poland,Yugoslavia,4,0,4,1.0,0.0,1539,1526
1937-10-10,Poland,Latvia,2,1,1,1.0,0.0,1547,1513
1937-10-10,Uruguay,Argentina,0,3,3,0.0,1.0,1644,1731
1937-10-11,El Salvador,Honduras,3,2,1,1.0,0.0,1491,1475
1937-10-13,Czechoslovakia,Latvia,4,0,4,1.0,0.0,1674,1509
1937-10-17,Denmark,Finland,2,1,1,1.0,0.0,1588,1432
1937-10-23,Northern Ireland,England,1,5,4,0.0,1.0,1454,1704
1937-10-24,Czechoslovakia,Austria,2,1,1,1.0,0.0,1683,1697
1937-10-24,Germany,Norway,3,0,3,1.0,0.0,1709,1544
1937-10-30,Wales,Scotland,2,1,1,1.0,0.0,1588,1692
1937-10-31,Netherlands,France,2,3,1,0.0,1.0,1560,1489
1937-10-31,Switzerland,Italy,2,2,0,0.5,0.5,1464,1751
1937-11-07,Bulgaria,Czechoslovakia,1,1,0,0.5,0.5,1489,1679
1937-11-07,Republic of Ireland,Norway,3,3,0,0.5,0.5,1530,1544
1937-11-10,Scotland,Northern Ireland,1,1,0,0.5,0.5,1688,1459
1937-11-11,Argentina,Uruguay,5,1,4,1.0,0.0,1738,1638
1937-11-14,Hungary,Switzerland,2,0,2,1.0,0.0,1685,1461
1937-11-17,England,Wales,2,1,1,1.0,0.0,1710,1583
1937-11-21,Germany,Sweden,5,0,5,1.0,0.0,1715,1602
1937-11-28,Netherlands,Luxembourg,4,0,4,1.0,0.0,1566,1434
1937-11-28,Spain,Portugal,1,2,1,0.0,1.0,1640,1513
1937-11-28,Mexico,Basque Country,1,4,3,0.0,1.0,1558,1575
1937-12-01,England,Czechoslovakia,5,4,1,1.0,0.0,1718,1672
1937-12-05,France,Italy,0,0,0,0.5,0.5,1495,1746
1937-12-05,Mexico,Basque Country,1,2,1,0.0,1.0,1551,1583
1937-12-08,Scotland,Czechoslovakia,5,0,5,1.0,0.0,1696,1665
1937-12-12,Mexico,Basque Country,0,4,4,0.0,1.0,1544,1591
1938-01-09,Dominica,Saint Lucia,4,1,3,1.0,0.0,1517,1493
1938-01-09,Portugal,Hungary,4,0,4,1.0,0.0,1525,1674
1938-01-09,Mexico,Basque Country,3,1,2,1.0,0.0,1554,1582
1938-01-10,Dominica,Saint Lucia,1,3,2,0.0,1.0,1509,1502
1938-01-11,Dominica,Saint Lucia,1,0,1,1.0,0.0,1517,1495
1938-01-16,Luxembourg,Hungary,0,6,6,0.0,1.0,1431,1678
1938-01-22,Israel,Greece,1,3,2,0.0,1.0,1477,1428
1938-01-30,France,Belgium,5,3,2,1.0,0.0,1503,1459
1938-01-30,Portugal,Spain,1,0,1,1.0,0.0,1536,1630
1938-02-06,Germany,Switzerland,1,1,0,0.5,0.5,1711,1466
1938-02-10,Mexico,Colombia,3,1,2,1.0,0.0,1561,1494
1938-02-12,Costa Rica,El Salvador,7,0,7,1.0,0.0,1568,1485
1938-02-12,Panama,Venezuela,2,1,1,1.0,0.0,1508,1492
1938-02-14,Panama,Colombia,2,4,2,0.0,1.0,1500,1503
1938-02-14,Mexico,Venezuela,1,0,1,1.0,0.0,1568,1486
1938-02-16,Panama,Costa Rica,0,11,11,0.0,1.0,1494,1575
1938-02-16,El Salvador,Venezuela,3,2,1,1.0,0.0,1494,1478
1938-02-18,Colombia,Costa Rica,1,2,1,0.0,1.0,1497,1582
1938-02-18,Mexico,El Salvador,6,0,6,1.0,0.0,1575,1488
1938-02-20,Greece,Israel,1,0,1,1.0,0.0,1438,1468
1938-02-20,Panama,Mexico,2,2,0,0.5,0.5,1496,1574
1938-02-20,Venezuela,Costa Rica,0,3,3,0.0,1.0,1473,1588
1938-02-21,Colombia,El Salvador,3,2,1,1.0,0.0,1505,1481
1938-02-22,Mexico,Costa Rica,2,1,1,1.0,0.0,1583,1580
1938-02-23,Venezuela,Colombia,2,1,1,1.0,0.0,1482,1497
1938-02-23,Panama,El Salvador,1,2,1,0.0,1.0,1488,1490
1938-02-27,Netherlands,Belgium,7,2,5,1.0,0.0,1572,1454
1938-03-13,Haiti,Jamaica,5,2,3,1.0,0.0,1479,1494
1938-03-13,Luxembourg,Belgium,2,3,1,0.0,1.0,1424,1462
1938-03-13,Switzerland,Poland,3,3,0,0.5,0.5,1468,1546
1938-03-16,Northern Ireland,Wales,1,0,1,1.0,0.0,1470,1573
1938-03-17,Haiti,Jamaica,2,0,2,1.0,0.0,1488,1486
1938-03-20,Germany,Luxembourg,2,1,1,1.0,0.0,1714,1422
1938-03-20,Germany,Hungary,1,1,0,0.5,0.5,1714,1679
1938-03-20,Haiti,Jamaica,2,0,2,1.0,0.0,1496,1479
1938-03-24,France,Bulgaria,6,1,5,1.0,0.0,1511,1482
1938-03-25,Hungary,Greece,11,1,10,1.0,0.0,1683,1435
1938-03-28,Guyana,Trinidad and Tobago,1,1,0,0.5,0.5,1511,1576
1938-04-01,Guyana,Trinidad and Tobago,0,3,3,0.0,1.0,1505,1583
1938-04-03,Belgium,Netherlands,1,1,0,0.5,0.5,1465,1570
1938-04-03,Switzerland,Czechoslovakia,4,0,4,1.0,0.0,1481,1653
1938-04-03,Yugoslavia,Poland,1,0,1,1.0,0.0,1535,1538
1938-04-07,Guyana,Trinidad and Tobago,0,2,2,0.0,1.0,1499,1590
1938-04-09,England,Scotland,0,1,1,0.0,1.0,1710,1705
1938-04-24,Czechoslovakia,Bulgaria,6,0,6,1.0,0.0,1658,1478
1938-04-24,Germany,Portugal,1,1,0,0.5,0.5,1711,1540
1938-04-28,Guernsey,Jersey,4,3,1,1.0,0.0,1663,1527
1938-05-01,Switzerland,Portugal,2,1,1,1.0,0.0,1491,1531
1938-05-05,Guernsey,Alderney,3,1,2,1.0,0.0,1666,1373
1938-05-08,Romania,Yugoslavia,0,1,1,0.0,1.0,1543,1544
1938-05-08,Switzerland,Belgium,0,3,3,0.0,1.0,1483,1474
1938-05-14,Germany,England,3,6,3,0.0,1.0,1703,1719
1938-05-15,Italy,Belgium,6,1,5,1.0,0.0,1749,1472
1938-05-17,Latvia,Lithuania,2,0,2,1.0,0.0,1515,1394
1938-05-18,Czechoslovakia,Republic of Ireland,2,2,0,0.5,0.5,1656,1533
1938-05-21,Netherlands,Scotland,1,3,2,0.0,1.0,1565,1711
1938-05-21,Switzerland,England,2,1,1,1.0,0.0,1496,1707
1938-05-22,Italy,Yugoslavia,4,0,4,1.0,0.0,1753,1541
1938-05-22,Poland,Republic of Ireland,6,0,6,1.0,0.0,1546,1526
1938-05-26,France,England,2,4,2,0.0,1.0,1508,1711
1938-05-29,Belgium,Yugoslavia,2,2,0,0.5,0.5,1474,1540
1938-05-29,Cuba,Basque Country,0,4,4,0.0,1.0,1513,1589
1938-05-31,Norway,Estonia,1,0,1,1.0,0.0,1550,1439
1938-06-04,Germany,Switzerland,1,1,0,0.5,0.5,1699,1501
1938-06-05,Brazil,Poland,6,5,1,1.0,0.0,1592,1539
1938-06-05,Cuba,Romania,3,3,0,0.5,0.5,1514,1543
1938-06-05,Czechoslovakia,Netherlands,3,0,3,1.0,0.0,1662,1560
1938-06-05,France,Belgium,3,1,2,1.0,0.0,1516,1467
1938-06-05,Hungary,Indonesia,6,0,6,1.0,0.0,1687,1484
1938-06-05,Italy,Norway,2,1,1,1.0,0.0,1757,1547
1938-06-09,Cuba,Romania,2,1,1,1.0,0.0,1523,1535
1938-06-09,Germany,Switzerland,2,4,2,0.0,1.0,1687,1514
1938-06-10,Sweden,Latvia,3,3,0,0.5,0.5,1601,1517
1938-06-11,Lithuania,Estonia,0,2,2,0.0,1.0,1388,1446
1938-06-12,Brazil,Czechoslovakia,1,1,0,0.5,0.5,1594,1661
1938-06-12,Cuba,Sweden,0,8,8,0.0,1.0,1517,1608
1938-06-12,France,Italy,1,3,2,0.0,1.0,1513,1761
1938-06-12,Hungary,Switzerland,2,0,2,1.0,0.0,1692,1510
1938-06-14,Brazil,Czechoslovakia,2,1,1,1.0,0.0,1604,1652
1938-06-15,Sweden,Finland,2,0,2,1.0,0.0,1613,1428
1938-06-16,Brazil,Italy,1,2,1,0.0,1.0,1600,1766
1938-06-16,Hungary,Sweden,5,1,4,1.0,0.0,1699,1607
1938-06-17,Norway,Finland,9,0,9,1.0,0.0,1553,1423
1938-06-18,Argentina,Uruguay,1,0,1,1.0,0.0,1744,1633
1938-06-19,Brazil,Sweden,4,2,2,1.0,0.0,1609,1599
1938-06-19,Hungary,Italy,2,4,2,0.0,1.0,1693,1773
1938-06-20,Cuba,Basque Country,3,4,1,0.0,1.0,1511,1596
1938-06-21,Denmark,Sweden,0,1,1,0.0,1.0,1581,1607
1938-06-22,Estonia,Hungary,2,3,1,0.0,1.0,1443,1697
1938-06-26,Netherlands,Indonesia,9,2,7,1.0,0.0,1567,1478
1938-07-04,Finland,Sweden,2,4,2,0.0,1.0,1419,1612
1938-07-05,Curaçao,Suriname,2,1,1,1.0,0.0,1566,1515
1938-07-07,Curaçao,Suriname,1,0,1,1.0,0.0,1573,1509
1938-07-08,Aruba,Suriname,5,0,5,1.0,0.0,1466,1500
1938-07-10,Curaçao,Suriname,4,1,3,1.0,0.0,1580,1494
1938-07-16,Trinidad and Tobago,Suriname,1,2,1,0.0,1.0,1580,1505
1938-07-18,Suriname,Trinidad and Tobago,3,0,3,1.0,0.0,1515,1571
1938-07-20,Estonia,Latvia,0,2,2,0.0,1.0,1437,1524
1938-07-20,Suriname,Trinidad and Tobago,0,1,1,0.0,1.0,1509,1578
1938-08-07,Sweden,Czechoslovakia,2,6,4,0.0,1.0,1605,1660
1938-08-08,Bolivia,Ecuador,1,1,0,0.5,0.5,1451,1499
1938-08-08,Colombia,Peru,2,4,2,0.0,1.0,1489,1482
1938-08-10,Colombia,Ecuador,1,2,1,0.0,1.0,1482,1507
1938-08-11,Bolivia,Venezuela,3,1,2,1.0,0.0,1460,1474
1938-08-11,Ecuador,Peru,1,9,8,0.0,1.0,1499,1491
1938-08-13,Colombia,Venezuela,2,0,2,1.0,0.0,1490,1467
1938-08-14,Bolivia,Peru,0,3,3,0.0,1.0,1453,1499
1938-08-16,Colombia,Bolivia,1,2,1,0.0,1.0,1482,1462
1938-08-17,Estonia,Finland,1,3,2,0.0,1.0,1429,1428
1938-08-17,Peru,Venezuela,2,1,1,1.0,0.0,1507,1460
1938-08-17,Saint Kitts and Nevis,Grenada,0,4,4,0.0,1.0,1492,1508
1938-08-18,Saint Kitts and Nevis,Grenada,2,4,2,0.0,1.0,1485,1516
1938-08-19,Ecuador,Venezuela,5,2,3,1.0,0.0,1507,1453
1938-08-22,Bolivia,Ecuador,2,1,1,1.0,0.0,1472,1498
1938-08-28,Yugoslavia,Czechoslovakia,1,3,2,0.0,1.0,1535,1666
1938-08-31,Finland,Denmark,2,1,1,1.0,0.0,1440,1570
1938-09-03,Australia,India,5,3,2,1.0,0.0,1549,1493
1938-09-03,Estonia,Lithuania,3,1,2,1.0,0.0,1437,1381
1938-09-04,Latvia,Lithuania,1,1,0,0.5,0.5,1521,1385
1938-09-04,Norway,Sweden,2,1,1,1.0,0.0,1563,1596
1938-09-05,Estonia,Latvia,1,1,0,0.5,0.5,1439,1520
1938-09-06,Yugoslavia,Romania,1,1,0,0.5,0.5,1535,1535
1938-09-10,Australia,India,4,4,0,0.5,0.5,1548,1495
1938-09-17,Australia,India,1,4,3,0.0,1.0,1539,1505
1938-09-18,Finland,Lithuania,3,1,2,1.0,0.0,1447,1379
1938-09-18,Germany,Poland,4,1,3,1.0,0.0,1692,1535
1938-09-18,Republic of Ireland,Switzerland,4,0,4,1.0,0.0,1534,1503
1938-09-18,Norway,Denmark,1,1,0,0.5,0.5,1564,1570
1938-09-24,Australia,India,5,4,1,1.0,0.0,1547,1498
1938-09-25,Latvia,Poland,2,1,1,1.0,0.0,1529,1527
1938-09-25,Poland,Yugoslavia,4,4,0,0.5,0.5,1528,1535
1938-09-25,Romania,Germany,1,4,3,0.0,1.0,1531,1697
1938-10-01,Australia,India,3,1,2,1.0,0.0,1554,1492
1938-10-02,Sweden,Norway,2,3,1,0.0,1.0,1588,1573
1938-10-08,Northern Ireland,Scotland,0,2,2,0.0,1.0,1467,1715
1938-10-10,Kenya,Uganda,1,3,2,0.0,1.0,1463,1547
1938-10-12,Uruguay,Argentina,2,3,1,0.0,1.0,1628,1750
1938-10-16,Mexico,Basque Country,8,4,4,1.0,0.0,1592,1588
1938-10-22,Wales,England,4,2,2,1.0,0.0,1585,1700
1938-10-23,Denmark,Netherlands,2,2,0,0.5,0.5,1570,1568
1938-10-23,Poland,Norway,2,2,0,0.5,0.5,1530,1572
1938-10-23,Mexico,Basque Country,2,6,4,0.0,1.0,1584,1597
1938-10-30,Mexico,Basque Country,1,3,2,0.0,1.0,1577,1605
1938-11-06,Switzerland,Portugal,1,0,1,1.0,0.0,1512,1523
1938-11-09,England,Norway,4,0,4,1.0,0.0,1706,1567
1938-11-09,Scotland,Wales,3,2,1,1.0,0.0,1721,1580
1938-11-13,Republic of Ireland,Poland,3,2,1,1.0,0.0,1542,1523
1938-11-16,England,Northern Ireland,7,0,7,1.0,0.0,1710,1464
1938-11-20,Italy,Switzerland,2,0,2,1.0,0.0,1776,1510
1938-12-04,Czechoslovakia,Romania,6,2,4,1.0,0.0,1672,1526
1938-12-04,Italy,France,1,0,1,1.0,0.0,1779,1511
1938-12-07,Scotland,Hungary,3,1,2,1.0,0.0,1729,1690
1939-01-12,Dominica,Martinique,3,1,2,1.0,0.0,1525,1497
1939-01-15,Brazil,Argentina,1,5,4,0.0,1.0,1605,1755
1939-01-15,Chile,Paraguay,1,5,4,0.0,1.0,1419,1527
1939-01-15,Peru,Ecuador,5,2,3,1.0,0.0,1515,1491
1939-01-22,Brazil,Argentina,3,2,1,1.0,0.0,1617,1744
1939-01-22,Ecuador,Uruguay,0,6,6,0.0,1.0,1487,1633
1939-01-22,France,Poland,4,0,4,1.0,0.0,1520,1515
1939-01-22,Peru,Chile,3,1,2,1.0,0.0,1521,1414
1939-01-29,Belgium,Germany,1,4,3,0.0,1.0,1464,1701
1939-01-29,Chile,Uruguay,2,3,1,0.0,1.0,1411,1637
1939-01-29,Peru,Paraguay,3,0,3,1.0,0.0,1530,1519
1939-02-05,Chile,Ecuador,4,1,3,1.0,0.0,1421,1478
1939-02-05,Paraguay,Uruguay,1,3,2,0.0,1.0,1514,1643
1939-02-12,Ecuador,Paraguay,1,3,2,0.0,1.0,1471,1522
1939-02-12,Peru,Uruguay,2,1,1,1.0,0.0,1541,1633
1939-02-12,Portugal,Switzerland,2,4,2,0.0,1.0,1515,1519
1939-02-26,Chile,Paraguay,4,1,3,1.0,0.0,1432,1512
1939-02-26,Germany,Yugoslavia,3,2,1,1.0,0.0,1706,1531
1939-02-26,Netherlands,Hungary,3,2,1,1.0,0.0,1579,1680
1939-03-15,Haiti,Panama,1,0,1,1.0,0.0,1504,1481
1939-03-15,Wales,Northern Ireland,3,1,2,1.0,0.0,1586,1459
1939-03-16,France,Hungary,2,2,0,0.5,0.5,1524,1677
1939-03-19,Belgium,Netherlands,5,4,1,1.0,0.0,1475,1569
1939-03-19,Haiti,Panama,1,1,0,0.5,0.5,1504,1482
1939-03-19,Republic of Ireland,Hungary,2,2,0,0.5,0.5,1545,1675
1939-03-24,Haiti,Panama,3,0,3,1.0,0.0,1512,1475
1939-03-26,Italy,Germany,3,2,1,1.0,0.0,1786,1700
1939-03-26,Luxembourg,Germany,2,1,1,1.0,0.0,1436,1687
1939-04-02,Switzerland,Hungary,3,1,2,1.0,0.0,1531,1664
1939-04-15,Scotland,England,1,2,1,0.0,1.0,1721,1719
1939-04-20,Jersey,Alderney,2,1,1,1.0,0.0,1532,1369
1939-04-23,Netherlands,Belgium,3,2,1,1.0,0.0,1575,1470
1939-04-23,Brittany,Luxembourg,3,1,2,1.0,0.0,1515,1430
1939-05-04,Guernsey,Jersey,0,1,1,0.0,1.0,1656,1543
1939-05-07,Romania,Yugoslavia,1,0,1,1.0,0.0,1535,1523
1939-05-07,Switzerland,Netherlands,2,1,1,1.0,0.0,1541,1566
1939-05-13,Italy,England,2,2,0,0.5,0.5,1785,1721
1939-05-14,Belgium,Switzerland,1,2,1,0.0,1.0,1464,1548
1939-05-18,Belgium,France,1,3,2,0.0,1.0,1458,1531
1939-05-18,Hungary,Republic of Ireland,2,2,0,0.5,0.5,1662,1548
1939-05-18,Romania,Latvia,4,0,4,1.0,0.0,1543,1522
1939-05-18,Yugoslavia,England,2,1,1,1.0,0.0,1536,1709
1939-05-20,France,Wales,2,1,1,1.0,0.0,1541,1577
1939-05-23,Germany,Republic of Ireland,1,1,0,0.5,0.5,1684,1552
1939-05-24,Bulgaria,Latvia,3,0,3,1.0,0.0,1488,1513
1939-05-24,Romania,England,0,2,2,0.0,1.0,1539,1714
1939-05-27,Poland,Belgium,3,3,0,0.5,0.5,1514,1460
1939-06-02,Sweden,Norway,3,2,1,1.0,0.0,1596,1560
1939-06-04,Poland,Switzerland,1,1,0,0.5,0.5,1515,1548
1939-06-04,Yugoslavia,Italy,1,2,1,0.0,1.0,1533,1789
1939-06-08,Hungary,Italy,1,3,2,0.0,1.0,1657,1795
1939-06-09,Sweden,Finland,5,1,4,1.0,0.0,1601,1443
1939-06-11,Romania,Italy,0,1,1,0.0,1.0,1537,1798
1939-06-11,Sweden,Lithuania,7,0,7,1.0,0.0,1605,1376
1939-06-14,Norway,Sweden,1,0,1,1.0,0.0,1570,1596
1939-06-15,Denmark,Finland,5,0,5,1.0,0.0,1576,1438
1939-06-18,Denmark,Norway,6,3,3,1.0,0.0,1584,1563
1939-06-22,Norway,Germany,0,4,4,0.0,1.0,1558,1690
1939-06-25,Denmark,Germany,0,2,2,0.0,1.0,1579,1696
1939-06-29,Estonia,Germany,0,2,2,0.0,1.0,1437,1699
1939-07-20,Finland,Italy,2,3,1,0.0,1.0,1437,1800
1939-07-27,Latvia,Estonia,3,3,0,0.5,0.5,1512,1439
1939-08-04,Finland,Estonia,4,2,2,1.0,0.0,1446,1431
1939-08-06,Panama,Cuba,0,4,4,0.0,1.0,1468,1519
1939-08-14,Paraguay,Argentina,0,1,1,0.0,1.0,1509,1748
1939-08-16,Paraguay,Argentina,2,2,0,0.5,0.5,1514,1744
1939-08-27,Czechoslovakia,Yugoslavia,7,3,4,1.0,0.0,1677,1529
1939-08-27,Estonia,Lithuania,0,1,1,0.0,1.0,1422,1386
1939-08-27,Poland,Hungary,4,2,2,1.0,0.0,1527,1646
1939-08-27,Slovakia,Germany,2,0,2,1.0,0.0,1513,1687
1939-09-02,China PR,Japan,0,3,3,0.0,1.0,1643,1455
1939-09-03,Finland,Norway,1,2,1,0.0,1.0,1441,1564
1939-09-03,Manchukuo,Japan,0,6,6,0.0,1.0,1491,1465
1939-09-17,Denmark,Finland,8,1,7,1.0,0.0,1584,1437
1939-09-17,Norway,Sweden,2,3,1,0.0,1.0,1557,1604
1939-09-24,Finland,Latvia,0,3,3,0.0,1.0,1431,1519
1939-09-24,Hungary,Germany,5,1,4,1.0,0.0,1655,1679
1939-10-01,Sweden,Denmark,4,1,3,1.0,0.0,1612,1577
1939-10-15,Yugoslavia,Germany,1,5,4,0.0,1.0,1525,1684
1939-10-22,Bulgaria,Germany,1,2,1,0.0,1.0,1485,1688
1939-10-22,Denmark,Norway,4,1,3,1.0,0.0,1585,1550
1939-11-12,Germany,Czechoslovakia,4,4,0,0.5,0.5,1688,1678
1939-11-12,Switzerland,Italy,3,1,2,1.0,0.0,1561,1788
1939-11-12,Yugoslavia,Hungary,0,2,2,0.0,1.0,1520,1661
1939-11-26,Germany,Italy,5,2,3,1.0,0.0,1699,1778
1939-11-28,Uganda,Kenya,5,2,3,1.0,0.0,1554,1457
1939-12-03,Germany,Slovakia,3,1,2,1.0,0.0,1704,1509
1940-01-28,France,Portugal,3,2,1,1.0,0.0,1549,1508
1940-02-18,Argentina,Paraguay,3,1,2,1.0,0.0,1748,1511
1940-02-18,Brazil,Argentina,2,2,0,0.5,0.5,1620,1746
1940-02-20,Kenya,Uganda,3,6,3,0.0,1.0,1452,1560
1940-02-25,Argentina,Paraguay,4,0,4,1.0,0.0,1750,1508
1940-02-25,Brazil,Argentina,0,3,3,0.0,1.0,1615,1756
1940-03-02,Argentina,Chile,4,1,3,1.0,0.0,1759,1430
1940-03-03,Italy,Switzerland,1,1,0,0.5,0.5,1774,1566
1940-03-05,Argentina,Brazil,6,1,5,1.0,0.0,1764,1611
1940-03-09,Argentina,Chile,3,2,1,1.0,0.0,1767,1428
1940-03-10,Argentina,Brazil,2,3,1,0.0,1.0,1756,1623
1940-03-12,Uruguay,Chile,3,2,1,1.0,0.0,1637,1425
1940-03-17,Argentina,Brazil,5,1,4,1.0,0.0,1762,1618
1940-03-17,Belgium,Netherlands,7,1,6,1.0,0.0,1471,1556
1940-03-24,Brazil,Uruguay,3,4,1,0.0,1.0,1611,1645
1940-03-31,Brazil,Uruguay,1,1,0,0.5,0.5,1612,1645
1940-03-31,Hungary,Switzerland,3,0,3,1.0,0.0,1667,1561
1940-03-31,Netherlands,Luxembourg,4,5,1,0.0,1.0,1546,1441
1940-03-31,Romania,Yugoslavia,3,3,0,0.5,0.5,1537,1521
1940-04-02,Croatia,Switzerland,4,0,4,1.0,0.0,1510,1552
1940-04-07,Germany,Hungary,2,2,0,0.5,0.5,1704,1668
1940-04-14,Germany,Yugoslavia,1,2,1,0.0,1.0,1693,1533
1940-04-14,Italy,Romania,2,1,1,1.0,0.0,1778,1534
1940-04-21,Netherlands,Belgium,4,2,2,1.0,0.0,1553,1465
1940-04-21,Switzerland,Croatia,0,1,1,0.0,1.0,1544,1519
1940-04-27,Israel,Lebanon,5,1,4,1.0,0.0,1477,1492
1940-05-02,Hungary,Croatia,1,0,1,1.0,0.0,1673,1515
1940-05-05,Italy,Germany,3,2,1,1.0,0.0,1785,1687
1940-05-19,Hungary,Romania,2,0,2,1.0,0.0,1678,1530
1940-06-06,Bulgaria,Slovakia,1,4,3,0.0,1.0,1478,1517
1940-06-07,Japan,Manchukuo,7,0,7,1.0,0.0,1474,1483
1940-06-09,Japan,China PR,6,0,6,1.0,0.0,1486,1632
1940-06-16,Japan,Philippines,1,0,1,1.0,0.0,1494,1454
1940-07-14,Germany,Romania,9,3,6,1.0,0.0,1692,1526
1940-07-18,Estonia,Latvia,2,1,1,1.0,0.0,1433,1509
1940-07-18,Uruguay,Argentina,3,0,3,1.0,0.0,1656,1752
1940-08-11,Lithuania,Estonia,2,0,2,1.0,0.0,1396,1424
1940-08-15,Argentina,Uruguay,5,0,5,1.0,0.0,1758,1651
1940-08-29,Finland,Sweden,2,3,1,0.0,1.0,1427,1617
1940-09-01,Germany,Finland,13,0,13,1.0,0.0,1695,1425
1940-09-06,Latvia,Lithuania,1,0,1,1.0,0.0,1515,1391
1940-09-07,Estonia,Lithuania,1,1,0,0.5,0.5,1424,1392
1940-09-08,Latvia,Estonia,2,2,0,0.5,0.5,1513,1427
1940-09-15,Slovakia,Germany,0,1,1,0.0,1.0,1513,1700
1940-09-22,Sweden,Finland,5,0,5,1.0,0.0,1621,1422
1940-09-22,Yugoslavia,Romania,1,2,1,0.0,1.0,1525,1535
1940-09-29,Hungary,Yugoslavia,0,0,0,0.5,0.5,1675,1529
1940-10-06,Hungary,Germany,2,2,0,0.5,0.5,1676,1700
1940-10-06,Sweden,Denmark,1,1,0,0.5,0.5,1621,1586
1940-10-13,Lithuania,Latvia,4,3,1,1.0,0.0,1403,1503
1940-10-20,Denmark,Sweden,3,3,0,0.5,0.5,1587,1621
1940-10-20,Germany,Bulgaria,7,3,4,1.0,0.0,1704,1475
1940-11-03,Yugoslavia,Germany,2,0,2,1.0,0.0,1541,1693
1940-11-12,Cuba,Puerto Rico,1,1,0,0.5,0.5,1519,1501
1940-11-17,Germany,Denmark,1,0,1,1.0,0.0,1699,1582
1940-12-01,Italy,Hungary,1,1,0,0.5,0.5,1783,1679
1940-12-08,Croatia,Hungary,1,1,0,0.5,0.5,1519,1676
1941-01-05,Chile,Argentina,1,2,1,0.0,1.0,1423,1761
1941-01-09,Chile,Argentina,2,5,3,0.0,1.0,1421,1764
1941-01-12,Portugal,Spain,2,2,0,0.5,0.5,1511,1628
1941-01-18,Curaçao,Aruba,4,0,4,1.0,0.0,1586,1461
1941-01-19,Curaçao,Aruba,2,1,1,1.0,0.0,1592,1456
1941-01-19,Peru,Argentina,1,1,0,0.5,0.5,1546,1760
1941-01-26,Peru,Argentina,1,1,0,0.5,0.5,1551,1756
1941-01-29,Peru,Argentina,0,3,3,0.0,1.0,1548,1760
1941-02-02,Chile,Ecuador,5,0,5,1.0,0.0,1431,1462
1941-02-09,Chile,Peru,1,0,1,1.0,0.0,1442,1538
1941-02-09,Ecuador,Uruguay,0,6,6,0.0,1.0,1458,1656
1941-02-12,Argentina,Peru,2,1,1,1.0,0.0,1764,1535
1941-02-16,Argentina,Ecuador,6,1,5,1.0,0.0,1767,1456
1941-02-16,Chile,Uruguay,0,2,2,0.0,1.0,1439,1660
1941-02-22,Guadeloupe,Martinique,1,2,1,0.0,1.0,1485,1505
1941-02-22,Uganda,Kenya,3,4,1,0.0,1.0,1550,1463
1941-02-23,Argentina,Uruguay,1,0,1,1.0,0.0,1773,1655
1941-02-23,Ecuador,Peru,0,4,4,0.0,1.0,1450,1542
1941-02-26,Peru,Uruguay,0,2,2,0.0,1.0,1537,1661
1941-03-04,Chile,Argentina,0,1,1,0.0,1.0,1437,1776
1941-03-09,Germany,Switzerland,4,2,2,1.0,0.0,1704,1540
1941-03-16,Spain,Portugal,5,1,4,1.0,0.0,1634,1506
1941-03-23,Yugoslavia,Hungary,1,1,0,0.5,0.5,1544,1674
1941-04-06,Germany,Hungary,7,0,7,1.0,0.0,1712,1667
1941-04-13,Aruba,Curaçao,0,0,0,0.5,0.5,1459,1590
1941-04-14,Aruba,Curaçao,2,2,0,0.5,0.5,1462,1588
1941-04-20,Switzerland,Germany,2,1,1,1.0,0.0,1552,1701
1941-05-08,Curaçao,Panama,3,3,0,0.5,0.5,1586,1471
1941-05-10,Costa Rica,Nicaragua,7,2,5,1.0,0.0,1587,1486
1941-05-11,Costa Rica,Panama,7,0,7,1.0,0.0,1593,1466
1941-05-11,Curaçao,El Salvador,2,2,0,0.5,0.5,1584,1493
1941-05-13,Costa Rica,Curaçao,6,2,4,1.0,0.0,1601,1577
1941-05-13,El Salvador,Nicaragua,8,0,8,1.0,0.0,1501,1479
1941-05-15,Curaçao,Nicaragua,9,1,8,1.0,0.0,1583,1474
1941-05-15,El Salvador,Panama,4,3,1,1.0,0.0,1509,1459
1941-05-18,Costa Rica,El Salvador,3,1,2,1.0,0.0,1607,1504
1941-05-18,Nicaragua,Panama,2,5,3,0.0,1.0,1466,1468
1941-06-01,Romania,Germany,1,4,3,0.0,1.0,1531,1706
1941-06-15,Germany,Croatia,5,1,4,1.0,0.0,1711,1515
1941-08-10,Afghanistan,India,1,3,2,0.0,1.0,1492,1501
1941-08-23,India,Iran,0,1,1,0.0,1.0,1493,1509
1941-09-07,Martinique,Guadeloupe,5,0,5,1.0,0.0,1513,1478
1941-09-14,Sweden,Denmark,2,2,0,0.5,0.5,1621,1583
1941-09-28,Croatia,Slovakia,5,2,3,1.0,0.0,1523,1506
1941-10-05,Finland,Germany,0,6,6,0.0,1.0,1420,1714
1941-10-05,Sweden,Germany,4,2,2,1.0,0.0,1632,1704
1941-10-12,Romania,Slovakia,3,2,1,1.0,0.0,1539,1499
1941-10-19,Denmark,Sweden,2,1,1,1.0,0.0,1593,1623
1941-11-16,Germany,Denmark,1,1,0,0.5,0.5,1702,1596
1941-11-16,Switzerland,Hungary,1,2,1,0.0,1.0,1547,1673
1941-12-07,Germany,Slovakia,4,0,4,1.0,0.0,1706,1496
1941-12-28,Spain,Switzerland,3,2,1,1.0,0.0,1641,1541
1942-01-01,Portugal,Switzerland,3,0,3,1.0,0.0,1515,1533
1942-01-10,Uruguay,Chile,6,1,5,1.0,0.0,1665,1434
1942-01-11,Argentina,Paraguay,4,3,1,1.0,0.0,1779,1506
1942-01-14,Brazil,Chile,6,1,5,1.0,0.0,1617,1430
1942-01-17,Argentina,Brazil,2,1,1,1.0,0.0,1784,1613
1942-01-18,Paraguay,Peru,1,1,0,0.5,0.5,1507,1537
1942-01-18,Uruguay,Ecuador,7,0,7,1.0,0.0,1669,1447
1942-01-18,Croatia,Germany,0,2,2,0.0,1.0,1519,1711
1942-01-21,Brazil,Peru,2,1,1,1.0,0.0,1620,1531
1942-01-22,Argentina,Ecuador,12,0,12,1.0,0.0,1787,1445
1942-01-22,Chile,Paraguay,0,2,2,0.0,1.0,1424,1514
1942-01-24,Uruguay,Brazil,1,0,1,1.0,0.0,1676,1614
1942-01-25,Argentina,Peru,3,1,2,1.0,0.0,1790,1529
1942-01-25,Ecuador,Paraguay,1,3,2,0.0,1.0,1439,1521
1942-01-26,Cuba,Puerto Rico,1,0,1,1.0,0.0,1527,1494
1942-01-28,Ecuador,Peru,1,2,1,0.0,1.0,1434,1535
1942-01-28,Uruguay,Paraguay,3,1,2,1.0,0.0,1681,1517
1942-01-29,Cuba,Puerto Rico,1,0,1,1.0,0.0,1535,1487
1942-01-31,Argentina,Chile,0,0,0,0.5,0.5,1784,1431
1942-01-31,Brazil,Ecuador,5,1,4,1.0,0.0,1619,1430
1942-02-01,Germany,Switzerland,1,2,1,0.0,1.0,1700,1545
1942-02-01,Uruguay,Peru,3,0,3,1.0,0.0,1686,1531
1942-02-05,Brazil,Paraguay,1,1,0,0.5,0.5,1617,1520
1942-02-05,Chile,Ecuador,2,1,1,1.0,0.0,1439,1423
1942-02-07,Chile,Peru,0,0,0,0.5,0.5,1442,1529
1942-02-07,Uruguay,Argentina,1,0,1,1.0,0.0,1697,1774
1942-03-08,France,Switzerland,0,2,2,0.0,1.0,1541,1554
1942-03-15,Spain,France,4,0,4,1.0,0.0,1647,1536
1942-04-05,Italy,Croatia,4,0,4,1.0,0.0,1786,1517
1942-04-11,Barbados,Trinidad and Tobago,3,3,0,0.5,0.5,1459,1576
1942-04-12,Germany,Spain,1,1,0,0.5,0.5,1699,1649
1942-04-19,Italy,Spain,4,0,4,1.0,0.0,1791,1645
1942-05-03,Hungary,Germany,3,5,2,0.0,1.0,1666,1707
1942-05-25,Argentina,Uruguay,4,1,3,1.0,0.0,1781,1691
1942-05-25,Curaçao,Aruba,2,2,0,0.5,0.5,1581,1465
1942-06-07,Slovakia,Croatia,1,2,1,0.0,1.0,1489,1525
1942-06-14,Hungary,Croatia,1,1,0,0.5,0.5,1663,1529
1942-06-28,Denmark,Sweden,0,3,3,0.0,1.0,1589,1631
1942-07-07,Kenya,Uganda,4,3,1,1.0,0.0,1473,1541
1942-07-19,Bulgaria,Germany,0,3,3,0.0,1.0,1472,1711
1942-08-03,Latvia,Estonia,4,0,4,1.0,0.0,1510,1421
1942-08-08,China PR,Japan,1,6,5,0.0,1.0,1621,1506
1942-08-09,Manchukuo,Japan,0,3,3,0.0,1.0,1476,1514
1942-08-10,Japan,Mongolia,12,0,12,1.0,0.0,1522,1493
1942-08-16,Germany,Romania,7,0,7,1.0,0.0,1716,1535
1942-08-18,Estonia,Latvia,1,8,7,0.0,1.0,1416,1516
1942-08-23,Slovakia,Romania,1,0,1,1.0,0.0,1499,1526
1942-08-25,Uruguay,Argentina,1,1,0,0.5,0.5,1694,1779
1942-09-06,Croatia,Slovakia,6,1,5,1.0,0.0,1537,1492
1942-09-20,Germany,Sweden,2,3,1,0.0,1.0,1707,1641
1942-10-04,Sweden,Denmark,2,1,1,1.0,0.0,1648,1583
1942-10-11,Romania,Croatia,2,2,0,0.5,0.5,1527,1537
1942-10-18,Switzerland,Germany,3,5,2,0.0,1.0,1550,1712
1942-11-01,Germany,Croatia,5,1,4,1.0,0.0,1717,1533
1942-11-01,Hungary,Switzerland,3,0,3,1.0,0.0,1669,1545
1942-11-15,Switzerland,Sweden,3,1,2,1.0,0.0,1556,1638
1942-11-22,Slovakia,Germany,2,5,3,0.0,1.0,1489,1721
1943-03-19,Uganda,Kenya,2,1,1,1.0,0.0,1548,1467
1943-03-28,Argentina,Uruguay,3,3,0,0.5,0.5,1778,1696
1943-04-04,Switzerland,Croatia,1,0,1,1.0,0.0,1564,1526
1943-04-04,Uruguay,Argentina,0,1,1,0.0,1.0,1690,1785
1943-04-10,Croatia,Slovakia,1,0,1,1.0,0.0,1534,1482
1943-05-16,Switzerland,Hungary,1,3,2,0.0,1.0,1559,1675
1943-06-06,Bulgaria,Hungary,2,4,2,0.0,1.0,1469,1679
1943-06-13,Romania,Slovakia,2,2,0,0.5,0.5,1526,1484
1943-06-14,Sweden,Switzerland,1,0,1,1.0,0.0,1645,1553
1943-06-20,Denmark,Sweden,3,2,1,1.0,0.0,1593,1636
1943-07-10,Paraguay,Argentina,2,5,3,0.0,1.0,1518,1788
1943-07-11,Paraguay,Argentina,2,1,1,1.0,0.0,1532,1775
1943-09-12,Sweden,Hungary,2,3,1,0.0,1.0,1629,1687
1943-09-15,Finland,Hungary,0,3,3,0.0,1.0,1418,1690
1943-09-25,Curaçao,Aruba,3,3,0,0.5,0.5,1579,1468
1943-09-26,Curaçao,Aruba,2,2,0,0.5,0.5,1577,1471
1943-10-03,Finland,Sweden,1,1,0,0.5,0.5,1423,1625
1943-11-07,Hungary,Sweden,2,7,5,0.0,1.0,1681,1635
1943-11-14,Guyana,Suriname,2,0,2,1.0,0.0,1508,1501
1943-11-21,Guyana,Suriname,0,1,1,0.0,1.0,1500,1510
1943-11-22,Guyana,Suriname,0,4,4,0.0,1.0,1493,1518
1943-12-05,Costa Rica,Nicaragua,7,0,7,1.0,0.0,1612,1462
1943-12-05,El Salvador,Guatemala,2,2,0,0.5,0.5,1503,1441
1943-12-07,Costa Rica,Guatemala,2,3,1,0.0,1.0,1601,1453
1943-12-07,El Salvador,Nicaragua,8,1,7,1.0,0.0,1511,1455
1943-12-09,El Salvador,Costa Rica,4,2,2,1.0,0.0,1522,1591
1943-12-09,Guatemala,Nicaragua,6,2,4,1.0,0.0,1462,1447
1943-12-11,Aruba,Curaçao,1,2,1,0.0,1.0,1466,1583
1943-12-12,Aruba,Curaçao,1,1,0,0.5,0.5,1469,1581
1943-12-12,El Salvador,Guatemala,2,1,1,1.0,0.0,1529,1456
1943-12-12,Nicaragua,Costa Rica,2,3,1,0.0,1.0,1443,1596
1943-12-16,El Salvador,Nicaragua,10,1,9,1.0,0.0,1536,1437
1943-12-16,Guatemala,Costa Rica,4,2,2,1.0,0.0,1468,1585
1943-12-19,El Salvador,Costa Rica,2,4,2,0.0,1.0,1530,1592
1943-12-19,Nicaragua,Guatemala,1,5,4,0.0,1.0,1430,1476
1944-02-17,Trinidad and Tobago,Barbados,5,0,5,1.0,0.0,1582,1454
1944-04-01,Aruba,Venezuela,1,3,2,0.0,1.0,1461,1462
1944-04-02,Curaçao,Haiti,5,0,5,1.0,0.0,1588,1506
1944-04-05,Haiti,Venezuela,0,2,2,0.0,1.0,1497,1472
1944-04-08,Aruba,Haiti,1,1,0,0.5,0.5,1462,1497
1944-04-09,Croatia,Slovakia,7,3,4,1.0,0.0,1541,1478
1944-04-09,Curaçao,Venezuela,3,3,0,0.5,0.5,1586,1475
1944-04-10,Curaçao,Aruba,3,1,2,1.0,0.0,1592,1457
1944-05-14,Brazil,Uruguay,6,1,5,1.0,0.0,1627,1681
1944-05-17,Brazil,Uruguay,4,0,4,1.0,0.0,1637,1672
1944-07-29,Curaçao,Aruba,2,4,2,0.0,1.0,1582,1468
1944-07-30,Curaçao,Aruba,2,3,1,0.0,1.0,1572,1479
1944-08-25,Suriname,Curaçao,1,2,1,0.0,1.0,1512,1579
1944-08-27,Suriname,Aruba,5,0,5,1.0,0.0,1520,1472
1944-08-29,Aruba,Curaçao,1,2,1,0.0,1.0,1467,1585
1944-08-31,Suriname,Curaçao,0,2,2,0.0,1.0,1514,1592
1944-09-02,Aruba,Curaçao,1,5,4,0.0,1.0,1462,1598
1944-09-05,Suriname,Aruba,2,3,1,0.0,1.0,1505,1472
1944-10-04,Trinidad and Tobago,Guyana,1,1,0,0.5,0.5,1580,1496
1944-10-04,Barbados,Trinidad and Tobago,1,1,0,0.5,0.5,1457,1578
1944-10-05,Trinidad and Tobago,Barbados,3,0,3,1.0,0.0,1584,1452
1944-10-07,Barbados,Guyana,0,3,3,0.0,1.0,1446,1503
1944-10-08,Barbados,Trinidad and Tobago,1,1,0,0.5,0.5,1450,1581
1944-10-09,Trinidad and Tobago,Barbados,6,1,5,1.0,0.0,1587,1445
1944-10-11,Barbados,Guyana,0,1,1,0.0,1.0,1439,1510
1944-10-13,Trinidad and Tobago,Guyana,3,0,3,1.0,0.0,1594,1504
1944-10-14,Barbados,Trinidad and Tobago,1,4,3,0.0,1.0,1435,1599
1944-10-16,Trinidad and Tobago,Guyana,3,0,3,1.0,0.0,1605,1499
1944-11-07,Kenya,Uganda,2,1,1,1.0,0.0,1477,1539
1944-12-24,France,Belgium,3,1,2,1.0,0.0,1543,1459
1945-01-06,Argentina,Paraguay,5,2,3,1.0,0.0,1779,1529
1945-01-09,Argentina,Paraguay,5,3,2,1.0,0.0,1783,1526
1945-01-14,Chile,Ecuador,6,3,3,1.0,0.0,1450,1416
1945-01-18,Argentina,Bolivia,4,0,4,1.0,0.0,1786,1470
1945-01-21,Brazil,Colombia,3,0,3,1.0,0.0,1642,1478
1945-01-24,Chile,Bolivia,5,0,5,1.0,0.0,1459,1462
1945-01-24,Ecuador,Uruguay,1,5,4,0.0,1.0,1414,1675
1945-01-28,Bolivia,Brazil,0,2,2,0.0,1.0,1458,1647
1945-01-28,Colombia,Uruguay,0,7,7,0.0,1.0,1475,1679
1945-01-31,Argentina,Ecuador,4,2,2,1.0,0.0,1788,1413
1945-01-31,Chile,Colombia,2,0,2,1.0,0.0,1468,1467
1945-02-07,Argentina,Colombia,9,1,8,1.0,0.0,1791,1465
1945-02-07,Brazil,Uruguay,3,0,3,1.0,0.0,1656,1671
1945-02-11,Bolivia,Ecuador,0,0,0,0.5,0.5,1457,1415
1945-02-11,Chile,Argentina,1,1,0,0.5,0.5,1474,1786
1945-02-15,Argentina,Brazil,3,1,2,1.0,0.0,1792,1651
1945-02-15,Bolivia,Uruguay,0,2,2,0.0,1.0,1454,1675
1945-02-18,Chile,Uruguay,1,0,1,1.0,0.0,1487,1663
1945-02-18,Colombia,Ecuador,3,1,2,1.0,0.0,1472,1409
1945-02-21,Bolivia,Colombia,3,3,0,0.5,0.5,1455,1472
1945-02-21,Brazil,Ecuador,9,2,7,1.0,0.0,1655,1406
1945-02-25,Argentina,Uruguay,1,0,1,1.0,0.0,1798,1658
1945-02-28,Chile,Brazil,0,1,1,0.0,1.0,1483,1660
1945-03-11,Portugal,Spain,2,2,0,0.5,0.5,1518,1643
1945-04-08,Switzerland,France,1,0,1,1.0,0.0,1561,1536
1945-04-14,Uganda,Kenya,4,1,3,1.0,0.0,1546,1471
1945-05-06,Spain,Portugal,4,2,2,1.0,0.0,1649,1513
1945-05-13,Luxembourg,Belgium,4,1,3,1.0,0.0,1450,1451
1945-05-21,Switzerland,Portugal,1,0,1,1.0,0.0,1568,1507
1945-05-26,England,France,2,2,0,0.5,0.5,1711,1540
1945-06-24,Sweden,Denmark,2,1,1,1.0,0.0,1643,1586
1945-06-30,Latvia,Lithuania,3,7,4,0.0,1.0,1506,1414
1945-07-01,Denmark,Sweden,3,4,1,0.0,1.0,1580,1650
1945-07-07,Paraguay,Argentina,5,1,4,1.0,0.0,1540,1785
1945-07-09,Paraguay,Argentina,1,3,2,0.0,1.0,1537,1789
1945-07-18,Uruguay,Argentina,2,2,0,0.5,0.5,1661,1787
1945-07-21,Switzerland,England,3,1,2,1.0,0.0,1580,1700
1945-08-15,Argentina,Uruguay,6,2,4,1.0,0.0,1793,1656
1945-08-19,Hungary,Austria,2,0,2,1.0,0.0,1690,1689
1945-08-20,Hungary,Austria,5,2,3,1.0,0.0,1698,1682
1945-08-20,Uganda,Tanzania,7,0,7,1.0,0.0,1553,1494
1945-08-26,Denmark,Norway,4,2,2,1.0,0.0,1588,1543
1945-08-26,Suriname,Guyana,3,1,2,1.0,0.0,1513,1492
1945-08-26,Sweden,Finland,7,2,5,1.0,0.0,1654,1420
1945-08-31,Suriname,Guyana,4,1,3,1.0,0.0,1521,1485
1945-09-02,Suriname,Guyana,6,0,6,1.0,0.0,1529,1478
1945-09-05,Lithuania,Estonia,2,3,1,0.0,1.0,1407,1424
1945-09-09,Norway,Denmark,1,5,4,0.0,1.0,1537,1595
1945-09-15,Northern Ireland,England,0,1,1,0.0,1.0,1456,1704
1945-09-17,Estonia,Lithuania,1,2,1,0.0,1.0,1416,1416
1945-09-30,Finland,Sweden,1,6,5,0.0,1.0,1417,1658
1945-09-30,Hungary,Romania,7,2,5,1.0,0.0,1703,1522
1945-09-30,Sweden,Denmark,4,1,3,1.0,0.0,1665,1589
1945-10-20,England,Wales,0,1,1,0.0,1.0,1694,1588
1945-10-21,Sweden,Norway,10,0,10,1.0,0.0,1671,1532
1945-11-11,Switzerland,Italy,4,4,0,0.5,0.5,1585,1787
1945-11-25,Switzerland,Sweden,3,0,3,1.0,0.0,1595,1662
1945-12-06,Austria,France,4,1,3,1.0,0.0,1687,1536
1945-12-08,Aruba,Curaçao,2,1,1,1.0,0.0,1483,1588
1945-12-09,Aruba,Curaçao,2,1,1,1.0,0.0,1494,1578
1945-12-15,Belgium,France,2,1,1,1.0,0.0,1461,1527
1945-12-16,Brazil,Argentina,3,4,1,0.0,1.0,1655,1799
1945-12-20,Brazil,Argentina,6,2,4,1.0,0.0,1667,1788
1945-12-23,Brazil,Argentina,3,1,2,1.0,0.0,1678,1778
1946-01-05,Uruguay,Brazil,4,3,1,1.0,0.0,1665,1670
1946-01-12,Argentina,Paraguay,2,0,2,1.0,0.0,1782,1534
1946-01-16,Bolivia,Brazil,0,3,3,0.0,1.0,1452,1674
1946-01-16,Chile,Uruguay,0,1,1,0.0,1.0,1479,1670
1946-01-19,Argentina,Bolivia,7,1,6,1.0,0.0,1785,1450
1946-01-19,Chile,Paraguay,2,1,1,1.0,0.0,1489,1525
1946-01-19,England,Belgium,2,0,2,1.0,0.0,1698,1458
1946-01-23,Brazil,Uruguay,4,3,1,1.0,0.0,1682,1663
1946-01-23,Scotland,Belgium,2,2,0,0.5,0.5,1716,1464
1946-01-26,Argentina,Chile,3,1,2,1.0,0.0,1788,1487
1946-01-26,Bolivia,Paraguay,2,4,2,0.0,1.0,1444,1532
1946-01-29,Bolivia,Uruguay,0,5,5,0.0,1.0,1441,1667
1946-01-29,Brazil,Paraguay,1,1,0,0.5,0.5,1679,1536
1946-02-02,Argentina,Uruguay,3,1,2,1.0,0.0,1794,1662
1946-02-03,Brazil,Chile,5,1,4,1.0,0.0,1683,1484
1946-02-08,Bolivia,Chile,1,4,3,0.0,1.0,1434,1492
1946-02-08,Paraguay,Uruguay,2,1,1,1.0,0.0,1547,1652
1946-02-10,Argentina,Brazil,2,0,2,1.0,0.0,1800,1678
1946-02-23,Belgium,Luxembourg,7,0,7,1.0,0.0,1472,1443
1946-02-23,El Salvador,Guatemala,1,3,2,0.0,1.0,1521,1486
1946-02-23,Panama,Honduras,1,0,1,1.0,0.0,1477,1467
1946-02-24,Costa Rica,Nicaragua,7,1,6,1.0,0.0,1597,1426
1946-02-26,Costa Rica,Panama,7,0,7,1.0,0.0,1603,1472
1946-02-28,El Salvador,Nicaragua,7,2,5,1.0,0.0,1527,1421
1946-02-28,Honduras,Guatemala,5,3,2,1.0,0.0,1476,1478
1946-03-07,Costa Rica,Honduras,5,1,4,1.0,0.0,1609,1471
1946-03-07,El Salvador,Panama,4,1,3,1.0,0.0,1534,1466
1946-03-07,Guatemala,Nicaragua,7,0,7,1.0,0.0,1485,1415
1946-03-10,Costa Rica,Guatemala,1,4,3,0.0,1.0,1599,1496
1946-03-10,El Salvador,Honduras,3,1,2,1.0,0.0,1541,1465
1946-03-10,Luxembourg,Netherlands,2,6,4,0.0,1.0,1438,1559
1946-03-10,Panama,Nicaragua,0,2,2,0.0,1.0,1457,1425
1946-03-13,Costa Rica,El Salvador,4,0,4,1.0,0.0,1606,1535
1946-03-13,Honduras,Nicaragua,10,0,10,1.0,0.0,1473,1418
1946-03-13,Panama,Guatemala,3,3,0,0.5,0.5,1458,1496
1946-04-07,France,Czechoslovakia,3,0,3,1.0,0.0,1539,1667
1946-04-11,Jersey,Guernsey,7,0,7,1.0,0.0,1554,1646
1946-04-13,Scotland,England,1,0,1,1.0,0.0,1724,1691
1946-04-14,Austria,Hungary,3,2,1,1.0,0.0,1696,1695
1946-04-14,Portugal,France,2,1,1,1.0,0.0,1516,1531
1946-04-24,England,Scotland,2,2,0,0.5,0.5,1692,1724
1946-05-02,Guernsey,Jersey,0,4,4,0.0,1.0,1636,1565
1946-05-05,France,Austria,3,1,2,1.0,0.0,1543,1685
1946-05-09,Czechoslovakia,Yugoslavia,0,2,2,0.0,1.0,1657,1555
1946-05-11,England,Switzerland,4,1,3,1.0,0.0,1698,1590
1946-05-12,Netherlands,Belgium,6,3,3,1.0,0.0,1566,1466
1946-05-15,Scotland,Switzerland,3,1,2,1.0,0.0,1730,1585
1946-05-19,France,England,2,1,1,1.0,0.0,1555,1687
1946-05-26,Curaçao,Aruba,2,1,1,1.0,0.0,1585,1488
1946-05-30,Belgium,Netherlands,2,2,0,0.5,0.5,1469,1564
1946-06-06,Aruba,Suriname,8,1,7,1.0,0.0,1497,1521
1946-06-10,Curaçao,Suriname,6,0,6,1.0,0.0,1592,1515
1946-06-16,Norway,Denmark,2,1,1,1.0,0.0,1542,1580
1946-06-16,Portugal,Republic of Ireland,3,1,2,1.0,0.0,1525,1544
1946-06-16,Zimbabwe,Zambia,0,4,4,0.0,1.0,1492,1508
1946-06-23,Denmark,Sweden,3,1,2,1.0,0.0,1590,1653
1946-06-23,Spain,Republic of Ireland,0,1,1,0.0,1.0,1639,1555
1946-06-28,Norway,Finland,12,0,12,1.0,0.0,1548,1412
1946-07-07,Sweden,Switzerland,7,2,5,1.0,0.0,1660,1579
1946-07-08,Denmark,Norway,2,0,2,1.0,0.0,1598,1541
1946-07-17,Iceland,Denmark,0,3,3,0.0,1.0,1495,1604
1946-07-28,Luxembourg,Norway,3,2,1,1.0,0.0,1449,1531
1946-08-22,Albania,Montenegro,5,0,5,1.0,0.0,1508,1492
1946-09-01,Finland,Denmark,2,5,3,0.0,1.0,1409,1608
1946-09-14,Czechoslovakia,Switzerland,3,2,1,1.0,0.0,1664,1573
1946-09-15,Finland,Sweden,0,7,7,0.0,1.0,1406,1664
1946-09-15,Norway,Sweden,0,3,3,0.0,1.0,1526,1670
1946-09-18,Kenya,Tanzania,3,0,3,1.0,0.0,1480,1486
1946-09-21,Kenya,Uganda,2,1,1,1.0,0.0,1490,1544
1946-09-28,Northern Ireland,England,2,7,5,0.0,1.0,1453,1691
1946-09-30,Republic of Ireland,England,0,1,1,0.0,1.0,1550,1697
1946-10-06,Hungary,Austria,2,0,2,1.0,0.0,1703,1678
1946-10-06,Sweden,Denmark,3,3,0,0.5,0.5,1669,1610
1946-10-07,Albania,Yugoslavia,2,3,1,0.0,1.0,1502,1562
1946-10-08,Bulgaria,Romania,2,2,0,0.5,0.5,1471,1521
1946-10-09,Albania,Bulgaria,3,1,2,1.0,0.0,1510,1464
1946-10-11,Romania,Yugoslavia,2,1,1,1.0,0.0,1530,1554
1946-10-13,Albania,Romania,1,0,1,1.0,0.0,1519,1522
1946-10-19,Wales,Scotland,3,1,2,1.0,0.0,1600,1719
1946-10-20,Denmark,Norway,7,1,6,1.0,0.0,1617,1520
1946-10-21,Guyana,Suriname,0,3,3,0.0,1.0,1471,1523
1946-10-24,Guyana,Suriname,0,1,1,0.0,1.0,1465,1530
1946-10-27,Austria,Czechoslovakia,3,4,1,0.0,1.0,1670,1673
1946-10-29,Guyana,Suriname,3,1,2,1.0,0.0,1475,1521
1946-10-30,Luxembourg,Hungary,2,7,5,0.0,1.0,1446,1707
1946-11-05,El Salvador,Panama,2,3,1,0.0,1.0,1526,1468
1946-11-10,El Salvador,Panama,3,3,0,0.5,0.5,1525,1470
1946-11-10,Switzerland,Austria,1,0,1,1.0,0.0,1584,1660
1946-11-13,England,Wales,3,0,3,1.0,0.0,1703,1595
1946-11-23,Aruba,Curaçao,0,4,4,0.0,1.0,1492,1598
1946-11-24,Aruba,Curaçao,3,1,2,1.0,0.0,1503,1588
1946-11-27,England,Netherlands,8,2,6,1.0,0.0,1708,1560
1946-11-27,Scotland,Northern Ireland,0,0,0,0.5,0.5,1714,1459
1946-12-01,Italy,Austria,3,2,1,1.0,0.0,1793,1655
1946-12-09,Colombia,Curaçao,4,2,2,1.0,0.0,1483,1578
1946-12-09,Panama,Guatemala,4,2,2,1.0,0.0,1479,1488
1946-12-10,Costa Rica,Puerto Rico,12,0,12,1.0,0.0,1612,1482
1946-12-12,Colombia,Venezuela,2,0,2,1.0,0.0,1491,1468
1946-12-12,Curaçao,Guatemala,2,2,0,0.5,0.5,1576,1491
1946-12-13,Panama,Puerto Rico,12,1,11,1.0,0.0,1488,1474
1946-12-14,Costa Rica,Venezuela,4,2,2,1.0,0.0,1617,1464
1946-12-15,Colombia,Guatemala,4,2,2,1.0,0.0,1499,1483
1946-12-15,Curaçao,Puerto Rico,14,0,14,1.0,0.0,1582,1469
1946-12-16,Colombia,Puerto Rico,4,1,3,1.0,0.0,1507,1462
1946-12-16,Costa Rica,Guatemala,6,0,6,1.0,0.0,1623,1478
1946-12-16,Panama,Venezuela,2,1,1,1.0,0.0,1496,1457
1946-12-17,Panama,Curaçao,2,2,0,0.5,0.5,1498,1581
1946-12-18,Venezuela,Guatemala,3,2,1,1.0,0.0,1466,1470
1946-12-18,Colombia,Costa Rica,4,1,3,1.0,0.0,1518,1613
1946-12-19,Curaçao,Venezuela,1,0,1,1.0,0.0,1587,1461
1946-12-19,Guatemala,Puerto Rico,4,1,3,1.0,0.0,1478,1455
1946-12-20,Colombia,Panama,2,1,1,1.0,0.0,1526,1491
1946-12-20,Curaçao,Costa Rica,4,2,2,1.0,0.0,1596,1605
1946-12-20,Venezuela,Puerto Rico,6,0,6,1.0,0.0,1469,1448
1946-12-21,Panama,Costa Rica,2,0,2,1.0,0.0,1502,1595
1947-01-05,Venezuela,Bolivia,2,2,0,0.5,0.5,1469,1435
1947-01-05,Portugal,Switzerland,2,2,0,0.5,0.5,1527,1583
1947-01-26,Portugal,Spain,4,1,3,1.0,0.0,1538,1629
1947-02-12,Jamaica,Trinidad and Tobago,0,0,0,0.5,0.5,1482,1603
1947-02-15,Jamaica,Trinidad and Tobago,2,1,1,1.0,0.0,1493,1593
1947-02-15,Madagascar,Mauritius,1,2,1,0.0,1.0,1492,1508
1947-02-19,Jamaica,Trinidad and Tobago,1,0,1,1.0,0.0,1504,1583
1947-02-22,Jamaica,Trinidad and Tobago,1,2,1,0.0,1.0,1498,1590
1947-02-22,Zambia,Zimbabwe,2,2,0,0.5,0.5,1508,1493
1947-02-26,Jamaica,Trinidad and Tobago,0,6,6,0.0,1.0,1493,1596
1947-03-01,Curaçao,Trinidad and Tobago,4,0,4,1.0,0.0,1604,1588
1947-03-02,Curaçao,Trinidad and Tobago,3,0,3,1.0,0.0,1612,1581
1947-03-02,Republic of Ireland,Spain,3,2,1,1.0,0.0,1560,1620
1947-03-02,Suriname,French Guiana,9,1,8,1.0,0.0,1529,1485
1947-03-23,France,Portugal,1,0,1,1.0,0.0,1563,1531
1947-03-29,Uruguay,Brazil,0,0,0,0.5,0.5,1653,1678
1947-04-01,Brazil,Uruguay,3,2,1,1.0,0.0,1686,1646
1947-04-07,Netherlands,Belgium,2,1,1,1.0,0.0,1566,1464
1947-04-12,England,Scotland,1,1,0,0.5,0.5,1709,1714
1947-04-16,Northern Ireland,Wales,2,1,1,1.0,0.0,1470,1585
1947-04-27,Italy,Switzerland,5,2,3,1.0,0.0,1797,1580
1947-05-01,Guernsey,Jersey,1,3,2,0.0,1.0,1627,1575
1947-05-03,England,France,3,0,3,1.0,0.0,1714,1559
1947-05-04,Belgium,Netherlands,1,2,1,0.0,1.0,1459,1572
1947-05-04,Hungary,Austria,5,2,3,1.0,0.0,1714,1649
1947-05-04,Republic of Ireland,Portugal,0,2,2,0.0,1.0,1552,1540
1947-05-10,Australia,South Africa,1,2,1,0.0,1.0,1545,1511
1947-05-11,Czechoslovakia,Yugoslavia,3,1,2,1.0,0.0,1679,1549
1947-05-11,Italy,Hungary,3,2,1,1.0,0.0,1804,1708
1947-05-15,Mauritius,Réunion,2,1,1,1.0,0.0,1516,1493
1947-05-18,Belgium,Scotland,2,1,1,1.0,0.0,1473,1701
1947-05-18,Switzerland,England,1,0,1,1.0,0.0,1591,1704
1947-05-24,Australia,South Africa,2,4,2,0.0,1.0,1537,1520
1947-05-24,Luxembourg,Scotland,0,6,6,0.0,1.0,1444,1704
1947-05-25,Albania,Romania,0,4,4,0.0,1.0,1512,1530
1947-05-25,Portugal,England,0,10,10,0.0,1.0,1536,1709
1947-05-26,France,Netherlands,4,0,4,1.0,0.0,1568,1564
1947-05-31,Australia,South Africa,3,3,0,0.5,0.5,1537,1521
1947-06-01,France,Belgium,4,2,2,1.0,0.0,1574,1468
1947-06-06,Madagascar,Réunion,4,2,2,1.0,0.0,1501,1485
1947-06-07,Australia,South Africa,5,1,4,1.0,0.0,1545,1514
1947-06-08,Switzerland,France,1,2,1,0.0,1.0,1583,1583
1947-06-11,Norway,Poland,3,1,2,1.0,0.0,1529,1519
1947-06-14,Australia,South Africa,1,2,1,0.0,1.0,1537,1523
1947-06-15,Bulgaria,Albania,2,0,2,1.0,0.0,1474,1503
1947-06-15,Denmark,Sweden,1,4,3,0.0,1.0,1611,1676
1947-06-20,Denmark,Czechoslovakia,2,2,0,0.5,0.5,1613,1678
1947-06-21,Curaçao,Aruba,4,1,3,1.0,0.0,1618,1498
1947-06-22,Curaçao,Aruba,0,0,0,0.5,0.5,1616,1501
1947-06-22,Romania,Yugoslavia,1,3,2,0.0,1.0,1523,1557
1947-06-26,Finland,Norway,1,2,1,0.0,1.0,1401,1535
1947-06-26,Sweden,Denmark,6,1,5,1.0,0.0,1683,1607
1947-06-28,New Zealand,South Africa,5,6,1,0.0,1.0,1467,1530
1947-06-28,Norway,Sweden,1,5,4,0.0,1.0,1531,1688
1947-06-29,Yugoslavia,Hungary,2,3,1,0.0,1.0,1553,1713
1947-07-05,New Zealand,South Africa,0,6,6,0.0,1.0,1461,1537
1947-07-06,Bulgaria,Romania,2,3,1,0.0,1.0,1468,1530
1947-07-12,New Zealand,South Africa,3,8,5,0.0,1.0,1455,1544
1947-07-13,Mexico,United States,5,0,5,1.0,0.0,1584,1504
1947-07-17,Cuba,Mexico,1,3,2,0.0,1.0,1529,1591
1947-07-19,New Zealand,South Africa,1,4,3,0.0,1.0,1450,1550
1947-07-19,Poland,Romania,1,2,1,0.0,1.0,1512,1538
1947-07-20,Cuba,United States,5,2,3,1.0,0.0,1537,1497
1947-07-24,Iceland,Norway,2,4,2,0.0,1.0,1488,1539
1947-08-17,Hungary,Bulgaria,9,0,9,1.0,0.0,1717,1465
1947-08-20,Hungary,Albania,3,0,3,1.0,0.0,1721,1500
1947-08-24,Sweden,Finland,7,0,7,1.0,0.0,1691,1399
1947-08-31,Czechoslovakia,Poland,6,3,3,1.0,0.0,1683,1508
1947-09-01,Suriname,Guyana,4,0,4,1.0,0.0,1536,1469
1947-09-05,Suriname,Guyana,0,0,0,0.5,0.5,1535,1471
1947-09-07,Finland,Norway,3,3,0,0.5,0.5,1403,1536
1947-09-07,Suriname,Guyana,1,0,1,1.0,0.0,1542,1465
1947-09-14,Albania,Yugoslavia,2,4,2,0.0,1.0,1494,1560
1947-09-14,Austria,Hungary,4,3,1,1.0,0.0,1659,1712
1947-09-14,Sweden,Poland,5,4,1,1.0,0.0,1696,1504
1947-09-17,Finland,Poland,1,4,3,0.0,1.0,1398,1510
1947-09-17,Kenya,Uganda,2,3,1,0.0,1.0,1484,1551
1947-09-18,Tanzania,Zanzibar,3,1,2,1.0,0.0,1495,1492
1947-09-20,Tanzania,Uganda,2,4,2,0.0,1.0,1489,1558
1947-09-21,Belgium,England,2,5,3,0.0,1.0,1465,1713
1947-09-21,Netherlands,Switzerland,6,2,4,1.0,0.0,1573,1575
1947-09-21,Norway,Denmark,3,5,2,0.0,1.0,1530,1614
1947-09-21,Romania,Czechoslovakia,2,6,4,0.0,1.0,1534,1688
1947-09-28,Latvia,Lithuania,3,2,1,1.0,0.0,1512,1411
1947-10-04,Northern Ireland,Scotland,2,0,2,1.0,0.0,1483,1692
1947-10-05,Czechoslovakia,Austria,3,2,1,1.0,0.0,1696,1652
1947-10-05,Denmark,Finland,4,1,3,1.0,0.0,1618,1395
1947-10-05,Lithuania,Latvia,0,3,3,0.0,1.0,1406,1518
1947-10-05,Sweden,Norway,4,1,3,1.0,0.0,1701,1526
1947-10-12,Lithuania,Estonia,0,0,0,0.5,0.5,1407,1416
1947-10-12,Romania,Hungary,0,3,3,0.0,1.0,1530,1717
1947-10-12,Yugoslavia,Bulgaria,2,1,1,1.0,0.0,1566,1460
1947-10-18,Wales,England,0,3,3,0.0,1.0,1580,1719
1947-10-19,Yugoslavia,Poland,7,1,6,1.0,0.0,1573,1504
1947-10-19,Catalonia,Spain,3,1,2,1.0,0.0,1494,1609
1947-10-26,Iran,Turkey,1,3,2,0.0,1.0,1500,1472
1947-10-26,Romania,Poland,0,0,0,0.5,0.5,1530,1505
1947-11-02,Switzerland,Belgium,4,0,4,1.0,0.0,1581,1460
1947-11-05,England,Northern Ireland,2,2,0,0.5,0.5,1715,1488
1947-11-05,Trinidad and Tobago,Guyana,1,2,1,0.0,1.0,1571,1476
1947-11-06,Guyana,Jamaica,2,0,2,1.0,0.0,1485,1485
1947-11-08,Trinidad and Tobago,Jamaica,6,0,6,1.0,0.0,1578,1479
1947-11-09,Austria,Italy,5,1,4,1.0,0.0,1664,1793
1947-11-10,Guyana,Jamaica,0,0,0,0.5,0.5,1485,1480
1947-11-12,Scotland,Wales,1,2,1,0.0,1.0,1682,1591
1947-11-12,Trinidad and Tobago,Jamaica,1,0,1,1.0,0.0,1584,1475
1947-11-14,Trinidad and Tobago,Guyana,2,0,2,1.0,0.0,1590,1480
1947-11-19,England,Sweden,4,2,2,1.0,0.0,1723,1694
1947-11-23,Portugal,France,2,4,2,0.0,1.0,1530,1590
1947-11-30,Ecuador,Bolivia,2,2,0,0.5,0.5,1407,1435
1947-12-02,Argentina,Paraguay,6,0,6,1.0,0.0,1804,1544
1947-12-02,Colombia,Uruguay,0,2,2,0.0,1.0,1521,1652
1947-12-04,Argentina,Bolivia,7,0,7,1.0,0.0,1806,1434
1947-12-04,Ecuador,Colombia,0,0,0,0.5,0.5,1410,1519
1947-12-05,Djibouti,Ethiopia,0,5,5,0.0,1.0,1492,1508
1947-12-06,Chile,Uruguay,0,6,6,0.0,1.0,1488,1657
1947-12-06,Cuba,Puerto Rico,4,0,4,1.0,0.0,1543,1443
1947-12-06,Paraguay,Peru,2,2,0,0.5,0.5,1544,1530
1947-12-09,Bolivia,Uruguay,0,3,3,0.0,1.0,1431,1661
1947-12-09,Chile,Peru,2,1,1,1.0,0.0,1497,1522
1947-12-10,Cuba,Puerto Rico,0,0,0,0.5,0.5,1541,1446
1947-12-11,Argentina,Peru,3,2,1,1.0,0.0,1809,1520
1947-12-11,Ecuador,Chile,0,3,3,0.0,1.0,1404,1504
1947-12-13,Bolivia,Colombia,0,0,0,0.5,0.5,1433,1518
1947-12-13,Paraguay,Uruguay,4,2,2,1.0,0.0,1555,1651
1947-12-14,Italy,Czechoslovakia,3,1,2,1.0,0.0,1799,1691
1947-12-16,Argentina,Chile,1,1,0,0.5,0.5,1804,1510
1947-12-16,Ecuador,Uruguay,1,6,5,0.0,1.0,1401,1655
1947-12-18,Argentina,Colombia,6,0,6,1.0,0.0,1807,1516
1947-12-18,Bolivia,Paraguay,1,3,2,0.0,1.0,1428,1561
1947-12-20,Colombia,Paraguay,0,2,2,0.0,1.0,1510,1568
1947-12-20,Ecuador,Peru,0,0,0,0.5,0.5,1404,1518
1947-12-23,Chile,Paraguay,0,1,1,0.0,1.0,1504,1575
1947-12-23,Colombia,Peru,1,5,4,0.0,1.0,1503,1526
1947-12-25,Ecuador,Argentina,0,2,2,0.0,1.0,1403,1809
1947-12-25,Peru,Uruguay,0,1,1,0.0,1.0,1521,1661
1947-12-27,Bolivia,Peru,0,2,2,0.0,1.0,1423,1527
1947-12-28,Argentina,Uruguay,3,1,2,1.0,0.0,1814,1657
1947-12-29,Chile,Colombia,4,1,3,1.0,0.0,1512,1496
1947-12-29,Ecuador,Paraguay,0,4,4,0.0,1.0,1399,1580
1947-12-31,Bolivia,Chile,3,4,1,0.0,1.0,1418,1518
1948-02-29,Costa Rica,El Salvador,3,1,2,1.0,0.0,1602,1519
1948-03-02,Guatemala,El Salvador,3,0,3,1.0,0.0,1487,1511
1948-03-04,Guatemala,Costa Rica,1,1,0,0.5,0.5,1490,1600
1948-03-04,Panama,Curaçao,1,3,2,0.0,1.0,1497,1622
1948-03-05,Guatemala,Curaçao,2,2,0,0.5,0.5,1493,1620
1948-03-07,Costa Rica,Curaçao,2,1,1,1.0,0.0,1609,1612
1948-03-07,El Salvador,Panama,1,2,1,0.0,1.0,1503,1506
1948-03-09,El Salvador,Curaçao,1,0,1,1.0,0.0,1514,1602
1948-03-09,Guatemala,Panama,4,3,1,1.0,0.0,1502,1498
1948-03-10,Wales,Northern Ireland,2,0,2,1.0,0.0,1597,1483
1948-03-11,Costa Rica,Panama,3,1,2,1.0,0.0,1615,1493
1948-03-11,Curaçao,El Salvador,0,2,2,0.0,1.0,1593,1524
1948-03-12,Suriname,Trinidad and Tobago,0,2,2,0.0,1.0,1536,1597
1948-03-13,Guatemala,El Salvador,1,1,0,0.5,0.5,1503,1524
1948-03-14,Belgium,Netherlands,1,1,0,0.5,0.5,1463,1571
1948-03-14,Curaçao,Panama,2,5,3,0.0,1.0,1583,1504
1948-03-14,Suriname,Trinidad and Tobago,0,0,0,0.5,0.5,1538,1596
1948-03-16,Guatemala,Costa Rica,3,2,1,1.0,0.0,1514,1605
1948-03-16,Panama,El Salvador,2,0,2,1.0,0.0,1513,1516
1948-03-16,Suriname,Trinidad and Tobago,1,0,1,1.0,0.0,1548,1587
1948-03-18,El Salvador,Costa Rica,0,6,6,0.0,1.0,1511,1611
1948-03-18,Guatemala,Curaçao,2,2,0,0.5,0.5,1516,1582
1948-03-20,Curaçao,Costa Rica,4,1,3,1.0,0.0,1591,1603
1948-03-21,Guatemala,Panama,4,5,1,0.0,1.0,1508,1522
1948-03-21,Spain,Portugal,2,0,2,1.0,0.0,1616,1524
1948-04-04,Bulgaria,Poland,1,1,0,0.5,0.5,1462,1504
1948-04-04,France,Italy,1,3,2,0.0,1.0,1587,1803
1948-04-04,Uruguay,Brazil,1,1,0,0.5,0.5,1658,1686
1948-04-10,Scotland,England,0,2,2,0.0,1.0,1675,1731
1948-04-11,Uruguay,Brazil,4,2,2,1.0,0.0,1667,1678
1948-04-15,Guernsey,Alderney,3,0,3,1.0,0.0,1630,1367
1948-04-18,Austria,Switzerland,3,1,2,1.0,0.0,1671,1575
1948-04-18,Netherlands,Belgium,2,2,0,0.5,0.5,1569,1466
1948-04-18,Poland,Czechoslovakia,3,1,2,1.0,0.0,1516,1680
1948-04-20,Silesia,Czechoslovakia,2,1,1,1.0,0.0,1501,1668
1948-04-21,Hungary,Switzerland,7,4,3,1.0,0.0,1722,1571
1948-04-23,Greece,Turkey,1,3,2,0.0,1.0,1428,1480
1948-04-28,Scotland,Belgium,2,0,2,1.0,0.0,1679,1463
1948-05-02,Austria,Hungary,3,2,1,1.0,0.0,1681,1713
1948-05-02,Romania,Albania,0,1,1,0.0,1.0,1522,1503
1948-05-06,Jersey,Guernsey,6,3,3,1.0,0.0,1585,1621
1948-05-16,Italy,England,0,4,4,0.0,1.0,1794,1741
1948-05-17,Switzerland,Scotland,2,1,1,1.0,0.0,1582,1669
1948-05-23,Albania,Hungary,0,0,0,0.5,0.5,1508,1709
1948-05-23,France,Scotland,3,0,3,1.0,0.0,1597,1660
1948-05-23,Hungary,Czechoslovakia,2,1,1,1.0,0.0,1717,1661
1948-05-23,Portugal,Republic of Ireland,2,0,2,1.0,0.0,1533,1544
1948-05-25,DR Congo,Zambia,2,3,1,0.0,1.0,1493,1516
1948-05-26,Norway,Netherlands,1,2,1,0.0,1.0,1519,1577
1948-05-30,Spain,Republic of Ireland,2,1,1,1.0,0.0,1623,1538
1948-05-30,Turkey,Austria,0,1,1,0.0,1.0,1477,1685
1948-06-01,Djibouti,Ethiopia,1,2,1,0.0,1.0,1485,1516
1948-06-06,Belgium,France,4,2,2,1.0,0.0,1474,1587
1948-06-06,Hungary,Romania,9,0,9,1.0,0.0,1721,1519
1948-06-09,Jamaica,Cuba,3,0,3,1.0,0.0,1485,1532
1948-06-09,Netherlands,Sweden,1,0,1,1.0,0.0,1588,1684
1948-06-12,Czechoslovakia,France,0,4,4,0.0,1.0,1652,1597
1948-06-12,Denmark,Norway,1,2,1,0.0,1.0,1608,1530
1948-06-12,Jamaica,Cuba,1,1,0,0.5,0.5,1487,1531
1948-06-15,Finland,Denmark,0,3,3,0.0,1.0,1392,1612
1948-06-20,Romania,Bulgaria,3,2,1,1.0,0.0,1526,1456
1948-06-20,Switzerland,Spain,3,3,0,0.5,0.5,1583,1623
1948-06-26,Denmark,Poland,8,0,8,1.0,0.0,1618,1511
1948-06-27,Yugoslavia,Albania,0,0,0,0.5,0.5,1572,1510
1948-07-02,Iceland,Finland,2,0,2,1.0,0.0,1494,1387
1948-07-04,Bulgaria,Yugoslavia,1,3,2,0.0,1.0,1451,1578
1948-07-04,Romania,Czechoslovakia,2,1,1,1.0,0.0,1537,1642
1948-07-11,Sweden,Austria,3,2,1,1.0,0.0,1693,1677
1948-07-15,Madagascar,Réunion,2,1,1,1.0,0.0,1509,1478
1948-07-17,Mauritius,Madagascar,4,1,3,1.0,0.0,1524,1502
1948-07-19,Mauritius,Réunion,5,1,4,1.0,0.0,1531,1472
1948-08-02,Sweden,Austria,3,0,3,1.0,0.0,1701,1670
1948-08-06,Norway,United States,11,0,11,1.0,0.0,1538,1490
1948-08-11,Northern Ireland,United States,5,0,5,1.0,0.0,1492,1482
1948-08-14,New Zealand,Australia,0,6,6,0.0,1.0,1444,1544
1948-08-25,Poland,Yugoslavia,0,1,1,0.0,1.0,1505,1585
1948-08-27,Zimbabwe,Zambia,4,0,4,1.0,0.0,1502,1508
1948-08-28,New Zealand,Australia,0,7,7,0.0,1.0,1439,1550
1948-08-29,Bulgaria,Czechoslovakia,1,0,1,1.0,0.0,1464,1630
1948-09-01,Martinique,Dominica,5,0,5,1.0,0.0,1522,1517
1948-09-04,New Zealand,Australia,0,4,4,0.0,1.0,1434,1556
1948-09-05,Norway,Finland,2,0,2,1.0,0.0,1543,1383
1948-09-11,New Zealand,Australia,1,8,7,0.0,1.0,1429,1562
1948-09-19,Finland,Sweden,2,2,0,0.5,0.5,1389,1696
1948-09-19,Norway,Sweden,3,5,2,0.0,1.0,1539,1701
1948-09-19,Poland,Hungary,2,6,4,0.0,1.0,1502,1725
1948-09-22,Kenya,Zanzibar,3,1,2,1.0,0.0,1493,1484
1948-09-23,Uganda,Tanzania,6,0,6,1.0,0.0,1565,1483
1948-09-25,Uganda,Kenya,2,1,1,1.0,0.0,1572,1487
1948-09-26,Denmark,England,0,0,0,0.5,0.5,1621,1739
1948-09-26,French Guiana,Suriname,2,4,2,0.0,1.0,1479,1555
1948-09-26,Latvia,Lithuania,0,1,1,0.0,1.0,1508,1418
1948-09-26,United States,Israel,3,1,2,1.0,0.0,1490,1470
1948-09-27,Estonia,Lithuania,1,2,1,0.0,1.0,1409,1426
1948-09-27,Latvia,Estonia,1,1,0,0.5,0.5,1506,1412
1948-10-01,Suriname,Guyana,3,0,3,1.0,0.0,1562,1474
1948-10-03,Hungary,Austria,2,1,1,1.0,0.0,1732,1664
1948-10-09,Northern Ireland,England,2,6,4,0.0,1.0,1489,1743
1948-10-10,French Guiana,Guyana,3,2,1,1.0,0.0,1487,1467
1948-10-10,Poland,Romania,0,0,0,0.5,0.5,1503,1537
1948-10-10,Sweden,Denmark,1,0,1,1.0,0.0,1708,1615
1948-10-10,Switzerland,Czechoslovakia,1,1,0,0.5,0.5,1585,1629
1948-10-11,Jamaica,Haiti,1,0,1,1.0,0.0,1496,1489
1948-10-13,Jamaica,Haiti,1,2,1,0.0,1.0,1488,1498
1948-10-16,Jamaica,Haiti,3,0,3,1.0,0.0,1497,1490
1948-10-17,France,Belgium,3,3,0,0.5,0.5,1595,1477
1948-10-17,Poland,Finland,1,0,1,1.0,0.0,1509,1384
1948-10-23,Trinidad and Tobago,Haiti,0,0,0,0.5,0.5,1585,1493
1948-10-23,Wales,Scotland,1,3,2,0.0,1.0,1591,1667
1948-10-24,Romania,Hungary,1,5,4,0.0,1.0,1534,1736
1948-10-27,Trinidad and Tobago,Haiti,4,0,4,1.0,0.0,1591,1488
1948-10-28,Iran,Turkey,1,1,0,0.5,0.5,1500,1478
1948-10-30,Trinidad and Tobago,Haiti,4,0,4,1.0,0.0,1597,1483
1948-10-31,Czechoslovakia,Austria,3,1,2,1.0,0.0,1638,1656
1948-11-07,Bulgaria,Hungary,1,0,1,1.0,0.0,1478,1723
1948-11-10,England,Wales,1,0,1,1.0,0.0,1748,1587
1948-11-14,Austria,Sweden,2,1,1,1.0,0.0,1666,1699
1948-11-17,Scotland,Northern Ireland,3,2,1,1.0,0.0,1672,1485
1948-11-21,Belgium,Netherlands,1,1,0,0.5,0.5,1480,1586
1948-11-28,Turkey,Greece,2,1,1,1.0,0.0,1485,1422
1948-12-02,England,Switzerland,6,0,6,1.0,0.0,1753,1581
1948-12-05,Republic of Ireland,Switzerland,0,1,1,0.0,1.0,1531,1589
1948-12-16,Dominica,Martinique,0,6,6,0.0,1.0,1510,1530
1948-12-16,Guadeloupe,Haiti,1,0,1,1.0,0.0,1487,1475
1948-12-18,Guadeloupe,French Guiana,7,2,5,1.0,0.0,1495,1479
1948-12-18,Martinique,Suriname,4,3,1,1.0,0.0,1539,1554
1948-12-20,Guadeloupe,Martinique,3,0,3,1.0,0.0,1505,1530
1948-12-24,Egypt,Norway,1,1,0,0.5,0.5,1537,1539
1949-01-02,China PR,South Korea,3,2,1,1.0,0.0,1627,1495
1949-01-02,Spain,Belgium,1,1,0,0.5,0.5,1620,1484
1949-01-16,Vietnam,South Korea,3,3,0,0.5,0.5,1500,1496
1949-01-25,Macau,South Korea,1,5,4,0.0,1.0,1492,1505
1949-02-27,Italy,Portugal,4,1,3,1.0,0.0,1797,1531
1949-03-09,Northern Ireland,Wales,0,2,2,0.0,1.0,1480,1593
1949-03-13,Netherlands,Belgium,3,3,0,0.5,0.5,1584,1487
1949-03-20,Austria,Turkey,1,0,1,1.0,0.0,1671,1481
1949-03-20,Portugal,Spain,1,1,0,0.5,0.5,1534,1618
1949-03-23,Czechoslovakia,Luxembourg,2,2,0,0.5,0.5,1634,1449
1949-03-27,Spain,Italy,1,3,2,0.0,1.0,1614,1802
1949-04-03,Brazil,Ecuador,9,1,8,1.0,0.0,1681,1397
1949-04-03,Switzerland,Austria,1,2,1,0.0,1.0,1583,1678
1949-04-06,Bolivia,Chile,3,2,1,1.0,0.0,1429,1508
1949-04-06,Colombia,Paraguay,0,3,3,0.0,1.0,1490,1587
1949-04-07,Jersey,Alderney,9,0,9,1.0,0.0,1589,1364
1949-04-09,England,Scotland,1,3,2,0.0,1.0,1744,1682
1949-04-10,Brazil,Bolivia,10,1,9,1.0,0.0,1685,1426
1949-04-10,Colombia,Peru,0,4,4,0.0,1.0,1483,1535
1949-04-10,Czechoslovakia,Hungary,5,2,3,1.0,0.0,1645,1713
1949-04-10,Ecuador,Paraguay,0,1,1,0.0,1.0,1393,1592
1949-04-13,Brazil,Chile,2,1,1,1.0,0.0,1690,1504
1949-04-13,Ecuador,Uruguay,2,3,1,0.0,1.0,1391,1670
1949-04-13,Paraguay,Peru,3,1,2,1.0,0.0,1599,1529
1949-04-17,Bolivia,Uruguay,3,2,1,1.0,0.0,1439,1658
1949-04-17,Brazil,Colombia,5,0,5,1.0,0.0,1694,1480
1949-04-17,Chile,Ecuador,1,0,1,1.0,0.0,1510,1386
1949-04-20,Chile,Colombia,1,1,0,0.5,0.5,1510,1481
1949-04-20,Ecuador,Peru,0,4,4,0.0,1.0,1382,1534
1949-04-20,Haiti,Trinidad and Tobago,2,2,0,0.5,0.5,1478,1595
1949-04-20,Paraguay,Uruguay,1,2,1,0.0,1.0,1593,1665
1949-04-23,Haiti,Trinidad and Tobago,2,3,1,0.0,1.0,1473,1601
1949-04-23,Netherlands,France,4,1,3,1.0,0.0,1593,1587
1949-04-24,Brazil,Peru,7,1,6,1.0,0.0,1699,1530
1949-04-24,Republic of Ireland,Belgium,0,2,2,0.0,1.0,1522,1497
1949-04-25,Bolivia,Ecuador,2,0,2,1.0,0.0,1446,1376
1949-04-25,Haiti,Trinidad and Tobago,5,0,5,1.0,0.0,1484,1591
1949-04-25,Uruguay,Colombia,2,2,0,0.5,0.5,1662,1485
1949-04-27,Bolivia,Peru,0,3,3,0.0,1.0,1440,1537
1949-04-27,Chile,Paraguay,2,4,2,0.0,1.0,1504,1600
1949-04-27,Scotland,France,2,0,2,1.0,0.0,1688,1582
1949-04-30,Bolivia,Paraguay,0,7,7,0.0,1.0,1436,1605
1949-04-30,Brazil,Uruguay,5,1,4,1.0,0.0,1707,1655
1949-04-30,Chile,Peru,0,3,3,0.0,1.0,1497,1545
1949-05-01,Ethiopia,Djibouti,6,0,6,1.0,0.0,1524,1478
1949-05-02,Jamaica,Trinidad and Tobago,3,1,2,1.0,0.0,1508,1581
1949-05-03,Colombia,Ecuador,1,4,3,0.0,1.0,1475,1387
1949-05-04,Jamaica,Trinidad and Tobago,2,1,1,1.0,0.0,1518,1572
1949-05-04,Peru,Uruguay,4,3,1,1.0,0.0,1556,1645
1949-05-05,Guernsey,Jersey,1,2,1,0.0,1.0,1613,1598
1949-05-06,Bolivia,Colombia,4,0,4,1.0,0.0,1445,1467
1949-05-07,Jamaica,Trinidad and Tobago,1,2,1,0.0,1.0,1512,1579
1949-05-08,Brazil,Paraguay,1,2,1,0.0,1.0,1697,1616
1949-05-08,Chile,Uruguay,3,1,2,1.0,0.0,1509,1634
1949-05-08,Hungary,Austria,6,1,5,1.0,0.0,1721,1671
1949-05-08,Romania,Poland,2,1,1,1.0,0.0,1542,1502
1949-05-09,Cuba,Martinique,0,0,0,0.5,0.5,1531,1531
1949-05-09,Puerto Rico,Trinidad and Tobago,2,8,6,0.0,1.0,1441,1585
1949-05-11,Brazil,Paraguay,7,0,7,1.0,0.0,1704,1610
1949-05-11,Puerto Rico,Trinidad and Tobago,0,7,7,0.0,1.0,1437,1590
1949-05-12,Egypt,Turkey,2,3,1,0.0,1.0,1528,1491
1949-05-12,Suriname,Cuba,0,1,1,0.0,1.0,1546,1540
1949-05-13,Sweden,England,3,1,2,1.0,0.0,1709,1735
1949-05-14,Cuba,Dominican Republic,0,1,1,0.0,1.0,1532,1509
1949-05-15,Greece,Turkey,1,2,1,0.0,1.0,1416,1498
1949-05-15,Portugal,Wales,3,2,1,1.0,0.0,1544,1584
1949-05-18,Greece,Egypt,1,3,2,0.0,1.0,1411,1534
1949-05-18,Norway,England,1,4,3,0.0,1.0,1536,1739
1949-05-22,Belgium,Wales,3,1,2,1.0,0.0,1507,1575
1949-05-22,Czechoslovakia,Romania,3,2,1,1.0,0.0,1651,1537
1949-05-22,France,England,1,3,2,0.0,1.0,1578,1744
1949-05-22,Republic of Ireland,Portugal,1,0,1,1.0,0.0,1531,1536
1949-05-22,Italy,Austria,3,1,2,1.0,0.0,1808,1666
1949-05-26,Switzerland,Wales,4,0,4,1.0,0.0,1591,1568
1949-06-02,Sweden,Republic of Ireland,3,1,2,1.0,0.0,1714,1527
1949-06-04,France,Switzerland,4,2,2,1.0,0.0,1587,1583
1949-06-12,Denmark,Netherlands,1,2,1,0.0,1.0,1607,1602
1949-06-12,Hungary,Italy,1,1,0,0.5,0.5,1723,1807
1949-06-12,Republic of Ireland,Spain,1,4,3,0.0,1.0,1521,1621
1949-06-16,Finland,Netherlands,1,4,3,0.0,1.0,1381,1606
1949-06-16,Madagascar,Mauritius,1,3,2,0.0,1.0,1495,1539
1949-06-19,France,Spain,1,5,4,0.0,1.0,1580,1629
1949-06-19,Norway,Yugoslavia,1,3,2,0.0,1.0,1530,1592
1949-06-19,Poland,Denmark,1,2,1,0.0,1.0,1497,1613
1949-06-19,Sweden,Hungary,2,2,0,0.5,0.5,1715,1723
1949-06-19,United States,Scotland,0,4,4,0.0,1.0,1487,1692
1949-06-26,Switzerland,Luxembourg,5,2,3,1.0,0.0,1589,1444
1949-07-01,Martinique,Trinidad and Tobago,2,0,2,1.0,0.0,1541,1581
1949-07-08,Finland,Norway,1,1,0,0.5,0.5,1385,1527
1949-07-10,Hungary,Poland,8,2,6,1.0,0.0,1727,1494
1949-07-30,Curaçao,Aruba,3,0,3,1.0,0.0,1597,1496
1949-07-30,Israel,Cyprus,3,1,2,1.0,0.0,1479,1492
1949-08-03,El Salvador,Panama,3,1,2,1.0,0.0,1520,1514
1949-08-04,El Salvador,Panama,2,3,1,0.0,1.0,1512,1523
1949-08-07,Denmark,Iceland,5,1,4,1.0,0.0,1619,1489
1949-08-14,Suriname,French Guiana,5,0,5,1.0,0.0,1553,1473
1949-08-19,Suriname,French Guiana,2,1,1,1.0,0.0,1560,1467
1949-08-21,Yugoslavia,Israel,6,0,6,1.0,0.0,1598,1474
1949-09-04,Czechoslovakia,Bulgaria,1,3,2,0.0,1.0,1640,1490
1949-09-04,Mexico,United States,6,0,6,1.0,0.0,1597,1482
1949-09-08,Republic of Ireland,Finland,3,0,3,1.0,0.0,1527,1380
1949-09-11,Denmark,Finland,0,2,2,0.0,1.0,1607,1393
1949-09-11,Mexico,Cuba,2,0,2,1.0,0.0,1604,1526
1949-09-11,Norway,Denmark,0,2,2,0.0,1.0,1521,1614
1949-09-14,Cuba,United States,1,1,0,0.5,0.5,1525,1484
1949-09-18,Israel,Yugoslavia,2,5,3,0.0,1.0,1469,1604
1949-09-18,Luxembourg,Switzerland,2,3,1,0.0,1.0,1440,1594
1949-09-18,Mexico,United States,6,2,4,1.0,0.0,1610,1479
1949-09-21,England,Republic of Ireland,0,2,2,0.0,1.0,1732,1540
1949-09-21,United States,Cuba,5,2,3,1.0,0.0,1489,1516
1949-09-25,Austria,Czechoslovakia,3,1,2,1.0,0.0,1674,1633
1949-09-25,Mexico,Cuba,3,0,3,1.0,0.0,1616,1511
1949-10-01,Northern Ireland,Scotland,2,8,6,0.0,1.0,1477,1696
1949-10-02,Belgium,Switzerland,3,0,3,1.0,0.0,1517,1585
1949-10-02,Poland,Bulgaria,3,2,1,1.0,0.0,1502,1483
1949-10-02,Sweden,Finland,8,1,7,1.0,0.0,1718,1391
1949-10-02,Sweden,Norway,3,3,0,0.5,0.5,1714,1526
1949-10-07,Réunion,Mauritius,0,6,6,0.0,1.0,1466,1546
1949-10-08,Sierra Leone,Nigeria,0,2,2,0.0,1.0,1492,1508
1949-10-09,Finland,Republic of Ireland,1,1,0,0.5,0.5,1395,1537
1949-10-09,Yugoslavia,France,1,1,0,0.5,0.5,1604,1581
1949-10-10,Réunion,Madagascar,1,3,2,0.0,1.0,1459,1503
1949-10-15,Wales,England,1,4,3,0.0,1.0,1564,1737
1949-10-16,Austria,Hungary,3,4,1,0.0,1.0,1668,1734
1949-10-23,Denmark,Sweden,3,2,1,1.0,0.0,1625,1704
1949-10-23,Lithuania,Estonia,2,1,1,1.0,0.0,1434,1405
1949-10-23,Romania,Albania,1,1,0,0.5,0.5,1537,1511
1949-10-24,Latvia,Estonia,2,1,1,1.0,0.0,1512,1400
1949-10-25,Lithuania,Latvia,1,0,1,1.0,0.0,1444,1503
1949-10-30,Czechoslovakia,Poland,2,0,2,1.0,0.0,1639,1497
1949-10-30,France,Yugoslavia,1,1,0,0.5,0.5,1582,1604
1949-10-30,Hungary,Bulgaria,5,0,5,1.0,0.0,1738,1480
1949-11-06,Netherlands,Belgium,0,1,1,0.0,1.0,1596,1528
1949-11-06,Poland,Albania,2,1,1,1.0,0.0,1506,1503
1949-11-09,Scotland,Wales,2,0,2,1.0,0.0,1702,1559
1949-11-13,France,Czechoslovakia,1,0,1,1.0,0.0,1592,1630
1949-11-13,Republic of Ireland,Sweden,1,3,2,0.0,1.0,1533,1709
1949-11-13,Yugoslavia,Austria,2,5,3,0.0,1.0,1598,1675
1949-11-16,England,Northern Ireland,9,2,7,1.0,0.0,1740,1475
1949-11-17,Bulgaria,Albania,0,0,0,0.5,0.5,1481,1503
1949-11-20,Hungary,Sweden,5,0,5,1.0,0.0,1746,1702
1949-11-20,Turkey,Syria,7,0,7,1.0,0.0,1507,1492
1949-11-23,Wales,Belgium,5,1,4,1.0,0.0,1567,1521
1949-11-25,Greece,Syria,8,0,8,1.0,0.0,1421,1483
1949-11-29,Albania,Romania,1,4,3,0.0,1.0,1496,1545
1949-11-30,England,Italy,2,0,2,1.0,0.0,1750,1798
1949-12-06,Zanzibar,Kenya,2,3,1,0.0,1.0,1477,1495
1949-12-08,Kenya,Tanzania,0,2,2,0.0,1.0,1487,1492
1949-12-11,France,Yugoslavia,2,3,1,0.0,1.0,1585,1606
1949-12-11,Netherlands,Denmark,0,1,1,0.0,1.0,1589,1633
1949-12-18,Cuba,Jamaica,2,5,3,0.0,1.0,1504,1520
1949-12-19,Haiti,Jamaica,2,0,2,1.0,0.0,1493,1512
1949-12-20,Haiti,Cuba,3,0,3,1.0,0.0,1502,1496
1950-01-24,Zambia,DR Congo,1,0,1,1.0,0.0,1516,1486
1950-02-17,Egypt,Greece,2,0,2,1.0,0.0,1540,1416
1950-02-26,Bolivia,Chile,2,0,2,1.0,0.0,1455,1500
1950-02-26,Croatia,Serbia,4,1,3,1.0,0.0,1549,1493
1950-03-05,Italy,Belgium,3,1,2,1.0,0.0,1801,1519
1950-03-08,Wales,Northern Ireland,0,0,0,0.5,0.5,1565,1478
1950-03-12,Chile,Bolivia,5,0,5,1.0,0.0,1507,1449
1950-03-19,Austria,Switzerland,3,3,0,0.5,0.5,1673,1588
1950-03-22,Guyana,Trinidad and Tobago,0,1,1,0.0,1.0,1462,1587
1950-03-24,Guyana,Trinidad and Tobago,1,4,3,0.0,1.0,1457,1593
1950-03-25,Argentina,Paraguay,2,2,0,0.5,0.5,1810,1615
1950-03-27,Guyana,Trinidad and Tobago,1,0,1,1.0,0.0,1468,1583
1950-03-29,Argentina,Paraguay,4,0,4,1.0,0.0,1814,1612
1950-03-29,Guyana,Trinidad and Tobago,1,2,1,0.0,1.0,1463,1589
1950-03-30,Guernsey,Alderney,3,1,2,1.0,0.0,1617,1361
1950-04-02,Austria,Italy,1,0,1,1.0,0.0,1684,1791
1950-04-02,Spain,Portugal,5,1,4,1.0,0.0,1635,1531
1950-04-07,Chile,Uruguay,1,5,4,0.0,1.0,1502,1640
1950-04-09,Chile,Uruguay,2,1,1,1.0,0.0,1514,1629
1950-04-09,Portugal,Spain,2,2,0,0.5,0.5,1534,1633
1950-04-14,Mauritius,Réunion,15,2,13,1.0,0.0,1553,1453
1950-04-15,Scotland,England,0,1,1,0.0,1.0,1696,1757
1950-04-16,Belgium,Netherlands,2,0,2,1.0,0.0,1529,1580
1950-04-16,South Korea,Taiwan,3,1,2,1.0,0.0,1513,1493
1950-04-26,Scotland,Switzerland,3,1,2,1.0,0.0,1702,1583
1950-04-30,Hungary,Czechoslovakia,5,0,5,1.0,0.0,1752,1625
1950-04-30,Paraguay,Uruguay,3,2,1,1.0,0.0,1621,1621
1950-05-01,Albania,Poland,0,0,0,0.5,0.5,1497,1506
1950-05-04,Jersey,Guernsey,0,2,2,0.0,1.0,1591,1625
1950-05-06,Brazil,Uruguay,3,4,1,0.0,1.0,1695,1631
1950-05-07,Brazil,Paraguay,2,0,2,1.0,0.0,1702,1615
1950-05-10,Belgium,Republic of Ireland,5,1,4,1.0,0.0,1538,1525
1950-05-13,Brazil,Paraguay,3,3,0,0.5,0.5,1701,1617
1950-05-14,Austria,Hungary,5,3,2,1.0,0.0,1694,1743
1950-05-14,Brazil,Uruguay,3,2,1,1.0,0.0,1708,1625
1950-05-14,Poland,Romania,3,3,0,0.5,0.5,1507,1545
1950-05-14,Portugal,England,3,5,2,0.0,1.0,1531,1761
1950-05-18,Belgium,England,1,4,3,0.0,1.0,1535,1765
1950-05-21,Portugal,Scotland,2,2,0,0.5,0.5,1535,1699
1950-05-21,Romania,Czechoslovakia,1,1,0,0.5,0.5,1547,1624
1950-05-27,France,Scotland,0,1,1,0.0,1.0,1580,1705
1950-05-28,Ghana,Nigeria,1,0,1,1.0,0.0,1509,1500
1950-05-28,Turkey,Iran,6,1,5,1.0,0.0,1515,1493
1950-05-28,Yugoslavia,Denmark,5,1,4,1.0,0.0,1615,1625
1950-06-04,Albania,Bulgaria,2,1,1,1.0,0.0,1505,1474
1950-06-04,Belgium,France,4,1,3,1.0,0.0,1545,1571
1950-06-04,Poland,Hungary,2,5,3,0.0,1.0,1504,1747
1950-06-08,Sweden,Netherlands,4,1,3,1.0,0.0,1708,1575
1950-06-11,Finland,Netherlands,4,1,3,1.0,0.0,1407,1564
1950-06-11,Switzerland,Yugoslavia,0,4,4,0.0,1.0,1576,1623
1950-06-14,Zimbabwe,Australia,0,5,5,0.0,1.0,1496,1569
1950-06-17,Zimbabwe,Australia,1,4,3,0.0,1.0,1490,1576
1950-06-22,Denmark,Norway,4,0,4,1.0,0.0,1631,1521
1950-06-24,Brazil,Mexico,4,0,4,1.0,0.0,1714,1611
1950-06-24,South Africa,Australia,3,2,1,1.0,0.0,1559,1568
1950-06-25,Chile,England,0,2,2,0.0,1.0,1511,1769
1950-06-25,Denmark,Norway,1,4,3,0.0,1.0,1621,1532
1950-06-25,Italy,Sweden,2,3,1,0.0,1.0,1782,1718
1950-06-25,Spain,United States,3,1,2,1.0,0.0,1638,1485
1950-06-25,Switzerland,Yugoslavia,0,3,3,0.0,1.0,1570,1630
1950-06-28,Brazil,Switzerland,2,2,0,0.5,0.5,1711,1574
1950-06-28,Mexico,Yugoslavia,1,4,3,0.0,1.0,1604,1638
1950-06-29,Chile,Spain,0,2,2,0.0,1.0,1506,1644
1950-06-29,England,United States,0,1,1,0.0,1.0,1756,1499
1950-06-29,Paraguay,Sweden,2,2,0,0.5,0.5,1620,1716
1950-07-01,Brazil,Yugoslavia,2,0,2,1.0,0.0,1718,1632
1950-07-01,South Africa,Australia,2,1,1,1.0,0.0,1568,1560
1950-07-02,Bolivia,Uruguay,0,8,8,0.0,1.0,1445,1630
1950-07-02,Chile,United States,5,2,3,1.0,0.0,1514,1492
1950-07-02,England,Spain,0,1,1,0.0,1.0,1746,1655
1950-07-02,Italy,Paraguay,2,0,2,1.0,0.0,1787,1616
1950-07-02,Mexico,Switzerland,1,2,1,0.0,1.0,1596,1583
1950-07-08,South Africa,Australia,1,2,1,0.0,1.0,1560,1569
1950-07-09,Brazil,Sweden,7,1,6,1.0,0.0,1726,1709
1950-07-09,Spain,Uruguay,2,2,0,0.5,0.5,1655,1631
1950-07-11,Madagascar,Réunion,2,3,1,0.0,1.0,1494,1463
1950-07-11,Madagascar,Mauritius,1,5,4,0.0,1.0,1488,1560
1950-07-13,Brazil,Spain,6,1,5,1.0,0.0,1733,1649
1950-07-13,Sweden,Uruguay,2,3,1,0.0,1.0,1700,1641
1950-07-16,Brazil,Uruguay,1,2,1,0.0,1.0,1723,1652
1950-07-16,Spain,Sweden,1,3,2,0.0,1.0,1643,1707
1950-07-16,Zambia,Zimbabwe,3,2,1,1.0,0.0,1524,1483
1950-07-23,South Africa,Australia,0,2,2,0.0,1.0,1553,1577
1950-08-15,Norway,Luxembourg,2,2,0,0.5,0.5,1530,1443
1950-08-27,Bulgaria,Czechoslovakia,1,2,1,0.0,1.0,1470,1629
1950-08-27,Finland,Denmark,1,2,1,0.0,1.0,1404,1625
1950-08-27,Suriname,Guyana,0,1,1,0.0,1.0,1550,1474
1950-08-31,Suriname,Guyana,3,0,3,1.0,0.0,1557,1468
1950-09-02,El Salvador,Guatemala,2,1,1,1.0,0.0,1520,1501
1950-09-03,Suriname,Guyana,4,1,3,1.0,0.0,1563,1463
1950-09-03,Sweden,Yugoslavia,1,2,1,0.0,1.0,1698,1642
1950-09-06,El Salvador,Guatemala,2,0,2,1.0,0.0,1528,1494
1950-09-07,Finland,Yugoslavia,3,2,1,1.0,0.0,1417,1630
1950-09-10,Denmark,Yugoslavia,1,4,3,0.0,1.0,1618,1638
1950-09-10,Norway,Finland,4,1,3,1.0,0.0,1536,1412
1950-09-24,Finland,Sweden,0,1,1,0.0,1.0,1410,1701
1950-09-24,Hungary,Albania,12,0,12,1.0,0.0,1751,1502
1950-09-24,Norway,Sweden,1,3,2,0.0,1.0,1532,1706
1950-10-07,Northern Ireland,England,1,4,3,0.0,1.0,1476,1749
1950-10-08,Austria,Yugoslavia,7,2,5,1.0,0.0,1701,1632
1950-10-08,Romania,Albania,6,0,6,1.0,0.0,1554,1496
1950-10-10,Tanzania,Zanzibar,4,0,4,1.0,0.0,1500,1470
1950-10-11,Kenya,Uganda,3,1,2,1.0,0.0,1497,1563
1950-10-14,Jamaica,Haiti,2,1,1,1.0,0.0,1520,1495
1950-10-14,Kenya,Tanzania,1,1,0,0.5,0.5,1498,1500
1950-10-15,Sweden,Denmark,4,0,4,1.0,0.0,1713,1612
1950-10-15,Switzerland,Netherlands,7,5,2,1.0,0.0,1591,1557
1950-10-16,Kenya,Tanzania,1,2,1,0.0,1.0,1491,1508
1950-10-21,Wales,Scotland,1,3,2,0.0,1.0,1561,1710
1950-10-22,Poland,Czechoslovakia,1,4,3,0.0,1.0,1499,1635
1950-10-26,Iran,Afghanistan,4,0,4,1.0,0.0,1501,1485
1950-10-28,Israel,Turkey,5,1,4,1.0,0.0,1479,1506
1950-10-29,Hungary,Austria,4,3,1,1.0,0.0,1758,1695
1950-10-30,Bulgaria,Poland,0,1,1,0.0,1.0,1463,1507
1950-11-01,France,Belgium,3,3,0,0.5,0.5,1571,1546
1950-11-01,Scotland,Northern Ireland,6,1,5,1.0,0.0,1714,1473
1950-11-05,Austria,Denmark,5,1,4,1.0,0.0,1702,1606
1950-11-05,Yugoslavia,Norway,4,0,4,1.0,0.0,1638,1527
1950-11-12,Belgium,Netherlands,7,2,5,1.0,0.0,1555,1549
1950-11-12,Bulgaria,Hungary,1,1,0,0.5,0.5,1469,1753
1950-11-12,Switzerland,Sweden,4,2,2,1.0,0.0,1602,1703
1950-11-15,England,Wales,4,2,2,1.0,0.0,1754,1557
1950-11-18,Curaçao,Suriname,2,3,1,0.0,1.0,1589,1572
1950-11-22,England,Yugoslavia,2,2,0,0.5,0.5,1752,1641
1950-11-22,Germany,Switzerland,1,0,1,1.0,0.0,1727,1597
1950-11-22,Trinidad and Tobago,Curaçao,3,2,1,1.0,0.0,1597,1581
1950-11-25,Trinidad and Tobago,Suriname,5,0,5,1.0,0.0,1605,1565
1950-11-26,Republic of Ireland,Norway,2,2,0,0.5,0.5,1526,1527
1950-11-28,Curaçao,Suriname,3,0,3,1.0,0.0,1589,1558
1950-11-30,Trinidad and Tobago,Suriname,1,1,0,0.5,0.5,1604,1560
1950-12-02,Trinidad and Tobago,Curaçao,5,1,4,1.0,0.0,1612,1582
1950-12-03,Turkey,Israel,3,2,1,1.0,0.0,1514,1472
1950-12-05,Guadeloupe,Trinidad and Tobago,0,1,1,0.0,1.0,1500,1618
1950-12-10,France,Netherlands,5,2,3,1.0,0.0,1579,1542
1950-12-13,Scotland,Austria,0,1,1,0.0,1.0,1706,1711
1951-02-06,France,Yugoslavia,2,1,1,1.0,0.0,1589,1632
1951-02-18,Spain,Switzerland,6,3,3,1.0,0.0,1650,1591
1951-02-24,Zimbabwe,Zambia,2,1,1,1.0,0.0,1492,1516
1951-02-25,Costa Rica,Nicaragua,8,1,7,1.0,0.0,1608,1414
1951-02-27,Panama,Costa Rica,2,0,2,1.0,0.0,1533,1599
1951-02-28,Panama,Nicaragua,4,0,4,1.0,0.0,1539,1409
1951-03-02,Panama,Costa Rica,1,1,0,0.5,0.5,1541,1598
1951-03-03,Nicaragua,Costa Rica,1,4,3,0.0,1.0,1405,1603
1951-03-04,Panama,Nicaragua,6,2,4,1.0,0.0,1547,1400
1951-03-05,Iran,Burma,2,0,2,1.0,0.0,1509,1493
1951-03-05,India,Indonesia,3,0,3,1.0,0.0,1501,1471
1951-03-07,Northern Ireland,Wales,1,2,1,0.0,1.0,1467,1564
1951-03-07,Iran,Japan,0,0,0,0.5,0.5,1510,1522
1951-03-07,India,Afghanistan,3,0,3,1.0,0.0,1509,1478
1951-03-08,Iran,Japan,3,2,1,1.0,0.0,1519,1514
1951-03-09,Japan,Afghanistan,2,0,2,1.0,0.0,1522,1471
1951-03-10,India,Iran,1,0,1,1.0,0.0,1518,1511
1951-03-19,Barbados,Grenada,1,3,2,0.0,1.0,1429,1523
1951-03-19,Martinique,Guadeloupe,3,0,3,1.0,0.0,1549,1493
1951-03-21,Barbados,Grenada,3,2,1,1.0,0.0,1440,1513
1951-04-08,Portugal,Italy,1,4,3,0.0,1.0,1532,1791
1951-04-12,Jersey,Alderney,8,1,7,1.0,0.0,1595,1358
1951-04-14,England,Scotland,2,3,1,0.0,1.0,1743,1716
1951-04-15,Netherlands,Belgium,5,4,1,1.0,0.0,1551,1547
1951-04-15,Switzerland,Germany,2,3,1,0.0,1.0,1586,1733
1951-05-03,Guernsey,Jersey,3,1,2,1.0,0.0,1633,1588
1951-05-06,Italy,Yugoslavia,0,0,0,0.5,0.5,1788,1636
1951-05-09,England,Argentina,2,1,1,1.0,0.0,1753,1805
1951-05-12,Northern Ireland,France,2,2,0,0.5,0.5,1470,1587
1951-05-12,Scotland,Denmark,3,1,2,1.0,0.0,1722,1601
1951-05-12,Wales,Portugal,2,1,1,1.0,0.0,1572,1525
1951-05-13,Republic of Ireland,Argentina,0,1,1,0.0,1.0,1524,1808
1951-05-16,Scotland,France,1,0,1,1.0,0.0,1728,1582
1951-05-16,Wales,Switzerland,3,2,1,1.0,0.0,1581,1578
1951-05-17,Guadeloupe,Martinique,1,1,0,0.5,0.5,1495,1548
1951-05-19,England,Portugal,5,2,3,1.0,0.0,1757,1522
1951-05-20,Belgium,Scotland,0,5,5,0.0,1.0,1543,1733
1951-05-20,Czechoslovakia,Romania,2,2,0,0.5,0.5,1634,1556
1951-05-25,Barbados,Jamaica,3,0,3,1.0,0.0,1450,1511
1951-05-26,Barbados,Jamaica,0,1,1,0.0,1.0,1444,1518
1951-05-27,Austria,Scotland,4,0,4,1.0,0.0,1720,1725
1951-05-27,Hungary,Poland,6,0,6,1.0,0.0,1757,1504
1951-05-28,Barbados,Jamaica,5,2,3,1.0,0.0,1454,1509
1951-05-30,Norway,Republic of Ireland,2,3,1,0.0,1.0,1519,1533
1951-06-03,Italy,France,4,1,3,1.0,0.0,1792,1579
1951-06-06,Netherlands,Norway,2,3,1,0.0,1.0,1543,1528
1951-06-10,Belgium,Spain,3,3,0,0.5,0.5,1546,1648
1951-06-10,Sweden,Turkey,3,1,2,1.0,0.0,1708,1510
1951-06-17,Denmark,Austria,3,3,0,0.5,0.5,1604,1718
1951-06-17,Germany,Turkey,1,2,1,0.0,1.0,1721,1523
1951-06-17,Portugal,Belgium,1,1,0,0.5,0.5,1523,1546
1951-06-17,Sweden,Spain,0,0,0,0.5,0.5,1707,1650
1951-06-24,Yugoslavia,Switzerland,7,3,4,1.0,0.0,1643,1572
1951-06-29,Iceland,Sweden,4,3,1,1.0,0.0,1502,1695
1951-07-14,Madagascar,Réunion,3,1,2,1.0,0.0,1496,1456
1951-07-19,Mauritius,Madagascar,7,1,6,1.0,0.0,1567,1490
1951-07-21,Mauritius,Réunion,10,2,8,1.0,0.0,1573,1451
1951-07-26,Norway,Iceland,3,1,2,1.0,0.0,1536,1495
1951-08-16,Finland,Norway,1,1,0,0.5,0.5,1413,1534
1951-08-23,Norway,Yugoslavia,2,4,2,0.0,1.0,1529,1649
1951-08-31,Suriname,Guyana,6,1,5,1.0,0.0,1566,1458
1951-09-02,Suriname,Guyana,5,0,5,1.0,0.0,1572,1453
1951-09-02,Sweden,Finland,3,2,1,1.0,0.0,1698,1411
1951-09-02,Yugoslavia,Sweden,2,1,1,1.0,0.0,1659,1689
1951-09-09,Suriname,Guyana,4,0,4,1.0,0.0,1578,1448
1951-09-16,Norway,Denmark,2,0,2,1.0,0.0,1539,1595
1951-09-19,New Caledonia,New Zealand,2,0,2,1.0,0.0,1507,1423
1951-09-22,New Caledonia,New Zealand,4,6,2,0.0,1.0,1498,1433
1951-09-23,Austria,Germany,0,2,2,0.0,1.0,1711,1729
1951-09-24,New Caledonia,New Zealand,2,0,2,1.0,0.0,1505,1427
1951-09-25,Kenya,Uganda,2,1,1,1.0,0.0,1501,1554
1951-09-26,Tanzania,Zanzibar,1,0,1,1.0,0.0,1516,1463
1951-09-29,Tanzania,Kenya,3,2,1,1.0,0.0,1524,1494
1951-09-30,Denmark,Finland,1,0,1,1.0,0.0,1600,1407
1951-09-30,New Caledonia,New Zealand,1,3,2,0.0,1.0,1496,1437
1951-09-30,Sweden,Norway,3,4,1,0.0,1.0,1678,1551
1951-10-03,England,France,2,2,0,0.5,0.5,1754,1583
1951-10-04,New Zealand,Vanuatu,9,0,9,1.0,0.0,1447,1491
1951-10-06,Northern Ireland,Scotland,0,3,3,0.0,1.0,1468,1728
1951-10-07,Fiji,New Zealand,4,6,2,0.0,1.0,1491,1457
1951-10-14,Belgium,Austria,1,8,7,0.0,1.0,1542,1716
1951-10-14,Czechoslovakia,Hungary,1,2,1,0.0,1.0,1629,1763
1951-10-14,Switzerland,France,1,2,1,0.0,1.0,1565,1591
1951-10-17,Republic of Ireland,Germany,3,2,1,1.0,0.0,1546,1717
1951-10-20,Nigeria,Ghana,5,0,5,1.0,0.0,1509,1501
1951-10-20,Wales,England,1,1,0,0.5,0.5,1585,1751
1951-10-21,Denmark,Sweden,3,1,2,1.0,0.0,1610,1669
1951-10-27,Netherlands,Finland,4,4,0,0.5,0.5,1541,1410
1951-11-01,France,Austria,2,2,0,0.5,0.5,1594,1714
1951-11-04,Luxembourg,Finland,3,0,3,1.0,0.0,1451,1403
1951-11-11,Italy,Sweden,1,1,0,0.5,0.5,1790,1672
1951-11-14,England,Northern Ireland,2,0,2,1.0,0.0,1754,1466
1951-11-14,Scotland,Wales,0,1,1,0.0,1.0,1717,1597
1951-11-14,Turkey,Sweden,1,0,1,1.0,0.0,1535,1661
1951-11-18,Hungary,Finland,8,0,8,1.0,0.0,1765,1402
1951-11-21,Turkey,Germany,0,2,2,0.0,1.0,1531,1722
1951-11-25,Greece,Egypt,1,0,1,1.0,0.0,1427,1530
1951-11-25,Netherlands,Belgium,6,7,1,0.0,1.0,1534,1550
1951-11-25,Switzerland,Italy,1,1,0,0.5,0.5,1570,1786
1951-11-28,England,Austria,2,2,0,0.5,0.5,1754,1715
1951-12-08,Venezuela,Panama,4,1,3,1.0,0.0,1479,1538
1951-12-13,Guadeloupe,Trinidad and Tobago,0,2,2,0.0,1.0,1490,1624
1951-12-23,Germany,Luxembourg,4,1,3,1.0,0.0,1725,1449
1951-12-26,Jamaica,Haiti,2,2,0,0.5,0.5,1509,1496
1951-12-27,Jamaica,Haiti,0,1,1,0.0,1.0,1501,1505
1951-12-29,Jamaica,Haiti,2,1,1,1.0,0.0,1510,1497
1952-02-02,Curaçao,Aruba,3,0,3,1.0,0.0,1589,1490
1952-02-03,Curaçao,Aruba,3,1,2,1.0,0.0,1595,1485
1952-02-14,Aruba,Suriname,2,1,1,1.0,0.0,1496,1568
1952-02-17,Guyana,Suriname,0,9,9,0.0,1.0,1443,1574
1952-02-24,Belgium,Italy,2,0,2,1.0,0.0,1563,1774
1952-03-12,Guadeloupe,Martinique,4,0,4,1.0,0.0,1500,1539
1952-03-13,Martinique,Guadeloupe,1,2,1,0.0,1.0,1531,1509
1952-03-14,Myanmar,India,0,4,4,0.0,1.0,1493,1526
1952-03-16,Chile,Panama,6,1,5,1.0,0.0,1523,1530
1952-03-18,Myanmar,Pakistan,0,1,1,0.0,1.0,1486,1508
1952-03-19,Wales,Northern Ireland,3,0,3,1.0,0.0,1603,1461
1952-03-23,Austria,Belgium,2,0,2,1.0,0.0,1720,1559
1952-03-23,India,Pakistan,0,0,0,0.5,0.5,1526,1509
1952-03-23,Mexico,Uruguay,1,3,2,0.0,1.0,1590,1659
1952-03-23,Panama,Peru,1,7,6,0.0,1.0,1523,1564
1952-03-24,Sri Lanka,India,1,2,1,0.0,1.0,1493,1534
1952-03-26,Chile,Mexico,4,0,4,1.0,0.0,1533,1581
1952-03-26,France,Sweden,0,1,1,0.0,1.0,1588,1668
1952-03-28,Sri Lanka,Pakistan,0,2,2,0.0,1.0,1486,1517
1952-03-30,Peru,Uruguay,2,5,3,0.0,1.0,1559,1665
1952-04-02,Chile,Peru,3,2,1,1.0,0.0,1542,1551
1952-04-03,Guernsey,Alderney,7,2,5,1.0,0.0,1636,1356
1952-04-05,Scotland,England,1,2,1,0.0,1.0,1710,1762
1952-04-06,Belgium,Netherlands,4,2,2,1.0,0.0,1567,1527
1952-04-06,Brazil,Mexico,2,0,2,1.0,0.0,1728,1577
1952-04-06,Panama,Uruguay,1,6,5,0.0,1.0,1519,1670
1952-04-10,Brazil,Peru,0,0,0,0.5,0.5,1725,1555
1952-04-10,Mexico,Panama,4,2,2,1.0,0.0,1584,1513
1952-04-13,Brazil,Panama,5,0,5,1.0,0.0,1729,1510
1952-04-13,Chile,Uruguay,2,0,2,1.0,0.0,1553,1660
1952-04-16,Brazil,Uruguay,4,2,2,1.0,0.0,1736,1654
1952-04-20,Chile,Brazil,0,3,3,0.0,1.0,1549,1741
1952-04-20,France,Portugal,3,0,3,1.0,0.0,1595,1517
1952-04-20,Luxembourg,Germany,0,3,3,0.0,1.0,1447,1728
1952-04-20,Mexico,Peru,0,3,3,0.0,1.0,1576,1564
1952-04-30,Scotland,United States,6,0,6,1.0,0.0,1714,1489
1952-05-01,Jersey,Guernsey,1,3,2,0.0,1.0,1582,1643
1952-05-04,Germany,Republic of Ireland,3,0,3,1.0,0.0,1733,1542
1952-05-07,Austria,Republic of Ireland,6,0,6,1.0,0.0,1725,1538
1952-05-11,Romania,Czechoslovakia,3,1,2,1.0,0.0,1566,1620
1952-05-14,Netherlands,Sweden,0,0,0,0.5,0.5,1531,1665
1952-05-18,Hungary,German DR,5,0,5,1.0,0.0,1768,1498
1952-05-18,Italy,England,1,1,0,0.5,0.5,1774,1763
1952-05-18,Poland,Bulgaria,0,1,1,0.0,1.0,1496,1478
1952-05-22,Belgium,France,1,2,1,0.0,1.0,1560,1603
1952-05-24,Russia,Hungary,1,1,0,0.5,0.5,1509,1763
1952-05-25,Austria,England,2,3,1,0.0,1.0,1718,1771
1952-05-25,Denmark,Scotland,1,2,1,0.0,1.0,1605,1720
1952-05-25,Romania,Poland,1,0,1,1.0,0.0,1573,1490
1952-05-27,Russia,Hungary,2,1,1,1.0,0.0,1522,1751
1952-05-28,Switzerland,England,0,3,3,0.0,1.0,1567,1775
1952-05-30,Sweden,Scotland,3,1,2,1.0,0.0,1675,1711
1952-06-01,Spain,Republic of Ireland,6,0,6,1.0,0.0,1656,1533
1952-06-01,Turkey,Switzerland,1,5,4,0.0,1.0,1524,1575
1952-06-08,Turkey,Spain,0,0,0,0.5,0.5,1527,1654
1952-06-10,Norway,Finland,1,2,1,0.0,1.0,1540,1414
1952-06-11,Denmark,Sweden,0,2,2,0.0,1.0,1599,1682
1952-06-13,Finland,Sweden,3,1,2,1.0,0.0,1428,1669
1952-06-15,Poland,Hungary,1,5,4,0.0,1.0,1488,1754
1952-06-22,Finland,Hungary,1,6,5,0.0,1.0,1426,1757
1952-06-22,Sweden,Denmark,4,3,1,1.0,0.0,1676,1593
1952-06-22,Switzerland,Austria,1,1,0,0.5,0.5,1579,1715
1952-06-25,Yugoslavia,Norway,4,1,3,1.0,0.0,1665,1535
1952-07-03,Netherlands,Curaçao,3,3,0,0.5,0.5,1533,1594
1952-07-19,Haiti,Jamaica,4,1,3,1.0,0.0,1506,1502
1952-07-20,Haiti,Jamaica,3,3,0,0.5,0.5,1506,1503
1952-07-23,Haiti,Jamaica,2,0,2,1.0,0.0,1514,1496
1952-07-24,Réunion,Madagascar,0,1,1,0.0,1.0,1444,1498
1952-07-27,Haiti,Jamaica,3,2,1,1.0,0.0,1522,1489
1952-07-27,Réunion,Mauritius,0,6,6,0.0,1.0,1439,1579
1952-07-31,Madagascar,Mauritius,0,7,7,0.0,1.0,1492,1586
1952-08-04,Finland,China PR,4,0,4,1.0,0.0,1439,1615
1952-08-10,Netherlands,Egypt,1,1,0,0.5,0.5,1533,1531
1952-08-24,Silesia,China PR,5,1,4,1.0,0.0,1512,1605
1952-08-31,Norway,Finland,7,2,5,1.0,0.0,1541,1434
1952-09-06,Zambia,Zimbabwe,1,4,3,0.0,1.0,1508,1501
1952-09-07,Fiji,New Zealand,0,2,2,0.0,1.0,1483,1466
1952-09-11,Zambia,Zimbabwe,3,2,1,1.0,0.0,1516,1494
1952-09-14,Czechoslovakia,Poland,2,2,0,0.5,0.5,1618,1491
1952-09-14,Fiji,New Zealand,0,9,9,0.0,1.0,1475,1475
1952-09-16,Fiji,New Zealand,2,5,3,0.0,1.0,1467,1483
1952-09-20,Switzerland,Hungary,2,4,2,0.0,1.0,1575,1762
1952-09-21,Denmark,Netherlands,3,2,1,1.0,0.0,1600,1527
1952-09-21,Finland,Sweden,1,8,7,0.0,1.0,1431,1680
1952-09-21,Poland,German DR,3,0,3,1.0,0.0,1500,1490
1952-09-21,Tahiti,New Zealand,2,2,0,0.5,0.5,1500,1484
1952-09-21,Yugoslavia,Austria,4,2,2,1.0,0.0,1675,1706
1952-09-23,Uganda,Tanzania,4,0,4,1.0,0.0,1562,1517
1952-09-24,Kenya,Zanzibar,7,1,6,1.0,0.0,1502,1456
1952-09-26,Tanzania,Zanzibar,1,3,2,0.0,1.0,1508,1466
1952-09-27,Uganda,Kenya,6,3,3,1.0,0.0,1569,1496
1952-09-28,Tahiti,New Zealand,3,5,2,0.0,1.0,1492,1493
1952-10-04,Northern Ireland,England,2,2,0,0.5,0.5,1467,1770
1952-10-05,Finland,Denmark,2,1,1,1.0,0.0,1443,1589
1952-10-05,France,Germany,3,1,2,1.0,0.0,1614,1723
1952-10-05,Norway,Sweden,1,2,1,0.0,1.0,1537,1685
1952-10-18,Wales,Scotland,1,2,1,0.0,1.0,1598,1717
1952-10-19,Austria,France,1,2,1,0.0,1.0,1696,1625
1952-10-19,Belgium,Netherlands,2,1,1,1.0,0.0,1568,1520
1952-10-19,Denmark,Norway,1,3,2,0.0,1.0,1580,1547
1952-10-19,Hungary,Czechoslovakia,5,0,5,1.0,0.0,1767,1614
1952-10-26,Romania,German DR,3,1,2,1.0,0.0,1580,1484
1952-10-26,Sweden,Italy,1,1,0,0.5,0.5,1688,1772
1952-11-02,Yugoslavia,Egypt,5,0,5,1.0,0.0,1680,1527
1952-11-05,Scotland,Northern Ireland,1,1,0,0.5,0.5,1713,1472
1952-11-09,Germany,Switzerland,5,1,4,1.0,0.0,1728,1571
1952-11-11,France,Northern Ireland,3,1,2,1.0,0.0,1630,1468
1952-11-12,England,Wales,5,2,3,1.0,0.0,1775,1594
1952-11-16,Republic of Ireland,France,1,1,0,0.5,0.5,1536,1628
1952-11-23,Portugal,Austria,1,1,0,0.5,0.5,1521,1693
1952-11-26,England,Belgium,5,0,5,1.0,0.0,1779,1565
1952-11-29,Albania,Czechoslovakia,3,2,1,1.0,0.0,1507,1604
1952-12-07,Spain,Argentina,0,1,1,0.0,1.0,1650,1813
1952-12-14,Portugal,Argentina,1,3,2,0.0,1.0,1519,1816
1952-12-21,Germany,Yugoslavia,3,2,1,1.0,0.0,1735,1674
1952-12-25,France,Belgium,0,1,1,0.0,1.0,1619,1575
1952-12-28,Italy,Switzerland,2,0,2,1.0,0.0,1776,1568
1952-12-28,Spain,Germany,2,2,0,0.5,0.5,1652,1734
1953-01-16,Egypt,Yugoslavia,1,3,2,0.0,1.0,1523,1679
1953-02-09,Gambia,Sierra Leone,2,1,1,1.0,0.0,1508,1485
1953-02-22,Peru,Bolivia,0,1,1,0.0,1.0,1554,1456
1953-02-25,Bolivia,Uruguay,0,2,2,0.0,1.0,1453,1658
1953-02-25,Chile,Paraguay,0,3,3,0.0,1.0,1543,1623
1953-02-28,Peru,Ecuador,1,0,1,1.0,0.0,1559,1383
1953-03-01,Bolivia,Brazil,1,8,7,0.0,1.0,1451,1744
1953-03-01,Chile,Uruguay,3,2,1,1.0,0.0,1554,1648
1953-03-04,Ecuador,Paraguay,0,0,0,0.5,0.5,1388,1619
1953-03-04,Peru,Chile,0,0,0,0.5,0.5,1559,1555
1953-03-07,Netherlands,Denmark,1,2,1,0.0,1.0,1514,1587
1953-03-08,Bolivia,Ecuador,1,1,0,0.5,0.5,1450,1390
1953-03-08,Costa Rica,El Salvador,5,1,4,1.0,0.0,1610,1522
1953-03-08,Honduras,Nicaragua,2,1,1,1.0,0.0,1480,1394
1953-03-08,Peru,Paraguay,2,2,0,0.5,0.5,1561,1618
1953-03-09,Guatemala,Curaçao,1,1,0,0.5,0.5,1497,1592
1953-03-10,Costa Rica,Panama,3,0,3,1.0,0.0,1616,1505
1953-03-10,El Salvador,Nicaragua,4,1,3,1.0,0.0,1528,1389
1953-03-11,Curaçao,Nicaragua,8,0,8,1.0,0.0,1596,1386
1953-03-11,Guatemala,Honduras,1,0,1,1.0,0.0,1505,1473
1953-03-12,Brazil,Ecuador,2,0,2,1.0,0.0,1746,1389
1953-03-12,Panama,Curaçao,2,4,2,0.0,1.0,1500,1602
1953-03-12,Paraguay,Uruguay,2,2,0,0.5,0.5,1619,1648
1953-03-13,Costa Rica,Honduras,4,1,3,1.0,0.0,1621,1469
1953-03-13,Guatemala,El Salvador,3,2,1,1.0,0.0,1514,1520
1953-03-14,Panama,Nicaragua,0,2,2,0.0,1.0,1490,1397
1953-03-15,Brazil,Uruguay,1,0,1,1.0,0.0,1752,1643
1953-03-15,Costa Rica,Curaçao,1,0,1,1.0,0.0,1629,1595
1953-03-15,El Salvador,Honduras,0,3,3,0.0,1.0,1511,1479
1953-03-16,Bolivia,Paraguay,1,2,1,0.0,1.0,1446,1624
1953-03-17,Costa Rica,Nicaragua,3,0,3,1.0,0.0,1633,1394
1953-03-17,Panama,Guatemala,2,2,0,0.5,0.5,1491,1514
1953-03-19,Chile,Ecuador,3,0,3,1.0,0.0,1560,1385
1953-03-19,Curaçao,Honduras,3,4,1,0.0,1.0,1585,1490
1953-03-19,El Salvador,Panama,2,1,1,1.0,0.0,1519,1484
1953-03-19,Guatemala,Nicaragua,1,0,1,1.0,0.0,1520,1389
1953-03-19,Peru,Brazil,1,0,1,1.0,0.0,1574,1740
1953-03-19,Spain,Belgium,3,1,2,1.0,0.0,1659,1569
1953-03-21,Costa Rica,Guatemala,3,0,3,1.0,0.0,1639,1515
1953-03-21,El Salvador,Curaçao,1,1,0,0.5,0.5,1521,1584
1953-03-21,Honduras,Panama,3,1,2,1.0,0.0,1498,1477
1953-03-22,Germany,Austria,0,0,0,0.5,0.5,1734,1694
1953-03-22,Netherlands,Switzerland,1,2,1,0.0,1.0,1508,1575
1953-03-23,Brazil,Chile,3,2,1,1.0,0.0,1745,1556
1953-03-23,Ecuador,Uruguay,0,6,6,0.0,1.0,1383,1646
1953-03-25,Republic of Ireland,Austria,4,0,4,1.0,0.0,1548,1683
1953-03-26,Jersey,Alderney,4,0,4,1.0,0.0,1586,1353
1953-03-27,Brazil,Paraguay,1,2,1,0.0,1.0,1735,1635
1953-03-28,Bolivia,Chile,2,2,0,0.5,0.5,1449,1554
1953-03-28,Peru,Uruguay,0,3,3,0.0,1.0,1568,1653
1953-04-01,Brazil,Paraguay,2,3,1,0.0,1.0,1725,1646
1953-04-05,Hong Kong,South Korea,4,0,4,1.0,0.0,1509,1505
1953-04-08,South Korea,Taiwan,2,4,2,0.0,1.0,1497,1502
1953-04-11,Singapore,South Korea,2,3,1,0.0,1.0,1492,1506
1953-04-15,Northern Ireland,Wales,2,3,1,0.0,1.0,1463,1600
1953-04-16,Malaysia,South Korea,2,3,1,0.0,1.0,1493,1514
1953-04-16,Martinique,Guadeloupe,4,3,1,1.0,0.0,1539,1502
1953-04-18,England,Scotland,2,2,0,0.5,0.5,1778,1715
1953-04-18,Singapore,South Korea,3,1,2,1.0,0.0,1501,1506
1953-04-19,Netherlands,Belgium,0,2,2,0.0,1.0,1502,1576
1953-04-19,Singapore,South Korea,1,3,2,0.0,1.0,1494,1514
1953-04-24,Singapore,South Korea,0,0,0,0.5,0.5,1495,1514
1953-04-26,Czechoslovakia,Italy,2,0,2,1.0,0.0,1616,1765
1953-04-26,Hungary,Austria,1,1,0,0.5,0.5,1766,1685
1953-04-26,Silesia,Poland,2,3,1,0.0,1.0,1504,1509
1953-04-30,Indonesia,South Korea,1,3,2,0.0,1.0,1464,1522
1953-04-30,Guernsey,Jersey,0,2,2,0.0,1.0,1634,1596
1953-05-06,Scotland,Sweden,1,2,1,0.0,1.0,1707,1697
1953-05-09,Yugoslavia,Greece,1,0,1,1.0,0.0,1683,1424
1953-05-10,Poland,Czechoslovakia,1,1,0,0.5,0.5,1512,1614
1953-05-14,Argentina,England,3,1,2,1.0,0.0,1824,1771
1953-05-14,Belgium,Yugoslavia,1,3,2,0.0,1.0,1571,1689
1953-05-14,France,Wales,6,1,5,1.0,0.0,1627,1593
1953-05-17,Argentina,England,0,0,0,0.5,0.5,1823,1773
1953-05-17,Guadeloupe,Martinique,0,2,2,0.0,1.0,1495,1547
1953-05-17,Italy,Hungary,0,3,3,0.0,1.0,1758,1774
1953-05-21,Yugoslavia,Wales,5,2,3,1.0,0.0,1695,1588
1953-05-24,Chile,England,1,2,1,0.0,1.0,1551,1777
1953-05-25,Finland,Belgium,2,4,2,0.0,1.0,1438,1577
1953-05-25,Switzerland,Turkey,1,2,1,0.0,1.0,1566,1537
1953-05-28,Sweden,Belgium,2,3,1,0.0,1.0,1687,1588
1953-05-31,Uruguay,England,2,1,1,1.0,0.0,1664,1767
1953-06-02,Gambia,Guinea-Bissau,1,3,2,0.0,1.0,1500,1509
1953-06-05,Turkey,Yugoslavia,2,2,0,0.5,0.5,1541,1692
1953-06-08,Guinea-Bissau,Gambia,1,0,1,1.0,0.0,1517,1493
1953-06-08,United States,England,3,6,3,0.0,1.0,1487,1770
1953-06-11,Sweden,France,1,0,1,1.0,0.0,1694,1621
1953-06-14,German DR,Bulgaria,0,0,0,0.5,0.5,1484,1479
1953-06-14,Czechoslovakia,Romania,2,0,2,1.0,0.0,1622,1573
1953-06-20,Singapore,Philippines,3,1,2,1.0,0.0,1503,1447
1953-06-21,Denmark,Sweden,1,3,2,0.0,1.0,1582,1700
1953-06-24,Norway,Saarland,2,3,1,0.0,1.0,1538,1510
1953-06-27,Switzerland,Denmark,1,4,3,0.0,1.0,1559,1590
1953-06-28,Romania,Bulgaria,3,1,2,1.0,0.0,1579,1474
1953-07-05,Argentina,Spain,1,0,1,1.0,0.0,1828,1655
1953-07-05,Sweden,Hungary,2,4,2,0.0,1.0,1694,1781
1953-07-12,Chile,Spain,1,2,1,0.0,1.0,1546,1661
1953-07-13,Mauritius,Réunion,9,4,5,1.0,0.0,1591,1435
1953-07-16,Madagascar,Réunion,6,4,2,1.0,0.0,1499,1429
1953-07-19,Mexico,Haiti,8,0,8,1.0,0.0,1583,1516
1953-07-20,Madagascar,Mauritius,2,3,1,0.0,1.0,1494,1597
1953-07-26,Peru,Chile,1,2,1,0.0,1.0,1560,1555
1953-07-28,Peru,Chile,5,0,5,1.0,0.0,1568,1548
1953-08-05,Finland,Sweden,3,3,0,0.5,0.5,1444,1689
1953-08-09,Denmark,Iceland,4,0,4,1.0,0.0,1596,1490
1953-08-09,Catalonia,Spain,0,6,6,0.0,1.0,1490,1666
1953-08-10,Jamaica,Trinidad and Tobago,3,2,1,1.0,0.0,1500,1614
1953-08-11,Jamaica,Trinidad and Tobago,0,1,1,0.0,1.0,1495,1620
1953-08-13,Norway,Iceland,3,1,2,1.0,0.0,1545,1484
1953-08-16,Sweden,Finland,4,0,4,1.0,0.0,1693,1441
1953-08-19,Norway,Germany,1,1,0,0.5,0.5,1549,1731
1953-08-29,Suriname,Aruba,3,3,0,0.5,0.5,1573,1498
1953-08-30,Finland,Norway,1,4,3,0.0,1.0,1436,1555
1953-09-03,Suriname,Aruba,3,3,0,0.5,0.5,1572,1500
1953-09-06,Bulgaria,Czechoslovakia,1,2,1,0.0,1.0,1470,1627
1953-09-11,Vanuatu,Tahiti,2,4,2,0.0,1.0,1484,1500
1953-09-13,Bulgaria,Poland,2,2,0,0.5,0.5,1471,1512
1953-09-13,Norway,Denmark,0,1,1,0.0,1.0,1548,1604
1953-09-13,Silesia,Poland,3,3,0,0.5,0.5,1505,1512
1953-09-14,Vanuatu,Tahiti,2,4,2,0.0,1.0,1477,1508
1953-09-19,Uganda,Burundi,9,1,8,1.0,0.0,1576,1494
1953-09-20,Czechoslovakia,Switzerland,5,0,5,1.0,0.0,1634,1553
1953-09-20,Luxembourg,France,1,6,5,0.0,1.0,1443,1626
1953-09-20,New Caledonia,Tahiti,5,0,5,1.0,0.0,1505,1500
1953-09-23,Belgium,Finland,2,2,0,0.5,0.5,1585,1440
1953-09-23,New Caledonia,Tahiti,4,1,3,1.0,0.0,1513,1493
1953-09-26,New Caledonia,Tahiti,4,1,3,1.0,0.0,1521,1486
1953-09-26,Kernow,Trinidad and Tobago,3,6,3,0.0,1.0,1495,1626
1953-09-27,Austria,Portugal,9,1,8,1.0,0.0,1690,1515
1953-09-27,Norway,Netherlands,4,0,4,1.0,0.0,1555,1496
1953-09-29,Zanzibar,Uganda,1,5,4,0.0,1.0,1461,1582
1953-09-30,Kenya,Tanzania,7,1,6,1.0,0.0,1505,1500
1953-09-30,Kernow,Trinidad and Tobago,2,4,2,0.0,1.0,1490,1632
1953-10-03,Kenya,Uganda,6,2,4,1.0,0.0,1515,1573
1953-10-03,Northern Ireland,Scotland,1,3,2,0.0,1.0,1460,1711
1953-10-03,Kernow,Trinidad and Tobago,1,1,0,0.5,0.5,1494,1629
1953-10-04,Bulgaria,Hungary,1,1,0,0.5,0.5,1477,1776
1953-10-04,Czechoslovakia,Hungary,1,5,4,0.0,1.0,1630,1781
1953-10-04,Denmark,Finland,6,1,5,1.0,0.0,1609,1436
1953-10-04,Republic of Ireland,France,3,5,2,0.0,1.0,1542,1633
1953-10-08,Belgium,Sweden,2,0,2,1.0,0.0,1596,1683
1953-10-10,Wales,England,1,4,3,0.0,1.0,1584,1775
1953-10-11,Austria,Hungary,2,3,1,0.0,1.0,1685,1787
1953-10-11,Bulgaria,Romania,1,2,1,0.0,1.0,1472,1585
1953-10-11,Germany,Saarland,3,0,3,1.0,0.0,1735,1507
1953-10-11,Ghana,Nigeria,1,0,1,1.0,0.0,1510,1501
1953-10-14,Zambia,Zimbabwe,1,0,1,1.0,0.0,1524,1487
1953-10-18,Sweden,Norway,0,0,0,0.5,0.5,1681,1558
1953-10-18,Yugoslavia,France,3,1,2,1.0,0.0,1699,1627
1953-10-24,Myanmar,Sri Lanka,3,2,1,1.0,0.0,1494,1478
1953-10-25,Netherlands,Belgium,1,0,1,1.0,0.0,1507,1586
1953-10-25,Romania,Czechoslovakia,0,1,1,0.0,1.0,1579,1637
1953-10-27,Sri Lanka,India,0,2,2,0.0,1.0,1472,1541
1953-10-28,Myanmar,Pakistan,1,1,0,0.5,0.5,1495,1517
1953-10-28,Republic of Ireland,Luxembourg,4,0,4,1.0,0.0,1548,1438
1953-10-31,Myanmar,India,2,4,2,0.0,1.0,1489,1548
1953-11-01,Greece,Israel,1,0,1,1.0,0.0,1434,1463
1953-11-04,Scotland,Wales,3,3,0,0.5,0.5,1709,1587
1953-11-08,Czechoslovakia,Bulgaria,0,0,0,0.5,0.5,1634,1476
1953-11-08,Saarland,Norway,0,0,0,0.5,0.5,1509,1557
1953-11-08,Spain,Sweden,2,2,0,0.5,0.5,1667,1681
1953-11-08,Yugoslavia,Israel,1,0,1,1.0,0.0,1703,1460
1953-11-11,England,Northern Ireland,3,1,2,1.0,0.0,1778,1458
1953-11-11,France,Switzerland,2,4,2,0.0,1.0,1618,1563
1953-11-13,Egypt,Italy,1,2,1,0.0,1.0,1520,1762
1953-11-14,Haiti,Jamaica,4,1,3,1.0,0.0,1524,1488
1953-11-15,Hungary,Sweden,2,2,0,0.5,0.5,1785,1684
1953-11-21,Haiti,Jamaica,1,0,1,1.0,0.0,1532,1481
1953-11-22,Germany,Norway,5,1,4,1.0,0.0,1740,1553
1953-11-22,Portugal,South Africa,3,1,2,1.0,0.0,1524,1545
1953-11-22,Switzerland,Belgium,2,2,0,0.5,0.5,1564,1586
1953-11-25,England,Hungary,3,6,3,0.0,1.0,1771,1793
1953-11-25,France,Republic of Ireland,1,0,1,1.0,0.0,1625,1542
1953-11-29,Albania,Poland,2,0,2,1.0,0.0,1516,1504
1953-11-29,Portugal,Austria,0,0,0,0.5,0.5,1528,1682
1953-12-13,Italy,Czechoslovakia,3,0,3,1.0,0.0,1768,1629
1953-12-17,France,Luxembourg,8,0,8,1.0,0.0,1630,1434
1953-12-27,Haiti,Mexico,0,4,4,0.0,1.0,1526,1590
1954-01-06,Spain,Turkey,4,1,3,1.0,0.0,1673,1536
1954-01-10,Mexico,United States,4,0,4,1.0,0.0,1596,1482
1954-01-14,Mexico,United States,3,1,2,1.0,0.0,1602,1477
1954-01-24,Italy,Egypt,5,1,4,1.0,0.0,1772,1517
1954-02-12,Egypt,Hungary,0,3,3,0.0,1.0,1515,1796
1954-02-14,Paraguay,Chile,4,0,4,1.0,0.0,1652,1543
1954-02-21,Chile,Paraguay,1,3,2,0.0,1.0,1538,1658
1954-02-28,Chile,Brazil,0,2,2,0.0,1.0,1534,1730
1954-03-07,Japan,South Korea,1,5,4,0.0,1.0,1514,1530
1954-03-07,Luxembourg,Republic of Ireland,0,1,1,0.0,1.0,1429,1548
1954-03-07,Paraguay,Brazil,0,1,1,0.0,1.0,1652,1737
1954-03-08,Israel,Greece,0,2,2,0.0,1.0,1452,1443
1954-03-14,Belgium,Portugal,0,0,0,0.5,0.5,1585,1530
1954-03-14,Brazil,Chile,1,0,1,1.0,0.0,1741,1531
1954-03-14,Japan,South Korea,2,2,0,0.5,0.5,1515,1530
1954-03-14,Turkey,Spain,1,0,1,1.0,0.0,1548,1662
1954-03-17,Turkey,Spain,2,2,0,0.5,0.5,1551,1660
1954-03-19,Martinique,Guadeloupe,2,2,0,0.5,0.5,1546,1497
1954-03-21,Israel,Yugoslavia,0,1,1,0.0,1.0,1449,1707
1954-03-21,Brazil,Paraguay,4,1,3,1.0,0.0,1747,1647
1954-03-28,Greece,Yugoslavia,0,1,1,0.0,1.0,1441,1710
1954-03-28,Saarland,Germany,1,3,2,0.0,1.0,1506,1744
1954-03-31,Wales,Northern Ireland,1,2,1,0.0,1.0,1577,1469
1954-04-01,Guernsey,Alderney,2,1,1,1.0,0.0,1637,1351
1954-04-03,Haiti,United States,2,3,1,0.0,1.0,1517,1487
1954-04-03,Scotland,England,2,4,2,0.0,1.0,1703,1778
1954-04-04,Belgium,Netherlands,4,0,4,1.0,0.0,1592,1501
1954-04-04,Haiti,United States,0,3,3,0.0,1.0,1509,1496
1954-04-10,Uruguay,Paraguay,1,4,3,0.0,1.0,1656,1656
1954-04-11,Austria,Hungary,0,1,1,0.0,1.0,1677,1802
1954-04-11,France,Italy,1,3,2,0.0,1.0,1626,1777
1954-04-18,Paraguay,Uruguay,1,1,0,0.5,0.5,1656,1656
1954-04-25,Singapore,Pakistan,2,2,0,0.5,0.5,1504,1517
1954-04-25,Switzerland,Germany,3,5,2,0.0,1.0,1560,1749
1954-05-01,Ethiopia,Djibouti,10,2,8,1.0,0.0,1531,1472
1954-05-01,South Africa,Israel,2,1,1,1.0,0.0,1551,1444
1954-05-01,Taiwan,Vietnam,3,2,1,1.0,0.0,1510,1493
1954-05-01,Japan,Indonesia,3,5,2,0.0,1.0,1506,1474
1954-05-02,Singapore,Pakistan,2,6,4,0.0,1.0,1497,1525
1954-05-02,South Korea,Hong Kong,3,3,0,0.5,0.5,1530,1510
1954-05-03,Zambia,Israel,0,0,0,0.5,0.5,1523,1446
1954-05-03,Philippines,Vietnam,2,3,1,0.0,1.0,1441,1500
1954-05-03,India,Japan,3,2,1,1.0,0.0,1556,1499
1954-05-04,Burma,Singapore,1,1,0,0.5,0.5,1494,1497
1954-05-04,South Korea,Afghanistan,8,2,6,1.0,0.0,1537,1465
1954-05-05,Scotland,Norway,1,0,1,1.0,0.0,1708,1549
1954-05-05,Zimbabwe,Israel,2,1,1,1.0,0.0,1495,1439
1954-05-05,Burma,Pakistan,2,1,1,1.0,0.0,1503,1517
1954-05-05,India,Indonesia,0,4,4,0.0,1.0,1547,1484
1954-05-06,Jersey,Guernsey,3,5,2,0.0,1.0,1589,1645
1954-05-06,Philippines,Taiwan,0,4,4,0.0,1.0,1435,1517
1954-05-06,Hong Kong,Afghanistan,4,2,2,1.0,0.0,1517,1459
1954-05-07,Taiwan,Indonesia,4,2,2,1.0,0.0,1525,1477
1954-05-07,Burma,South Korea,2,2,0,0.5,0.5,1504,1537
1954-05-08,German DR,Romania,0,1,1,0.0,1.0,1479,1585
1954-05-08,Indonesia,Burma,4,5,1,0.0,1.0,1470,1512
1954-05-08,Taiwan,South Korea,5,2,3,1.0,0.0,1534,1529
1954-05-09,Austria,Wales,2,0,2,1.0,0.0,1683,1572
1954-05-09,Yugoslavia,Belgium,0,2,2,0.0,1.0,1700,1603
1954-05-09,Zimbabwe,Israel,1,2,1,0.0,1.0,1486,1449
1954-05-16,Yugoslavia,England,1,0,1,1.0,0.0,1710,1769
1954-05-19,Norway,Scotland,1,1,0,0.5,0.5,1553,1705
1954-05-19,Sweden,Netherlands,6,1,5,1.0,0.0,1689,1497
1954-05-21,Guadeloupe,Martinique,2,4,2,0.0,1.0,1491,1553
1954-05-23,Hungary,England,7,1,6,1.0,0.0,1810,1762
1954-05-23,Switzerland,Uruguay,3,3,0,0.5,0.5,1563,1654
1954-05-24,Zimbabwe,Zambia,1,0,1,1.0,0.0,1495,1515
1954-05-25,Finland,Scotland,1,2,1,0.0,1.0,1434,1708
1954-05-30,Austria,Norway,5,0,5,1.0,0.0,1689,1548
1954-05-30,Belgium,France,3,3,0,0.5,0.5,1604,1626
1954-05-30,Switzerland,Netherlands,3,1,2,1.0,0.0,1570,1491
1954-06-01,Djibouti,Ethiopia,0,2,2,0.0,1.0,1466,1538
1954-06-01,Ghana,Sierra Leone,2,0,2,1.0,0.0,1518,1478
1954-06-02,Djibouti,Ethiopia,1,2,1,0.0,1.0,1460,1545
1954-06-02,Hong Kong,Taiwan,2,2,0,0.5,0.5,1518,1534
1954-06-04,Denmark,Norway,1,2,1,0.0,1.0,1600,1558
1954-06-04,Sweden,Finland,6,0,6,1.0,0.0,1692,1432
1954-06-05,Saarland,Uruguay,1,7,6,0.0,1.0,1502,1659
1954-06-07,Sweden,Norway,3,0,3,1.0,0.0,1698,1553
1954-06-13,Finland,Denmark,2,2,0,0.5,0.5,1436,1597
1954-06-16,Austria,Scotland,1,0,1,1.0,0.0,1698,1700
1954-06-16,Brazil,Mexico,5,0,5,1.0,0.0,1752,1598
1954-06-16,Czechoslovakia,Uruguay,0,2,2,0.0,1.0,1622,1667
1954-06-16,France,Yugoslavia,0,1,1,0.0,1.0,1620,1717
1954-06-17,Belgium,England,4,4,0,0.5,0.5,1608,1759
1954-06-17,Germany,Turkey,4,1,3,1.0,0.0,1753,1548
1954-06-17,Hungary,South Korea,9,0,9,1.0,0.0,1813,1527
1954-06-17,Switzerland,Italy,2,1,1,1.0,0.0,1583,1765
1954-06-19,Austria,Czechoslovakia,5,0,5,1.0,0.0,1705,1616
1954-06-19,Brazil,Yugoslavia,1,1,0,0.5,0.5,1752,1718
1954-06-19,France,Mexico,3,2,1,1.0,0.0,1628,1591
1954-06-19,Scotland,Uruguay,0,7,7,0.0,1.0,1692,1676
1954-06-20,Belgium,Italy,1,4,3,0.0,1.0,1604,1770
1954-06-20,Germany,Hungary,3,8,5,0.0,1.0,1747,1820
1954-06-20,South Korea,Turkey,0,7,7,0.0,1.0,1520,1556
1954-06-20,Switzerland,England,0,2,2,0.0,1.0,1579,1764
1954-06-23,Germany,Turkey,7,2,5,1.0,0.0,1751,1553
1954-06-23,Switzerland,Italy,4,1,3,1.0,0.0,1592,1758
1954-06-26,England,Uruguay,2,4,2,0.0,1.0,1755,1686
1954-06-26,Switzerland,Austria,5,7,2,0.0,1.0,1587,1711
1954-06-27,Brazil,Hungary,2,4,2,0.0,1.0,1746,1827
1954-06-27,Germany,Yugoslavia,2,0,2,1.0,0.0,1759,1711
1954-06-30,Austria,Germany,1,6,5,0.0,1.0,1705,1766
1954-06-30,Hungary,Uruguay,4,2,2,1.0,0.0,1832,1682
1954-07-03,Austria,Uruguay,3,1,2,1.0,0.0,1713,1675
1954-07-04,Germany,Hungary,3,2,1,1.0,0.0,1776,1823
1954-07-04,Iceland,Norway,1,0,1,1.0,0.0,1494,1544
1954-07-11,Madagascar,Réunion,2,6,4,0.0,1.0,1485,1439
1954-07-14,Mauritius,Madagascar,4,1,3,1.0,0.0,1603,1480
1954-07-18,Mauritius,Réunion,11,0,11,1.0,0.0,1608,1435
1954-07-25,Curaçao,Netherlands,2,0,2,1.0,0.0,1590,1486
1954-07-27,Aruba,Netherlands,2,2,0,0.5,0.5,1500,1487
1954-07-29,Curaçao,Netherlands,2,1,1,1.0,0.0,1596,1482
1954-08-01,Suriname,Netherlands,3,4,1,0.0,1.0,1562,1493
1954-08-05,Suriname,Netherlands,0,2,2,0.0,1.0,1553,1503
1954-08-08,Poland,Bulgaria,2,2,0,0.5,0.5,1504,1477
1954-08-14,Australia,New Zealand,1,2,1,0.0,1.0,1568,1503
1954-08-15,Finland,Sweden,1,10,9,0.0,1.0,1434,1701
1954-08-18,Zimbabwe,Zambia,2,4,2,0.0,1.0,1488,1523
1954-08-24,Sweden,Iceland,3,2,1,1.0,0.0,1705,1491
1954-08-28,Australia,New Zealand,4,1,3,1.0,0.0,1575,1497
1954-08-29,Norway,Finland,3,1,2,1.0,0.0,1550,1429
1954-09-04,Australia,New Zealand,4,1,3,1.0,0.0,1582,1491
1954-09-08,Russia,Sweden,7,0,7,1.0,0.0,1534,1694
1954-09-17,Chile,Peru,2,1,1,1.0,0.0,1540,1560
1954-09-19,Chile,Peru,2,4,2,0.0,1.0,1533,1568
1954-09-19,Denmark,Switzerland,1,1,0,0.5,0.5,1597,1588
1954-09-19,Hungary,Romania,5,1,4,1.0,0.0,1827,1582
1954-09-19,Norway,Sweden,1,1,0,0.5,0.5,1554,1691
1954-09-22,Wales,Yugoslavia,1,3,2,0.0,1.0,1568,1716
1954-09-26,Belgium,Germany,2,0,2,1.0,0.0,1616,1765
1954-09-26,German DR,Poland,0,1,1,0.0,1.0,1472,1512
1954-09-26,Russia,Hungary,1,1,0,0.5,0.5,1540,1822
1954-09-26,Saarland,Yugoslavia,1,5,4,0.0,1.0,1499,1720
1954-10-02,Northern Ireland,England,0,2,2,0.0,1.0,1467,1758
1954-10-03,Austria,Yugoslavia,2,2,0,0.5,0.5,1714,1720
1954-10-05,Kenya,Zanzibar,5,0,5,1.0,0.0,1522,1455
1954-10-06,Tanzania,Uganda,3,5,2,0.0,1.0,1494,1580
1954-10-09,Kenya,Uganda,2,2,0,0.5,0.5,1524,1579
1954-10-10,Hungary,Switzerland,3,0,3,1.0,0.0,1826,1585
1954-10-10,Kenya,Uganda,1,4,3,0.0,1.0,1518,1586
1954-10-10,Sweden,Denmark,5,2,3,1.0,0.0,1697,1592
1954-10-16,Germany,France,1,3,2,0.0,1.0,1754,1640
1954-10-16,Wales,Scotland,0,1,1,0.0,1.0,1563,1698
1954-10-17,Yugoslavia,Turkey,5,1,4,1.0,0.0,1725,1549
1954-10-24,Belgium,Netherlands,4,3,1,1.0,0.0,1622,1498
1954-10-24,Bulgaria,German DR,3,1,2,1.0,0.0,1485,1465
1954-10-24,Hungary,Czechoslovakia,4,1,3,1.0,0.0,1830,1613
1954-10-30,Nigeria,Ghana,3,0,3,1.0,0.0,1510,1510
1954-10-31,Denmark,Norway,0,1,1,0.0,1.0,1584,1563
1954-10-31,Sweden,Austria,2,1,1,1.0,0.0,1706,1706
1954-11-01,Cambodia,Thailand,7,1,6,1.0,0.0,1508,1492
1954-11-03,Scotland,Northern Ireland,2,2,0,0.5,0.5,1694,1472
1954-11-07,Greece,Egypt,1,1,0,0.5,0.5,1443,1514
1954-11-07,Republic of Ireland,Norway,2,1,1,1.0,0.0,1557,1555
1954-11-10,England,Wales,3,2,1,1.0,0.0,1762,1560
1954-11-11,France,Belgium,2,2,0,0.5,0.5,1640,1623
1954-11-14,Hungary,Austria,4,1,3,1.0,0.0,1836,1701
1954-11-28,Portugal,Argentina,1,3,2,0.0,1.0,1528,1831
1954-12-01,England,Germany,3,1,2,1.0,0.0,1770,1747
1954-12-05,Italy,Argentina,2,0,2,1.0,0.0,1768,1822
1954-12-08,Scotland,Hungary,2,4,2,0.0,1.0,1690,1841
1954-12-18,Sri Lanka,Pakistan,1,2,1,0.0,1.0,1466,1524
1954-12-19,India,Myanmar,2,1,1,1.0,0.0,1554,1483
1954-12-19,Portugal,Germany,0,3,3,0.0,1.0,1525,1751
1954-12-21,India,Sri Lanka,1,1,0,0.5,0.5,1553,1468
1954-12-23,Myanmar,Pakistan,1,1,0,0.5,0.5,1484,1524
1954-12-25,Myanmar,Sri Lanka,1,2,1,0.0,1.0,1476,1477
1955-01-07,Egypt,Bulgaria,1,0,1,1.0,0.0,1522,1478
1955-01-11,Myanmar,Japan,0,1,1,0.0,1.0,1469,1507
1955-01-16,Italy,Belgium,1,0,1,1.0,0.0,1773,1619
1955-01-23,Lebanon,Bulgaria,2,3,1,0.0,1.0,1484,1487
1955-02-27,Chile,Ecuador,7,1,6,1.0,0.0,1538,1379
1955-03-01,Martinique,Guadeloupe,4,1,3,1.0,0.0,1560,1485
1955-03-02,Argentina,Paraguay,5,3,2,1.0,0.0,1827,1652
1955-03-06,Chile,Peru,5,4,1,1.0,0.0,1547,1560
1955-03-09,Argentina,Ecuador,4,0,4,1.0,0.0,1829,1378
1955-03-09,Paraguay,Uruguay,1,3,2,0.0,1.0,1645,1683
1955-03-13,Chile,Uruguay,2,2,0,0.5,0.5,1550,1681
1955-03-13,Ecuador,Peru,2,4,2,0.0,1.0,1374,1565
1955-03-13,Netherlands,Denmark,1,1,0,0.5,0.5,1500,1583
1955-03-16,Argentina,Peru,2,2,0,0.5,0.5,1824,1571
1955-03-16,Ecuador,Paraguay,0,2,2,0.0,1.0,1372,1648
1955-03-17,Spain,France,1,2,1,0.0,1.0,1652,1649
1955-03-20,Chile,Paraguay,5,0,5,1.0,0.0,1561,1638
1955-03-23,Ecuador,Uruguay,1,5,4,0.0,1.0,1370,1684
1955-03-23,Paraguay,Peru,1,1,0,0.5,0.5,1637,1573
1955-03-27,Argentina,Uruguay,6,1,5,1.0,0.0,1829,1680
1955-03-27,Czechoslovakia,Austria,3,2,1,1.0,0.0,1623,1692
1955-03-30,Chile,Argentina,0,1,1,0.0,1.0,1559,1832
1955-03-30,Germany,Italy,1,2,1,0.0,1.0,1744,1781
1955-03-30,Peru,Uruguay,2,1,1,1.0,0.0,1584,1670
1955-03-31,Jersey,Alderney,3,0,3,1.0,0.0,1593,1348
1955-04-02,England,Scotland,7,2,5,1.0,0.0,1777,1684
1955-04-03,France,Sweden,2,0,2,1.0,0.0,1659,1697
1955-04-03,Netherlands,Belgium,1,0,1,1.0,0.0,1511,1609
1955-04-20,Northern Ireland,Wales,2,3,1,0.0,1.0,1466,1567
1955-04-24,Austria,Hungary,2,2,0,0.5,0.5,1696,1838
1955-05-01,Republic of Ireland,Netherlands,1,0,1,1.0,0.0,1564,1505
1955-05-01,Switzerland,Austria,2,3,1,0.0,1.0,1580,1702
1955-05-04,Scotland,Portugal,3,0,3,1.0,0.0,1689,1521
1955-05-05,Martinique,Guadeloupe,1,1,0,0.5,0.5,1559,1487
1955-05-05,Guernsey,Jersey,0,0,0,0.5,0.5,1644,1595
1955-05-08,Norway,Hungary,0,5,5,0.0,1.0,1553,1841
1955-05-11,Sweden,Hungary,3,7,4,0.0,1.0,1693,1846
1955-05-15,Denmark,Hungary,0,6,6,0.0,1.0,1581,1849
1955-05-15,France,England,1,0,1,1.0,0.0,1670,1767
1955-05-15,Yugoslavia,Scotland,2,2,0,0.5,0.5,1725,1690
1955-05-18,Spain,England,1,1,0,0.5,0.5,1655,1765
1955-05-19,Austria,Scotland,1,4,3,0.0,1.0,1694,1699
1955-05-19,Finland,Hungary,1,9,8,0.0,1.0,1428,1851
1955-05-19,Netherlands,Switzerland,4,1,3,1.0,0.0,1515,1571
1955-05-22,Bulgaria,Egypt,2,1,1,1.0,0.0,1496,1514
1955-05-22,Portugal,England,3,1,2,1.0,0.0,1534,1753
1955-05-25,Norway,Republic of Ireland,1,3,2,0.0,1.0,1546,1572
1955-05-28,Germany,Republic of Ireland,2,1,1,1.0,0.0,1749,1568
1955-05-28,Ghana,Nigeria,1,0,1,1.0,0.0,1518,1502
1955-05-29,Hungary,Scotland,3,1,2,1.0,0.0,1856,1695
1955-05-29,Italy,Yugoslavia,0,4,4,0.0,1.0,1772,1735
1955-05-29,Romania,Poland,2,2,0,0.5,0.5,1581,1514
1955-05-30,Jersey,Guernsey,1,0,1,1.0,0.0,1605,1635
1955-06-05,Belgium,Czechoslovakia,1,3,2,0.0,1.0,1602,1631
1955-06-12,Norway,Romania,0,1,1,0.0,1.0,1539,1589
1955-06-15,Sweden,Romania,4,1,3,1.0,0.0,1699,1584
1955-06-18,El Salvador,Honduras,2,2,0,0.5,0.5,1521,1499
1955-06-19,Denmark,Finland,2,1,1,1.0,0.0,1586,1424
1955-06-19,El Salvador,Honduras,0,0,0,0.5,0.5,1521,1500
1955-06-19,Switzerland,Spain,0,3,3,0.0,1.0,1565,1662
1955-06-26,Bulgaria,Poland,1,1,0,0.5,0.5,1497,1514
1955-06-26,Sweden,Russia,0,6,6,0.0,1.0,1688,1552
1955-06-26,Yugoslavia,Switzerland,0,0,0,0.5,0.5,1732,1569
1955-07-03,Iceland,Denmark,0,4,4,0.0,1.0,1486,1592
1955-07-07,Réunion,Mauritius,1,3,2,0.0,1.0,1431,1613
1955-07-10,Réunion,Madagascar,2,4,2,0.0,1.0,1425,1487
1955-07-12,Tahiti,New Caledonia,1,1,0,0.5,0.5,1487,1521
1955-07-14,Madagascar,Mauritius,2,1,1,1.0,0.0,1498,1603
1955-07-24,Costa Rica,Guatemala,9,1,8,1.0,0.0,1645,1510
1955-07-31,Guatemala,Costa Rica,3,1,2,1.0,0.0,1521,1635
1955-08-14,Costa Rica,Aruba,3,2,1,1.0,0.0,1641,1495
1955-08-14,Finland,Norway,1,3,2,0.0,1.0,1419,1545
1955-08-14,Honduras,Cuba,3,0,3,1.0,0.0,1508,1489
1955-08-15,Guatemala,El Salvador,2,3,1,0.0,1.0,1513,1529
1955-08-16,Costa Rica,Cuba,6,0,6,1.0,0.0,1646,1485
1955-08-16,Curaçao,Aruba,2,1,1,1.0,0.0,1602,1490
1955-08-17,Honduras,El Salvador,3,1,2,1.0,0.0,1517,1521
1955-08-18,Guatemala,Curaçao,4,1,3,1.0,0.0,1524,1592
1955-08-19,Aruba,Cuba,4,1,3,1.0,0.0,1498,1478
1955-08-19,Costa Rica,El Salvador,4,0,4,1.0,0.0,1652,1516
1955-08-20,El Salvador,Cuba,2,1,1,1.0,0.0,1524,1471
1955-08-20,Honduras,Curaçao,0,2,2,0.0,1.0,1511,1599
1955-08-21,Guatemala,Costa Rica,0,2,2,0.0,1.0,1519,1658
1955-08-21,Russia,Germany,3,2,1,1.0,0.0,1565,1737
1955-08-22,Honduras,Aruba,1,1,0,0.5,0.5,1511,1499
1955-08-24,Costa Rica,Curaçao,2,1,1,1.0,0.0,1665,1593
1955-08-24,El Salvador,Aruba,2,0,2,1.0,0.0,1532,1492
1955-08-25,Iceland,United States,3,2,1,1.0,0.0,1495,1488
1955-08-26,Curaçao,El Salvador,3,0,3,1.0,0.0,1600,1526
1955-08-28,Curaçao,Cuba,2,0,2,1.0,0.0,1606,1466
1955-08-28,Honduras,Costa Rica,1,2,1,0.0,1.0,1507,1670
1955-08-28,Sweden,Finland,3,0,3,1.0,0.0,1691,1417
1955-09-03,Australia,South Africa,0,3,3,0.0,1.0,1574,1560
1955-09-10,Australia,South Africa,0,2,2,0.0,1.0,1566,1569
1955-09-11,Finland,Poland,1,3,2,0.0,1.0,1412,1520
1955-09-11,Norway,Denmark,1,1,0,0.5,0.5,1547,1591
1955-09-16,Russia,India,11,1,10,1.0,0.0,1573,1546
1955-09-17,Australia,South Africa,0,8,8,0.0,1.0,1559,1577
1955-09-17,Switzerland,Hungary,4,5,1,0.0,1.0,1567,1859
1955-09-18,Brazil,Chile,1,1,0,0.5,0.5,1743,1563
1955-09-18,Romania,German DR,2,3,1,0.0,1.0,1574,1476
1955-09-20,Brazil,Chile,2,1,1,1.0,0.0,1748,1559
1955-09-24,Australia,South Africa,0,6,6,0.0,1.0,1552,1585
1955-09-25,Czechoslovakia,Belgium,5,2,3,1.0,0.0,1639,1595
1955-09-25,Hungary,Russia,1,1,0,0.5,0.5,1854,1579
1955-09-25,Sweden,Norway,1,1,0,0.5,0.5,1688,1551
1955-09-25,Yugoslavia,Germany,3,1,2,1.0,0.0,1741,1729
1955-09-28,Romania,Belgium,1,0,1,1.0,0.0,1583,1587
1955-10-01,Australia,South Africa,1,4,3,0.0,1.0,1545,1593
1955-10-02,Czechoslovakia,Hungary,1,3,2,0.0,1.0,1636,1858
1955-10-02,Denmark,England,1,5,4,0.0,1.0,1587,1758
1955-10-08,Northern Ireland,Scotland,2,1,1,1.0,0.0,1479,1683
1955-10-09,Japan,Myanmar,0,0,0,0.5,0.5,1507,1470
1955-10-09,Romania,Bulgaria,1,1,0,0.5,0.5,1582,1499
1955-10-09,Switzerland,France,1,2,1,0.0,1.0,1562,1676
1955-10-11,Kenya,Uganda,0,1,1,0.0,1.0,1512,1593
1955-10-13,Kenya,Zanzibar,8,0,8,1.0,0.0,1519,1449
1955-10-15,Tanzania,Uganda,1,5,4,0.0,1.0,1489,1599
1955-10-16,Denmark,Sweden,3,3,0,0.5,0.5,1590,1686
1955-10-16,Hungary,Austria,6,1,5,1.0,0.0,1863,1690
1955-10-16,Netherlands,Belgium,2,2,0,0.5,0.5,1517,1586
1955-10-19,Republic of Ireland,Yugoslavia,1,4,3,0.0,1.0,1564,1746
1955-10-22,Wales,England,2,1,1,1.0,0.0,1580,1746
1955-10-23,Russia,France,2,2,0,0.5,0.5,1582,1674
1955-10-30,Austria,Yugoslavia,2,1,1,1.0,0.0,1700,1737
1955-10-30,Ghana,Nigeria,7,0,7,1.0,0.0,1526,1495
1955-11-02,England,Northern Ireland,3,0,3,1.0,0.0,1749,1477
1955-11-06,Netherlands,Norway,3,0,3,1.0,0.0,1526,1543
1955-11-09,Scotland,Wales,2,0,2,1.0,0.0,1689,1575
1955-11-11,France,Yugoslavia,1,1,0,0.5,0.5,1676,1736
1955-11-13,Brazil,Paraguay,3,0,3,1.0,0.0,1754,1632
1955-11-13,Bulgaria,Czechoslovakia,3,0,3,1.0,0.0,1511,1625
1955-11-13,Hungary,Sweden,4,2,2,1.0,0.0,1868,1682
1955-11-16,Germany,Norway,2,0,2,1.0,0.0,1734,1539
1955-11-16,Saarland,Netherlands,1,2,1,0.0,1.0,1492,1534
1955-11-17,Brazil,Paraguay,3,3,0,0.5,0.5,1752,1635
1955-11-20,German DR,Bulgaria,1,0,1,1.0,0.0,1485,1503
1955-11-20,Portugal,Sweden,2,6,4,0.0,1.0,1530,1687
1955-11-23,Wales,Austria,1,2,1,0.0,1.0,1570,1706
1955-11-27,Hungary,Italy,2,0,2,1.0,0.0,1874,1767
1955-11-27,Republic of Ireland,Spain,2,2,0,0.5,0.5,1567,1660
1955-11-30,England,Spain,4,1,3,1.0,0.0,1755,1655
1955-12-14,Suriname,Trinidad and Tobago,5,2,3,1.0,0.0,1563,1620
1955-12-16,Suriname,Trinidad and Tobago,3,1,2,1.0,0.0,1573,1611
1955-12-17,Pakistan,Myanmar,4,2,2,1.0,0.0,1531,1464
1955-12-18,Italy,Germany,2,1,1,1.0,0.0,1775,1727
1955-12-18,Sri Lanka,India,3,4,1,0.0,1.0,1471,1553
1955-12-18,Suriname,Trinidad and Tobago,3,0,3,1.0,0.0,1582,1603
1955-12-18,Turkey,Portugal,3,1,2,1.0,0.0,1557,1523
1955-12-22,Myanmar,India,1,2,1,0.0,1.0,1459,1559
1955-12-23,Egypt,Portugal,0,4,4,0.0,1.0,1507,1531
1955-12-25,Belgium,France,2,1,1,1.0,0.0,1597,1666
1955-12-25,Myanmar,Sri Lanka,3,1,2,1.0,0.0,1468,1463
1956-01-13,Curaçao,Martinique,3,1,2,1.0,0.0,1613,1553
1956-01-15,Curaçao,Martinique,3,1,2,1.0,0.0,1620,1547
1956-01-21,Uruguay,Paraguay,4,2,2,1.0,0.0,1678,1628
1956-01-22,Argentina,Peru,2,1,1,1.0,0.0,1836,1581
1956-01-24,Brazil,Chile,1,4,3,0.0,1.0,1740,1572
1956-01-28,Uruguay,Peru,2,0,2,1.0,0.0,1684,1576
1956-01-29,Argentina,Chile,2,0,2,1.0,0.0,1839,1570
1956-01-29,Brazil,Paraguay,0,0,0,0.5,0.5,1738,1631
1956-02-01,Argentina,Paraguay,1,0,1,1.0,0.0,1843,1628
1956-02-01,Brazil,Peru,2,1,1,1.0,0.0,1743,1572
1956-02-05,Argentina,Brazil,0,1,1,0.0,1.0,1833,1754
1956-02-05,Paraguay,Peru,1,1,0,0.5,0.5,1627,1574
1956-02-06,Uruguay,Chile,2,1,1,1.0,0.0,1690,1565
1956-02-09,Chile,Peru,4,3,1,1.0,0.0,1574,1566
1956-02-10,Uruguay,Brazil,0,0,0,0.5,0.5,1692,1753
1956-02-12,Chile,Paraguay,2,0,2,1.0,0.0,1584,1618
1956-02-15,Italy,France,2,0,2,1.0,0.0,1781,1661
1956-02-15,Uruguay,Argentina,1,0,1,1.0,0.0,1704,1822
1956-02-19,Turkey,Hungary,3,1,2,1.0,0.0,1571,1861
1956-02-25,Philippines,South Korea,0,2,2,0.0,1.0,1429,1527
1956-02-26,Mexico,Costa Rica,1,1,0,0.5,0.5,1593,1669
1956-02-28,Argentina,Peru,0,0,0,0.5,0.5,1817,1572
1956-02-29,Lebanon,Hungary,1,4,3,0.0,1.0,1483,1863
1956-03-01,Brazil,Chile,2,1,1,1.0,0.0,1758,1580
1956-03-04,Mexico,Peru,0,2,2,0.0,1.0,1585,1581
1956-03-06,Argentina,Costa Rica,4,3,1,1.0,0.0,1822,1665
1956-03-06,Brazil,Peru,1,0,1,1.0,0.0,1763,1577
1956-03-08,Chile,Costa Rica,1,2,1,0.0,1.0,1574,1672
1956-03-08,Haiti,Panama,3,2,1,1.0,0.0,1517,1470
1956-03-08,Mexico,Brazil,1,2,1,0.0,1.0,1581,1768
1956-03-09,Panama,Venezuela,0,1,1,0.0,1.0,1463,1487
1956-03-10,Haiti,Venezuela,1,1,0,0.5,0.5,1517,1488
1956-03-11,Argentina,Chile,3,0,3,1.0,0.0,1826,1571
1956-03-11,Belgium,Switzerland,1,3,2,0.0,1.0,1589,1571
1956-03-12,Haiti,Panama,2,1,1,1.0,0.0,1524,1457
1956-03-13,Brazil,Costa Rica,7,1,6,1.0,0.0,1774,1667
1956-03-13,Mexico,Argentina,0,0,0,0.5,0.5,1586,1822
1956-03-14,Germany,Netherlands,1,2,1,0.0,1.0,1715,1547
1956-03-14,Panama,Venezuela,2,4,2,0.0,1.0,1450,1496
1956-03-15,Chile,Peru,2,2,0,0.5,0.5,1572,1577
1956-03-16,Haiti,Venezuela,3,0,3,1.0,0.0,1532,1489
1956-03-17,Costa Rica,Peru,4,2,2,1.0,0.0,1673,1572
1956-03-17,Malaysia,Cambodia,9,2,7,1.0,0.0,1502,1500
1956-03-18,Argentina,Brazil,2,2,0,0.5,0.5,1821,1776
1956-03-22,Guernsey,Alderney,4,0,4,1.0,0.0,1638,1346
1956-03-25,France,Austria,3,1,2,1.0,0.0,1671,1697
1956-03-25,Portugal,Turkey,3,1,2,1.0,0.0,1540,1563
1956-03-31,Guadeloupe,Curaçao,1,2,1,0.0,1.0,1482,1626
1956-04-01,Martinique,Curaçao,0,1,1,0.0,1.0,1541,1633
1956-04-08,Belgium,Netherlands,0,1,1,0.0,1.0,1581,1556
1956-04-08,Portugal,Brazil,0,1,1,0.0,1.0,1537,1780
1956-04-11,Switzerland,Brazil,1,1,0,0.5,0.5,1576,1776
1956-04-11,Wales,Northern Ireland,1,1,0,0.5,0.5,1568,1480
1956-04-14,Scotland,England,1,1,0,0.5,0.5,1691,1754
1956-04-15,Austria,Brazil,2,3,1,0.0,1.0,1691,1783
1956-04-21,Czechoslovakia,Brazil,0,0,0,0.5,0.5,1629,1780
1956-04-21,South Korea,Philippines,3,0,3,1.0,0.0,1533,1424
1956-04-22,Yugoslavia,Romania,0,1,1,0.0,1.0,1725,1594
1956-04-24,Cambodia,Malaysia,3,2,1,1.0,0.0,1509,1494
1956-04-25,Italy,Brazil,3,0,3,1.0,0.0,1789,1773
1956-04-26,Martinique,Guadeloupe,3,0,3,1.0,0.0,1548,1476
1956-04-29,Hungary,Yugoslavia,2,2,0,0.5,0.5,1860,1729
1956-05-01,Saarland,Switzerland,1,1,0,0.5,0.5,1494,1575
1956-05-01,Turkey,Brazil,0,1,1,0.0,1.0,1560,1777
1956-05-02,Scotland,Austria,1,1,0,0.5,0.5,1691,1691
1956-05-03,Vietnam Republic,Malaysia,4,0,4,1.0,0.0,1508,1487
1956-05-03,Jersey,Guernsey,2,1,1,1.0,0.0,1614,1630
1956-05-09,England,Brazil,4,2,2,1.0,0.0,1763,1769
1956-05-10,Netherlands,Republic of Ireland,1,4,3,0.0,1.0,1549,1575
1956-05-10,Switzerland,Czechoslovakia,1,6,5,0.0,1.0,1569,1636
1956-05-16,Sweden,England,0,0,0,0.5,0.5,1689,1762
1956-05-20,Finland,England,1,5,4,0.0,1.0,1411,1764
1956-05-20,Guadeloupe,Martinique,2,2,0,0.5,0.5,1478,1547
1956-05-20,Hungary,Czechoslovakia,2,4,2,0.0,1.0,1848,1649
1956-05-23,Russia,Denmark,5,1,4,1.0,0.0,1591,1582
1956-05-24,Malaysia,Vietnam Republic,3,3,0,0.5,0.5,1488,1508
1956-05-26,Germany,England,1,3,2,0.0,1.0,1709,1771
1956-05-30,Norway,Poland,0,0,0,0.5,0.5,1539,1521
1956-06-03,Belgium,Hungary,5,4,1,1.0,0.0,1595,1835
1956-06-03,Portugal,Spain,3,1,2,1.0,0.0,1548,1645
1956-06-06,Netherlands,Saarland,3,2,1,1.0,0.0,1556,1488
1956-06-09,Portugal,Hungary,2,2,0,0.5,0.5,1554,1830
1956-06-10,Finland,Sweden,1,3,2,0.0,1.0,1409,1692
1956-06-12,Paraguay,Brazil,0,2,2,0.0,1.0,1614,1774
1956-06-13,Norway,Germany,1,3,2,0.0,1.0,1535,1714
1956-06-17,India,China PR,0,1,1,0.0,1.0,1553,1612
1956-06-17,Paraguay,Brazil,2,5,3,0.0,1.0,1610,1779
1956-06-17,Romania,Sweden,0,2,2,0.0,1.0,1589,1698
1956-06-17,Yugoslavia,Austria,1,1,0,0.5,0.5,1729,1692
1956-06-24,Argentina,Italy,1,0,1,1.0,0.0,1829,1782
1956-06-24,Brazil,Uruguay,2,0,2,1.0,0.0,1786,1698
1956-06-24,Denmark,Norway,2,3,1,0.0,1.0,1573,1545
1956-06-25,Myanmar,China PR,2,3,1,0.0,1.0,1464,1617
1956-06-28,Romania,Norway,2,0,2,1.0,0.0,1596,1539
1956-06-29,Finland,Iceland,2,1,1,1.0,0.0,1419,1486
1956-06-30,Mauritius,Réunion,8,3,5,1.0,0.0,1608,1421
1956-06-30,Sweden,Germany,2,2,0,0.5,0.5,1699,1714
1956-07-01,Brazil,Italy,2,0,2,1.0,0.0,1794,1775
1956-07-01,Denmark,Russia,2,5,3,0.0,1.0,1566,1599
1956-07-01,Uruguay,Argentina,1,2,1,0.0,1.0,1693,1835
1956-07-05,Madagascar,Réunion,4,2,2,1.0,0.0,1505,1415
1956-07-08,Argentina,Brazil,0,0,0,0.5,0.5,1835,1795
1956-07-08,Madagascar,Mauritius,3,3,0,0.5,0.5,1508,1606
1956-07-15,Hungary,Poland,4,1,3,1.0,0.0,1833,1519
1956-07-15,Paraguay,Uruguay,2,2,0,0.5,0.5,1612,1692
1956-07-22,Poland,German DR,0,2,2,0.0,1.0,1511,1494
1956-08-03,Belarus,Kyrgyzstan,1,0,1,1.0,0.0,1500,1492
1956-08-03,Estonia,Lithuania,0,1,1,0.0,1.0,1394,1451
1956-08-05,Brazil,Czechoslovakia,0,1,1,0.0,1.0,1784,1661
1956-08-05,Russia,Lithuania,2,0,2,1.0,0.0,1604,1447
1956-08-08,Brazil,Czechoslovakia,4,1,3,1.0,0.0,1790,1656
1956-08-09,Russia,Belarus,5,1,4,1.0,0.0,1610,1495
1956-08-09,Yugoslavia,China PR,4,0,4,1.0,0.0,1735,1612
1956-08-10,Estonia,Lithuania,0,2,2,0.0,1.0,1388,1454
1956-08-11,Russia,Belarus,4,2,2,1.0,0.0,1616,1490
1956-08-12,Lithuania,Moldova,1,4,3,0.0,1.0,1448,1507
1956-08-12,Uruguay,Czechoslovakia,2,1,1,1.0,0.0,1700,1649
1956-08-15,Paraguay,Argentina,0,1,1,0.0,1.0,1609,1839
1956-08-19,Argentina,Czechoslovakia,1,0,1,1.0,0.0,1844,1645
1956-08-26,Chile,Czechoslovakia,3,0,3,1.0,0.0,1582,1636
1956-08-26,South Korea,Taiwan,2,0,2,1.0,0.0,1542,1526
1956-08-26,Norway,Finland,1,1,0,0.5,0.5,1537,1422
1956-08-26,Poland,Bulgaria,1,2,1,0.0,1.0,1503,1512
1956-09-01,Hong Kong,Israel,2,3,1,0.0,1.0,1509,1459
1956-09-06,Hong Kong,South Korea,2,2,0,0.5,0.5,1510,1542
1956-09-08,Israel,South Korea,1,2,1,0.0,1.0,1453,1549
1956-09-09,Hong Kong,Vietnam Republic,2,2,0,0.5,0.5,1510,1509
1956-09-09,Yugoslavia,Indonesia,4,2,2,1.0,0.0,1738,1468
1956-09-10,Bulgaria,Romania,2,0,2,1.0,0.0,1522,1587
1956-09-12,Croatia,Indonesia,5,2,3,1.0,0.0,1556,1462
1956-09-12,Israel,Vietnam Republic,2,1,1,1.0,0.0,1463,1500
1956-09-12,Singapore,Pakistan,1,1,0,0.5,0.5,1498,1531
1956-09-15,Germany,Russia,1,2,1,0.0,1.0,1704,1627
1956-09-15,South Korea,Vietnam Republic,5,3,2,1.0,0.0,1556,1494
1956-09-15,Switzerland,Netherlands,2,3,1,0.0,1.0,1561,1565
1956-09-16,Finland,Denmark,0,4,4,0.0,1.0,1418,1571
1956-09-16,Norway,Sweden,3,1,2,1.0,0.0,1549,1688
1956-09-16,Yugoslavia,Hungary,1,3,2,0.0,1.0,1733,1839
1956-09-17,Hong Kong,South Korea,2,4,2,0.0,1.0,1504,1563
1956-09-20,German DR,Indonesia,3,1,2,1.0,0.0,1502,1455
1956-09-23,Russia,Hungary,0,1,1,0.0,1.0,1624,1843
1956-09-25,Guyana,Suriname,1,1,0,0.5,0.5,1447,1579
1956-09-28,Guyana,Suriname,2,1,1,1.0,0.0,1458,1569
1956-09-30,Austria,Luxembourg,7,0,7,1.0,0.0,1695,1427
1956-09-30,Guyana,Suriname,1,2,1,0.0,1.0,1453,1575
1956-09-30,Yugoslavia,Czechoslovakia,1,2,1,0.0,1.0,1723,1647
1956-10-03,Republic of Ireland,Denmark,2,1,1,1.0,0.0,1583,1564
1956-10-04,China PR,North Vietnam,5,3,2,1.0,0.0,1618,1495
1956-10-06,Nigeria,Togo,1,1,0,0.5,0.5,1496,1500
1956-10-06,Northern Ireland,England,1,1,0,0.5,0.5,1486,1766
1956-10-07,China PR,North Korea,0,1,1,0.0,1.0,1608,1511
1956-10-07,France,Hungary,1,2,1,0.0,1.0,1667,1848
1956-10-10,North Korea,North Vietnam,3,0,3,1.0,0.0,1519,1488
1956-10-10,Uruguay,Argentina,1,2,1,0.0,1.0,1696,1849
1956-10-14,Austria,Hungary,0,2,2,0.0,1.0,1691,1853
1956-10-14,Belgium,Netherlands,2,3,1,0.0,1.0,1587,1574
1956-10-14,Bulgaria,German DR,3,1,2,1.0,0.0,1530,1495
1956-10-19,Vietnam Republic,Thailand,2,1,1,1.0,0.0,1502,1485
1956-10-20,Togo,Ghana,1,1,0,0.5,0.5,1501,1526
1956-10-20,Wales,Scotland,2,2,0,0.5,0.5,1571,1689
1956-10-21,France,Russia,2,1,1,1.0,0.0,1675,1617
1956-10-21,Sweden,Denmark,1,1,0,0.5,0.5,1686,1567
1956-10-22,Vietnam Republic,Thailand,3,1,2,1.0,0.0,1510,1478
1956-10-27,Nigeria,Ghana,3,0,3,1.0,0.0,1505,1518
1956-10-28,Poland,Norway,5,3,2,1.0,0.0,1513,1540
1956-10-31,South Korea,United States,1,0,1,1.0,0.0,1570,1482
1956-11-04,Denmark,Netherlands,2,2,0,0.5,0.5,1568,1574
1956-11-04,Poland,Finland,5,0,5,1.0,0.0,1519,1413
1956-11-07,Scotland,Northern Ireland,1,0,1,1.0,0.0,1693,1483
1956-11-10,Philippines,United States,0,4,4,0.0,1.0,1418,1489
1956-11-10,Sierra Leone,Gambia,1,0,1,1.0,0.0,1487,1485
1956-11-11,France,Belgium,6,3,3,1.0,0.0,1682,1581
1956-11-11,Switzerland,Italy,1,1,0,0.5,0.5,1566,1771
1956-11-14,Argentina,Uruguay,2,2,0,0.5,0.5,1846,1700
1956-11-14,England,Wales,3,1,2,1.0,0.0,1770,1568
1956-11-16,Ethiopia,Sudan,2,1,1,1.0,0.0,1552,1494
1956-11-16,Indonesia,United States,7,5,2,1.0,0.0,1464,1481
1956-11-16,Turkey,Poland,1,1,0,0.5,0.5,1560,1520
1956-11-21,Germany,Switzerland,1,3,2,0.0,1.0,1693,1578
1956-11-21,Scotland,Yugoslavia,2,0,2,1.0,0.0,1702,1715
1956-11-25,Czechoslovakia,Turkey,1,1,0,0.5,0.5,1646,1562
1956-11-25,Republic of Ireland,Germany,3,0,3,1.0,0.0,1594,1683
1956-11-27,Tanzania,Kenya,0,9,9,0.0,1.0,1482,1527
1956-11-28,England,Yugoslavia,3,0,3,1.0,0.0,1777,1709
1956-11-28,Uganda,Zanzibar,5,2,3,1.0,0.0,1604,1445
1956-11-30,Tanzania,Zanzibar,2,3,1,0.0,1.0,1474,1454
1956-12-01,Uganda,Kenya,3,2,1,1.0,0.0,1611,1521
1956-12-05,England,Denmark,5,2,3,1.0,0.0,1781,1565
1956-12-09,Italy,Austria,2,1,1,1.0,0.0,1778,1685
1956-12-12,Australia,India,1,7,6,0.0,1.0,1538,1561
1956-12-13,Singapore,Bulgaria,2,10,8,0.0,1.0,1491,1538
1956-12-16,Ghana,Sierra Leone,4,3,1,1.0,0.0,1526,1480
1956-12-23,Germany,Belgium,4,1,3,1.0,0.0,1689,1576
1956-12-23,Indonesia,Yugoslavia,1,5,4,0.0,1.0,1461,1713
1956-12-29,India,Yugoslavia,0,3,3,0.0,1.0,1557,1718
1957-01-16,Portugal,Northern Ireland,1,1,0,0.5,0.5,1553,1485
1957-01-21,Jamaica,Trinidad and Tobago,2,0,2,1.0,0.0,1492,1593
1957-01-26,Jamaica,Trinidad and Tobago,1,0,1,1.0,0.0,1503,1583
1957-01-28,Jamaica,Trinidad and Tobago,2,1,1,1.0,0.0,1513,1574
1957-01-30,Spain,Netherlands,5,1,4,1.0,0.0,1652,1568
1957-02-09,Singapore,India,2,3,1,0.0,1.0,1485,1564
1957-02-10,Guatemala,Costa Rica,2,6,4,0.0,1.0,1515,1678
1957-02-10,Sudan,Egypt,1,2,1,0.0,1.0,1487,1515
1957-02-16,Egypt,Ethiopia,4,0,4,1.0,0.0,1524,1544
1957-02-16,Malaysia,India,2,3,1,0.0,1.0,1482,1571
1957-02-17,Costa Rica,Guatemala,3,1,2,1.0,0.0,1683,1511
1957-02-17,Sudan,Egypt,3,4,1,0.0,1.0,1480,1532
1957-02-24,Malta,Austria,2,3,1,0.0,1.0,1496,1690
1957-03-03,Costa Rica,Curaçao,4,0,4,1.0,0.0,1690,1627
1957-03-07,Ecuador,Uruguay,2,5,3,0.0,1.0,1368,1703
1957-03-08,Sudan,Syria,1,0,1,1.0,0.0,1489,1475
1957-03-10,Austria,Germany,2,3,1,0.0,1.0,1682,1698
1957-03-10,German DR,Luxembourg,3,0,3,1.0,0.0,1502,1421
1957-03-10,Peru,Ecuador,2,1,1,1.0,0.0,1576,1365
1957-03-10,Spain,Switzerland,2,2,0,0.5,0.5,1651,1580
1957-03-13,Argentina,Colombia,8,2,6,1.0,0.0,1848,1466
1957-03-13,Brazil,Chile,4,2,2,1.0,0.0,1794,1579
1957-03-14,Guatemala,Curaçao,1,3,2,0.0,1.0,1506,1633
1957-03-16,Peru,Chile,1,0,1,1.0,0.0,1585,1571
1957-03-17,Argentina,Ecuador,3,0,3,1.0,0.0,1849,1365
1957-03-17,Colombia,Uruguay,1,0,1,1.0,0.0,1479,1691
1957-03-20,Argentina,Uruguay,4,0,4,1.0,0.0,1854,1687
1957-03-20,Netherlands,Luxembourg,4,1,3,1.0,0.0,1573,1417
1957-03-21,Brazil,Ecuador,7,1,6,1.0,0.0,1796,1364
1957-03-21,Chile,Colombia,3,2,1,1.0,0.0,1577,1474
1957-03-23,Peru,Uruguay,3,5,2,0.0,1.0,1580,1693
1957-03-24,Brazil,Colombia,9,0,9,1.0,0.0,1799,1472
1957-03-24,Chile,Ecuador,2,2,0,0.5,0.5,1573,1369
1957-03-27,Peru,Colombia,4,1,3,1.0,0.0,1586,1467
1957-03-28,Argentina,Chile,6,2,4,1.0,0.0,1857,1571
1957-03-28,Brazil,Uruguay,2,3,1,0.0,1.0,1789,1704
1957-03-28,Jersey,Alderney,7,1,6,1.0,0.0,1617,1344
1957-03-31,Belgium,Spain,0,5,5,0.0,1.0,1570,1658
1957-03-31,Peru,Brazil,0,1,1,0.0,1.0,1583,1793
1957-04-01,Chile,Uruguay,0,2,2,0.0,1.0,1566,1710
1957-04-01,Colombia,Ecuador,4,1,3,1.0,0.0,1473,1364
1957-04-03,Argentina,Brazil,3,0,3,1.0,0.0,1864,1787
1957-04-03,Netherlands,Germany,1,2,1,0.0,1.0,1568,1704
1957-04-06,England,Scotland,2,1,1,1.0,0.0,1788,1696
1957-04-06,Peru,Argentina,2,1,1,1.0,0.0,1597,1851
1957-04-07,Mexico,United States,6,0,6,1.0,0.0,1592,1476
1957-04-09,Peru,Argentina,1,4,3,0.0,1.0,1594,1855
1957-04-10,Northern Ireland,Wales,0,0,0,0.5,0.5,1487,1567
1957-04-13,Peru,Brazil,1,1,0,0.5,0.5,1599,1783
1957-04-14,Austria,Switzerland,4,0,4,1.0,0.0,1688,1575
1957-04-17,Mauritius,Réunion,1,0,1,1.0,0.0,1610,1412
1957-04-20,Martinique,Guadeloupe,6,1,5,1.0,0.0,1554,1472
1957-04-21,Brazil,Peru,1,0,1,1.0,0.0,1788,1595
1957-04-25,Italy,Northern Ireland,1,0,1,1.0,0.0,1781,1485
1957-04-28,Netherlands,Belgium,1,1,0,0.5,0.5,1569,1570
1957-04-28,United States,Mexico,2,7,5,0.0,1.0,1471,1598
1957-05-01,Northern Ireland,Portugal,3,0,3,1.0,0.0,1495,1544
1957-05-01,Wales,Czechoslovakia,1,0,1,1.0,0.0,1577,1637
1957-05-02,Guernsey,Jersey,6,4,2,1.0,0.0,1638,1610
1957-05-05,Austria,Sweden,1,0,1,1.0,0.0,1696,1679
1957-05-05,Greece,Yugoslavia,0,0,0,0.5,0.5,1449,1713
1957-05-08,England,Republic of Ireland,5,1,4,1.0,0.0,1792,1591
1957-05-08,Scotland,Spain,4,2,2,1.0,0.0,1704,1651
1957-05-12,Indonesia,China PR,2,0,2,1.0,0.0,1473,1597
1957-05-12,Yugoslavia,Italy,6,1,5,1.0,0.0,1723,1772
1957-05-15,Denmark,England,1,4,3,0.0,1.0,1562,1796
1957-05-15,Guadeloupe,Martinique,5,2,3,1.0,0.0,1482,1545
1957-05-18,Czechoslovakia,Yugoslavia,1,0,1,1.0,0.0,1647,1714
1957-05-19,German DR,Wales,2,1,1,1.0,0.0,1512,1568
1957-05-19,Republic of Ireland,England,1,1,0,0.5,0.5,1596,1792
1957-05-19,Poland,Turkey,0,1,1,0.0,1.0,1513,1570
1957-05-19,Switzerland,Scotland,1,2,1,0.0,1.0,1570,1710
1957-05-22,Germany,Scotland,1,3,2,0.0,1.0,1697,1718
1957-05-22,Norway,Bulgaria,1,2,1,0.0,1.0,1532,1547
1957-05-23,Uruguay,Argentina,0,0,0,0.5,0.5,1714,1852
1957-05-24,Syria,Sudan,1,1,0,0.5,0.5,1476,1489
1957-05-26,Austria,Netherlands,3,2,1,1.0,0.0,1702,1564
1957-05-26,Belgium,Romania,1,0,1,1.0,0.0,1579,1579
1957-05-26,Czechoslovakia,Wales,2,0,2,1.0,0.0,1654,1562
1957-05-26,Denmark,Bulgaria,1,1,0,0.5,0.5,1562,1548
1957-05-26,Portugal,Italy,3,0,3,1.0,0.0,1557,1760
1957-05-26,Spain,Scotland,4,1,3,1.0,0.0,1661,1709
1957-06-01,Russia,Romania,1,1,0,0.5,0.5,1617,1580
1957-06-02,China PR,Indonesia,4,3,1,1.0,0.0,1603,1468
1957-06-02,France,Iceland,8,0,8,1.0,0.0,1686,1483
1957-06-02,Tunisia,Libya,4,2,2,1.0,0.0,1508,1492
1957-06-05,Argentina,Uruguay,1,1,0,0.5,0.5,1849,1718
1957-06-05,Belgium,Iceland,8,3,5,1.0,0.0,1585,1478
1957-06-06,Paraguay,Bolivia,5,2,3,1.0,0.0,1614,1445
1957-06-11,Brazil,Portugal,2,1,1,1.0,0.0,1792,1554
1957-06-12,Norway,Hungary,2,1,1,1.0,0.0,1546,1840
1957-06-13,Paraguay,Bolivia,0,1,1,0.0,1.0,1603,1457
1957-06-16,Brazil,Portugal,3,0,3,1.0,0.0,1796,1551
1957-06-16,Colombia,Uruguay,1,1,0,0.5,0.5,1478,1714
1957-06-16,Czechoslovakia,German DR,3,1,2,1.0,0.0,1659,1508
1957-06-16,Greece,Romania,1,2,1,0.0,1.0,1444,1586
1957-06-16,Sweden,Hungary,0,0,0,0.5,0.5,1683,1837
1957-06-18,Finland,Denmark,2,0,2,1.0,0.0,1425,1551
1957-06-18,Norway,Sweden,0,0,0,0.5,0.5,1550,1680
1957-06-19,Denmark,Norway,2,0,2,1.0,0.0,1559,1543
1957-06-19,Finland,Sweden,1,5,4,0.0,1.0,1423,1683
1957-06-20,Colombia,Paraguay,2,3,1,0.0,1.0,1473,1609
1957-06-22,Canada,United States,5,1,4,1.0,0.0,1502,1464
1957-06-23,China PR,Indonesia,0,0,0,0.5,0.5,1601,1471
1957-06-23,Colombia,Paraguay,1,2,1,0.0,1.0,1468,1615
1957-06-23,Hungary,Bulgaria,4,1,3,1.0,0.0,1840,1546
1957-06-23,Russia,Poland,3,0,3,1.0,0.0,1623,1508
1957-06-27,Myanmar,China PR,2,1,1,1.0,0.0,1476,1590
1957-06-30,Denmark,Sweden,1,2,1,0.0,1.0,1554,1689
1957-06-30,Mexico,Canada,3,0,3,1.0,0.0,1604,1497
1957-06-30,Uruguay,Colombia,1,0,1,1.0,0.0,1718,1465
1957-07-03,Mexico,Canada,2,0,2,1.0,0.0,1610,1492
1957-07-05,Finland,Poland,1,3,2,0.0,1.0,1417,1515
1957-07-06,United States,Canada,2,3,1,0.0,1.0,1457,1500
1957-07-07,Brazil,Argentina,1,2,1,0.0,1.0,1790,1856
1957-07-07,Paraguay,Colombia,3,0,3,1.0,0.0,1620,1461
1957-07-08,Iceland,Norway,0,3,3,0.0,1.0,1472,1550
1957-07-10,Brazil,Argentina,2,0,2,1.0,0.0,1800,1847
1957-07-10,Iceland,Denmark,2,6,4,0.0,1.0,1466,1561
1957-07-12,Denmark,Norway,1,3,2,0.0,1.0,1553,1559
1957-07-14,Paraguay,Uruguay,5,0,5,1.0,0.0,1631,1708
1957-07-21,Bulgaria,Russia,0,4,4,0.0,1.0,1540,1630
1957-07-21,China PR,Sudan,4,1,3,1.0,0.0,1596,1484
1957-07-27,Russia,Finland,2,1,1,1.0,0.0,1634,1414
1957-07-28,Uruguay,Paraguay,2,0,2,1.0,0.0,1715,1625
1957-08-04,Curaçao,Costa Rica,1,2,1,0.0,1.0,1627,1697
1957-08-13,Curaçao,Haiti,1,3,2,0.0,1.0,1617,1543
1957-08-14,Cuba,Panama,0,1,1,0.0,1.0,1458,1459
1957-08-15,Finland,Russia,0,10,10,0.0,1.0,1411,1638
1957-08-18,Bolivia,Paraguay,3,3,0,0.5,0.5,1461,1622
1957-08-18,Curaçao,Cuba,2,0,2,1.0,0.0,1622,1454
1957-08-21,Bolivia,Paraguay,2,1,1,1.0,0.0,1473,1611
1957-08-21,Cuba,Honduras,0,2,2,0.0,1.0,1448,1514
1957-08-21,Curaçao,Panama,3,0,3,1.0,0.0,1627,1455
1957-08-23,Cuba,Haiti,1,6,5,0.0,1.0,1443,1549
1957-08-24,Sierra Leone,Ghana,2,3,1,0.0,1.0,1474,1533
1957-08-25,Curaçao,Honduras,1,1,0,0.5,0.5,1625,1517
1957-08-26,Aruba,Panama,2,2,0,0.5,0.5,1492,1456
1957-08-28,Malawi,Zambia,0,5,5,0.0,1.0,1493,1531
1957-08-31,Indonesia,Thailand,4,0,4,1.0,0.0,1480,1470
1957-08-31,Singapore,Vietnam Republic,5,5,0,0.5,0.5,1486,1510
1957-09-01,Cambodia,Thailand,0,3,3,0.0,1.0,1501,1479
1957-09-01,Finland,Norway,0,4,4,0.0,1.0,1407,1564
1957-09-01,Iceland,France,1,5,4,0.0,1.0,1463,1690
1957-09-01,Malaysia,Myanmar,5,2,3,1.0,0.0,1490,1469
1957-09-01,Singapore,Vietnam Republic,1,2,1,0.0,1.0,1479,1518
1957-09-03,Myanmar,Cambodia,2,0,2,1.0,0.0,1478,1493
1957-09-03,Malaysia,Vietnam Republic,1,4,3,0.0,1.0,1483,1526
1957-09-03,Singapore,Thailand,6,0,6,1.0,0.0,1487,1471
1957-09-03,Tanzania,Uganda,2,4,2,0.0,1.0,1470,1616
1957-09-04,Iceland,Belgium,2,5,3,0.0,1.0,1458,1591
1957-09-04,Zanzibar,Kenya,1,5,4,0.0,1.0,1448,1528
1957-09-05,Myanmar,Thailand,5,2,3,1.0,0.0,1486,1464
1957-09-05,Cambodia,Singapore,1,1,0,0.5,0.5,1493,1488
1957-09-05,Indonesia,Vietnam Republic,3,1,2,1.0,0.0,1490,1517
1957-09-05,Zanzibar,Tanzania,3,3,0,0.5,0.5,1449,1470
1957-09-07,Myanmar,Singapore,2,3,1,0.0,1.0,1479,1496
1957-09-07,Malaysia,Indonesia,4,2,2,1.0,0.0,1492,1482
1957-09-07,Kenya,Uganda,1,2,1,0.0,1.0,1522,1623
1957-09-09,Tahiti,Vanuatu,2,1,1,1.0,0.0,1495,1470
1957-09-10,Singapore,Myanmar,2,1,1,1.0,0.0,1504,1472
1957-09-11,Netherlands,Luxembourg,5,2,3,1.0,0.0,1569,1413
1957-09-15,Bulgaria,Hungary,1,2,1,0.0,1.0,1538,1843
1957-09-15,Chile,Brazil,1,0,1,1.0,0.0,1579,1788
1957-09-15,China PR,Albania,3,2,1,1.0,0.0,1603,1510
1957-09-15,New Caledonia,Tahiti,2,4,2,0.0,1.0,1513,1504
1957-09-15,Yugoslavia,Austria,3,3,0,0.5,0.5,1714,1703
1957-09-18,Chile,Brazil,1,1,0,0.5,0.5,1584,1784
1957-09-18,New Caledonia,Tahiti,2,1,1,1.0,0.0,1521,1497
1957-09-22,Chile,Bolivia,2,1,1,1.0,0.0,1590,1468
1957-09-22,Hungary,Russia,1,2,1,0.0,1.0,1831,1651
1957-09-22,Norway,Denmark,2,2,0,0.5,0.5,1564,1554
1957-09-22,Sweden,Finland,5,1,4,1.0,0.0,1692,1405
1957-09-25,Netherlands,Austria,1,1,0,0.5,0.5,1572,1701
1957-09-25,Wales,German DR,4,1,3,1.0,0.0,1569,1502
1957-09-27,New Caledonia,Tahiti,2,0,2,1.0,0.0,1529,1490
1957-09-29,Bolivia,Chile,3,0,3,1.0,0.0,1479,1580
1957-09-29,Bulgaria,Poland,1,1,0,0.5,0.5,1538,1516
1957-09-29,Luxembourg,Austria,0,3,3,0.0,1.0,1411,1704
1957-09-29,Romania,Yugoslavia,1,1,0,0.5,0.5,1589,1712
1957-10-02,Denmark,Republic of Ireland,0,2,2,0.0,1.0,1547,1604
1957-10-05,Northern Ireland,Scotland,1,1,0,0.5,0.5,1500,1705
1957-10-06,Bolivia,Argentina,2,0,2,1.0,0.0,1494,1833
1957-10-06,Hungary,France,2,0,2,1.0,0.0,1836,1686
1957-10-13,Austria,Czechoslovakia,2,2,0,0.5,0.5,1703,1661
1957-10-13,Chile,Argentina,0,2,2,0.0,1.0,1577,1837
1957-10-13,Denmark,Finland,3,0,3,1.0,0.0,1552,1401
1957-10-13,Sweden,Norway,5,2,3,1.0,0.0,1698,1559
1957-10-19,Wales,England,0,4,4,0.0,1.0,1566,1796
1957-10-20,Argentina,Chile,4,0,4,1.0,0.0,1840,1575
1957-10-20,Madagascar,Réunion,0,1,1,0.0,1.0,1498,1423
1957-10-20,Mexico,Costa Rica,2,0,2,1.0,0.0,1620,1688
1957-10-20,Poland,Russia,2,1,1,1.0,0.0,1527,1641
1957-10-24,Mauritius,Madagascar,4,0,4,1.0,0.0,1616,1493
1957-10-27,Argentina,Bolivia,4,0,4,1.0,0.0,1842,1493
1957-10-27,Belgium,France,0,0,0,0.5,0.5,1594,1684
1957-10-27,Costa Rica,Mexico,1,1,0,0.5,0.5,1687,1622
1957-10-27,German DR,Czechoslovakia,1,4,3,0.0,1.0,1498,1666
1957-10-27,Ghana,Nigeria,3,3,0,0.5,0.5,1533,1506
1957-10-27,Mauritius,Réunion,1,0,1,1.0,0.0,1620,1420
1957-10-31,Cambodia,Malaysia,1,3,2,0.0,1.0,1485,1501
1957-11-03,Bulgaria,Norway,7,0,7,1.0,0.0,1547,1551
1957-11-03,Poland,Finland,4,0,4,1.0,0.0,1533,1396
1957-11-03,Romania,Greece,3,0,3,1.0,0.0,1594,1440
1957-11-06,England,Northern Ireland,2,3,1,0.0,1.0,1783,1514
1957-11-06,Scotland,Switzerland,3,2,1,1.0,0.0,1711,1565
1957-11-10,Hungary,Norway,5,0,5,1.0,0.0,1839,1549
1957-11-10,Yugoslavia,Greece,4,1,3,1.0,0.0,1715,1438
1957-11-13,Scotland,Wales,1,1,0,0.5,0.5,1708,1570
1957-11-17,Netherlands,Belgium,5,2,3,1.0,0.0,1581,1586
1957-11-17,Yugoslavia,Romania,2,0,2,1.0,0.0,1721,1589
1957-11-20,Germany,Sweden,1,0,1,1.0,0.0,1706,1690
1957-11-24,Poland,Russia,0,2,2,0.0,1.0,1528,1647
1957-11-24,Switzerland,Spain,1,4,3,0.0,1.0,1560,1667
1957-11-27,England,France,4,0,4,1.0,0.0,1789,1679
1957-12-04,Northern Ireland,Italy,2,2,0,0.5,0.5,1519,1756
1957-12-08,Turkey,Belgium,1,1,0,0.5,0.5,1571,1586
1957-12-13,Egypt,Czechoslovakia,1,2,1,0.0,1.0,1527,1672
1957-12-22,Germany,Hungary,1,0,1,1.0,0.0,1717,1829
1957-12-22,Italy,Portugal,3,0,3,1.0,0.0,1760,1548
1957-12-25,France,Bulgaria,2,2,0,0.5,0.5,1677,1550
1958-01-15,Israel,Wales,0,2,2,0.0,1.0,1458,1576
1958-01-15,Northern Ireland,Italy,2,1,1,1.0,0.0,1532,1748
1958-01-25,Malta,Denmark,3,0,3,1.0,0.0,1506,1543
1958-02-05,Wales,Israel,2,0,2,1.0,0.0,1582,1453
1958-02-18,Hong Kong,South Korea,3,2,1,1.0,0.0,1514,1561
1958-02-20,Ghana,Togo,5,2,3,1.0,0.0,1541,1494
1958-02-25,Hong Kong,South Korea,1,1,0,0.5,0.5,1516,1560
1958-03-01,Malaysia,Singapore,5,2,3,1.0,0.0,1510,1496
1958-03-02,Belgium,Germany,0,2,2,0.0,1.0,1581,1723
1958-03-02,Malaysia,Singapore,3,1,2,1.0,0.0,1518,1489
1958-03-13,France,Spain,2,2,0,0.5,0.5,1677,1668
1958-03-19,Germany,Spain,2,0,2,1.0,0.0,1730,1662
1958-03-23,Austria,Italy,3,2,1,1.0,0.0,1713,1739
1958-03-27,Guernsey,Alderney,8,2,6,1.0,0.0,1641,1342
1958-04-02,Czechoslovakia,Germany,3,2,1,1.0,0.0,1682,1721
1958-04-03,Morocco,Libya,3,1,2,1.0,0.0,1508,1485
1958-04-06,Uruguay,Argentina,1,0,1,1.0,0.0,1726,1832
1958-04-13,Belgium,Netherlands,2,7,5,0.0,1.0,1573,1589
1958-04-13,Spain,Portugal,1,0,1,1.0,0.0,1668,1543
1958-04-14,Martinique,Guadeloupe,1,1,0,0.5,0.5,1544,1484
1958-04-16,France,Switzerland,0,0,0,0.5,0.5,1675,1563
1958-04-16,Wales,Northern Ireland,1,1,0,0.5,0.5,1581,1534
1958-04-19,Scotland,England,0,4,4,0.0,1.0,1702,1796
1958-04-20,Hungary,Yugoslavia,2,0,2,1.0,0.0,1835,1716
1958-04-20,Paraguay,Argentina,1,0,1,1.0,0.0,1624,1820
1958-04-22,Zimbabwe,Zambia,0,2,2,0.0,1.0,1481,1539
1958-04-23,Netherlands,Curaçao,8,1,7,1.0,0.0,1598,1617
1958-04-26,Argentina,Paraguay,2,0,2,1.0,0.0,1824,1621
1958-04-30,Argentina,Uruguay,2,0,2,1.0,0.0,1830,1721
1958-05-01,Jersey,Guernsey,2,1,1,1.0,0.0,1619,1633
1958-05-03,Singapore,Malaysia,3,3,0,0.5,0.5,1490,1518
1958-05-04,Albania,German DR,1,1,0,0.5,0.5,1510,1499
1958-05-04,Brazil,Paraguay,5,1,4,1.0,0.0,1789,1617
1958-05-04,Netherlands,Turkey,1,2,1,0.0,1.0,1590,1580
1958-05-04,Singapore,Malaysia,0,3,3,0.0,1.0,1483,1526
1958-05-04,Trinidad and Tobago,Jamaica,1,0,1,1.0,0.0,1581,1507
1958-05-07,Brazil,Paraguay,0,0,0,0.5,0.5,1786,1621
1958-05-07,England,Portugal,2,1,1,1.0,0.0,1800,1540
1958-05-07,Scotland,Hungary,1,1,0,0.5,0.5,1705,1833
1958-05-07,Sweden,Switzerland,3,2,1,1.0,0.0,1696,1558
1958-05-09,Philippines,Indonesia,1,2,1,0.0,1.0,1412,1489
1958-05-09,Tunisia,Libya,4,1,3,1.0,0.0,1516,1478
1958-05-11,Poland,Republic of Ireland,2,2,0,0.5,0.5,1530,1603
1958-05-11,Trinidad and Tobago,Jamaica,4,0,4,1.0,0.0,1588,1501
1958-05-11,Yugoslavia,England,5,0,5,1.0,0.0,1726,1791
1958-05-13,Philippines,Indonesia,0,3,3,0.0,1.0,1406,1496
1958-05-13,Trinidad and Tobago,Jamaica,0,1,1,0.0,1.0,1579,1511
1958-05-14,Austria,Republic of Ireland,3,1,2,1.0,0.0,1719,1598
1958-05-14,Brazil,Bulgaria,4,0,4,1.0,0.0,1790,1547
1958-05-14,Hong Kong,Taiwan,2,1,1,1.0,0.0,1525,1518
1958-05-14,Malaysia,Pakistan,4,2,2,1.0,0.0,1535,1523
1958-05-15,Denmark,Curaçao,3,2,1,1.0,0.0,1553,1608
1958-05-17,Singapore,Pakistan,4,4,0,0.5,0.5,1484,1523
1958-05-18,Brazil,Bulgaria,3,1,2,1.0,0.0,1794,1544
1958-05-18,Russia,England,1,1,0,0.5,0.5,1651,1788
1958-05-25,Denmark,Poland,3,2,1,1.0,0.0,1561,1523
1958-05-25,Vietnam Republic,Pakistan,1,1,0,0.5,0.5,1518,1523
1958-05-25,Taiwan,Malaya,2,1,1,1.0,0.0,1526,1493
1958-05-25,Indonesia,Burma,4,2,2,1.0,0.0,1505,1504
1958-05-25,Hong Kong,Philippines,4,1,3,1.0,0.0,1531,1401
1958-05-26,Switzerland,Belgium,0,2,2,0.0,1.0,1551,1581
1958-05-26,Burma,India,2,3,1,0.0,1.0,1498,1578
1958-05-26,Japan,Philippines,0,1,1,0.0,1.0,1497,1412
1958-05-26,South Korea,Singapore,2,1,1,1.0,0.0,1567,1478
1958-05-26,Israel,Iran,4,0,4,1.0,0.0,1463,1502
1958-05-27,Malaya,Vietnam Republic,1,6,5,0.0,1.0,1486,1526
1958-05-27,Pakistan,Taiwan,1,3,2,0.0,1.0,1516,1534
1958-05-28,Norway,Netherlands,0,0,0,0.5,0.5,1550,1590
1958-05-28,India,Indonesia,1,2,1,0.0,1.0,1569,1515
1958-05-28,Japan,Hong Kong,0,2,2,0.0,1.0,1490,1539
1958-05-28,Iran,South Korea,0,5,5,0.0,1.0,1496,1574
1958-05-28,Singapore,Israel,1,2,1,0.0,1.0,1470,1472
1958-05-30,Taiwan,Israel,2,0,2,1.0,0.0,1541,1466
1958-05-30,Indonesia,Philippines,5,2,3,1.0,0.0,1521,1407
1958-05-30,Hong Kong,India,2,5,3,0.0,1.0,1532,1577
1958-05-30,South Korea,Vietnam Republic,3,1,2,1.0,0.0,1581,1520
1958-05-31,Taiwan,Indonesia,1,0,1,1.0,0.0,1549,1514
1958-05-31,India,South Korea,1,3,2,0.0,1.0,1570,1589
1958-06-01,Poland,Scotland,1,2,1,0.0,1.0,1519,1710
1958-06-01,Indonesia,India,4,1,3,1.0,0.0,1524,1561
1958-06-01,Taiwan,South Korea,3,2,1,1.0,0.0,1558,1581
1958-06-04,Hong Kong,Malaysia,2,2,0,0.5,0.5,1533,1535
1958-06-08,Argentina,Germany,1,3,2,0.0,1.0,1820,1732
1958-06-08,Austria,Brazil,0,3,3,0.0,1.0,1713,1801
1958-06-08,Czechoslovakia,Northern Ireland,0,1,1,0.0,1.0,1671,1546
1958-06-08,England,Russia,2,2,0,0.5,0.5,1785,1655
1958-06-08,France,Paraguay,7,3,4,1.0,0.0,1682,1615
1958-06-08,Hungary,Wales,1,1,0,0.5,0.5,1829,1586
1958-06-08,Scotland,Yugoslavia,1,1,0,0.5,0.5,1711,1726
1958-06-08,Sweden,Mexico,3,0,3,1.0,0.0,1703,1616
1958-06-11,Argentina,Northern Ireland,3,1,2,1.0,0.0,1823,1544
1958-06-11,Austria,Russia,0,2,2,0.0,1.0,1704,1665
1958-06-11,Brazil,England,0,0,0,0.5,0.5,1801,1786
1958-06-11,Czechoslovakia,Germany,2,2,0,0.5,0.5,1673,1731
1958-06-11,France,Yugoslavia,2,3,1,0.0,1.0,1676,1733
1958-06-11,Mexico,Wales,1,1,0,0.5,0.5,1616,1587
1958-06-11,Paraguay,Scotland,3,2,1,1.0,0.0,1626,1701
1958-06-12,Sweden,Hungary,2,1,1,1.0,0.0,1714,1819
1958-06-15,Argentina,Czechoslovakia,1,6,5,0.0,1.0,1812,1685
1958-06-15,Austria,England,2,2,0,0.5,0.5,1706,1785
1958-06-15,Brazil,Russia,2,0,2,1.0,0.0,1807,1660
1958-06-15,France,Scotland,2,1,1,1.0,0.0,1685,1693
1958-06-15,Germany,Northern Ireland,2,2,0,0.5,0.5,1728,1548
1958-06-15,Hungary,Mexico,4,0,4,1.0,0.0,1823,1613
1958-06-15,Norway,Finland,2,0,2,1.0,0.0,1555,1392
1958-06-15,Paraguay,Yugoslavia,3,3,0,0.5,0.5,1629,1731
1958-06-15,Sweden,Wales,0,0,0,0.5,0.5,1712,1590
1958-06-17,Czechoslovakia,Northern Ireland,1,2,1,0.0,1.0,1674,1560
1958-06-17,England,Russia,0,1,1,0.0,1.0,1775,1671
1958-06-17,Hungary,Wales,1,2,1,0.0,1.0,1811,1603
1958-06-19,Brazil,Wales,1,0,1,1.0,0.0,1811,1600
1958-06-19,France,Northern Ireland,4,0,4,1.0,0.0,1691,1555
1958-06-19,Germany,Yugoslavia,1,0,1,1.0,0.0,1737,1723
1958-06-19,Sweden,Russia,2,0,2,1.0,0.0,1720,1664
1958-06-24,Brazil,France,5,2,3,1.0,0.0,1817,1686
1958-06-24,Sweden,Germany,3,1,2,1.0,0.0,1729,1729
1958-06-28,France,Germany,6,3,3,1.0,0.0,1695,1721
1958-06-28,German DR,Poland,1,1,0,0.5,0.5,1500,1519
1958-06-29,Denmark,Norway,1,2,1,0.0,1.0,1553,1564
1958-06-29,Sweden,Brazil,2,5,3,0.0,1.0,1723,1824
1958-07-02,Singapore,Indonesia,0,5,5,0.0,1.0,1464,1531
1958-07-03,Malaysia,Indonesia,2,4,2,0.0,1.0,1527,1540
1958-08-13,Norway,German DR,6,5,1,1.0,0.0,1571,1494
1958-08-16,New Zealand,Australia,2,3,1,0.0,1.0,1485,1545
1958-08-20,Finland,Sweden,1,7,6,0.0,1.0,1390,1726
1958-08-23,New Zealand,Australia,2,2,0,0.5,0.5,1487,1544
1958-08-30,Czechoslovakia,Russia,1,2,1,0.0,1.0,1666,1673
1958-08-30,Singapore,Vietnam Republic,4,4,0,0.5,0.5,1466,1519
1958-08-30,Malaysia,Indonesia,3,2,1,1.0,0.0,1536,1532
1958-08-31,Indonesia,Singapore,2,0,2,1.0,0.0,1539,1460
1958-08-31,New Caledonia,New Zealand,1,2,1,0.0,1.0,1521,1496
1958-09-02,Indonesia,Vietnam Republic,4,1,3,1.0,0.0,1547,1512
1958-09-02,Malaysia,Singapore,0,0,0,0.5,0.5,1535,1462
1958-09-04,Malaysia,Vietnam Republic,2,0,2,1.0,0.0,1543,1505
1958-09-07,New Caledonia,New Zealand,1,5,4,0.0,1.0,1513,1505
1958-09-09,Zimbabwe,Zambia,4,2,2,1.0,0.0,1491,1530
1958-09-14,Austria,Yugoslavia,3,4,1,0.0,1.0,1699,1731
1958-09-14,Finland,Denmark,1,4,3,0.0,1.0,1386,1558
1958-09-14,German DR,Romania,3,2,1,1.0,0.0,1505,1579
1958-09-14,New Caledonia,New Zealand,1,2,1,0.0,1.0,1505,1514
1958-09-14,Norway,Sweden,0,2,2,0.0,1.0,1567,1731
1958-09-14,Poland,Hungary,1,3,2,0.0,1.0,1517,1814
1958-09-20,Czechoslovakia,Switzerland,2,1,1,1.0,0.0,1672,1546
1958-09-24,Denmark,Germany,1,1,0,0.5,0.5,1562,1718
1958-09-28,Belgium,Netherlands,2,3,1,0.0,1.0,1574,1598
1958-09-28,Russia,Hungary,3,1,2,1.0,0.0,1685,1803
1958-10-01,France,Greece,7,1,6,1.0,0.0,1698,1436
1958-10-04,Northern Ireland,England,3,3,0,0.5,0.5,1560,1771
1958-10-04,Uganda,Zanzibar,1,1,0,0.5,0.5,1620,1453
1958-10-05,Austria,France,1,2,1,0.0,1.0,1691,1707
1958-10-05,German DR,Bulgaria,1,1,0,0.5,0.5,1506,1544
1958-10-05,Republic of Ireland,Poland,2,2,0,0.5,0.5,1597,1519
1958-10-05,Kenya,Tanzania,3,1,2,1.0,0.0,1529,1464
1958-10-05,Yugoslavia,Hungary,4,4,0,0.5,0.5,1733,1802
1958-10-07,Uganda,Tanzania,2,0,2,1.0,0.0,1625,1460
1958-10-08,Kenya,Zanzibar,4,0,4,1.0,0.0,1536,1447
1958-10-10,Tanzania,Zanzibar,3,2,1,1.0,0.0,1468,1440
1958-10-11,Kenya,Uganda,2,0,2,1.0,0.0,1547,1615
1958-10-12,Czechoslovakia,Bulgaria,0,1,1,0.0,1.0,1662,1555
1958-10-15,Netherlands,Denmark,5,1,4,1.0,0.0,1606,1555
1958-10-15,Spain,Northern Ireland,6,2,4,1.0,0.0,1674,1555
1958-10-16,Réunion,Mauritius,0,2,2,0.0,1.0,1417,1624
1958-10-18,Wales,Scotland,0,3,3,0.0,1.0,1595,1699
1958-10-19,Réunion,Madagascar,1,3,2,0.0,1.0,1411,1500
1958-10-22,England,Russia,5,0,5,1.0,0.0,1778,1679
1958-10-23,Madagascar,Mauritius,3,2,1,1.0,0.0,1511,1614
1958-10-25,Nigeria,Ghana,3,2,1,1.0,0.0,1515,1533
1958-10-26,Belgium,Turkey,1,1,0,0.5,0.5,1575,1580
1958-10-26,France,Germany,2,2,0,0.5,0.5,1708,1718
1958-10-26,Romania,Hungary,1,2,1,0.0,1.0,1576,1806
1958-10-26,Sweden,Denmark,4,4,0,0.5,0.5,1728,1559
1958-11-02,German DR,Norway,4,1,3,1.0,0.0,1516,1558
1958-11-02,Netherlands,Switzerland,2,0,2,1.0,0.0,1613,1540
1958-11-02,Romania,Turkey,3,0,3,1.0,0.0,1585,1572
1958-11-05,Scotland,Northern Ireland,2,2,0,0.5,0.5,1696,1559
1958-11-09,France,Italy,2,2,0,0.5,0.5,1709,1739
1958-11-12,Netherlands,South Africa,9,3,6,1.0,0.0,1621,1586
1958-11-19,Germany,Austria,2,2,0,0.5,0.5,1718,1692
1958-11-23,Hungary,Belgium,3,1,2,1.0,0.0,1810,1572
1958-11-26,England,Wales,2,2,0,0.5,0.5,1775,1599
1958-12-03,Greece,France,1,1,0,0.5,0.5,1442,1704
1958-12-07,Turkey,Bulgaria,0,0,0,0.5,0.5,1572,1556
1958-12-13,Italy,Czechoslovakia,1,1,0,0.5,0.5,1738,1664
1958-12-18,Turkey,Czechoslovakia,1,0,1,1.0,0.0,1583,1654
1958-12-21,Germany,Bulgaria,3,0,3,1.0,0.0,1723,1552
1958-12-25,Hong Kong,Japan,5,2,3,1.0,0.0,1541,1483
1958-12-28,Egypt,Germany,2,1,1,1.0,0.0,1540,1711
1958-12-28,Malaysia,Japan,6,2,4,1.0,0.0,1550,1477
1959-01-04,Malaysia,Japan,1,3,2,0.0,1.0,1541,1487
1959-01-10,Singapore,Japan,3,4,1,0.0,1.0,1455,1495
1959-01-11,Singapore,Japan,3,2,1,1.0,0.0,1464,1487
1959-02-11,Indonesia,German DR,2,2,0,0.5,0.5,1547,1517
1959-02-28,Italy,Spain,1,1,0,0.5,0.5,1737,1676
1959-03-01,France,Belgium,2,2,0,0.5,0.5,1702,1575
1959-03-01,Guyana,Jamaica,2,2,0,0.5,0.5,1455,1510
1959-03-01,Mexico,Costa Rica,3,1,2,1.0,0.0,1623,1678
1959-03-02,Trinidad and Tobago,Barbados,2,0,2,1.0,0.0,1585,1449
1959-03-04,Barbados,Jamaica,1,3,2,0.0,1.0,1443,1517
1959-03-05,Trinidad and Tobago,Guyana,2,1,1,1.0,0.0,1591,1450
1959-03-07,Argentina,Chile,6,1,5,1.0,0.0,1816,1572
1959-03-08,Bolivia,Uruguay,0,7,7,0.0,1.0,1490,1725
1959-03-08,Costa Rica,Mexico,1,2,1,0.0,1.0,1669,1633
1959-03-08,Tunisia,Malta,0,0,0,0.5,0.5,1516,1507
1959-03-09,Barbados,Guyana,2,1,1,1.0,0.0,1452,1442
1959-03-10,Brazil,Peru,2,2,0,0.5,0.5,1820,1600
1959-03-10,Trinidad and Tobago,Jamaica,2,1,1,1.0,0.0,1598,1511
1959-03-11,Argentina,Bolivia,2,0,2,1.0,0.0,1819,1488
1959-03-11,Chile,Paraguay,1,2,1,0.0,1.0,1566,1636
1959-03-11,Martinique,Guadeloupe,3,0,3,1.0,0.0,1551,1478
1959-03-14,Peru,Uruguay,5,3,2,1.0,0.0,1611,1715
1959-03-15,Bolivia,Paraguay,0,5,5,0.0,1.0,1484,1641
1959-03-15,Brazil,Chile,3,0,3,1.0,0.0,1824,1563
1959-03-18,Argentina,Peru,3,1,2,1.0,0.0,1823,1608
1959-03-18,Paraguay,Uruguay,1,3,2,0.0,1.0,1635,1722
1959-03-21,Bolivia,Brazil,2,4,2,0.0,1.0,1483,1826
1959-03-21,Chile,Peru,1,1,0,0.5,0.5,1565,1607
1959-03-22,Argentina,Paraguay,3,1,2,1.0,0.0,1828,1631
1959-03-26,Bolivia,Chile,2,5,3,0.0,1.0,1477,1572
1959-03-26,Brazil,Uruguay,3,1,2,1.0,0.0,1832,1717
1959-03-29,Bolivia,Peru,0,0,0,0.5,0.5,1480,1605
1959-03-29,Brazil,Paraguay,4,1,3,1.0,0.0,1836,1628
1959-03-29,Philippines,Hong Kong,0,7,7,0.0,1.0,1402,1547
1959-03-30,Argentina,Uruguay,4,1,3,1.0,0.0,1834,1712
1959-03-31,Philippines,Taiwan,4,7,3,0.0,1.0,1398,1563
1959-04-02,Chile,Uruguay,1,0,1,1.0,0.0,1584,1701
1959-04-02,Paraguay,Peru,2,1,1,1.0,0.0,1636,1598
1959-04-04,Argentina,Brazil,1,1,0,0.5,0.5,1835,1836
1959-04-05,Republic of Ireland,Czechoslovakia,2,0,2,1.0,0.0,1607,1645
1959-04-09,Jersey,Alderney,6,0,6,1.0,0.0,1622,1340
1959-04-11,England,Scotland,1,0,1,1.0,0.0,1782,1690
1959-04-14,Kenya,Réunion,1,0,1,1.0,0.0,1553,1406
1959-04-19,Hungary,Yugoslavia,4,0,4,1.0,0.0,1817,1727
1959-04-19,Netherlands,Belgium,2,2,0,0.5,0.5,1620,1577
1959-04-22,Northern Ireland,Wales,4,1,3,1.0,0.0,1568,1591
1959-04-26,Switzerland,Yugoslavia,1,5,4,0.0,1.0,1536,1732
1959-04-26,Turkey,Romania,2,0,2,1.0,0.0,1592,1577
1959-04-30,Guernsey,Jersey,2,3,1,0.0,1.0,1625,1631
1959-05-01,German DR,Hungary,0,1,1,0.0,1.0,1515,1820
1959-05-01,Uruguay,Paraguay,1,3,2,0.0,1.0,1692,1646
1959-05-06,England,Italy,2,2,0,0.5,0.5,1781,1739
1959-05-06,Scotland,Germany,3,2,1,1.0,0.0,1699,1703
1959-05-09,Singapore,Vietnam Republic,1,4,3,0.0,1.0,1457,1513
1959-05-10,Czechoslovakia,Republic of Ireland,4,0,4,1.0,0.0,1653,1600
1959-05-10,Turkey,Netherlands,0,0,0,0.5,0.5,1593,1620
1959-05-11,Singapore,Malaysia,2,5,3,0.0,1.0,1451,1548
1959-05-13,Brazil,England,2,0,2,1.0,0.0,1843,1775
1959-05-13,Bulgaria,Netherlands,3,2,1,1.0,0.0,1562,1611
1959-05-13,Malaysia,Vietnam Republic,0,1,1,0.0,1.0,1540,1522
1959-05-16,Switzerland,Portugal,4,3,1,1.0,0.0,1545,1532
1959-05-17,Peru,England,4,1,3,1.0,0.0,1610,1764
1959-05-20,Germany,Poland,1,1,0,0.5,0.5,1700,1523
1959-05-20,Norway,Austria,0,1,1,0.0,1.0,1553,1698
1959-05-21,Martinique,Guadeloupe,1,2,1,0.0,1.0,1542,1488
1959-05-21,Sweden,Portugal,2,0,2,1.0,0.0,1732,1529
1959-05-22,Egypt,Ethiopia,4,0,4,1.0,0.0,1549,1536
1959-05-24,Belgium,Austria,0,2,2,0.0,1.0,1572,1704
1959-05-24,Mexico,England,2,1,1,1.0,0.0,1644,1754
1959-05-25,Ethiopia,Sudan,0,1,1,0.0,1.0,1527,1494
1959-05-27,Netherlands,Scotland,1,2,1,0.0,1.0,1605,1706
1959-05-28,United States,England,1,8,7,0.0,1.0,1455,1757
1959-05-29,Egypt,Sudan,2,1,1,1.0,0.0,1556,1488
1959-05-30,Martinique,Suriname,3,1,2,1.0,0.0,1551,1567
1959-05-31,Martinique,Suriname,3,0,3,1.0,0.0,1560,1559
1959-05-31,Yugoslavia,Bulgaria,2,0,2,1.0,0.0,1737,1558
1959-06-03,Portugal,Scotland,1,0,1,1.0,0.0,1541,1695
1959-06-06,Guadeloupe,Suriname,3,3,0,0.5,0.5,1490,1558
1959-06-07,Guadeloupe,Suriname,3,1,2,1.0,0.0,1500,1549
1959-06-14,Austria,Belgium,4,2,2,1.0,0.0,1710,1567
1959-06-17,Norway,Luxembourg,1,0,1,1.0,0.0,1558,1407
1959-06-21,Denmark,Sweden,0,6,6,0.0,1.0,1555,1737
1959-06-21,German DR,Portugal,0,2,2,0.0,1.0,1508,1549
1959-06-21,Poland,Israel,7,2,5,1.0,0.0,1530,1460
1959-06-28,Finland,Norway,2,4,2,0.0,1.0,1382,1563
1959-06-28,Hungary,Sweden,3,2,1,1.0,0.0,1827,1731
1959-06-28,Poland,Spain,2,4,2,0.0,1.0,1526,1681
1959-06-28,Portugal,German DR,3,2,1,1.0,0.0,1557,1501
1959-07-21,Tahiti,New Caledonia,2,4,2,0.0,1.0,1483,1513
1959-07-22,Tahiti,New Caledonia,3,1,2,1.0,0.0,1492,1505
1959-08-02,Sweden,Finland,3,1,2,1.0,0.0,1733,1381
1959-08-12,German DR,Czechoslovakia,2,1,1,1.0,0.0,1513,1642
1959-08-22,Hong Kong,Taiwan,1,3,2,0.0,1.0,1540,1571
1959-08-30,South Korea,Vietnam Republic,2,3,1,0.0,1.0,1572,1532
1959-08-30,Poland,Romania,2,3,1,0.0,1.0,1520,1584
1959-08-31,India,Singapore,2,0,2,1.0,0.0,1567,1446
1959-09-02,South Korea,Singapore,4,1,3,1.0,0.0,1578,1441
1959-09-02,Malaysia,Vietnam Republic,4,3,1,1.0,0.0,1548,1525
1959-09-03,Japan,Singapore,4,1,3,1.0,0.0,1494,1435
1959-09-04,Malaysia,India,1,1,0,0.5,0.5,1549,1567
1959-09-05,Japan,South Korea,0,0,0,0.5,0.5,1496,1577
1959-09-06,Finland,German DR,3,2,1,1.0,0.0,1392,1503
1959-09-06,India,Vietnam Republic,2,2,0,0.5,0.5,1567,1526
1959-09-06,Japan,South Korea,1,3,2,0.0,1.0,1490,1584
1959-09-06,Russia,Czechoslovakia,3,1,2,1.0,0.0,1687,1635
1959-09-07,Malaysia,South Korea,2,4,2,0.0,1.0,1542,1592
1959-09-08,India,South Korea,1,1,0,0.5,0.5,1568,1592
1959-09-10,Hong Kong,South Korea,2,3,1,0.0,1.0,1534,1599
1959-09-10,India,Vietnam Republic,1,5,4,0.0,1.0,1560,1535
1959-09-11,Singapore,India,2,3,1,0.0,1.0,1430,1566
1959-09-13,Singapore,South Korea,0,4,4,0.0,1.0,1426,1604
1959-09-17,Brazil,Chile,7,0,7,1.0,0.0,1846,1582
1959-09-20,Brazil,Chile,1,0,1,1.0,0.0,1849,1580
1959-09-20,Suriname,Martinique,1,0,1,1.0,0.0,1558,1552
1959-09-23,Austria,Norway,5,2,3,1.0,0.0,1715,1559
1959-09-23,Denmark,Czechoslovakia,2,2,0,0.5,0.5,1557,1634
1959-09-25,Suriname,Martinique,4,1,3,1.0,0.0,1566,1545
1959-09-27,Hungary,Russia,0,1,1,0.0,1.0,1816,1699
1959-10-03,China PR,Russia,0,1,1,0.0,1.0,1598,1705
1959-10-03,Northern Ireland,Scotland,0,4,4,0.0,1.0,1563,1701
1959-10-03,Tanzania,Zanzibar,2,2,0,0.5,0.5,1468,1441
1959-10-04,Denmark,Finland,4,0,4,1.0,0.0,1562,1388
1959-10-04,Kenya,Uganda,0,0,0,0.5,0.5,1555,1614
1959-10-04,Netherlands,Belgium,9,1,8,1.0,0.0,1613,1560
1959-10-04,Switzerland,Germany,0,4,4,0.0,1.0,1541,1705
1959-10-06,Tanzania,Uganda,2,2,0,0.5,0.5,1472,1611
1959-10-07,Kenya,Zanzibar,5,0,5,1.0,0.0,1561,1436
1959-10-09,Zanzibar,Uganda,1,0,1,1.0,0.0,1448,1600
1959-10-10,Tanzania,Kenya,0,2,2,0.0,1.0,1467,1567
1959-10-11,Bulgaria,France,1,0,1,1.0,0.0,1570,1691
1959-10-11,Yugoslavia,Hungary,2,4,2,0.0,1.0,1731,1823
1959-10-14,Spain,Poland,3,0,3,1.0,0.0,1686,1516
1959-10-17,Wales,England,1,1,0,0.5,0.5,1595,1754
1959-10-18,Czechoslovakia,Denmark,5,1,4,1.0,0.0,1641,1556
1959-10-18,Sweden,Norway,6,2,4,1.0,0.0,1738,1555
1959-10-21,Germany,Netherlands,7,0,7,1.0,0.0,1711,1608
1959-10-22,North Korea,North Vietnam,5,0,5,1.0,0.0,1527,1481
1959-10-25,Bulgaria,Yugoslavia,1,1,0,0.5,0.5,1574,1728
1959-10-25,Hungary,Switzerland,8,0,8,1.0,0.0,1826,1539
1959-10-25,North Korea,China PR,1,0,1,1.0,0.0,1537,1589
1959-10-28,China PR,North Vietnam,2,0,2,1.0,0.0,1595,1476
1959-10-28,England,Sweden,2,3,1,0.0,1.0,1746,1747
1959-11-01,Czechoslovakia,Italy,2,1,1,1.0,0.0,1652,1729
1959-11-01,Republic of Ireland,Sweden,3,2,1,1.0,0.0,1612,1736
1959-11-04,Netherlands,Norway,7,1,6,1.0,0.0,1615,1549
1959-11-08,Benin,Nigeria,0,1,1,0.0,1.0,1493,1523
1959-11-08,Hungary,Germany,4,3,1,1.0,0.0,1832,1706
1959-11-11,France,Portugal,5,3,2,1.0,0.0,1697,1552
1959-11-18,Chile,Argentina,4,2,2,1.0,0.0,1594,1822
1959-11-18,England,Northern Ireland,2,1,1,1.0,0.0,1751,1559
1959-11-21,Ghana,Nigeria,5,2,3,1.0,0.0,1541,1516
1959-11-22,Spain,Austria,6,3,3,1.0,0.0,1695,1707
1959-11-28,Nigeria,Benin,10,1,9,1.0,0.0,1524,1486
1959-11-29,Israel,Poland,1,1,0,0.5,0.5,1462,1515
1959-11-29,Italy,Hungary,1,1,0,0.5,0.5,1732,1830
1959-12-02,Greece,Denmark,1,3,2,0.0,1.0,1437,1562
1959-12-05,Brazil,Paraguay,3,2,1,1.0,0.0,1853,1643
1959-12-05,Iran,Israel,3,0,3,1.0,0.0,1504,1455
1959-12-06,Bulgaria,Denmark,2,1,1,1.0,0.0,1582,1555
1959-12-06,Ecuador,Uruguay,0,4,4,0.0,1.0,1362,1695
1959-12-06,India,Pakistan,1,0,1,1.0,0.0,1573,1510
1959-12-08,India,Israel,1,3,2,0.0,1.0,1563,1466
1959-12-09,Argentina,Paraguay,4,2,2,1.0,0.0,1827,1639
1959-12-10,Israel,Pakistan,2,0,2,1.0,0.0,1476,1501
1959-12-12,Brazil,Uruguay,0,3,3,0.0,1.0,1842,1707
1959-12-12,Ecuador,Argentina,1,1,0,0.5,0.5,1369,1821
1959-12-12,Israel,Iran,1,1,0,0.5,0.5,1477,1504
1959-12-13,El Salvador,Honduras,1,0,1,1.0,0.0,1534,1510
1959-12-13,France,Austria,5,2,3,1.0,0.0,1706,1699
1959-12-13,Malaysia,Myanmar,2,1,1,1.0,0.0,1549,1466
1959-12-13,Thailand,Vietnam Republic,0,4,4,0.0,1.0,1458,1542
1959-12-14,Costa Rica,Honduras,6,1,5,1.0,0.0,1674,1506
1959-12-14,Vietnam Republic,Myanmar,3,0,3,1.0,0.0,1549,1460
1959-12-14,Thailand,Malaysia,3,1,2,1.0,0.0,1469,1539
1959-12-15,Malaysia,Vietnam Republic,2,1,1,1.0,0.0,1548,1541
1959-12-15,Thailand,Myanmar,5,2,3,1.0,0.0,1477,1453
1959-12-16,Argentina,Uruguay,0,5,5,0.0,1.0,1811,1718
1959-12-17,France,Spain,4,3,1,1.0,0.0,1714,1688
1959-12-17,Pakistan,Israel,2,2,0,0.5,0.5,1501,1478
1959-12-17,Thailand,Vietnam Republic,1,3,2,0.0,1.0,1471,1548
1959-12-19,Ecuador,Brazil,1,3,2,0.0,1.0,1369,1843
1959-12-20,Gambia,Cape Verde,3,2,1,1.0,0.0,1494,1492
1959-12-20,Germany,Yugoslavia,1,1,0,0.5,0.5,1707,1728
1959-12-22,Argentina,Brazil,4,1,3,1.0,0.0,1820,1835
1959-12-22,Paraguay,Uruguay,1,1,0,0.5,0.5,1641,1717
1959-12-25,Ecuador,Paraguay,3,1,2,1.0,0.0,1383,1628
1959-12-27,Ecuador,Brazil,1,2,1,0.0,1.0,1382,1837
1960-01-01,Morocco,Yugoslavia,0,5,5,0.0,1.0,1505,1732
1960-01-03,Tunisia,Yugoslavia,1,5,4,0.0,1.0,1513,1736
1960-01-06,Italy,Switzerland,3,0,3,1.0,0.0,1736,1536
1960-01-08,Egypt,Yugoslavia,0,1,1,0.0,1.0,1552,1741
1960-01-27,Guinea-Bissau,Gambia,3,2,1,1.0,0.0,1525,1487
1960-01-31,Guinea-Bissau,Sierra Leone,3,4,1,0.0,1.0,1516,1484
1960-02-07,Ghana,Sierra Leone,6,2,4,1.0,0.0,1548,1478
1960-02-14,Costa Rica,Curaçao,1,1,0,0.5,0.5,1673,1610
1960-02-19,Honduras,Curaçao,3,3,0,0.5,0.5,1509,1608
1960-02-20,Martinique,Guadeloupe,2,2,0,0.5,0.5,1544,1502
1960-02-23,Cuba,Curaçao,3,4,1,0.0,1.0,1439,1613
1960-02-27,Curaçao,Suriname,1,0,1,1.0,0.0,1620,1560
1960-02-28,Belgium,France,1,0,1,1.0,0.0,1572,1703
1960-02-29,Costa Rica,Curaçao,4,0,4,1.0,0.0,1680,1614
1960-03-06,Brazil,Mexico,2,2,0,0.5,0.5,1833,1649
1960-03-08,Costa Rica,Argentina,0,0,0,0.5,0.5,1684,1817
1960-03-10,Argentina,Mexico,3,2,1,1.0,0.0,1822,1645
1960-03-10,Costa Rica,Brazil,3,0,3,1.0,0.0,1696,1822
1960-03-13,Argentina,Brazil,2,1,1,1.0,0.0,1830,1814
1960-03-13,Spain,Italy,3,1,2,1.0,0.0,1698,1727
1960-03-15,Brazil,Mexico,2,1,1,1.0,0.0,1819,1641
1960-03-15,Costa Rica,Argentina,0,2,2,0.0,1.0,1691,1836
1960-03-16,France,Chile,6,0,6,1.0,0.0,1709,1589
1960-03-17,Argentina,Mexico,2,0,2,1.0,0.0,1840,1638
1960-03-17,Costa Rica,Brazil,0,4,4,0.0,1.0,1686,1825
1960-03-20,Argentina,Brazil,0,1,1,0.0,1.0,1832,1834
1960-03-23,Germany,Chile,2,1,1,1.0,0.0,1713,1584
1960-03-27,Austria,France,2,4,2,0.0,1.0,1692,1717
1960-03-27,Belgium,Switzerland,3,1,2,1.0,0.0,1580,1529
1960-03-30,Republic of Ireland,Chile,2,0,2,1.0,0.0,1620,1577
1960-03-31,Guernsey,Alderney,5,1,4,1.0,0.0,1628,1338
1960-04-03,Netherlands,Bulgaria,4,2,2,1.0,0.0,1623,1575
1960-04-06,Switzerland,Chile,4,2,2,1.0,0.0,1539,1568
1960-04-06,Wales,Northern Ireland,3,2,1,1.0,0.0,1603,1552
1960-04-09,Scotland,England,1,1,0,0.5,0.5,1703,1750
1960-04-13,Belgium,Chile,1,1,0,0.5,0.5,1580,1569
1960-04-14,Cameroon,Djibouti,9,2,7,1.0,0.0,1508,1453
1960-04-14,Central African Republic,Mali,3,4,1,0.0,1.0,1492,1508
1960-04-14,Gabon,Burkina Faso,4,5,1,0.0,1.0,1492,1508
1960-04-14,Ivory Coast,Benin,3,2,1,1.0,0.0,1508,1479
1960-04-14,Ivory Coast,Benin,3,2,1,1.0,0.0,1516,1472
1960-04-14,Burkina Faso,Gabon,5,4,1,1.0,0.0,1516,1485
1960-04-14,Congo,Réunion,4,1,3,1.0,0.0,1506,1401
1960-04-14,Cameroon,Djibouti,9,2,7,1.0,0.0,1515,1447
1960-04-14,Mali,Central African Republic,4,3,1,1.0,0.0,1516,1485
1960-04-15,Cameroon,Mali,3,2,1,1.0,0.0,1524,1508
1960-04-15,Congo,Ivory Coast,3,2,1,1.0,0.0,1515,1508
1960-04-15,Madagascar,Burkina Faso,6,1,5,1.0,0.0,1520,1508
1960-04-15,Madagascar,Burkina Faso,6,1,5,1.0,0.0,1528,1501
1960-04-15,Cameroon,Mali,3,2,1,1.0,0.0,1532,1501
1960-04-15,Congo,Ivory Coast,3,2,1,1.0,0.0,1523,1501
1960-04-17,Congo,Cameroon,4,5,1,0.0,1.0,1516,1540
1960-04-17,Cameroon,Congo,5,4,1,1.0,0.0,1548,1509
1960-04-18,Madagascar,Congo,8,1,7,1.0,0.0,1536,1502
1960-04-20,Indonesia,Malaysia,5,0,5,1.0,0.0,1556,1540
1960-04-24,Belgium,Netherlands,2,1,1,1.0,0.0,1589,1615
1960-04-24,Togo,Nigeria,1,1,0,0.5,0.5,1495,1524
1960-04-26,Cameroon,Nigeria,0,0,0,0.5,0.5,1548,1525
1960-04-27,Germany,Portugal,2,1,1,1.0,0.0,1718,1548
1960-04-29,Egypt,Brazil,0,5,5,0.0,1.0,1550,1837
1960-05-01,Czechoslovakia,Austria,4,0,4,1.0,0.0,1661,1684
1960-05-01,Egypt,Brazil,1,3,2,0.0,1.0,1548,1840
1960-05-01,Togo,Ghana,2,3,1,0.0,1.0,1489,1555
1960-05-04,Scotland,Poland,2,3,1,0.0,1.0,1692,1527
1960-05-05,Singapore,India,3,0,3,1.0,0.0,1438,1552
1960-05-05,Jersey,Guernsey,5,1,4,1.0,0.0,1639,1621
1960-05-06,Egypt,Brazil,0,3,3,0.0,1.0,1546,1843
1960-05-06,Malaysia,India,0,0,0,0.5,0.5,1541,1552
1960-05-08,Portugal,Yugoslavia,2,1,1,1.0,0.0,1561,1729
1960-05-10,Denmark,Brazil,3,4,1,0.0,1.0,1553,1846
1960-05-11,England,Yugoslavia,3,3,0,0.5,0.5,1750,1730
1960-05-11,Germany,Republic of Ireland,0,1,1,0.0,1.0,1708,1631
1960-05-15,Spain,England,3,0,3,1.0,0.0,1708,1741
1960-05-18,Sweden,Republic of Ireland,4,1,3,1.0,0.0,1742,1626
1960-05-18,Switzerland,Netherlands,3,1,2,1.0,0.0,1549,1606
1960-05-19,Russia,Poland,7,1,6,1.0,0.0,1710,1523
1960-05-22,Bulgaria,Belgium,4,1,3,1.0,0.0,1584,1581
1960-05-22,Hungary,England,2,0,2,1.0,0.0,1836,1736
1960-05-22,Romania,Czechoslovakia,0,2,2,0.0,1.0,1578,1668
1960-05-22,Yugoslavia,Portugal,5,1,4,1.0,0.0,1735,1557
1960-05-26,Argentina,Brazil,4,2,2,1.0,0.0,1841,1838
1960-05-26,Denmark,Norway,3,0,3,1.0,0.0,1561,1542
1960-05-29,Argentina,Brazil,1,4,3,0.0,1.0,1833,1847
1960-05-29,Austria,Scotland,4,1,3,1.0,0.0,1693,1684
1960-05-29,Czechoslovakia,Romania,3,0,3,1.0,0.0,1674,1573
1960-06-01,Chile,Uruguay,2,3,1,0.0,1.0,1565,1722
1960-06-01,Mali,Nigeria,3,2,1,1.0,0.0,1510,1517
1960-06-05,Hungary,Scotland,3,3,0,0.5,0.5,1833,1688
1960-06-05,Tunisia,Iraq,2,1,1,1.0,0.0,1521,1493
1960-06-05,Uruguay,Chile,2,2,0,0.5,0.5,1719,1569
1960-06-08,Turkey,Scotland,4,2,2,1.0,0.0,1604,1678
1960-06-09,Norway,Iceland,4,0,4,1.0,0.0,1549,1452
1960-06-16,Martinique,Guadeloupe,1,0,1,1.0,0.0,1552,1495
1960-06-22,Finland,Sweden,0,3,3,0.0,1.0,1387,1744
1960-06-22,Norway,Austria,1,2,1,0.0,1.0,1545,1698
1960-06-26,Mexico,Netherlands,3,1,2,1.0,0.0,1646,1599
1960-06-26,Poland,Bulgaria,4,0,4,1.0,0.0,1533,1575
1960-06-29,Brazil,Chile,4,0,4,1.0,0.0,1850,1567
1960-06-29,Curaçao,Netherlands,0,0,0,0.5,0.5,1614,1600
1960-07-03,Denmark,Greece,7,2,5,1.0,0.0,1567,1432
1960-07-03,Ghana,Egypt,2,2,0,0.5,0.5,1555,1547
1960-07-03,Paraguay,Brazil,1,2,1,0.0,1.0,1625,1854
1960-07-03,Suriname,Netherlands,3,4,1,0.0,1.0,1553,1608
1960-07-06,Czechoslovakia,Russia,0,3,3,0.0,1.0,1667,1718
1960-07-06,France,Yugoslavia,4,5,1,0.0,1.0,1710,1743
1960-07-09,Argentina,Paraguay,1,0,1,1.0,0.0,1837,1622
1960-07-09,France,Czechoslovakia,0,2,2,0.0,1.0,1702,1676
1960-07-09,Uruguay,Brazil,1,0,1,1.0,0.0,1730,1844
1960-07-10,Bulgaria,German DR,2,0,2,1.0,0.0,1582,1497
1960-07-10,Mali,Sierra Leone,1,0,1,1.0,0.0,1518,1471
1960-07-10,Peru,Spain,1,3,2,0.0,1.0,1605,1714
1960-07-10,Russia,Yugoslavia,2,1,1,1.0,0.0,1727,1735
1960-07-12,Brazil,Argentina,5,1,4,1.0,0.0,1852,1830
1960-07-13,Uruguay,Paraguay,2,1,1,1.0,0.0,1736,1617
1960-07-14,Chile,Spain,0,4,4,0.0,1.0,1563,1719
1960-07-17,Chile,Spain,1,4,3,0.0,1.0,1559,1724
1960-07-24,Argentina,Spain,2,0,2,1.0,0.0,1836,1719
1960-08-03,Iceland,Germany,0,5,5,0.0,1.0,1450,1711
1960-08-05,Malaysia,Japan,3,0,3,1.0,0.0,1548,1484
1960-08-05,Pakistan,Thailand,7,0,7,1.0,0.0,1509,1464
1960-08-06,South Korea,Indonesia,2,0,2,1.0,0.0,1611,1550
1960-08-06,Yugoslavia,Tunisia,7,0,7,1.0,0.0,1739,1518
1960-08-07,Malaysia,Thailand,8,2,6,1.0,0.0,1555,1458
1960-08-07,Vietnam Republic,Singapore,2,1,1,1.0,0.0,1554,1433
1960-08-08,Indonesia,Singapore,8,3,5,1.0,0.0,1556,1428
1960-08-10,Denmark,Finland,2,1,1,1.0,0.0,1572,1383
1960-08-10,Vietnam Republic,South Korea,0,0,0,0.5,0.5,1556,1610
1960-08-10,Pakistan,Japan,3,1,2,1.0,0.0,1517,1477
1960-08-11,South Korea,Singapore,3,3,0,0.5,0.5,1607,1432
1960-08-12,Japan,Thailand,3,1,2,1.0,0.0,1485,1451
1960-08-12,Malaysia,Pakistan,1,0,1,1.0,0.0,1563,1510
1960-08-13,Indonesia,Vietnam Republic,5,3,2,1.0,0.0,1564,1548
1960-08-14,Indonesia,Pakistan,4,0,4,1.0,0.0,1571,1504
1960-08-14,Malaysia,South Korea,0,0,0,0.5,0.5,1565,1606
1960-08-17,Argentina,Uruguay,4,0,4,1.0,0.0,1842,1731
1960-08-17,German DR,Russia,0,1,1,0.0,1.0,1494,1731
1960-08-17,Indonesia,Vietnam Republic,1,1,0,0.5,0.5,1571,1549
1960-08-18,Pakistan,Vietnam Republic,2,2,0,0.5,0.5,1506,1548
1960-08-19,Singapore,Pakistan,4,1,3,1.0,0.0,1442,1497
1960-08-21,Costa Rica,Guatemala,3,2,1,1.0,0.0,1691,1502
1960-08-21,India,Tunisia,2,2,0,0.5,0.5,1552,1519
1960-08-21,Indonesia,Pakistan,5,2,3,1.0,0.0,1578,1491
1960-08-28,Ghana,Nigeria,4,1,3,1.0,0.0,1563,1510
1960-08-28,Guatemala,Costa Rica,4,4,0,0.5,0.5,1506,1688
1960-08-28,Norway,Finland,6,3,3,1.0,0.0,1550,1379
1960-09-04,Austria,Russia,3,1,2,1.0,0.0,1707,1723
1960-09-04,Honduras,Costa Rica,2,1,1,1.0,0.0,1521,1677
1960-09-05,Tahiti,New Zealand,1,5,4,0.0,1.0,1485,1522
1960-09-10,Nigeria,Ghana,2,2,0,0.5,0.5,1512,1562
1960-09-11,Costa Rica,Honduras,5,0,5,1.0,0.0,1682,1517
1960-09-12,Tahiti,New Zealand,1,2,1,0.0,1.0,1478,1530
1960-09-18,Norway,Sweden,3,1,2,1.0,0.0,1563,1732
1960-09-18,Trinidad and Tobago,Martinique,1,1,0,0.5,0.5,1597,1554
1960-09-20,Trinidad and Tobago,Martinique,1,1,0,0.5,0.5,1597,1555
1960-09-22,Trinidad and Tobago,Martinique,3,1,2,1.0,0.0,1605,1548
1960-09-24,Trinidad and Tobago,Martinique,0,0,0,0.5,0.5,1604,1550
1960-09-25,Finland,France,1,2,1,0.0,1.0,1377,1705
1960-09-25,Honduras,Guatemala,1,1,0,0.5,0.5,1517,1507
1960-09-28,Republic of Ireland,Wales,2,3,1,0.0,1.0,1618,1612
1960-09-28,Poland,France,2,2,0,0.5,0.5,1537,1702
1960-10-02,Belgium,Netherlands,1,4,3,0.0,1.0,1574,1616
1960-10-02,Ghana,Mali,5,1,4,1.0,0.0,1569,1512
1960-10-02,Nigeria,Guinea-Bissau,4,1,3,1.0,0.0,1521,1508
1960-10-02,Suriname,Curaçao,1,2,1,0.0,1.0,1547,1621
1960-10-03,North Vietnam,Mongolia,3,1,2,1.0,0.0,1485,1485
1960-10-04,China PR,North Korea,1,0,1,1.0,0.0,1602,1531
1960-10-05,Nigeria,Mali,2,3,1,0.0,1.0,1513,1521
1960-10-07,China PR,Mongolia,6,1,5,1.0,0.0,1608,1480
1960-10-08,North Vietnam,North Korea,1,3,2,0.0,1.0,1479,1538
1960-10-08,Northern Ireland,England,2,5,3,0.0,1.0,1548,1741
1960-10-08,Uganda,Tanzania,1,0,1,1.0,0.0,1606,1462
1960-10-09,Hungary,Yugoslavia,1,1,0,0.5,0.5,1831,1742
1960-10-09,Nigeria,Ghana,0,3,3,0.0,1.0,1507,1576
1960-10-10,Kenya,Zanzibar,4,1,3,1.0,0.0,1573,1443
1960-10-10,Mongolia,North Korea,1,10,9,0.0,1.0,1474,1545
1960-10-11,North Vietnam,China PR,3,4,1,0.0,1.0,1474,1614
1960-10-11,Uganda,Zanzibar,3,0,3,1.0,0.0,1611,1439
1960-10-12,Kenya,Tanzania,5,0,5,1.0,0.0,1579,1457
1960-10-12,Switzerland,France,6,2,4,1.0,0.0,1561,1691
1960-10-14,South Korea,Vietnam Republic,5,1,4,1.0,0.0,1613,1542
1960-10-14,Tanzania,Zanzibar,4,2,2,1.0,0.0,1465,1432
1960-10-15,Uganda,Kenya,1,1,0,0.5,0.5,1611,1580
1960-10-16,Taiwan,Vietnam Republic,2,0,2,1.0,0.0,1579,1535
1960-10-17,South Korea,Israel,3,0,3,1.0,0.0,1619,1473
1960-10-19,Israel,Vietnam Republic,5,1,4,1.0,0.0,1483,1526
1960-10-19,Luxembourg,England,0,9,9,0.0,1.0,1405,1744
1960-10-19,Sweden,Belgium,2,0,2,1.0,0.0,1737,1570
1960-10-21,South Korea,Taiwan,1,0,1,1.0,0.0,1627,1572
1960-10-22,Wales,Scotland,2,0,2,1.0,0.0,1622,1669
1960-10-23,Sweden,Denmark,2,0,2,1.0,0.0,1742,1568
1960-10-23,Israel,Taiwan,1,0,1,1.0,0.0,1494,1562
1960-10-26,England,Spain,4,2,2,1.0,0.0,1752,1712
1960-10-26,Northern Ireland,Germany,3,4,1,0.0,1.0,1544,1716
1960-10-29,Nigeria,Ghana,1,1,0,0.5,0.5,1509,1575
1960-10-30,Austria,Spain,3,0,3,1.0,0.0,1716,1704
1960-10-30,Belgium,Hungary,2,1,1,1.0,0.0,1584,1818
1960-10-30,Czechoslovakia,Netherlands,4,0,4,1.0,0.0,1683,1610
1960-10-30,German DR,Finland,5,1,4,1.0,0.0,1500,1372
1960-10-30,Morocco,Tunisia,2,1,1,1.0,0.0,1514,1511
1960-10-30,Sweden,France,1,0,1,1.0,0.0,1749,1685
1960-11-03,United States,Mexico,3,3,0,0.5,0.5,1460,1642
1960-11-06,Republic of Ireland,Norway,3,1,2,1.0,0.0,1625,1557
1960-11-06,South Korea,Japan,2,1,1,1.0,0.0,1632,1481
1960-11-06,Mexico,United States,3,0,3,1.0,0.0,1647,1456
1960-11-09,Scotland,Northern Ireland,5,2,3,1.0,0.0,1675,1539
1960-11-13,Cyprus,Israel,1,1,0,0.5,0.5,1493,1494
1960-11-13,Hungary,Poland,4,1,3,1.0,0.0,1821,1535
1960-11-13,Tunisia,Morocco,2,1,1,1.0,0.0,1520,1506
1960-11-20,Belgium,Switzerland,2,4,2,0.0,1.0,1576,1570
1960-11-20,Greece,Germany,0,3,3,0.0,1.0,1430,1719
1960-11-20,Hungary,Austria,2,0,2,1.0,0.0,1827,1711
1960-11-23,Bulgaria,Germany,2,1,1,1.0,0.0,1594,1708
1960-11-23,England,Wales,5,1,4,1.0,0.0,1758,1617
1960-11-27,Bulgaria,Turkey,2,1,1,1.0,0.0,1603,1596
1960-11-27,Curaçao,Suriname,0,0,0,0.5,0.5,1620,1549
1960-11-27,Israel,Cyprus,6,1,5,1.0,0.0,1502,1486
1960-12-04,Ecuador,Argentina,3,6,3,0.0,1.0,1381,1844
1960-12-04,Tunisia,German DR,0,3,3,0.0,1.0,1512,1509
1960-12-08,Malta,Tunisia,1,0,1,1.0,0.0,1516,1504
1960-12-10,Italy,Austria,1,2,1,0.0,1.0,1719,1720
1960-12-11,France,Bulgaria,3,0,3,1.0,0.0,1692,1597
1960-12-11,Morocco,German DR,2,3,1,0.0,1.0,1499,1517
1960-12-17,Argentina,Ecuador,5,0,5,1.0,0.0,1846,1380
1960-12-18,Chile,Paraguay,4,1,3,1.0,0.0,1569,1608
1960-12-21,Chile,Paraguay,3,1,2,1.0,0.0,1578,1600
1960-12-23,Iraq,Tunisia,3,2,1,1.0,0.0,1502,1496
1961-01-14,Costa Rica,Honduras,1,0,1,1.0,0.0,1687,1513
1961-01-15,Saint Lucia,Dominica,4,1,3,1.0,0.0,1504,1502
1961-01-16,Grenada,Saint Vincent and the Grenadines,3,6,3,0.0,1.0,1505,1509
1961-01-17,Saint Lucia,Grenada,0,4,4,0.0,1.0,1497,1513
1961-01-18,Dominica,Saint Vincent and the Grenadines,1,1,0,0.5,0.5,1503,1509
1961-01-19,Dominica,Grenada,1,8,7,0.0,1.0,1496,1521
1961-01-20,Saint Lucia,Saint Vincent and the Grenadines,2,2,0,0.5,0.5,1498,1509
1961-01-22,Morocco,Tunisia,1,1,0,0.5,0.5,1499,1497
1961-02-05,Colombia,United States,2,0,2,1.0,0.0,1469,1449
1961-02-17,Egypt,Hungary,0,2,2,0.0,1.0,1545,1830
1961-03-05,Costa Rica,Cuba,4,1,3,1.0,0.0,1691,1436
1961-03-05,Ghana,Mali,3,0,3,1.0,0.0,1582,1515
1961-03-06,Curaçao,El Salvador,0,0,0,0.5,0.5,1619,1536
1961-03-07,Cuba,Haiti,1,2,1,0.0,1.0,1431,1555
1961-03-08,Germany,Belgium,1,0,1,1.0,0.0,1714,1571
1961-03-09,Guatemala,Haiti,1,3,2,0.0,1.0,1501,1562
1961-03-10,Cuba,Panama,0,1,1,0.0,1.0,1424,1464
1961-03-10,Curaçao,Honduras,2,4,2,0.0,1.0,1609,1524
1961-03-12,Cuba,Guatemala,0,2,2,0.0,1.0,1418,1508
1961-03-13,Curaçao,Nicaragua,2,1,1,1.0,0.0,1613,1386
1961-03-13,Haiti,Panama,3,1,2,1.0,0.0,1568,1459
1961-03-14,Israel,Ethiopia,1,0,1,1.0,0.0,1511,1519
1961-03-15,France,Belgium,1,1,0,0.5,0.5,1690,1574
1961-03-17,Haiti,Honduras,0,2,2,0.0,1.0,1559,1534
1961-03-19,Chile,Peru,5,2,3,1.0,0.0,1587,1597
1961-03-19,Israel,Ethiopia,3,2,1,1.0,0.0,1520,1511
1961-03-19,Panama,Paraguay,0,0,0,0.5,0.5,1463,1597
1961-03-19,Portugal,Luxembourg,6,0,6,1.0,0.0,1562,1401
1961-03-22,Costa Rica,Mexico,1,0,1,1.0,0.0,1698,1641
1961-03-22,Netherlands,Belgium,6,2,4,1.0,0.0,1618,1567
1961-03-22,Panama,Haiti,0,3,3,0.0,1.0,1458,1565
1961-03-23,Panama,Haiti,0,2,2,0.0,1.0,1453,1571
1961-03-26,Chile,Germany,3,1,2,1.0,0.0,1598,1704
1961-03-26,Czechoslovakia,Sweden,2,1,1,1.0,0.0,1693,1740
1961-03-29,Costa Rica,Curaçao,6,0,6,1.0,0.0,1705,1607
1961-04-02,Ghana,Morocco,0,0,0,0.5,0.5,1581,1501
1961-04-02,Spain,France,2,0,2,1.0,0.0,1712,1683
1961-04-05,Mexico,Curaçao,7,0,7,1.0,0.0,1649,1600
1961-04-08,Nigeria,Ghana,0,0,0,0.5,0.5,1511,1580
1961-04-11,Martinique,Guadeloupe,2,2,0,0.5,0.5,1549,1497
1961-04-12,Mexico,Costa Rica,4,1,3,1.0,0.0,1659,1696
1961-04-12,Northern Ireland,Wales,1,5,4,0.0,1.0,1533,1624
1961-04-13,Jersey,Alderney,4,2,2,1.0,0.0,1642,1336
1961-04-15,England,Scotland,9,3,6,1.0,0.0,1765,1669
1961-04-16,Hungary,German DR,2,0,2,1.0,0.0,1833,1515
1961-04-19,Netherlands,Mexico,1,2,1,0.0,1.0,1611,1667
1961-04-19,Wales,Spain,1,2,1,0.0,1.0,1618,1719
1961-04-22,Sierra Leone,Nigeria,1,4,3,0.0,1.0,1464,1519
1961-04-23,Curaçao,Costa Rica,2,0,2,1.0,0.0,1611,1686
1961-04-25,Italy,Northern Ireland,3,2,1,1.0,0.0,1724,1529
1961-04-29,Czechoslovakia,Mexico,2,1,1,1.0,0.0,1701,1660
1961-04-30,Colombia,Peru,1,0,1,1.0,0.0,1480,1587
1961-04-30,Ghana,Nigeria,2,2,0,0.5,0.5,1579,1521
1961-04-30,Netherlands,Hungary,0,3,3,0.0,1.0,1608,1837
1961-04-30,Paraguay,Brazil,0,2,2,0.0,1.0,1595,1855
1961-05-03,Greece,Northern Ireland,2,1,1,1.0,0.0,1441,1519
1961-05-03,Paraguay,Brazil,2,3,1,0.0,1.0,1593,1858
1961-05-03,Scotland,Republic of Ireland,4,1,3,1.0,0.0,1676,1619
1961-05-04,Guernsey,Jersey,1,2,1,0.0,1.0,1614,1650
1961-05-07,Chile,Brazil,1,2,1,0.0,1.0,1596,1861
1961-05-07,Republic of Ireland,Scotland,0,3,3,0.0,1.0,1613,1683
1961-05-07,Peru,Colombia,1,1,0,0.5,0.5,1585,1483
1961-05-07,Yugoslavia,Hungary,2,4,2,0.0,1.0,1737,1843
1961-05-10,England,Mexico,8,0,8,1.0,0.0,1771,1655
1961-05-10,Germany,Northern Ireland,2,1,1,1.0,0.0,1709,1515
1961-05-11,Chile,Brazil,0,1,1,0.0,1.0,1594,1864
1961-05-14,Czechoslovakia,Scotland,4,0,4,1.0,0.0,1709,1676
1961-05-14,German DR,Netherlands,1,1,0,0.5,0.5,1518,1606
1961-05-14,Turkey,Romania,0,1,1,0.0,1.0,1588,1582
1961-05-16,Norway,Mexico,1,1,0,0.5,0.5,1560,1653
1961-05-17,Paraguay,Argentina,0,0,0,0.5,0.5,1598,1842
1961-05-18,Spain,Wales,1,1,0,0.5,0.5,1717,1621
1961-05-20,Switzerland,Belgium,2,1,1,1.0,0.0,1578,1560
1961-05-21,Curaçao,Mexico,0,0,0,0.5,0.5,1612,1653
1961-05-21,Poland,Russia,1,0,1,1.0,0.0,1547,1712
1961-05-21,Portugal,England,1,1,0,0.5,0.5,1567,1767
1961-05-24,Italy,England,2,3,1,0.0,1.0,1717,1775
1961-05-27,Austria,England,3,1,2,1.0,0.0,1730,1766
1961-05-28,Denmark,German DR,1,1,0,0.5,0.5,1567,1520
1961-05-28,Hungary,Wales,3,2,1,1.0,0.0,1847,1618
1961-05-28,Japan,Malaysia,3,2,1,1.0,0.0,1491,1556
1961-05-28,Morocco,Ghana,1,0,1,1.0,0.0,1511,1570
1961-05-28,Sweden,Switzerland,4,0,4,1.0,0.0,1745,1574
1961-06-01,Ghana,Nigeria,3,0,3,1.0,0.0,1577,1515
1961-06-01,Norway,Turkey,0,1,1,0.0,1.0,1553,1596
1961-06-04,Portugal,Argentina,0,2,2,0.0,1.0,1565,1845
1961-06-04,Yugoslavia,Poland,2,1,1,1.0,0.0,1742,1543
1961-06-11,Hungary,Austria,1,2,1,0.0,1.0,1837,1741
1961-06-11,Japan,South Korea,0,2,2,0.0,1.0,1487,1637
1961-06-11,Spain,Argentina,2,0,2,1.0,0.0,1728,1835
1961-06-15,Italy,Argentina,4,1,3,1.0,0.0,1728,1825
1961-06-16,Finland,Bulgaria,0,2,2,0.0,1.0,1369,1601
1961-06-18,Denmark,Sweden,1,2,1,0.0,1.0,1563,1750
1961-06-18,Russia,Turkey,1,0,1,1.0,0.0,1718,1591
1961-06-18,Yugoslavia,Morocco,3,2,1,1.0,0.0,1746,1508
1961-06-19,Czechoslovakia,Argentina,3,3,0,0.5,0.5,1712,1823
1961-06-21,German DR,Morocco,1,2,1,0.0,1.0,1512,1517
1961-06-24,Russia,Argentina,0,0,0,0.5,0.5,1721,1821
1961-06-25,Poland,Yugoslavia,1,1,0,0.5,0.5,1548,1742
1961-06-27,Finland,Norway,4,1,3,1.0,0.0,1381,1542
1961-06-29,Brazil,Paraguay,3,2,1,1.0,0.0,1867,1596
1961-07-01,Russia,Norway,5,2,3,1.0,0.0,1726,1538
1961-07-15,Bolivia,Uruguay,1,1,0,0.5,0.5,1485,1727
1961-07-30,Uruguay,Bolivia,2,1,1,1.0,0.0,1731,1482
1961-08-02,Indonesia,Singapore,1,0,1,1.0,0.0,1584,1437
1961-08-02,Malaysia,Japan,3,2,1,1.0,0.0,1563,1481
1961-08-03,India,Vietnam Republic,1,2,1,0.0,1.0,1544,1535
1961-08-05,Kenya,Uganda,0,1,1,0.0,1.0,1573,1619
1961-08-05,Malaysia,Vietnam Republic,3,1,2,1.0,0.0,1571,1528
1961-08-06,Hong Kong,Thailand,2,1,1,1.0,0.0,1541,1445
1961-08-06,India,Japan,1,3,2,0.0,1.0,1535,1491
1961-08-09,Indonesia,Thailand,2,1,1,1.0,0.0,1589,1441
1961-08-09,Malaysia,India,1,2,1,0.0,1.0,1563,1544
1961-08-09,Sweden,Finland,4,0,4,1.0,0.0,1752,1380
1961-08-10,Japan,Vietnam Republic,2,3,1,0.0,1.0,1484,1536
1961-08-12,Singapore,Thailand,5,3,2,1.0,0.0,1446,1433
1961-08-13,Malaysia,Indonesia,1,2,1,0.0,1.0,1556,1597
1961-08-13,Singapore,Vietnam Republic,1,2,1,0.0,1.0,1441,1542
1961-08-15,Indonesia,Japan,2,0,2,1.0,0.0,1603,1479
1961-08-16,Thailand,Vietnam Republic,1,2,1,0.0,1.0,1428,1548
1961-08-17,India,Vietnam Republic,1,3,2,0.0,1.0,1537,1556
1961-08-23,Norway,Russia,0,3,3,0.0,1.0,1534,1731
1961-09-05,New Caledonia,Tahiti,2,2,0,0.5,0.5,1505,1479
1961-09-08,New Caledonia,Tahiti,3,0,3,1.0,0.0,1513,1472
1961-09-10,German DR,Hungary,2,3,1,0.0,1.0,1510,1840
1961-09-10,Russia,Austria,0,1,1,0.0,1.0,1724,1749
1961-09-17,Norway,Denmark,0,4,4,0.0,1.0,1527,1571
1961-09-20,Germany,Denmark,5,1,4,1.0,0.0,1714,1567
1961-09-22,New Caledonia,Tahiti,2,1,1,1.0,0.0,1521,1465
1961-09-23,Uganda,Kenya,0,1,1,0.0,1.0,1610,1583
1961-09-28,England,Luxembourg,4,1,3,1.0,0.0,1768,1400
1961-09-28,France,Finland,5,1,4,1.0,0.0,1686,1378
1961-09-29,Scotland,Czechoslovakia,3,2,1,1.0,0.0,1685,1704
1961-09-30,Uganda,Zanzibar,2,1,1,1.0,0.0,1615,1428
1961-10-01,Kenya,Tanzania,0,0,0,0.5,0.5,1581,1468
1961-10-03,Tanzania,Uganda,3,1,2,1.0,0.0,1480,1604
1961-10-04,Belgium,Sweden,0,2,2,0.0,1.0,1557,1756
1961-10-04,Kenya,Zanzibar,10,0,10,1.0,0.0,1586,1424
1961-10-06,Tanzania,Zanzibar,3,0,3,1.0,0.0,1487,1418
1961-10-07,Kenya,Uganda,2,1,1,1.0,0.0,1595,1596
1961-10-07,Northern Ireland,Scotland,1,6,5,0.0,1.0,1511,1690
1961-10-08,Austria,Hungary,2,1,1,1.0,0.0,1760,1830
1961-10-08,Republic of Ireland,Czechoslovakia,1,3,2,0.0,1.0,1608,1710
1961-10-08,Luxembourg,Portugal,4,2,2,1.0,0.0,1412,1554
1961-10-08,Poland,Germany,0,2,2,0.0,1.0,1544,1719
1961-10-08,Romania,Turkey,4,0,4,1.0,0.0,1591,1583
1961-10-08,Yugoslavia,South Korea,5,1,4,1.0,0.0,1748,1632
1961-10-12,Argentina,Paraguay,5,1,4,1.0,0.0,1825,1593
1961-10-12,Chile,Uruguay,2,3,1,0.0,1.0,1590,1736
1961-10-14,Wales,England,1,1,0,0.5,0.5,1622,1765
1961-10-15,Denmark,Finland,9,1,8,1.0,0.0,1572,1374
1961-10-15,Israel,Italy,2,4,2,0.0,1.0,1517,1732
1961-10-17,Northern Ireland,Greece,2,0,2,1.0,0.0,1518,1435
1961-10-18,Belgium,France,3,0,3,1.0,0.0,1568,1676
1961-10-18,Turkey,South Korea,1,0,1,1.0,0.0,1593,1623
1961-10-21,Vietnam Republic,Indonesia,4,1,3,1.0,0.0,1566,1594
1961-10-22,Germany,Greece,2,1,1,1.0,0.0,1722,1433
1961-10-22,Hungary,Netherlands,3,3,0,0.5,0.5,1826,1611
1961-10-22,Israel,South Korea,1,1,0,0.5,0.5,1520,1621
1961-10-22,Poland,German DR,3,1,2,1.0,0.0,1552,1503
1961-10-22,Sweden,Norway,2,0,2,1.0,0.0,1760,1524
1961-10-23,Indonesia,Malaysia,1,3,2,0.0,1.0,1586,1565
1961-10-25,England,Portugal,2,0,2,1.0,0.0,1769,1551
1961-10-26,Vietnam Republic,Malaysia,1,0,1,1.0,0.0,1574,1558
1961-10-28,Myanmar,South Korea,3,0,3,1.0,0.0,1465,1610
1961-10-29,Bulgaria,Finland,3,1,2,1.0,0.0,1605,1371
1961-10-29,Czechoslovakia,Republic of Ireland,7,1,6,1.0,0.0,1716,1603
1961-10-29,Mexico,Paraguay,1,0,1,1.0,0.0,1660,1587
1961-10-29,Switzerland,Sweden,3,2,1,1.0,0.0,1586,1749
1961-10-29,Turkey,Norway,2,1,1,1.0,0.0,1600,1518
1961-10-29,Uganda,Kenya,2,0,2,1.0,0.0,1604,1588
1961-11-04,Italy,Israel,6,0,6,1.0,0.0,1736,1517
1961-11-05,Malta,Norway,1,1,0,0.5,0.5,1517,1518
1961-11-05,Paraguay,Mexico,0,0,0,0.5,0.5,1589,1659
1961-11-05,Poland,Denmark,5,0,5,1.0,0.0,1561,1564
1961-11-08,Scotland,Wales,2,0,2,1.0,0.0,1697,1616
1961-11-12,Bulgaria,France,1,0,1,1.0,0.0,1615,1667
1961-11-12,Morocco,Spain,0,1,1,0.0,1.0,1514,1732
1961-11-12,Netherlands,Belgium,0,4,4,0.0,1.0,1603,1577
1961-11-12,Switzerland,Sweden,2,1,1,1.0,0.0,1598,1738
1961-11-12,Turkey,Russia,1,2,1,0.0,1.0,1595,1730
1961-11-18,Argentina,Russia,1,2,1,0.0,1.0,1815,1741
1961-11-19,Yugoslavia,Austria,2,1,1,1.0,0.0,1757,1752
1961-11-22,Chile,Russia,0,1,1,0.0,1.0,1586,1746
1961-11-22,England,Northern Ireland,1,1,0,0.5,0.5,1765,1523
1961-11-23,Spain,Morocco,3,2,1,1.0,0.0,1736,1511
1961-11-25,Nigeria,Tunisia,2,1,1,1.0,0.0,1523,1490
1961-11-26,South Korea,Yugoslavia,1,3,2,0.0,1.0,1606,1762
1961-11-29,Czechoslovakia,Scotland,4,2,2,1.0,0.0,1724,1690
1961-11-29,Uruguay,Russia,1,2,1,0.0,1.0,1729,1754
1961-12-02,Hong Kong,Yugoslavia,1,2,1,0.0,1.0,1538,1766
1961-12-03,Kenya,Zanzibar,4,0,4,1.0,0.0,1593,1414
1961-12-04,Panama,Venezuela,2,6,4,0.0,1.0,1446,1497
1961-12-05,Senegal,Gambia,2,3,1,0.0,1.0,1492,1496
1961-12-05,Uganda,Zanzibar,2,0,2,1.0,0.0,1609,1410
1961-12-07,Indonesia,Yugoslavia,1,5,4,0.0,1.0,1582,1771
1961-12-07,Kenya,Uganda,4,1,3,1.0,0.0,1602,1601
1961-12-09,Chile,Hungary,5,1,4,1.0,0.0,1599,1814
1961-12-09,Tanzania,Kenya,1,3,2,0.0,1.0,1482,1608
1961-12-10,France,Spain,1,1,0,0.5,0.5,1669,1735
1961-12-10,Morocco,German DR,2,0,2,1.0,0.0,1519,1496
1961-12-11,Myanmar,Cambodia,4,0,4,1.0,0.0,1474,1477
1961-12-11,Thailand,Vietnam Republic,0,0,0,0.5,0.5,1432,1571
1961-12-12,Panama,Venezuela,0,3,3,0.0,1.0,1440,1504
1961-12-12,Malaysia,Cambodia,4,0,4,1.0,0.0,1565,1471
1961-12-12,Vietnam Republic,Laos,7,0,7,1.0,0.0,1578,1494
1961-12-13,Chile,Hungary,0,0,0,0.5,0.5,1604,1810
1961-12-13,Myanmar,Malaysia,1,2,1,0.0,1.0,1469,1571
1961-12-13,Thailand,Laos,5,2,3,1.0,0.0,1442,1485
1961-12-14,Israel,Yugoslavia,0,2,2,0.0,1.0,1514,1775
1961-12-14,Malaysia,Thailand,2,2,0,0.5,0.5,1569,1445
1961-12-14,Myanmar,Vietnam Republic,2,1,1,1.0,0.0,1480,1568
1961-12-16,Bulgaria,France,1,0,1,1.0,0.0,1625,1660
1961-12-16,Thailand,Vietnam Republic,1,1,0,0.5,0.5,1448,1566
1961-12-16,Myanmar,Malaysia,0,2,2,0.0,1.0,1475,1575
1961-12-17,Ghana,Nigeria,5,1,4,1.0,0.0,1584,1517
1961-12-23,Uruguay,Hungary,1,1,0,0.5,0.5,1731,1809
1961-12-24,Belgium,Bulgaria,4,0,4,1.0,0.0,1587,1616
1961-12-25,Madagascar,Mauritania,5,1,4,1.0,0.0,1544,1493
1961-12-25,Central African Republic,Liberia,1,1,0,0.5,0.5,1486,1500
1961-12-25,Ivory Coast,Burkina Faso,2,1,1,1.0,0.0,1509,1493
1961-12-25,Senegal,Gabon,3,2,1,1.0,0.0,1500,1478
1961-12-25,Chad,Niger,2,2,0,0.5,0.5,1500,1500
1961-12-26,Benin,Mauritania,7,0,7,1.0,0.0,1481,1485
1961-12-26,Ivory Coast,Liberia,5,0,5,1.0,0.0,1517,1493
1961-12-26,Cameroon,Gabon,6,0,6,1.0,0.0,1555,1472
1961-12-27,Benin,Madagascar,3,1,2,1.0,0.0,1491,1535
1961-12-27,Burkina Faso,Liberia,5,1,4,1.0,0.0,1501,1485
1961-12-27,Ivory Coast,Central African Republic,1,0,1,1.0,0.0,1525,1479
1961-12-27,Senegal,Cameroon,4,0,4,1.0,0.0,1510,1546
1961-12-29,Ivory Coast,Senegal,1,1,0,0.5,0.5,1525,1511
1961-12-31,Ethiopia,Kenya,4,3,1,1.0,0.0,1522,1598
1961-12-31,Benin,Senegal,4,3,1,1.0,0.0,1500,1503
1962-01-05,Egypt,Austria,1,0,1,1.0,0.0,1558,1740
1962-01-07,Ethiopia,Kenya,6,1,5,1.0,0.0,1532,1589
1962-01-14,Ethiopia,Tunisia,4,2,2,1.0,0.0,1540,1483
1962-01-18,Egypt,Uganda,2,1,1,1.0,0.0,1567,1593
1962-01-20,Tunisia,Uganda,3,0,3,1.0,0.0,1494,1583
1962-01-21,Ethiopia,Egypt,4,2,2,1.0,0.0,1549,1559
1962-02-04,Mali,Ivory Coast,4,0,4,1.0,0.0,1524,1517
1962-02-06,Mali,Ivory Coast,0,2,2,0.0,1.0,1516,1526
1962-02-17,Mali,Ghana,0,1,1,0.0,1.0,1510,1591
1962-02-19,Indonesia,Vietnam Republic,1,2,1,0.0,1.0,1574,1575
1962-03-11,Libya,Tunisia,6,3,3,1.0,0.0,1487,1486
1962-03-13,Uruguay,Argentina,1,1,0,0.5,0.5,1733,1814
1962-03-17,Ghana,Mali,0,0,0,0.5,0.5,1590,1512
1962-03-27,Curaçao,Suriname,1,0,1,1.0,0.0,1619,1543
1962-03-28,Argentina,Mexico,1,0,1,1.0,0.0,1819,1655
1962-03-29,Guernsey,Alderney,6,1,5,1.0,0.0,1617,1334
1962-04-01,Belgium,Netherlands,3,1,2,1.0,0.0,1596,1595
1962-04-01,Colombia,Mexico,0,1,1,0.0,1.0,1479,1660
1962-04-04,Colombia,Mexico,2,2,0,0.5,0.5,1483,1657
1962-04-04,England,Austria,3,1,2,1.0,0.0,1773,1733
1962-04-07,Sweden,Czechoslovakia,3,1,2,1.0,0.0,1746,1717
1962-04-08,Republic of Ireland,Austria,2,3,1,0.0,1.0,1598,1739
1962-04-11,France,Poland,1,3,2,0.0,1.0,1650,1572
1962-04-11,Germany,Uruguay,3,0,3,1.0,0.0,1731,1725
1962-04-11,Luxembourg,Russia,1,3,2,0.0,1.0,1411,1756
1962-04-11,Wales,Northern Ireland,4,0,4,1.0,0.0,1622,1518
1962-04-14,Scotland,England,2,0,2,1.0,0.0,1700,1764
1962-04-15,Morocco,Poland,1,3,2,0.0,1.0,1513,1579
1962-04-18,Hungary,Uruguay,1,1,0,0.5,0.5,1808,1727
1962-04-18,Sweden,Russia,0,2,2,0.0,1.0,1739,1764
1962-04-19,Guadeloupe,Martinique,1,0,1,1.0,0.0,1507,1540
1962-04-21,Brazil,Paraguay,6,0,6,1.0,0.0,1870,1587
1962-04-22,Czechoslovakia,Uruguay,3,1,2,1.0,0.0,1726,1719
1962-04-24,Brazil,Paraguay,4,0,4,1.0,0.0,1873,1585
1962-04-25,Mexico,Colombia,1,0,1,1.0,0.0,1662,1479
1962-04-27,Russia,Uruguay,5,0,5,1.0,0.0,1771,1713
1962-04-29,Hungary,Turkey,2,1,1,1.0,0.0,1812,1592
1962-05-02,Scotland,Uruguay,2,3,1,0.0,1.0,1693,1721
1962-05-03,Russia,German DR,2,1,1,1.0,0.0,1774,1494
1962-05-03,Jersey,Guernsey,2,1,1,1.0,0.0,1658,1610
1962-05-05,Italy,France,2,1,1,1.0,0.0,1743,1644
1962-05-06,Austria,Bulgaria,2,0,2,1.0,0.0,1745,1611
1962-05-06,Brazil,Portugal,2,1,1,1.0,0.0,1876,1549
1962-05-09,Brazil,Portugal,1,0,1,1.0,0.0,1879,1547
1962-05-09,England,Switzerland,3,1,2,1.0,0.0,1769,1594
1962-05-09,Netherlands,Northern Ireland,4,0,4,1.0,0.0,1602,1512
1962-05-09,Togo,Guinea,2,1,1,1.0,0.0,1498,1492
1962-05-12,Brazil,Wales,3,1,2,1.0,0.0,1882,1620
1962-05-13,Belgium,Italy,1,3,2,0.0,1.0,1592,1748
1962-05-16,Brazil,Wales,3,1,2,1.0,0.0,1885,1618
1962-05-16,Norway,Netherlands,2,1,1,1.0,0.0,1528,1593
1962-05-16,Turkey,Israel,1,0,1,1.0,0.0,1599,1508
1962-05-16,Yugoslavia,German DR,3,1,2,1.0,0.0,1778,1492
1962-05-17,Portugal,Belgium,1,2,1,0.0,1.0,1541,1599
1962-05-19,Jamaica,Haiti,3,4,1,0.0,1.0,1505,1578
1962-05-20,Peru,England,0,4,4,0.0,1.0,1581,1774
1962-05-21,Jamaica,Haiti,1,3,2,0.0,1.0,1499,1585
1962-05-22,Mexico,Wales,2,1,1,1.0,0.0,1669,1612
1962-05-23,German DR,Denmark,4,1,3,1.0,0.0,1502,1555
1962-05-23,Jamaica,Haiti,2,5,3,0.0,1.0,1493,1592
1962-05-23,Poland,Belgium,2,0,2,1.0,0.0,1588,1591
1962-05-30,Argentina,Bulgaria,1,0,1,1.0,0.0,1823,1608
1962-05-30,Brazil,Mexico,2,0,2,1.0,0.0,1889,1666
1962-05-30,Chile,Switzerland,3,1,2,1.0,0.0,1612,1587
1962-05-30,Colombia,Uruguay,1,2,1,0.0,1.0,1476,1725
1962-05-31,Czechoslovakia,Spain,1,0,1,1.0,0.0,1735,1727
1962-05-31,England,Hungary,1,2,1,0.0,1.0,1767,1820
1962-05-31,Germany,Italy,0,0,0,0.5,0.5,1732,1748
1962-05-31,Russia,Yugoslavia,2,0,2,1.0,0.0,1783,1770
1962-06-02,Argentina,England,1,3,2,0.0,1.0,1814,1777
1962-06-02,Brazil,Czechoslovakia,0,0,0,0.5,0.5,1886,1739
1962-06-02,Chile,Italy,2,0,2,1.0,0.0,1623,1738
1962-06-02,New Zealand,New Caledonia,4,1,3,1.0,0.0,1538,1514
1962-06-02,Uruguay,Yugoslavia,1,3,2,0.0,1.0,1719,1777
1962-06-03,Bulgaria,Hungary,1,6,5,0.0,1.0,1605,1824
1962-06-03,Colombia,Russia,4,4,0,0.5,0.5,1482,1778
1962-06-03,Germany,Switzerland,2,1,1,1.0,0.0,1737,1583
1962-06-03,Mexico,Spain,0,1,1,0.0,1.0,1660,1734
1962-06-03,Tunisia,Libya,2,2,0,0.5,0.5,1487,1487
1962-06-04,New Zealand,New Caledonia,4,2,2,1.0,0.0,1546,1507
1962-06-06,Argentina,Hungary,0,0,0,0.5,0.5,1815,1824
1962-06-06,Brazil,Spain,2,1,1,1.0,0.0,1891,1730
1962-06-06,Chile,Germany,0,2,2,0.0,1.0,1618,1743
1962-06-06,Russia,Uruguay,2,1,1,1.0,0.0,1785,1713
1962-06-07,Bulgaria,England,0,0,0,0.5,0.5,1609,1774
1962-06-07,Colombia,Yugoslavia,0,5,5,0.0,1.0,1480,1780
1962-06-07,Czechoslovakia,Mexico,1,3,2,0.0,1.0,1730,1670
1962-06-07,Italy,Switzerland,3,0,3,1.0,0.0,1743,1579
1962-06-09,Singapore,Hong Kong,2,6,4,0.0,1.0,1436,1544
1962-06-10,Brazil,England,3,1,2,1.0,0.0,1897,1769
1962-06-10,Chile,Russia,2,1,1,1.0,0.0,1630,1774
1962-06-10,Czechoslovakia,Hungary,1,0,1,1.0,0.0,1741,1814
1962-06-10,Germany,Yugoslavia,0,1,1,0.0,1.0,1736,1788
1962-06-11,Denmark,Norway,6,1,5,1.0,0.0,1563,1521
1962-06-13,Chile,Brazil,2,4,2,0.0,1.0,1628,1900
1962-06-13,Czechoslovakia,Yugoslavia,3,1,2,1.0,0.0,1751,1779
1962-06-16,Chile,Yugoslavia,1,0,1,1.0,0.0,1640,1768
1962-06-17,Brazil,Czechoslovakia,3,1,2,1.0,0.0,1905,1747
1962-06-19,Finland,Sweden,0,3,3,0.0,1.0,1370,1741
1962-06-21,Norway,Sweden,0,2,2,0.0,1.0,1518,1745
1962-06-24,Austria,Hungary,1,2,1,0.0,1.0,1739,1821
1962-06-28,Denmark,Malta,6,1,5,1.0,0.0,1570,1511
1962-07-03,Norway,Malta,5,0,5,1.0,0.0,1526,1504
1962-07-06,Kenya,Zanzibar,5,0,5,1.0,0.0,1594,1406
1962-07-07,Jamaica,Curaçao,4,4,0,0.5,0.5,1496,1617
1962-07-09,Iceland,Norway,1,3,2,0.0,1.0,1444,1533
1962-07-09,Jamaica,Curaçao,2,1,1,1.0,0.0,1507,1607
1962-07-11,Jamaica,Curaçao,1,2,1,0.0,1.0,1502,1613
1962-07-12,Singapore,Indonesia,1,2,1,0.0,1.0,1432,1579
1962-07-14,Gabon,Congo,3,1,2,1.0,0.0,1481,1494
1962-07-14,Vietnam Republic,Taiwan,1,1,0,0.5,0.5,1575,1563
1962-07-25,Thailand,Taiwan,4,0,4,1.0,0.0,1459,1553
1962-07-27,Singapore,Taiwan,2,2,0,0.5,0.5,1435,1551
1962-07-28,Kenya,Tanzania,4,3,1,1.0,0.0,1600,1477
1962-08-10,Bolivia,Paraguay,3,1,2,1.0,0.0,1493,1575
1962-08-12,Bolivia,Paraguay,3,2,1,1.0,0.0,1503,1566
1962-08-12,Republic of Ireland,Iceland,4,2,2,1.0,0.0,1603,1440
1962-08-15,Argentina,Uruguay,3,1,2,1.0,0.0,1821,1708
1962-08-20,Gabon,Cameroon,1,1,0,0.5,0.5,1483,1545
1962-08-25,Indonesia,Vietnam Republic,1,0,1,1.0,0.0,1587,1568
1962-08-25,Japan,Thailand,3,1,2,1.0,0.0,1487,1452
1962-08-26,Norway,Finland,2,1,1,1.0,0.0,1538,1366
1962-08-26,Malaysia,Philippines,15,1,14,1.0,0.0,1580,1394
1962-08-26,India,South Korea,0,2,2,0.0,1.0,1531,1613
1962-08-27,Indonesia,Philippines,6,0,6,1.0,0.0,1591,1391
1962-08-27,South Korea,Thailand,3,2,1,1.0,0.0,1618,1448
1962-08-28,Indonesia,Malaysia,2,3,1,0.0,1.0,1583,1589
1962-08-28,Thailand,India,1,4,3,0.0,1.0,1442,1538
1962-08-29,Vietnam Republic,Malaysia,3,0,3,1.0,0.0,1577,1581
1962-08-29,India,Japan,2,0,2,1.0,0.0,1545,1481
1962-08-30,Vietnam Republic,Philippines,6,0,6,1.0,0.0,1582,1387
1962-08-30,South Korea,Japan,1,0,1,1.0,0.0,1623,1477
1962-08-31,Suriname,Guadeloupe,3,1,2,1.0,0.0,1551,1500
1962-09-01,Uganda,Kenya,3,1,2,1.0,0.0,1592,1592
1962-09-01,Vietnam Republic,India,2,3,1,0.0,1.0,1574,1554
1962-09-01,South Korea,Malaysia,2,1,1,1.0,0.0,1631,1574
1962-09-02,Iceland,Republic of Ireland,1,1,0,0.5,0.5,1444,1600
1962-09-02,Poland,Hungary,0,2,2,0.0,1.0,1585,1825
1962-09-03,Vietnam Republic,Malaysia,1,4,3,0.0,1.0,1566,1582
1962-09-04,India,South Korea,2,1,1,1.0,0.0,1564,1622
1962-09-05,Netherlands,Curaçao,8,0,8,1.0,0.0,1602,1605
1962-09-08,Malaysia,Japan,2,2,0,0.5,0.5,1580,1480
1962-09-09,Myanmar,Pakistan,0,1,1,0.0,1.0,1468,1499
1962-09-11,Denmark,Curaçao,3,1,2,1.0,0.0,1579,1597
1962-09-11,Indonesia,Singapore,2,0,2,1.0,0.0,1588,1431
1962-09-12,Indonesia,Philippines,9,0,9,1.0,0.0,1592,1384
1962-09-12,Japan,Pakistan,1,1,0,0.5,0.5,1481,1499
1962-09-13,Malaysia,Myanmar,3,2,1,1.0,0.0,1586,1463
1962-09-13,Philippines,Singapore,0,5,5,0.0,1.0,1378,1438
1962-09-14,Indonesia,Vietnam Republic,2,1,1,1.0,0.0,1600,1559
1962-09-15,Myanmar,Japan,3,1,2,1.0,0.0,1472,1473
1962-09-16,Austria,Czechoslovakia,0,6,6,0.0,1.0,1732,1755
1962-09-16,Congo,Gabon,3,1,2,1.0,0.0,1502,1476
1962-09-16,Finland,Denmark,1,6,5,0.0,1.0,1363,1583
1962-09-16,German DR,Yugoslavia,2,2,0,0.5,0.5,1508,1763
1962-09-16,Malaysia,Pakistan,0,0,0,0.5,0.5,1585,1501
1962-09-16,Norway,Sweden,2,1,1,1.0,0.0,1551,1733
1962-09-16,Philippines,Vietnam Republic,0,6,6,0.0,1.0,1374,1564
1962-09-16,Trinidad and Tobago,Suriname,1,1,0,0.5,0.5,1603,1553
1962-09-17,Singapore,Vietnam Republic,2,2,0,0.5,0.5,1441,1562
1962-09-18,Trinidad and Tobago,Suriname,1,0,1,1.0,0.0,1610,1547
1962-09-19,Indonesia,Pakistan,2,1,1,1.0,0.0,1606,1496
1962-09-19,Yugoslavia,Ethiopia,5,2,3,1.0,0.0,1767,1546
1962-09-20,Trinidad and Tobago,Suriname,1,1,0,0.5,0.5,1609,1549
1962-09-21,Singapore,Japan,2,1,1,1.0,0.0,1450,1465
1962-09-22,Trinidad and Tobago,Suriname,1,1,0,0.5,0.5,1608,1551
1962-09-26,Denmark,Netherlands,4,1,3,1.0,0.0,1592,1594
1962-09-29,Ghana,Kenya,6,3,3,1.0,0.0,1599,1584
1962-09-30,Bulgaria,Poland,2,1,1,1.0,0.0,1617,1578
1962-09-30,Romania,Morocco,4,0,4,1.0,0.0,1598,1507
1962-09-30,Yugoslavia,Germany,2,3,1,0.0,1.0,1759,1745
1962-10-03,England,France,1,1,0,0.5,0.5,1767,1647
1962-10-10,Poland,Northern Ireland,0,2,2,0.0,1.0,1569,1522
1962-10-10,Turkey,Ethiopia,3,0,3,1.0,0.0,1606,1540
1962-10-10,Uganda,Ghana,1,4,3,0.0,1.0,1585,1607
1962-10-11,Poland,Morocco,1,1,0,0.5,0.5,1568,1509
1962-10-12,Kenya,Ghana,0,4,4,0.0,1.0,1577,1615
1962-10-12,South Korea,Indonesia,2,0,2,1.0,0.0,1630,1599
1962-10-13,Suriname,Guadeloupe,3,3,0,0.5,0.5,1550,1502
1962-10-14,Belgium,Netherlands,2,0,2,1.0,0.0,1600,1586
1962-10-14,German DR,Romania,3,2,1,1.0,0.0,1519,1588
1962-10-14,Hungary,Yugoslavia,0,1,1,0.0,1.0,1816,1769
1962-10-14,South Korea,Indonesia,2,0,2,1.0,0.0,1638,1592
1962-10-15,Malawi,Ghana,0,12,12,0.0,1.0,1488,1621
1962-10-15,Suriname,French Guiana,4,2,2,1.0,0.0,1557,1461
1962-10-17,Israel,Austria,1,1,0,0.5,0.5,1513,1728
1962-10-18,Greece,Ethiopia,3,2,1,1.0,0.0,1444,1530
1962-10-18,Tanzania,Ghana,2,6,4,0.0,1.0,1473,1626
1962-10-20,Northern Ireland,England,1,3,2,0.0,1.0,1519,1771
1962-10-20,Wales,Scotland,2,3,1,0.0,1.0,1606,1700
1962-10-24,Germany,France,2,2,0,0.5,0.5,1743,1650
1962-10-25,Vietnam Republic,Indonesia,4,0,4,1.0,0.0,1571,1584
1962-10-27,Malaysia,Thailand,4,2,2,1.0,0.0,1590,1438
1962-10-28,Czechoslovakia,Poland,2,1,1,1.0,0.0,1760,1564
1962-10-28,Hungary,Austria,2,0,2,1.0,0.0,1823,1722
1962-10-28,Indonesia,Malaysia,2,1,1,1.0,0.0,1593,1582
1962-10-28,Sweden,Denmark,4,2,2,1.0,0.0,1738,1588
1962-10-28,Vietnam Republic,Thailand,0,1,1,0.0,1.0,1561,1449
1962-10-30,Indonesia,Thailand,7,0,7,1.0,0.0,1598,1445
1962-10-30,Vietnam Republic,Malaysia,2,0,2,1.0,0.0,1570,1574
1962-10-31,Vietnam Republic,Indonesia,2,0,2,1.0,0.0,1579,1590
1962-11-01,Spain,Romania,6,0,6,1.0,0.0,1735,1584
1962-11-04,Sweden,Norway,1,1,0,0.5,0.5,1735,1555
1962-11-04,Tanzania,Uganda,3,1,2,1.0,0.0,1484,1575
1962-11-04,Yugoslavia,Belgium,3,2,1,1.0,0.0,1774,1596
1962-11-05,Kenya,Uganda,4,1,3,1.0,0.0,1585,1568
1962-11-07,Bulgaria,Portugal,3,1,2,1.0,0.0,1624,1535
1962-11-07,Chile,Argentina,1,1,0,0.5,0.5,1644,1818
1962-11-07,Hungary,Wales,3,1,2,1.0,0.0,1827,1603
1962-11-07,Scotland,Northern Ireland,5,1,4,1.0,0.0,1705,1515
1962-11-10,Nigeria,Ghana,0,0,0,0.5,0.5,1520,1624
1962-11-11,Austria,Italy,1,2,1,0.0,1.0,1715,1751
1962-11-11,France,Hungary,2,3,1,0.0,1.0,1646,1832
1962-11-11,Guadeloupe,Martinique,3,1,2,1.0,0.0,1511,1532
1962-11-11,Netherlands,Switzerland,3,1,2,1.0,0.0,1594,1572
1962-11-16,Thailand,Sweden,1,2,1,0.0,1.0,1443,1738
1962-11-20,Puerto Rico,Martinique,1,6,5,0.0,1.0,1432,1538
1962-11-21,Argentina,Chile,1,0,1,1.0,0.0,1823,1640
1962-11-21,England,Wales,4,0,4,1.0,0.0,1776,1599
1962-11-21,German DR,Czechoslovakia,2,1,1,1.0,0.0,1532,1748
1962-11-22,Malaysia,Sweden,0,1,1,0.0,1.0,1570,1743
1962-11-24,Grenada,Saint Vincent and the Grenadines,2,1,1,1.0,0.0,1529,1502
1962-11-24,Puerto Rico,Guadeloupe,0,3,3,0.0,1.0,1426,1518
1962-11-25,Bulgaria,Austria,1,1,0,0.5,0.5,1627,1713
1962-11-25,Israel,Turkey,0,2,2,0.0,1.0,1508,1612
1962-11-25,Romania,Spain,3,1,2,1.0,0.0,1596,1724
1962-11-27,Indonesia,Sweden,0,3,3,0.0,1.0,1586,1748
1962-11-28,Northern Ireland,Poland,2,0,2,1.0,0.0,1525,1555
1962-11-30,Senegal,Ivory Coast,1,1,0,0.5,0.5,1504,1526
1962-12-02,Belgium,Spain,1,1,0,0.5,0.5,1599,1722
1962-12-02,Italy,Turkey,6,0,6,1.0,0.0,1756,1608
1962-12-08,Malta,Denmark,1,3,2,0.0,1.0,1498,1595
1962-12-08,Nigeria,Cameroon,3,1,2,1.0,0.0,1529,1537
1962-12-08,Tanzania,Malawi,6,2,4,1.0,0.0,1493,1480
1962-12-09,Mali,German DR,1,2,1,0.0,1.0,1505,1540
1962-12-12,Turkey,Denmark,1,1,0,0.5,0.5,1608,1596
1962-12-15,Tanzania,Zanzibar,6,0,6,1.0,0.0,1500,1400
1962-12-16,Ethiopia,Turkey,0,0,0,0.5,0.5,1532,1607
1962-12-16,Guinea,German DR,2,3,1,0.0,1.0,1486,1547
1962-12-16,Portugal,Bulgaria,3,1,2,1.0,0.0,1546,1617
1962-12-23,Germany,Switzerland,5,1,4,1.0,0.0,1748,1568
1962-12-23,Morocco,Romania,3,1,2,1.0,0.0,1519,1587
1962-12-24,Central African Republic,Cameroon,1,4,3,0.0,1.0,1473,1544
1962-12-24,Congo,Madagascar,6,1,5,1.0,0.0,1511,1527
1962-12-27,Cameroon,Congo,0,3,3,0.0,1.0,1536,1520
1962-12-31,Central African Republic,Madagascar,4,1,3,1.0,0.0,1483,1518
1963-01-01,Cameroon,Nigeria,1,2,1,0.0,1.0,1528,1538
1963-01-06,Algeria,Bulgaria,2,1,1,1.0,0.0,1511,1607
1963-01-06,Kuwait,Jordan,2,1,1,1.0,0.0,1508,1492
1963-01-09,Spain,France,0,0,0,0.5,0.5,1721,1648
1963-01-13,Morocco,Switzerland,1,0,1,1.0,0.0,1529,1559
1963-01-14,Myanmar,China PR,0,3,3,0.0,1.0,1468,1619
1963-01-19,Uganda,Zanzibar,8,0,8,1.0,0.0,1573,1396
1963-01-20,Myanmar,China PR,2,1,1,1.0,0.0,1480,1608
1963-01-23,Bulgaria,Portugal,1,0,1,1.0,0.0,1614,1540
1963-01-26,Pakistan,China PR,0,0,0,0.5,0.5,1499,1606
1963-01-27,Benin,Nigeria,1,1,0,0.5,0.5,1501,1538
1963-01-30,Pakistan,China PR,3,2,1,1.0,0.0,1510,1596
1963-02-01,Mali,Burkina Faso,1,0,1,1.0,0.0,1513,1494
1963-02-02,Nigeria,Benin,4,1,3,1.0,0.0,1546,1494
1963-02-03,Pakistan,China PR,1,1,0,0.5,0.5,1512,1595
1963-02-06,Pakistan,China PR,0,2,2,0.0,1.0,1506,1602
1963-02-17,Paraguay,Bolivia,3,0,3,1.0,0.0,1573,1497
1963-02-19,Paraguay,Bolivia,5,1,4,1.0,0.0,1580,1491
1963-02-23,Jamaica,Haiti,3,2,1,1.0,0.0,1513,1582
1963-02-24,Mali,Senegal,3,1,2,1.0,0.0,1521,1497
1963-02-27,France,England,5,2,3,1.0,0.0,1659,1766
1963-02-27,Jamaica,Curaçao,1,2,1,0.0,1.0,1507,1604
1963-02-27,Nigeria,Senegal,4,0,4,1.0,0.0,1553,1491
1963-03-02,Guatemala,Honduras,1,2,1,0.0,1.0,1501,1542
1963-03-02,Haiti,Curaçao,0,1,1,0.0,1.0,1575,1612
1963-03-03,Ghana,Mali,4,0,4,1.0,0.0,1630,1516
1963-03-03,Netherlands,Belgium,0,1,1,0.0,1.0,1587,1607
1963-03-03,Paraguay,Brazil,2,2,0,0.5,0.5,1586,1900
1963-03-03,Tunisia,Kuwait,2,1,1,1.0,0.0,1496,1500
1963-03-04,Jamaica,Curaçao,1,2,1,0.0,1.0,1502,1618
1963-03-06,Jamaica,Haiti,0,3,3,0.0,1.0,1496,1582
1963-03-10,Argentina,Colombia,4,2,2,1.0,0.0,1825,1479
1963-03-10,Bolivia,Ecuador,4,4,0,0.5,0.5,1489,1383
1963-03-10,Brazil,Peru,1,0,1,1.0,0.0,1903,1579
1963-03-10,Guatemala,Honduras,2,1,1,1.0,0.0,1510,1534
1963-03-10,Ivory Coast,Tunisia,3,0,3,1.0,0.0,1534,1489
1963-03-13,Argentina,Peru,1,2,1,0.0,1.0,1813,1592
1963-03-14,Brazil,Colombia,5,1,4,1.0,0.0,1905,1478
1963-03-14,Ecuador,Paraguay,1,3,2,0.0,1.0,1380,1590
1963-03-17,Bolivia,Colombia,2,1,1,1.0,0.0,1497,1471
1963-03-17,Brazil,Paraguay,0,2,2,0.0,1.0,1892,1604
1963-03-17,Ecuador,Peru,1,2,1,0.0,1.0,1377,1596
1963-03-20,Argentina,Ecuador,4,2,2,1.0,0.0,1815,1376
1963-03-20,Colombia,Paraguay,2,3,1,0.0,1.0,1466,1610
1963-03-20,Wales,Hungary,1,1,0,0.5,0.5,1604,1828
1963-03-21,Bolivia,Peru,3,2,1,1.0,0.0,1508,1586
1963-03-23,Guatemala,Panama,2,2,0,0.5,0.5,1509,1442
1963-03-23,El Salvador,Nicaragua,6,1,5,1.0,0.0,1541,1382
1963-03-23,Uruguay,Chile,3,2,1,1.0,0.0,1715,1634
1963-03-24,Argentina,Brazil,3,0,3,1.0,0.0,1825,1883
1963-03-24,Bolivia,Paraguay,2,0,2,1.0,0.0,1519,1600
1963-03-24,Colombia,Peru,1,1,0,0.5,0.5,1469,1584
1963-03-24,Costa Rica,Jamaica,6,0,6,1.0,0.0,1691,1492
1963-03-24,Mexico,Curaçao,1,2,1,0.0,1.0,1661,1628
1963-03-24,Uganda,Ethiopia,1,7,6,0.0,1.0,1565,1541
1963-03-25,Honduras,Nicaragua,1,0,1,1.0,0.0,1539,1378
1963-03-25,El Salvador,Panama,1,1,0,0.5,0.5,1539,1445
1963-03-27,Brazil,Ecuador,2,2,0,0.5,0.5,1876,1384
1963-03-27,Guatemala,Nicaragua,3,1,2,1.0,0.0,1515,1373
1963-03-27,El Salvador,Honduras,2,2,0,0.5,0.5,1539,1539
1963-03-27,Paraguay,Peru,4,1,3,1.0,0.0,1608,1577
1963-03-27,Turkey,Italy,0,1,1,0.0,1.0,1603,1761
1963-03-28,Bolivia,Argentina,3,2,1,1.0,0.0,1533,1812
1963-03-28,Costa Rica,Curaçao,1,0,1,1.0,0.0,1698,1622
1963-03-28,Jamaica,Mexico,0,8,8,0.0,1.0,1488,1666
1963-03-29,Guatemala,Honduras,1,2,1,0.0,1.0,1508,1547
1963-03-29,Nicaragua,Panama,0,5,5,0.0,1.0,1367,1452
1963-03-30,Costa Rica,Mexico,0,0,0,0.5,0.5,1698,1667
1963-03-30,Jamaica,Curaçao,1,2,1,0.0,1.0,1483,1628
1963-03-31,Panama,Honduras,0,1,1,0.0,1.0,1447,1553
1963-03-31,El Salvador,Guatemala,1,1,0,0.5,0.5,1539,1509
1963-03-31,Argentina,Paraguay,1,1,0,0.5,0.5,1808,1613
1963-03-31,Belgium,Yugoslavia,0,1,1,0.0,1.0,1603,1779
1963-03-31,Bolivia,Brazil,5,4,1,1.0,0.0,1548,1862
1963-03-31,Colombia,Ecuador,3,4,1,0.0,1.0,1460,1394
1963-03-31,Czechoslovakia,German DR,1,1,0,0.5,0.5,1744,1552
1963-03-31,Lebanon,Kuwait,6,0,6,1.0,0.0,1492,1492
1963-03-31,Syria,Jordan,4,0,4,1.0,0.0,1485,1484
1963-03-31,Suriname,Trinidad and Tobago,3,1,2,1.0,0.0,1567,1599
1963-03-31,Switzerland,Netherlands,1,1,0,0.5,0.5,1560,1587
1963-04-02,Suriname,Trinidad and Tobago,1,2,1,0.0,1.0,1560,1607
1963-04-02,Syria,Tunisia,0,1,1,0.0,1.0,1478,1497
1963-04-02,Kuwait,Jordan,4,0,4,1.0,0.0,1500,1477
1963-04-03,Honduras,Curaçao,1,4,3,0.0,1.0,1547,1635
1963-04-03,El Salvador,Costa Rica,1,4,3,0.0,1.0,1535,1703
1963-04-03,Northern Ireland,Wales,1,4,3,0.0,1.0,1519,1611
1963-04-04,Jordan,Tunisia,0,4,4,0.0,1.0,1470,1505
1963-04-04,Lebanon,Syria,2,3,1,0.0,1.0,1484,1487
1963-04-04,Suriname,Trinidad and Tobago,4,3,1,1.0,0.0,1570,1598
1963-04-04,Jersey,Alderney,6,0,6,1.0,0.0,1661,1332
1963-04-05,Costa Rica,Curaçao,1,0,1,1.0,0.0,1710,1629
1963-04-05,El Salvador,Honduras,3,0,3,1.0,0.0,1544,1539
1963-04-06,England,Scotland,1,2,1,0.0,1.0,1757,1715
1963-04-06,Kuwait,Tunisia,1,5,4,0.0,1.0,1493,1513
1963-04-06,Lebanon,Jordan,5,0,5,1.0,0.0,1492,1463
1963-04-07,El Salvador,Curaçao,3,2,1,1.0,0.0,1554,1620
1963-04-07,Costa Rica,Honduras,2,1,1,1.0,0.0,1715,1535
1963-04-07,Kuwait,Syria,0,4,4,0.0,1.0,1485,1496
1963-04-07,Lebanon,Tunisia,0,1,1,0.0,1.0,1485,1521
1963-04-12,Senegal,Cameroon,1,0,1,1.0,0.0,1500,1520
1963-04-12,Nigeria,Niger,1,0,1,1.0,0.0,1560,1494
1963-04-12,Madagascar,Benin,1,0,1,1.0,0.0,1526,1487
1963-04-12,Liberia,Chad,2,1,1,1.0,0.0,1494,1492
1963-04-12,France,Gambia,5,1,4,1.0,0.0,1664,1492
1963-04-12,Gabon,Burkina Faso,4,0,4,1.0,0.0,1485,1486
1963-04-12,Congo,Ivory Coast,3,2,1,1.0,0.0,1529,1526
1963-04-12,DR Congo,Mauritania,6,0,6,1.0,0.0,1494,1478
1963-04-13,Brazil,Argentina,2,3,1,0.0,1.0,1853,1818
1963-04-13,Tunisia,Ivory Coast,3,1,2,1.0,0.0,1530,1518
1963-04-13,Congo,DR Congo,2,1,1,1.0,0.0,1537,1487
1963-04-14,Senegal,Nigeria,5,1,4,1.0,0.0,1510,1551
1963-04-14,Cameroon,Niger,3,2,1,1.0,0.0,1528,1487
1963-04-14,Benin,Liberia,1,0,1,1.0,0.0,1496,1486
1963-04-14,Madagascar,Chad,2,1,1,1.0,0.0,1534,1485
1963-04-14,France,Gabon,3,0,3,1.0,0.0,1669,1481
1963-04-14,Gambia,Burkina Faso,2,2,0,0.5,0.5,1492,1487
1963-04-14,Ivory Coast,Mauritania,2,0,2,1.0,0.0,1526,1471
1963-04-14,Tunisia,Congo,2,0,2,1.0,0.0,1539,1529
1963-04-15,Tunisia,Mauritania,4,0,4,1.0,0.0,1546,1465
1963-04-15,Ivory Coast,DR Congo,1,0,1,1.0,0.0,1534,1480
1963-04-16,Brazil,Argentina,5,2,3,1.0,0.0,1861,1811
1963-04-16,Guadeloupe,Martinique,3,0,3,1.0,0.0,1527,1530
1963-04-16,Senegal,Niger,3,1,2,1.0,0.0,1518,1480
1963-04-16,Madagascar,Liberia,3,1,2,1.0,0.0,1541,1480
1963-04-16,Benin,Chad,6,2,4,1.0,0.0,1504,1478
1963-04-16,Gambia,Gabon,2,2,0,0.5,0.5,1492,1482
1963-04-16,France,Burkina Faso,1,0,1,1.0,0.0,1674,1483
1963-04-16,Congo,Mauritania,7,0,7,1.0,0.0,1536,1459
1963-04-16,DR Congo,Tunisia,1,0,1,1.0,0.0,1490,1537
1963-04-17,Netherlands,France,1,0,1,1.0,0.0,1597,1665
1963-04-18,Tunisia,Madagascar,2,1,1,1.0,0.0,1546,1533
1963-04-18,Senegal,France,2,0,2,1.0,0.0,1530,1654
1963-04-20,Guadeloupe,Puerto Rico,3,0,3,1.0,0.0,1533,1421
1963-04-20,France,Madagascar,4,1,3,1.0,0.0,1660,1528
1963-04-20,Senegal,Tunisia,1,1,0,0.5,0.5,1531,1546
1963-04-21,Portugal,Brazil,1,0,1,1.0,0.0,1554,1848
1963-04-24,Austria,Czechoslovakia,3,1,2,1.0,0.0,1722,1736
1963-04-24,Belgium,Brazil,5,1,4,1.0,0.0,1616,1836
1963-04-25,China PR,North Vietnam,1,0,1,1.0,0.0,1608,1469
1963-04-26,Cambodia,North Vietnam,2,3,1,0.0,1.0,1463,1478
1963-04-26,Indonesia,Egypt,1,3,2,0.0,1.0,1578,1568
1963-04-27,Cambodia,China PR,0,6,6,0.0,1.0,1459,1613
1963-04-27,Indonesia,Egypt,2,2,0,0.5,0.5,1578,1569
1963-04-28,Bulgaria,Czechoslovakia,1,0,1,1.0,0.0,1625,1726
1963-04-28,France,Brazil,2,3,1,0.0,1.0,1656,1841
1963-04-30,Egypt,China PR,2,0,2,1.0,0.0,1579,1604
1963-04-30,Indonesia,North Vietnam,3,1,2,1.0,0.0,1584,1473
1963-05-02,Netherlands,Brazil,1,0,1,1.0,0.0,1610,1829
1963-05-02,Tanzania,Ethiopia,0,2,2,0.0,1.0,1493,1549
1963-05-02,Guernsey,Jersey,1,4,3,0.0,1.0,1604,1668
1963-05-05,Germany,Brazil,1,2,1,0.0,1.0,1742,1836
1963-05-05,Sweden,Hungary,2,1,1,1.0,0.0,1758,1819
1963-05-08,England,Brazil,1,1,0,0.5,0.5,1759,1835
1963-05-08,Scotland,Austria,4,1,3,1.0,0.0,1724,1714
1963-05-12,Italy,Brazil,3,0,3,1.0,0.0,1771,1826
1963-05-12,Romania,German DR,3,2,1,1.0,0.0,1595,1545
1963-05-15,Norway,Poland,2,5,3,0.0,1.0,1547,1563
1963-05-17,Egypt,Brazil,0,1,1,0.0,1.0,1576,1830
1963-05-19,Hungary,Denmark,6,0,6,1.0,0.0,1823,1593
1963-05-19,Indonesia,China PR,1,2,1,0.0,1.0,1577,1612
1963-05-19,Israel,Brazil,0,5,5,0.0,1.0,1506,1833
1963-05-22,Poland,Greece,4,0,4,1.0,0.0,1569,1439
1963-05-22,Russia,Sweden,0,1,1,0.0,1.0,1766,1767
1963-05-27,Zanzibar,Ethiopia,0,4,4,0.0,1.0,1392,1554
1963-05-29,Czechoslovakia,England,2,4,2,0.0,1.0,1719,1767
1963-05-30,Spain,Northern Ireland,1,1,0,0.5,0.5,1717,1524
1963-06-01,Kenya,Sudan,0,1,1,0.0,1.0,1575,1499
1963-06-02,Czechoslovakia,Hungary,2,2,0,0.5,0.5,1722,1821
1963-06-02,German DR,England,1,2,1,0.0,1.0,1542,1771
1963-06-02,Poland,Romania,1,1,0,0.5,0.5,1570,1595
1963-06-03,Denmark,Finland,1,1,0,0.5,0.5,1589,1368
1963-06-03,Kenya,Ethiopia,1,2,1,0.0,1.0,1567,1563
1963-06-04,Norway,Scotland,4,3,1,1.0,0.0,1559,1713
1963-06-05,Switzerland,England,1,8,7,0.0,1.0,1557,1775
1963-06-09,Austria,Italy,0,1,1,0.0,1.0,1708,1778
1963-06-09,Republic of Ireland,Scotland,1,0,1,1.0,0.0,1611,1703
1963-06-09,Tunisia,Lebanon,2,0,2,1.0,0.0,1553,1479
1963-06-13,Spain,Scotland,2,6,4,0.0,1.0,1709,1712
1963-06-16,Ethiopia,Sudan,4,0,4,1.0,0.0,1570,1493
1963-06-16,Tunisia,Morocco,4,1,3,1.0,0.0,1561,1522
1963-06-19,Yugoslavia,Sweden,0,0,0,0.5,0.5,1779,1768
1963-06-27,Finland,Norway,2,0,2,1.0,0.0,1381,1547
1963-06-29,Denmark,Albania,4,0,4,1.0,0.0,1596,1504
1963-06-30,Sudan,Kenya,5,0,5,1.0,0.0,1503,1558
1963-07-02,Morocco,Tunisia,4,2,2,1.0,0.0,1531,1553
1963-07-06,Zambia,Malawi,5,1,4,1.0,0.0,1537,1474
1963-07-07,Algeria,Egypt,2,2,0,0.5,0.5,1513,1575
1963-07-24,Chile,Uruguay,0,0,0,0.5,0.5,1636,1714
1963-07-27,Nigeria,Guinea,2,2,0,0.5,0.5,1550,1488
1963-08-05,Jamaica,El Salvador,0,1,1,0.0,1.0,1477,1561
1963-08-07,Jamaica,El Salvador,0,0,0,0.5,0.5,1479,1560
1963-08-08,Malaysia,Japan,3,4,1,0.0,1.0,1560,1476
1963-08-09,Taiwan,Vietnam Republic,1,1,0,0.5,0.5,1552,1579
1963-08-09,Jamaica,El Salvador,1,1,0,0.5,0.5,1481,1559
1963-08-10,Thailand,Japan,1,4,3,0.0,1.0,1436,1484
1963-08-11,South Korea,Thailand,5,1,4,1.0,0.0,1642,1433
1963-08-11,Malaysia,Vietnam Republic,0,5,5,0.0,1.0,1553,1587
1963-08-12,Malaysia,Taiwan,2,3,1,0.0,1.0,1545,1561
1963-08-12,Vietnam Republic,Japan,1,5,4,0.0,1.0,1577,1495
1963-08-13,South Korea,Japan,1,1,0,0.5,0.5,1639,1499
1963-08-14,South Korea,Vietnam Republic,3,1,2,1.0,0.0,1646,1571
1963-08-14,Malaysia,Thailand,2,2,0,0.5,0.5,1543,1436
1963-08-14,Sweden,Finland,0,0,0,0.5,0.5,1762,1388
1963-08-14,Sweden,Norway,0,0,0,0.5,0.5,1758,1552
1963-08-15,Taiwan,Japan,2,0,2,1.0,0.0,1568,1493
1963-08-16,Taiwan,Thailand,2,2,0,0.5,0.5,1566,1439
1963-08-16,Malaysia,South Korea,3,0,3,1.0,0.0,1554,1636
1963-08-17,Thailand,Vietnam Republic,2,3,1,0.0,1.0,1434,1577
1963-08-18,Taiwan,South Korea,1,0,1,1.0,0.0,1576,1627
1963-08-29,Fiji,Papua New Guinea,3,1,2,1.0,0.0,1476,1492
1963-08-30,Solomon Islands,Vanuatu,6,3,3,1.0,0.0,1508,1463
1963-09-01,Colombia,Costa Rica,4,5,1,0.0,1.0,1458,1718
1963-09-01,Fiji,Solomon Islands,5,0,5,1.0,0.0,1485,1500
1963-09-01,New Caledonia,Tahiti,2,1,1,1.0,0.0,1515,1458
1963-09-04,China PR,Myanmar,4,0,4,1.0,0.0,1618,1475
1963-09-04,Colombia,Costa Rica,1,0,1,1.0,0.0,1472,1705
1963-09-04,German DR,Bulgaria,1,1,0,0.5,0.5,1544,1624
1963-09-04,Poland,Norway,9,0,9,1.0,0.0,1578,1545
1963-09-06,Solomon Islands,Tahiti,0,18,18,0.0,1.0,1492,1467
1963-09-06,Fiji,New Caledonia,2,8,6,0.0,1.0,1478,1523
1963-09-08,Mauritius,Réunion,0,2,2,0.0,1.0,1602,1414
1963-09-11,Netherlands,Luxembourg,1,1,0,0.5,0.5,1606,1416
1963-09-15,Madagascar,Réunion,6,1,5,1.0,0.0,1534,1409
1963-09-15,Norway,Denmark,0,4,4,0.0,1.0,1539,1603
1963-09-18,Bulgaria,Sudan,1,1,0,0.5,0.5,1622,1506
1963-09-18,Sweden,Yugoslavia,3,2,1,1.0,0.0,1767,1771
1963-09-22,Poland,Turkey,0,0,0,0.5,0.5,1579,1603
1963-09-22,Russia,Hungary,1,1,0,0.5,0.5,1768,1820
1963-09-25,Austria,Republic of Ireland,0,0,0,0.5,0.5,1706,1614
1963-09-27,Martinique,Puerto Rico,6,0,6,1.0,0.0,1536,1416
1963-09-28,Germany,Turkey,3,0,3,1.0,0.0,1747,1599
1963-09-28,Kenya,Tanzania,4,1,3,1.0,0.0,1565,1487
1963-09-29,Bulgaria,France,1,0,1,1.0,0.0,1631,1648
1963-09-29,Uganda,Zanzibar,2,0,2,1.0,0.0,1570,1388
1963-10-01,Kenya,Zanzibar,1,0,1,1.0,0.0,1570,1384
1963-10-02,Tanzania,Uganda,1,1,0,0.5,0.5,1489,1569
1963-10-04,Tanzania,Zanzibar,2,1,1,1.0,0.0,1495,1379
1963-10-05,Kenya,Uganda,1,2,1,0.0,1.0,1562,1578
1963-10-06,Denmark,Sweden,2,2,0,0.5,0.5,1607,1764
1963-10-06,Yugoslavia,Hungary,2,0,2,1.0,0.0,1781,1811
1963-10-08,Liberia,Nigeria,2,2,0,0.5,0.5,1482,1549
1963-10-09,Turkey,Romania,0,0,0,0.5,0.5,1599,1596
1963-10-12,Japan,Vietnam Republic,2,1,1,1.0,0.0,1503,1568
1963-10-12,Northern Ireland,Scotland,2,1,1,1.0,0.0,1536,1701
1963-10-12,Wales,England,0,4,4,0.0,1.0,1607,1780
1963-10-13,Republic of Ireland,Austria,3,2,1,1.0,0.0,1625,1696
1963-10-13,Russia,Italy,2,0,2,1.0,0.0,1777,1770
1963-10-15,Paraguay,Argentina,0,4,4,0.0,1.0,1610,1815
1963-10-15,Suriname,Curaçao,2,3,1,0.0,1.0,1564,1627
1963-10-16,Greece,Poland,3,1,2,1.0,0.0,1451,1568
1963-10-19,German DR,Hungary,1,2,1,0.0,1.0,1542,1814
1963-10-19,Zambia,Kenya,0,1,1,0.0,1.0,1530,1570
1963-10-20,Netherlands,Belgium,1,1,0,0.5,0.5,1607,1616
1963-10-26,France,Bulgaria,3,1,2,1.0,0.0,1656,1624
1963-10-26,Nigeria,Liberia,3,0,3,1.0,0.0,1556,1476
1963-10-27,Hungary,Austria,2,1,1,1.0,0.0,1820,1691
1963-10-27,Romania,Yugoslavia,2,1,1,1.0,0.0,1608,1770
1963-10-29,Argentina,Paraguay,2,3,1,0.0,1.0,1803,1623
1963-10-30,Albania,Denmark,1,0,1,1.0,0.0,1515,1597
1963-10-30,Netherlands,Luxembourg,1,2,1,0.0,1.0,1595,1429
1963-10-30,Northern Ireland,Spain,0,1,1,0.0,1.0,1532,1714
1963-10-31,Cameroon,Togo,2,1,1,1.0,0.0,1536,1491
1963-11-03,Hungary,German DR,3,3,0,0.5,0.5,1815,1548
1963-11-03,Sweden,Germany,2,1,1,1.0,0.0,1772,1740
1963-11-03,Switzerland,Norway,0,2,2,0.0,1.0,1549,1548
1963-11-03,Yugoslavia,Czechoslovakia,2,0,2,1.0,0.0,1777,1716
1963-11-07,Scotland,Norway,6,1,5,1.0,0.0,1706,1544
1963-11-10,Italy,Russia,1,1,0,0.5,0.5,1771,1777
1963-11-11,France,Switzerland,2,2,0,0.5,0.5,1654,1552
1963-11-11,North Korea,Somalia,14,0,14,1.0,0.0,1552,1494
1963-11-12,China PR,Mali,3,1,2,1.0,0.0,1624,1511
1963-11-12,Egypt,North Vietnam,4,1,3,1.0,0.0,1581,1468
1963-11-13,Laos,North Vietnam,1,9,8,0.0,1.0,1477,1477
1963-11-14,Indonesia,Mali,3,2,1,1.0,0.0,1584,1505
1963-11-15,Egypt,Laos,15,0,15,1.0,0.0,1587,1472
1963-11-16,Indonesia,China PR,1,1,0,0.5,0.5,1585,1624
1963-11-18,Egypt,Saudi Arabia,7,0,7,1.0,0.0,1594,1494
1963-11-18,Indonesia,North Korea,1,5,4,0.0,1.0,1577,1561
1963-11-19,North Korea,North Vietnam,2,0,2,1.0,0.0,1568,1471
1963-11-20,England,Northern Ireland,8,3,5,1.0,0.0,1784,1529
1963-11-20,Hong Kong,Singapore,3,4,1,0.0,1.0,1534,1461
1963-11-20,Scotland,Wales,2,1,1,1.0,0.0,1712,1602
1963-11-21,Senegal,Ethiopia,1,2,1,0.0,1.0,1524,1578
1963-11-22,Egypt,North Korea,1,1,0,0.5,0.5,1594,1569
1963-11-24,Egypt,Nigeria,6,3,3,1.0,0.0,1602,1549
1963-11-24,Ghana,Tunisia,1,1,0,0.5,0.5,1629,1555
1963-11-26,Egypt,Sudan,2,2,0,0.5,0.5,1600,1509
1963-11-26,Ghana,Ethiopia,2,0,2,1.0,0.0,1636,1572
1963-11-27,Cyprus,Greece,3,1,2,1.0,0.0,1494,1444
1963-11-28,Ethiopia,Tunisia,4,2,2,1.0,0.0,1580,1548
1963-11-28,Nigeria,Sudan,0,4,4,0.0,1.0,1541,1518
1963-11-30,Egypt,Ethiopia,3,0,3,1.0,0.0,1608,1573
1963-12-01,Ghana,Sudan,3,0,3,1.0,0.0,1642,1513
1963-12-01,Morocco,Russia,1,1,0,0.5,0.5,1536,1773
1963-12-01,Spain,Belgium,1,2,1,0.0,1.0,1704,1627
1963-12-04,Luxembourg,Denmark,3,3,0,0.5,0.5,1433,1594
1963-12-07,Hong Kong,Thailand,3,3,0,0.5,0.5,1532,1437
1963-12-07,Kenya,Tanzania,6,2,4,1.0,0.0,1577,1489
1963-12-07,Vietnam Republic,Malaysia,5,3,2,1.0,0.0,1576,1547
1963-12-10,Denmark,Luxembourg,2,2,0,0.5,0.5,1591,1437
1963-12-11,Kenya,Uganda,1,1,0,0.5,0.5,1578,1578
1963-12-11,Malaysia,Thailand,3,1,2,1.0,0.0,1553,1432
1963-12-11,Vietnam Republic,Hong Kong,1,4,3,0.0,1.0,1567,1542
1963-12-13,Tanzania,Uganda,0,5,5,0.0,1.0,1484,1584
1963-12-14,Hong Kong,Malaysia,4,3,1,1.0,0.0,1551,1545
1963-12-14,Italy,Austria,1,0,1,1.0,0.0,1778,1685
1963-12-14,Vietnam Republic,Thailand,3,0,3,1.0,0.0,1573,1427
1963-12-15,Senegal,Guinea,1,1,0,0.5,0.5,1524,1489
1963-12-15,Tunisia,Algeria,0,0,0,0.5,0.5,1548,1514
1963-12-16,Philippines,Taiwan,0,7,7,0.0,1.0,1371,1580
1963-12-17,Myanmar,German DR,1,5,4,0.0,1.0,1469,1555
1963-12-18,Denmark,Luxembourg,1,0,1,1.0,0.0,1596,1433
1963-12-25,France,Belgium,1,2,1,0.0,1.0,1646,1636
1963-12-29,Morocco,Germany,1,4,3,0.0,1.0,1533,1744
1963-12-31,Cameroon,Guinea,1,5,4,0.0,1.0,1527,1499
1964-01-01,Algeria,Germany,2,0,2,1.0,0.0,1527,1732
1964-01-02,Hong Kong,Israel,0,3,3,0.0,1.0,1542,1516
1964-01-06,Saint Lucia,Saint Vincent and the Grenadines,2,2,0,0.5,0.5,1499,1502
1964-01-07,Dominica,Saint Vincent and the Grenadines,2,2,0,0.5,0.5,1497,1502
1964-01-08,Saint Lucia,Dominica,4,2,2,1.0,0.0,1507,1490
1964-01-10,Saint Lucia,Saint Vincent and the Grenadines,0,0,0,0.5,0.5,1507,1503
1964-01-11,Dominica,Saint Vincent and the Grenadines,1,1,0,0.5,0.5,1491,1503
1964-01-12,Sri Lanka,German DR,1,12,11,0.0,1.0,1458,1561
1964-01-12,Saint Lucia,Dominica,5,0,5,1.0,0.0,1515,1484
1964-01-31,Cameroon,Benin,2,4,2,0.0,1.0,1519,1513
1964-02-02,Cameroon,Congo,7,1,6,1.0,0.0,1528,1528
1964-02-14,Congo,Cameroon,4,4,0,0.5,0.5,1528,1528
1964-02-23,Ghana,German DR,3,0,3,1.0,0.0,1649,1555
1964-02-23,Sri Lanka,Indonesia,3,9,6,0.0,1.0,1453,1583
1964-02-24,Congo,DR Congo,0,0,0,0.5,0.5,1528,1491
1964-02-29,Sri Lanka,Indonesia,1,4,3,0.0,1.0,1448,1589
1964-03-03,Singapore,Japan,1,2,1,0.0,1.0,1454,1511
1964-03-08,Libya,Lebanon,0,1,1,0.0,1.0,1479,1488
1964-03-11,Spain,Republic of Ireland,5,1,4,1.0,0.0,1711,1619
1964-03-15,Ivory Coast,Mali,1,1,0,0.5,0.5,1534,1506
1964-03-15,Libya,Malta,2,2,0,0.5,0.5,1480,1498
1964-03-18,Bulgaria,Yugoslavia,0,1,1,0.0,1.0,1620,1782
1964-03-20,Egypt,Algeria,1,0,1,1.0,0.0,1615,1521
1964-03-22,Belgium,Netherlands,0,0,0,0.5,0.5,1636,1596
1964-03-28,Congo,Chad,11,0,11,1.0,0.0,1535,1472
1964-04-01,Yugoslavia,Bulgaria,1,0,1,1.0,0.0,1787,1616
1964-04-05,Guyana,Trinidad and Tobago,1,2,1,0.0,1.0,1438,1603
1964-04-08,Republic of Ireland,Spain,0,2,2,0.0,1.0,1614,1717
1964-04-10,Guyana,Trinidad and Tobago,1,6,5,0.0,1.0,1434,1608
1964-04-11,Italy,Czechoslovakia,0,0,0,0.5,0.5,1777,1718
1964-04-11,Scotland,England,1,0,1,1.0,0.0,1722,1775
1964-04-11,Guernsey,Alderney,3,0,3,1.0,0.0,1607,1330
1964-04-12,Guyana,Trinidad and Tobago,1,4,3,0.0,1.0,1430,1613
1964-04-12,Netherlands,Austria,1,1,0,0.5,0.5,1599,1683
1964-04-15,Switzerland,Belgium,2,0,2,1.0,0.0,1562,1627
1964-04-15,Wales,Northern Ireland,2,3,1,0.0,1.0,1593,1539
1964-04-22,Cameroon,DR Congo,2,2,0,0.5,0.5,1528,1492
1964-04-25,France,Hungary,1,3,2,0.0,1.0,1642,1820
1964-04-29,Germany,Czechoslovakia,3,4,1,0.0,1.0,1724,1727
1964-04-29,Netherlands,Sweden,0,1,1,0.0,1.0,1595,1777
1964-04-29,Northern Ireland,Uruguay,3,0,3,1.0,0.0,1551,1703
1964-04-29,Switzerland,Portugal,2,3,1,0.0,1.0,1554,1563
1964-05-03,Austria,Hungary,1,0,1,1.0,0.0,1695,1809
1964-05-03,Belgium,Portugal,1,2,1,0.0,1.0,1618,1573
1964-05-06,England,Uruguay,2,1,1,1.0,0.0,1782,1697
1964-05-07,Jersey,Guernsey,1,0,1,1.0,0.0,1675,1601
1964-05-10,Poland,Republic of Ireland,3,1,2,1.0,0.0,1578,1605
1964-05-10,Switzerland,Italy,1,3,2,0.0,1.0,1551,1781
1964-05-12,Germany,Scotland,2,2,0,0.5,0.5,1724,1723
1964-05-13,Greece,Ethiopia,3,1,2,1.0,0.0,1455,1563
1964-05-13,Norway,Republic of Ireland,1,4,3,0.0,1.0,1538,1612
1964-05-13,Sweden,Russia,1,1,0,0.5,0.5,1777,1774
1964-05-14,Austria,Uruguay,0,2,2,0.0,1.0,1688,1705
1964-05-17,Czechoslovakia,Yugoslavia,2,3,1,0.0,1.0,1721,1794
1964-05-17,Portugal,England,3,4,1,0.0,1.0,1570,1786
1964-05-17,Tunisia,Ethiopia,3,2,1,1.0,0.0,1557,1555
1964-05-20,Russia,Uruguay,1,0,1,1.0,0.0,1781,1699
1964-05-23,Hungary,France,2,1,1,1.0,0.0,1814,1638
1964-05-24,Republic of Ireland,England,1,3,2,0.0,1.0,1608,1791
1964-05-24,Netherlands,Albania,2,0,2,1.0,0.0,1602,1509
1964-05-26,Israel,Hong Kong,1,0,1,1.0,0.0,1525,1534
1964-05-27,India,South Korea,2,0,2,1.0,0.0,1574,1618
1964-05-27,Russia,Sweden,3,1,2,1.0,0.0,1789,1770
1964-05-27,United States,England,0,10,10,0.0,1.0,1448,1793
1964-05-29,Israel,India,2,0,2,1.0,0.0,1535,1565
1964-05-30,Brazil,England,5,1,4,1.0,0.0,1841,1786
1964-05-30,Hong Kong,South Korea,0,1,1,0.0,1.0,1528,1625
1964-05-31,Argentina,Portugal,2,0,2,1.0,0.0,1807,1567
1964-06-02,Hong Kong,India,1,3,2,0.0,1.0,1521,1573
1964-06-03,Brazil,Argentina,0,3,3,0.0,1.0,1833,1816
1964-06-03,Israel,South Korea,2,1,1,1.0,0.0,1546,1615
1964-06-04,England,Portugal,1,1,0,0.5,0.5,1782,1572
1964-06-04,French Guiana,Suriname,3,1,2,1.0,0.0,1472,1554
1964-06-05,French Guiana,Suriname,3,3,0,0.5,0.5,1474,1553
1964-06-06,Argentina,England,1,0,1,1.0,0.0,1824,1775
1964-06-07,Brazil,Portugal,4,1,3,1.0,0.0,1836,1570
1964-06-07,Finland,Germany,1,4,3,0.0,1.0,1386,1727
1964-06-17,Denmark,Russia,0,3,3,0.0,1.0,1593,1793
1964-06-17,Spain,Hungary,2,1,1,1.0,0.0,1728,1804
1964-06-17,Yugoslavia,Romania,1,2,1,0.0,1.0,1783,1620
1964-06-20,Congo,Guinea,1,2,1,0.0,1.0,1527,1508
1964-06-20,Hungary,Denmark,3,1,2,1.0,0.0,1808,1590
1964-06-21,Spain,Russia,2,1,1,1.0,0.0,1738,1784
1964-06-28,Sweden,Denmark,4,1,3,1.0,0.0,1775,1586
1964-06-30,Vietnam Republic,South Korea,1,2,1,0.0,1.0,1566,1623
1964-07-01,Norway,Switzerland,3,2,1,1.0,0.0,1547,1543
1964-07-03,Zambia,Tanzania,3,0,3,1.0,0.0,1537,1478
1964-07-04,Malawi,Zambia,0,5,5,0.0,1.0,1468,1544
1964-07-04,Singapore,Hong Kong,1,1,0,0.5,0.5,1456,1520
1964-07-05,Singapore,Hong Kong,2,1,1,1.0,0.0,1466,1511
1964-07-13,Cameroon,DR Congo,1,1,0,0.5,0.5,1528,1493
1964-07-14,Cameroon,Central African Republic,2,1,1,1.0,0.0,1535,1477
1964-07-17,Cameroon,Congo,3,1,2,1.0,0.0,1543,1520
1964-07-19,Cameroon,DR Congo,2,1,1,1.0,0.0,1550,1487
1964-08-02,Finland,Sweden,1,0,1,1.0,0.0,1401,1761
1964-08-10,Iceland,Bermuda,4,3,1,1.0,0.0,1454,1491
1964-08-15,Congo,Mali,1,0,1,1.0,0.0,1528,1499
1964-08-20,Norway,Finland,2,0,2,1.0,0.0,1552,1397
1964-08-22,Malaysia,Thailand,3,0,3,1.0,0.0,1551,1422
1964-08-23,Cambodia,Taiwan,0,4,4,0.0,1.0,1454,1586
1964-08-23,Iceland,Finland,0,2,2,0.0,1.0,1445,1407
1964-08-24,Malaysia,India,1,1,0,0.5,0.5,1552,1573
1964-08-27,Cambodia,India,0,4,4,0.0,1.0,1449,1579
1964-08-28,Taiwan,Vietnam Republic,0,0,0,0.5,0.5,1586,1567
1964-08-28,Malaysia,Myanmar,0,3,3,0.0,1.0,1543,1479
1964-08-29,India,Thailand,2,1,1,1.0,0.0,1584,1418
1964-08-30,Myanmar,Taiwan,2,4,2,0.0,1.0,1474,1592
1964-08-30,Malaysia,Vietnam Republic,1,2,1,0.0,1.0,1536,1575
1964-09-01,Cambodia,Thailand,0,1,1,0.0,1.0,1441,1427
1964-09-02,Myanmar,Vietnam Republic,1,0,1,1.0,0.0,1485,1565
1964-09-02,Malaysia,Taiwan,5,2,3,1.0,0.0,1546,1583
1964-09-04,Guyana,Trinidad and Tobago,1,1,0,0.5,0.5,1434,1610
1964-09-05,Guyana,Trinidad and Tobago,1,2,1,0.0,1.0,1430,1615
1964-09-05,Malaysia,Thailand,1,1,0,0.5,0.5,1544,1430
1964-09-06,Myanmar,India,1,0,1,1.0,0.0,1496,1574
1964-09-06,Finland,Denmark,2,1,1,1.0,0.0,1419,1575
1964-09-08,India,Taiwan,6,4,2,1.0,0.0,1583,1575
1964-09-08,Kenya,Zanzibar,5,1,4,1.0,0.0,1582,1376
1964-09-10,Tahiti,New Caledonia,0,2,2,0.0,1.0,1461,1530
1964-09-13,Poland,Czechoslovakia,2,1,1,1.0,0.0,1590,1710
1964-09-14,Martinique,Puerto Rico,4,0,4,1.0,0.0,1542,1411
1964-09-19,Martinique,Guadeloupe,1,0,1,1.0,0.0,1550,1526
1964-09-20,Norway,Sweden,1,1,0,0.5,0.5,1557,1757
1964-09-23,Guadeloupe,Puerto Rico,4,0,4,1.0,0.0,1532,1406
1964-09-24,Argentina,Chile,5,0,5,1.0,0.0,1829,1632
1964-09-26,Tanzania,Kenya,1,0,1,1.0,0.0,1489,1572
1964-09-27,Austria,Yugoslavia,3,2,1,1.0,0.0,1699,1773
1964-09-27,Tahiti,New Caledonia,4,1,3,1.0,0.0,1471,1521
1964-09-27,Turkey,Poland,2,3,1,0.0,1.0,1591,1599
1964-09-27,Uganda,Zanzibar,2,3,1,0.0,1.0,1572,1389
1964-09-29,Yugoslavia,Luxembourg,3,1,2,1.0,0.0,1775,1432
1964-09-29,Tanzania,Zanzibar,3,1,2,1.0,0.0,1495,1384
1964-09-30,Belgium,Netherlands,1,0,1,1.0,0.0,1626,1595
1964-09-30,Kenya,Uganda,0,1,1,0.0,1.0,1564,1580
1964-10-03,Northern Ireland,England,3,4,1,0.0,1.0,1548,1779
1964-10-03,Tanzania,Uganda,3,0,3,1.0,0.0,1505,1571
1964-10-03,Wales,Scotland,3,2,1,1.0,0.0,1604,1713
1964-10-04,Luxembourg,France,0,2,2,0.0,1.0,1429,1642
1964-10-04,Switzerland,Hungary,0,2,2,0.0,1.0,1541,1811
1964-10-05,Zanzibar,Uganda,3,4,1,0.0,1.0,1380,1576
1964-10-07,Sweden,Poland,3,3,0,0.5,0.5,1754,1603
1964-10-09,Uganda,Burundi,7,5,2,1.0,0.0,1583,1488
1964-10-11,Austria,Russia,1,0,1,1.0,0.0,1709,1775
1964-10-11,Denmark,Norway,2,0,2,1.0,0.0,1583,1550
1964-10-11,Hungary,Czechoslovakia,2,2,0,0.5,0.5,1809,1713
1964-10-14,Chile,Argentina,1,1,0,0.5,0.5,1637,1825
1964-10-14,Northern Ireland,Switzerland,1,0,1,1.0,0.0,1556,1534
1964-10-18,Uganda,Kenya,3,2,1,1.0,0.0,1591,1557
1964-10-20,Zambia,Uganda,0,2,2,0.0,1.0,1538,1598
1964-10-21,Denmark,Wales,1,0,1,1.0,0.0,1592,1596
1964-10-21,England,Belgium,2,2,0,0.5,0.5,1776,1630
1964-10-21,Ghana,Kenya,7,1,6,1.0,0.0,1655,1552
1964-10-21,Scotland,Finland,3,1,2,1.0,0.0,1716,1417
1964-10-23,Ghana,Uganda,2,0,2,1.0,0.0,1662,1592
1964-10-23,Zambia,Kenya,2,3,1,0.0,1.0,1531,1560
1964-10-25,Albania,Netherlands,0,2,2,0.0,1.0,1503,1602
1964-10-25,Hungary,Yugoslavia,2,1,1,1.0,0.0,1817,1768
1964-10-25,Republic of Ireland,Poland,3,2,1,1.0,0.0,1616,1596
1964-10-25,Zambia,Ghana,3,4,1,0.0,1.0,1526,1668
1964-10-28,Israel,Yugoslavia,2,0,2,1.0,0.0,1559,1756
1964-11-01,Turkey,Tunisia,4,1,3,1.0,0.0,1599,1550
1964-11-04,Algeria,Russia,2,2,0,0.5,0.5,1526,1771
1964-11-04,Germany,Sweden,1,1,0,0.5,0.5,1728,1754
1964-11-04,Italy,Finland,6,1,5,1.0,0.0,1783,1416
1964-11-08,Luxembourg,Norway,0,2,2,0.0,1.0,1424,1556
1964-11-11,France,Norway,1,0,1,1.0,0.0,1649,1550
1964-11-13,Jordan,Lebanon,0,0,0,0.5,0.5,1464,1488
1964-11-13,Kuwait,Iraq,0,1,1,0.0,1.0,1478,1510
1964-11-14,Switzerland,Northern Ireland,2,1,1,1.0,0.0,1543,1548
1964-11-14,Libya,Lebanon,2,1,1,1.0,0.0,1489,1480
1964-11-15,Kuwait,Jordan,2,0,2,1.0,0.0,1486,1457
1964-11-15,Portugal,Spain,2,1,1,1.0,0.0,1582,1727
1964-11-16,Iraq,Lebanon,1,0,1,1.0,0.0,1518,1473
1964-11-16,Jordan,Libya,2,5,3,0.0,1.0,1450,1497
1964-11-17,Kuwait,Lebanon,2,3,1,0.0,1.0,1478,1482
1964-11-17,Iraq,Libya,1,1,0,0.5,0.5,1518,1498
1964-11-18,England,Wales,2,1,1,1.0,0.0,1781,1592
1964-11-19,Kuwait,Libya,1,1,0,0.5,0.5,1479,1498
1964-11-22,Yugoslavia,Russia,1,1,0,0.5,0.5,1757,1771
1964-11-25,Paraguay,Argentina,3,0,3,1.0,0.0,1636,1813
1964-11-25,Scotland,Northern Ireland,3,2,1,1.0,0.0,1721,1544
1964-11-29,Bulgaria,Russia,0,0,0,0.5,0.5,1620,1768
1964-11-29,Greece,Denmark,4,2,2,1.0,0.0,1467,1581
1964-12-01,Israel,Denmark,0,1,1,0.0,1.0,1552,1589
1964-12-02,Belgium,France,3,0,3,1.0,0.0,1639,1641
1964-12-05,Italy,Denmark,3,1,2,1.0,0.0,1787,1586
1964-12-08,Argentina,Paraguay,8,1,7,1.0,0.0,1818,1632
1964-12-09,Greece,Wales,2,0,2,1.0,0.0,1478,1582
1964-12-09,Netherlands,England,1,1,0,0.5,0.5,1606,1778
1964-12-11,Kenya,Zambia,4,2,2,1.0,0.0,1568,1519
1964-12-13,Kenya,Zambia,2,8,6,0.0,1.0,1559,1529
1964-12-20,Turkey,Bulgaria,0,0,0,0.5,0.5,1600,1620
1965-01-03,Uruguay,German DR,0,2,2,0.0,1.0,1688,1567
1965-01-09,Togo,DR Congo,0,3,3,0.0,1.0,1483,1496
1965-01-16,Jamaica,Cuba,2,0,2,1.0,0.0,1488,1412
1965-01-17,Ivory Coast,DR Congo,2,0,2,1.0,0.0,1542,1489
1965-01-20,Cuba,Curaçao,1,1,0,0.5,0.5,1417,1623
1965-01-23,Jamaica,Curaçao,2,0,2,1.0,0.0,1499,1613
1965-01-24,Portugal,Turkey,5,1,4,1.0,0.0,1591,1592
1965-01-26,Israel,Netherlands,0,1,1,0.0,1.0,1546,1613
1965-01-30,Cuba,Curaçao,0,1,1,0.0,1.0,1414,1617
1965-02-01,Congo,DR Congo,0,3,3,0.0,1.0,1520,1498
1965-02-03,Curaçao,Jamaica,0,0,0,0.5,0.5,1615,1502
1965-02-07,Cuba,Jamaica,2,1,1,1.0,0.0,1424,1493
1965-02-07,Trinidad and Tobago,Suriname,4,1,3,1.0,0.0,1622,1547
1965-02-12,Costa Rica,Suriname,1,0,1,1.0,0.0,1710,1543
1965-02-21,Costa Rica,Trinidad and Tobago,4,0,4,1.0,0.0,1717,1616
1965-02-21,Uganda,Ethiopia,1,2,1,0.0,1.0,1584,1564
1965-02-22,Costa Rica,Trinidad and Tobago,1,0,1,1.0,0.0,1723,1611
1965-02-25,Senegal,Guinea,2,0,2,1.0,0.0,1532,1501
1965-02-28,Honduras,Mexico,0,1,1,0.0,1.0,1530,1673
1965-02-28,Suriname,Costa Rica,1,3,2,0.0,1.0,1539,1728
1965-02-28,Tunisia,Morocco,0,0,0,0.5,0.5,1550,1534
1965-03-04,Mexico,Honduras,3,0,3,1.0,0.0,1678,1526
1965-03-07,El Salvador,Nicaragua,4,0,4,1.0,0.0,1563,1364
1965-03-07,Trinidad and Tobago,Costa Rica,0,1,1,0.0,1.0,1606,1734
1965-03-07,United States,Mexico,2,2,0,0.5,0.5,1453,1674
1965-03-09,Curaçao,Costa Rica,1,2,1,0.0,1.0,1610,1740
1965-03-10,Guatemala,Paraguay,1,4,3,0.0,1.0,1504,1638
1965-03-11,Hong Kong,Japan,1,4,3,0.0,1.0,1503,1519
1965-03-11,Honduras,Nicaragua,0,2,2,0.0,1.0,1515,1376
1965-03-12,Kuwait,Morocco,0,2,2,0.0,1.0,1473,1541
1965-03-12,Mexico,United States,2,0,2,1.0,0.0,1678,1450
1965-03-13,Germany,Italy,1,1,0,0.5,0.5,1730,1786
1965-03-14,El Salvador,Honduras,3,1,2,1.0,0.0,1570,1509
1965-03-14,Guatemala,Paraguay,0,3,3,0.0,1.0,1499,1644
1965-03-14,Libya,Kuwait,4,1,3,1.0,0.0,1506,1466
1965-03-14,Suriname,Trinidad and Tobago,6,1,5,1.0,0.0,1549,1597
1965-03-15,Hong Kong,Japan,1,2,1,0.0,1.0,1496,1527
1965-03-17,Costa Rica,Paraguay,1,0,1,1.0,0.0,1746,1639
1965-03-17,Honduras,United States,0,1,1,0.0,1.0,1500,1460
1965-03-17,Israel,Switzerland,0,0,0,0.5,0.5,1546,1544
1965-03-17,Northern Ireland,Netherlands,2,1,1,1.0,0.0,1554,1604
1965-03-17,Wales,Greece,4,1,3,1.0,0.0,1588,1473
1965-03-19,Costa Rica,Paraguay,0,0,0,0.5,0.5,1744,1642
1965-03-19,Libya,Morocco,1,0,1,1.0,0.0,1515,1533
1965-03-20,Cyprus,Lebanon,2,0,2,1.0,0.0,1502,1475
1965-03-21,Honduras,United States,1,1,0,0.5,0.5,1500,1461
1965-03-22,Myanmar,Japan,1,1,0,0.5,0.5,1497,1527
1965-03-24,France,Austria,1,2,1,0.0,1.0,1635,1716
1965-03-24,Republic of Ireland,Belgium,0,2,2,0.0,1.0,1609,1647
1965-03-25,Singapore,Japan,1,4,3,0.0,1.0,1460,1534
1965-03-27,Malaysia,Japan,1,1,0,0.5,0.5,1544,1535
1965-03-27,Sudan,Ethiopia,2,1,1,1.0,0.0,1523,1555
1965-03-28,Costa Rica,Curaçao,6,0,6,1.0,0.0,1750,1605
1965-03-28,El Salvador,Mexico,0,2,2,0.0,1.0,1565,1684
1965-03-28,Guatemala,Haiti,3,0,3,1.0,0.0,1509,1573
1965-03-30,El Salvador,Curaçao,1,1,0,0.5,0.5,1566,1605
1965-03-30,Costa Rica,Haiti,3,1,2,1.0,0.0,1755,1569
1965-03-31,Guinea,Senegal,3,1,2,1.0,0.0,1510,1524
1965-03-31,Northern Ireland,Wales,0,5,5,0.0,1.0,1547,1596
1965-04-01,Mexico,Curaçao,5,0,5,1.0,0.0,1691,1599
1965-04-01,Guatemala,Costa Rica,0,0,0,0.5,0.5,1514,1751
1965-04-03,Peru,Paraguay,0,1,1,0.0,1.0,1571,1649
1965-04-04,Guatemala,El Salvador,4,1,3,1.0,0.0,1524,1557
1965-04-04,Haiti,Mexico,0,3,3,0.0,1.0,1564,1697
1965-04-06,Costa Rica,Mexico,1,1,0,0.5,0.5,1750,1699
1965-04-06,Guatemala,Curaçao,3,2,1,1.0,0.0,1534,1590
1965-04-07,Belgium,Poland,0,0,0,0.5,0.5,1646,1598
1965-04-07,Netherlands,Northern Ireland,0,0,0,0.5,0.5,1603,1549
1965-04-08,Costa Rica,El Salvador,1,2,1,0.0,1.0,1738,1570
1965-04-08,Haiti,Curaçao,1,1,0,0.5,0.5,1565,1590
1965-04-08,Jersey,Alderney,8,0,8,1.0,0.0,1677,1329
1965-04-10,England,Scotland,2,2,0,0.5,0.5,1777,1723
1965-04-11,Albania,Switzerland,0,2,2,0.0,1.0,1496,1552
1965-04-11,Guatemala,Mexico,1,2,1,0.0,1.0,1530,1704
1965-04-11,El Salvador,Haiti,3,1,2,1.0,0.0,1578,1558
1965-04-14,Ghana,DR Congo,4,1,3,1.0,0.0,1673,1494
1965-04-15,Chile,Peru,4,1,3,1.0,0.0,1644,1565
1965-04-18,Ethiopia,Uganda,2,0,2,1.0,0.0,1564,1576
1965-04-18,Ethiopia,Sudan,1,0,1,1.0,0.0,1572,1516
1965-04-18,Mali,Senegal,0,2,2,0.0,1.0,1492,1532
1965-04-18,Poland,Italy,0,0,0,0.5,0.5,1602,1783
1965-04-18,Yugoslavia,France,1,0,1,1.0,0.0,1763,1630
1965-04-19,Turkey,Portugal,0,1,1,0.0,1.0,1584,1600
1965-04-24,Germany,Cyprus,5,0,5,1.0,0.0,1734,1499
1965-04-25,Austria,German DR,1,1,0,0.5,0.5,1713,1571
1965-04-25,Costa Rica,Mexico,0,0,0,0.5,0.5,1738,1705
1965-04-25,Czechoslovakia,Portugal,0,1,1,0.0,1.0,1703,1611
1965-04-25,Paraguay,Uruguay,2,1,1,1.0,0.0,1658,1680
1965-04-28,Peru,Chile,0,1,1,0.0,1.0,1559,1651
1965-04-29,Indonesia,Sri Lanka,5,0,5,1.0,0.0,1594,1444
1965-05-01,Italy,Wales,4,1,3,1.0,0.0,1788,1592
1965-05-01,Uganda,Sudan,1,3,2,0.0,1.0,1567,1526
1965-05-01,Uruguay,Paraguay,4,0,4,1.0,0.0,1688,1651
1965-05-02,Morocco,Tunisia,0,1,1,0.0,1.0,1526,1558
1965-05-02,Romania,Turkey,3,0,3,1.0,0.0,1628,1577
1965-05-02,Switzerland,Albania,1,0,1,1.0,0.0,1559,1490
1965-05-03,Jamaica,Mexico,2,3,1,0.0,1.0,1490,1709
1965-05-03,Mali,Congo,1,1,0,0.5,0.5,1493,1520
1965-05-05,England,Hungary,1,0,1,1.0,0.0,1786,1809
1965-05-05,Republic of Ireland,Spain,1,0,1,1.0,0.0,1620,1717
1965-05-05,Senegal,Mali,3,1,2,1.0,0.0,1540,1486
1965-05-05,Sweden,Cyprus,3,0,3,1.0,0.0,1757,1497
1965-05-06,Guernsey,Jersey,2,4,2,0.0,1.0,1595,1684
1965-05-07,Mexico,Jamaica,8,0,8,1.0,0.0,1713,1487
1965-05-07,Northern Ireland,Albania,4,1,3,1.0,0.0,1556,1484
1965-05-08,Scotland,Spain,0,0,0,0.5,0.5,1723,1718
1965-05-09,Belgium,Israel,1,0,1,1.0,0.0,1652,1541
1965-05-09,Bulgaria,Turkey,4,1,3,1.0,0.0,1628,1570
1965-05-09,Chile,Uruguay,0,0,0,0.5,0.5,1652,1688
1965-05-09,Yugoslavia,England,1,1,0,0.5,0.5,1764,1786
1965-05-11,Costa Rica,Jamaica,7,0,7,1.0,0.0,1742,1484
1965-05-12,Germany,England,0,1,1,0.0,1.0,1728,1793
1965-05-16,Mexico,Costa Rica,1,0,1,1.0,0.0,1722,1734
1965-05-16,Peru,Venezuela,1,0,1,1.0,0.0,1566,1498
1965-05-16,Poland,Bulgaria,1,1,0,0.5,0.5,1603,1628
1965-05-16,Russia,Austria,0,0,0,0.5,0.5,1767,1715
1965-05-16,Sweden,England,1,2,1,0.0,1.0,1750,1801
1965-05-16,Uruguay,Chile,1,1,0,0.5,0.5,1688,1653
1965-05-19,Norway,Thailand,7,0,7,1.0,0.0,1556,1425
1965-05-22,Iran,Turkey,1,2,1,0.0,1.0,1498,1577
1965-05-22,Jamaica,Costa Rica,1,1,0,0.5,0.5,1489,1730
1965-05-23,German DR,Hungary,1,1,0,0.5,0.5,1576,1805
1965-05-23,Mali,Guinea,2,1,1,1.0,0.0,1495,1502
1965-05-23,Poland,Scotland,1,1,0,0.5,0.5,1606,1721
1965-05-23,Russia,Greece,3,1,2,1.0,0.0,1770,1471
1965-05-23,Uruguay,Venezuela,5,0,5,1.0,0.0,1693,1494
1965-05-24,Iran,Turkey,2,1,1,1.0,0.0,1508,1568
1965-05-26,Switzerland,Germany,0,1,1,0.0,1.0,1555,1733
1965-05-27,Finland,Scotland,1,2,1,0.0,1.0,1414,1724
1965-05-27,Norway,Luxembourg,4,2,2,1.0,0.0,1562,1419
1965-05-29,Liberia,Ivory Coast,0,1,1,0.0,1.0,1470,1549
1965-05-30,Romania,Czechoslovakia,1,0,1,1.0,0.0,1638,1694
1965-05-30,Russia,Wales,2,1,1,1.0,0.0,1775,1588
1965-05-30,Venezuela,Uruguay,1,3,2,0.0,1.0,1491,1697
1965-06-02,Brazil,Belgium,5,0,5,1.0,0.0,1841,1648
1965-06-02,Venezuela,Peru,3,6,3,0.0,1.0,1485,1573
1965-06-03,France,Argentina,0,0,0,0.5,0.5,1634,1815
1965-06-06,Brazil,Germany,2,0,2,1.0,0.0,1847,1728
1965-06-06,Guinea,Mali,2,1,1,1.0,0.0,1510,1488
1965-06-06,Peru,Uruguay,0,1,1,0.0,1.0,1568,1703
1965-06-09,Brazil,Argentina,0,0,0,0.5,0.5,1847,1816
1965-06-09,Denmark,Finland,3,1,2,1.0,0.0,1591,1410
1965-06-13,Austria,Hungary,0,1,1,0.0,1.0,1710,1811
1965-06-13,Bulgaria,Israel,4,0,4,1.0,0.0,1635,1535
1965-06-13,Uruguay,Peru,2,1,1,1.0,0.0,1709,1563
1965-06-14,Portugal,Romania,2,1,1,1.0,0.0,1620,1630
1965-06-16,Norway,Yugoslavia,3,0,3,1.0,0.0,1575,1752
1965-06-16,Sweden,Italy,2,2,0,0.5,0.5,1751,1788
1965-06-17,Algeria,Brazil,0,3,3,0.0,1.0,1524,1850
1965-06-20,Denmark,Sweden,2,1,1,1.0,0.0,1603,1740
1965-06-23,Finland,Italy,0,2,2,0.0,1.0,1409,1790
1965-06-24,Portugal,Brazil,0,0,0,0.5,0.5,1625,1846
1965-06-27,Congo,Benin,1,6,5,0.0,1.0,1512,1522
1965-06-27,Hungary,Italy,2,1,1,1.0,0.0,1819,1783
1965-06-27,Russia,Denmark,6,0,6,1.0,0.0,1780,1599
1965-06-30,Sweden,Brazil,1,2,1,0.0,1.0,1735,1852
1965-07-04,Russia,Brazil,0,3,3,0.0,1.0,1774,1859
1965-07-05,Iceland,Denmark,1,3,2,0.0,1.0,1441,1604
1965-07-11,Honduras,Costa Rica,1,1,0,0.5,0.5,1505,1726
1965-07-14,Argentina,Chile,1,0,1,1.0,0.0,1821,1649
1965-07-19,Congo,Uganda,2,1,1,1.0,0.0,1522,1558
1965-07-19,Mali,Togo,1,2,1,0.0,1.0,1480,1492
1965-07-19,Ivory Coast,Algeria,1,0,1,1.0,0.0,1557,1517
1965-07-19,Madagascar,DR Congo,0,7,7,0.0,1.0,1526,1503
1965-07-20,Colombia,Ecuador,0,1,1,0.0,1.0,1463,1404
1965-07-20,Congo,Togo,7,2,5,1.0,0.0,1530,1485
1965-07-20,Mali,Uganda,5,1,4,1.0,0.0,1490,1549
1965-07-20,Togo,Uganda,1,1,0,0.5,0.5,1487,1548
1965-07-20,Ivory Coast,Madagascar,5,0,5,1.0,0.0,1565,1519
1965-07-20,Algeria,DR Congo,4,1,3,1.0,0.0,1525,1496
1965-07-21,Chile,Argentina,1,1,0,0.5,0.5,1653,1818
1965-07-21,Pakistan,Turkey,1,3,2,0.0,1.0,1500,1575
1965-07-21,Congo,Mali,1,2,1,0.0,1.0,1522,1499
1965-07-21,Ivory Coast,DR Congo,1,1,0,0.5,0.5,1564,1498
1965-07-21,Algeria,Madagascar,1,0,1,1.0,0.0,1533,1512
1965-07-23,Iran,Pakistan,4,1,3,1.0,0.0,1516,1493
1965-07-23,Mali,Algeria,2,1,1,1.0,0.0,1508,1525
1965-07-23,Congo,Ivory Coast,1,0,1,1.0,0.0,1531,1556
1965-07-25,Ecuador,Colombia,2,0,2,1.0,0.0,1414,1454
1965-07-25,Iran,Turkey,0,0,0,0.5,0.5,1518,1574
1965-07-25,Paraguay,Bolivia,2,0,2,1.0,0.0,1657,1543
1965-07-25,Suriname,French Guiana,7,0,7,1.0,0.0,1556,1468
1965-07-25,Ivory Coast,Algeria,2,0,2,1.0,0.0,1564,1518
1965-07-25,Congo,Mali,0,0,0,0.5,0.5,1531,1509
1965-07-25,DR Congo,Togo,5,1,4,1.0,0.0,1506,1480
1965-07-25,Uganda,Madagascar,5,0,5,1.0,0.0,1556,1505
1965-07-26,Suriname,French Guiana,5,0,5,1.0,0.0,1563,1462
1965-07-26,Togo,Madagascar,1,0,1,1.0,0.0,1489,1497
1965-07-26,DR Congo,Uganda,6,2,4,1.0,0.0,1516,1547
1965-07-30,Jordan,Iraq,0,0,0,0.5,0.5,1452,1517
1965-08-01,Argentina,Paraguay,3,0,3,1.0,0.0,1823,1653
1965-08-01,Chile,Colombia,7,2,5,1.0,0.0,1657,1451
1965-08-02,China PR,Indonesia,3,0,3,1.0,0.0,1632,1587
1965-08-02,North Korea,North Vietnam,1,0,1,1.0,0.0,1575,1466
1965-08-03,Cambodia,North Vietnam,1,1,0,0.5,0.5,1442,1466
1965-08-03,Guinea,Indonesia,3,1,2,1.0,0.0,1520,1578
1965-08-04,North Korea,China PR,3,0,3,1.0,0.0,1585,1623
1965-08-05,Jamaica,Trinidad and Tobago,4,0,4,1.0,0.0,1500,1587
1965-08-06,Cambodia,Indonesia,0,0,0,0.5,0.5,1445,1576
1965-08-06,Guinea,North Vietnam,1,2,1,0.0,1.0,1511,1476
1965-08-07,Cambodia,China PR,1,3,2,0.0,1.0,1441,1628
1965-08-07,Colombia,Chile,2,0,2,1.0,0.0,1464,1645
1965-08-07,North Korea,Guinea,3,0,3,1.0,0.0,1592,1505
1965-08-08,Finland,Norway,4,0,4,1.0,0.0,1421,1564
1965-08-08,North Korea,Indonesia,3,0,3,1.0,0.0,1600,1569
1965-08-08,Paraguay,Argentina,0,0,0,0.5,0.5,1657,1820
1965-08-09,China PR,North Vietnam,3,3,0,0.5,0.5,1625,1480
1965-08-10,China PR,Guinea,2,0,2,1.0,0.0,1631,1500
1965-08-10,North Korea,Cambodia,4,0,4,1.0,0.0,1605,1437
1965-08-11,Indonesia,North Vietnam,2,1,1,1.0,0.0,1575,1475
1965-08-14,South Korea,Thailand,2,3,1,0.0,1.0,1611,1438
1965-08-14,Malaysia,Japan,2,2,0,0.5,0.5,1544,1536
1965-08-14,Liberia,DR Congo,2,1,1,1.0,0.0,1480,1507
1965-08-15,Myanmar,Hong Kong,4,2,2,1.0,0.0,1505,1489
1965-08-15,Vietnam Republic,Taiwan,5,2,3,1.0,0.0,1574,1567
1965-08-15,India,Japan,1,1,0,0.5,0.5,1582,1538
1965-08-15,Ecuador,Chile,2,2,0,0.5,0.5,1419,1641
1965-08-17,Argentina,Bolivia,4,1,3,1.0,0.0,1823,1541
1965-08-17,Hong Kong,Vietnam Republic,1,2,1,0.0,1.0,1483,1581
1965-08-17,Malaysia,South Korea,0,2,2,0.0,1.0,1538,1618
1965-08-18,Japan,Taiwan,0,4,4,0.0,1.0,1531,1575
1965-08-19,Hong Kong,India,2,2,0,0.5,0.5,1486,1580
1965-08-19,Malaysia,Vietnam Republic,3,3,0,0.5,0.5,1539,1581
1965-08-20,Thailand,Taiwan,2,3,1,0.0,1.0,1434,1580
1965-08-20,Japan,Myanmar,3,1,2,1.0,0.0,1539,1498
1965-08-21,South Korea,Vietnam Republic,0,0,0,0.5,0.5,1618,1582
1965-08-21,Malaysia,India,0,3,3,0.0,1.0,1532,1588
1965-08-22,Bolivia,Paraguay,2,1,1,1.0,0.0,1552,1647
1965-08-22,Myanmar,Thailand,1,1,0,0.5,0.5,1497,1436
1965-08-22,Chile,Ecuador,3,1,2,1.0,0.0,1645,1416
1965-08-22,Sudan,Uganda,4,1,3,1.0,0.0,1535,1539
1965-08-22,Sweden,Finland,2,2,0,0.5,0.5,1730,1427
1965-08-23,India,South Korea,0,1,1,0.0,1.0,1581,1626
1965-08-23,Malaysia,Hong Kong,1,3,2,0.0,1.0,1523,1496
1965-08-24,Myanmar,Taiwan,3,1,2,1.0,0.0,1507,1571
1965-08-24,Japan,Thailand,0,0,0,0.5,0.5,1537,1439
1965-08-25,Hong Kong,South Korea,0,1,1,0.0,1.0,1491,1632
1965-08-25,India,Vietnam Republic,2,0,2,1.0,0.0,1590,1574
1965-08-27,Myanmar,India,1,1,0,0.5,0.5,1509,1589
1965-08-27,Hong Kong,Thailand,1,1,0,0.5,0.5,1490,1441
1965-08-28,Gabon,Nigeria,2,2,0,0.5,0.5,1484,1540
1965-08-28,Japan,Vietnam Republic,2,1,1,1.0,0.0,1546,1566
1965-08-28,South Korea,Taiwan,1,1,0,0.5,0.5,1631,1573
1965-08-29,Bolivia,Argentina,1,2,1,0.0,1.0,1550,1826
1965-08-29,Gabon,Nigeria,1,4,3,0.0,1.0,1478,1547
1965-08-31,Singapore,India,1,2,1,0.0,1.0,1455,1595
1965-09-04,Bulgaria,German DR,3,2,1,1.0,0.0,1642,1570
1965-09-04,Russia,Yugoslavia,0,0,0,0.5,0.5,1774,1753
1965-09-05,DR Congo,Ivory Coast,4,2,2,1.0,0.0,1517,1555
1965-09-05,Hungary,Austria,3,0,3,1.0,0.0,1825,1705
1965-09-07,Brazil,Uruguay,3,0,3,1.0,0.0,1864,1705
1965-09-11,New Caledonia,Tahiti,4,1,3,1.0,0.0,1528,1465
1965-09-12,Zambia,Kenya,3,3,0,0.5,0.5,1530,1559
1965-09-13,New Caledonia,Tahiti,2,1,1,1.0,0.0,1535,1459
1965-09-14,Zambia,Kenya,2,3,1,0.0,1.0,1523,1567
1965-09-15,Norway,France,0,1,1,0.0,1.0,1558,1641
1965-09-18,Uganda,Zambia,2,2,0,0.5,0.5,1539,1524
1965-09-19,Czechoslovakia,Romania,3,1,2,1.0,0.0,1701,1624
1965-09-19,Luxembourg,Yugoslavia,2,5,3,0.0,1.0,1417,1756
1965-09-19,Zambia,Kenya,3,2,1,1.0,0.0,1533,1559
1965-09-21,DR Congo,Liberia,3,2,1,1.0,0.0,1525,1473
1965-09-21,Ivory Coast,Liberia,4,0,4,1.0,0.0,1562,1467
1965-09-25,Uganda,Zanzibar,4,1,3,1.0,0.0,1544,1376
1965-09-26,Bulgaria,Belgium,3,0,3,1.0,0.0,1651,1640
1965-09-26,Kenya,Tanzania,0,2,2,0.0,1.0,1550,1515
1965-09-26,Norway,Denmark,2,2,0,0.5,0.5,1560,1603
1965-09-26,Sweden,Germany,1,2,1,0.0,1.0,1722,1737
1965-09-26,Finland,Poland,2,0,2,1.0,0.0,1439,1595
1965-09-28,Uganda,Kenya,2,2,0,0.5,0.5,1545,1550
1965-09-29,Tanzania,Zanzibar,3,0,3,1.0,0.0,1520,1372
1965-10-01,Kenya,Zanzibar,5,1,4,1.0,0.0,1555,1368
1965-10-02,Northern Ireland,Scotland,3,2,1,1.0,0.0,1568,1713
1965-10-02,Uganda,Tanzania,1,1,0,0.5,0.5,1545,1521
1965-10-02,Wales,England,0,0,0,0.5,0.5,1593,1797
1965-10-03,Greece,Russia,1,4,3,0.0,1.0,1469,1777
1965-10-09,France,Yugoslavia,1,0,1,1.0,0.0,1652,1746
1965-10-09,Germany,Austria,4,1,3,1.0,0.0,1745,1698
1965-10-09,Hungary,German DR,3,2,1,1.0,0.0,1828,1568
1965-10-09,Turkey,Czechoslovakia,0,6,6,0.0,1.0,1569,1707
1965-10-12,Chile,Ecuador,2,1,1,1.0,0.0,1649,1413
1965-10-13,Scotland,Poland,1,2,1,0.0,1.0,1703,1606
1965-10-14,Ghana,Congo,5,0,5,1.0,0.0,1678,1527
1965-10-17,Congo,Ghana,2,1,1,1.0,0.0,1539,1667
1965-10-17,Denmark,Russia,1,3,2,0.0,1.0,1599,1782
1965-10-17,Netherlands,Switzerland,0,0,0,0.5,0.5,1602,1557
1965-10-20,England,Austria,2,3,1,0.0,1.0,1787,1709
1965-10-21,Congo,Ghana,1,2,1,0.0,1.0,1534,1673
1965-10-23,Kenya,Tanzania,4,2,2,1.0,0.0,1563,1514
1965-10-23,Turkey,Romania,2,1,1,1.0,0.0,1579,1615
1965-10-24,Poland,Finland,7,0,7,1.0,0.0,1611,1435
1965-10-27,Belgium,Bulgaria,5,0,5,1.0,0.0,1649,1643
1965-10-27,Denmark,Greece,1,1,0,0.5,0.5,1597,1472
1965-10-27,Spain,Republic of Ireland,4,1,3,1.0,0.0,1724,1615
1965-10-27,Wales,Russia,2,1,1,1.0,0.0,1605,1771
1965-10-30,Nigeria,Ghana,0,4,4,0.0,1.0,1542,1679
1965-10-31,Algeria,Morocco,0,0,0,0.5,0.5,1519,1526
1965-10-31,German DR,Austria,1,0,1,1.0,0.0,1580,1698
1965-10-31,Portugal,Czechoslovakia,0,0,0,0.5,0.5,1627,1706
1965-10-31,Sweden,Norway,0,0,0,0.5,0.5,1719,1564
1965-11-01,Italy,Poland,6,1,5,1.0,0.0,1788,1607
1965-11-06,France,Luxembourg,4,1,3,1.0,0.0,1656,1414
1965-11-07,Cyprus,Sweden,0,5,5,0.0,1.0,1494,1723
1965-11-07,Ghana,Nigeria,3,0,3,1.0,0.0,1684,1538
1965-11-07,Yugoslavia,Norway,1,1,0,0.5,0.5,1743,1568
1965-11-09,Scotland,Italy,1,0,1,1.0,0.0,1713,1779
1965-11-10,England,Northern Ireland,2,1,1,1.0,0.0,1791,1565
1965-11-10,Republic of Ireland,Spain,0,1,1,0.0,1.0,1610,1730
1965-11-10,Israel,Belgium,0,5,5,0.0,1.0,1530,1655
1965-11-12,DR Congo,Ghana,2,5,3,0.0,1.0,1521,1689
1965-11-12,Tunisia,Ethiopia,4,0,4,1.0,0.0,1567,1564
1965-11-13,Vietnam Republic,Thailand,4,0,4,1.0,0.0,1572,1436
1965-11-14,DR Congo,Ivory Coast,0,3,3,0.0,1.0,1514,1570
1965-11-14,Cyprus,Germany,0,6,6,0.0,1.0,1491,1749
1965-11-14,Switzerland,Netherlands,2,1,1,1.0,0.0,1567,1593
1965-11-14,Tunisia,Senegal,0,0,0,0.5,0.5,1567,1541
1965-11-16,Vietnam Republic,Malaysia,2,2,0,0.5,0.5,1571,1525
1965-11-19,Ethiopia,Senegal,1,5,4,0.0,1.0,1556,1550
1965-11-19,Ghana,Ivory Coast,4,1,3,1.0,0.0,1695,1565
1965-11-21,Brazil,Russia,2,2,0,0.5,0.5,1862,1774
1965-11-21,Brazil,Hungary,5,3,2,1.0,0.0,1870,1821
1965-11-21,Czechoslovakia,Turkey,3,1,2,1.0,0.0,1712,1574
1965-11-21,Dominica,Grenada,2,0,2,1.0,0.0,1494,1520
1965-11-21,Israel,Bulgaria,1,2,1,0.0,1.0,1525,1649
1965-11-21,Ivory Coast,Senegal,1,0,1,1.0,0.0,1573,1543
1965-11-21,North Korea,Australia,6,1,5,1.0,0.0,1612,1538
1965-11-21,Romania,Portugal,2,0,2,1.0,0.0,1624,1619
1965-11-21,Tunisia,Ghana,2,3,1,0.0,1.0,1562,1701
1965-11-22,Saint Vincent and the Grenadines,Saint Lucia,1,2,1,0.0,1.0,1496,1523
1965-11-23,Congo,Ivory Coast,0,1,1,0.0,1.0,1527,1581
1965-11-23,Dominica,Saint Lucia,1,0,1,1.0,0.0,1503,1515
1965-11-24,Albania,Northern Ireland,1,1,0,0.5,0.5,1486,1564
1965-11-24,Australia,North Korea,1,3,2,0.0,1.0,1532,1619
1965-11-24,Scotland,Wales,4,1,3,1.0,0.0,1719,1600
1965-11-25,Ivory Coast,Mali,1,3,2,0.0,1.0,1572,1519
1965-11-26,Cambodia,Australia,0,0,0,0.5,0.5,1440,1530
1965-11-26,Saint Vincent and the Grenadines,Dominica,3,1,2,1.0,0.0,1505,1495
1965-11-29,Hong Kong,Australia,1,0,1,1.0,0.0,1499,1522
1965-12-01,Argentina,Russia,1,1,0,0.5,0.5,1825,1776
1965-12-01,Wales,Denmark,4,2,2,1.0,0.0,1608,1590
1965-12-03,Australia,Taiwan,3,1,2,1.0,0.0,1532,1564
1965-12-04,Uruguay,Russia,1,3,2,0.0,1.0,1699,1783
1965-12-05,Hong Kong,Singapore,0,0,0,0.5,0.5,1498,1457
1965-12-07,Hong Kong,Singapore,1,2,1,0.0,1.0,1490,1466
1965-12-07,Italy,Scotland,3,0,3,1.0,0.0,1786,1713
1965-12-07,Malaysia,Australia,0,1,1,0.0,1.0,1518,1540
1965-12-08,Malaysia,Australia,0,3,3,0.0,1.0,1511,1548
1965-12-08,Spain,England,0,2,2,0.0,1.0,1724,1798
1965-12-11,Kenya,Ghana,2,13,11,0.0,1.0,1559,1706
1965-12-11,Nigeria,Benin,0,1,1,0.0,1.0,1530,1531
1965-12-13,Kenya,Ghana,3,3,0,0.5,0.5,1563,1703
1965-12-15,Thailand,Vietnam Republic,2,1,1,1.0,0.0,1447,1561
1965-12-15,Myanmar,Singapore,1,0,1,1.0,0.0,1517,1459
1965-12-16,Vietnam Republic,Singapore,5,1,4,1.0,0.0,1567,1454
1965-12-18,Thailand,Vietnam Republic,2,0,2,1.0,0.0,1458,1557
1965-12-18,Malaysia,Myanmar,0,2,2,0.0,1.0,1504,1525
1965-12-20,Malaysia,Vietnam Republic,0,2,2,0.0,1.0,1498,1564
1965-12-22,Myanmar,Thailand,2,2,0,0.5,0.5,1524,1460
1965-12-28,Bermuda,Jamaica,0,3,3,0.0,1.0,1484,1508
1965-12-29,Belgium,Bulgaria,1,2,1,0.0,1.0,1647,1658
1966-01-05,England,Poland,1,1,0,0.5,0.5,1794,1612
1966-02-08,Panama,Nicaragua,3,1,2,1.0,0.0,1454,1370
1966-02-13,Malta,Libya,1,0,1,1.0,0.0,1507,1507
1966-02-23,Chile,Russia,0,2,2,0.0,1.0,1644,1789
1966-02-23,England,Germany,1,0,1,1.0,0.0,1801,1743
1966-02-25,Egypt,Bulgaria,2,2,0,0.5,0.5,1616,1658
1966-02-27,Benin,Nigeria,1,2,1,0.0,1.0,1523,1539
1966-02-27,Niger,DR Congo,2,1,1,1.0,0.0,1489,1506
1966-02-28,Panama,Guatemala,0,1,1,0.0,1.0,1448,1537
1966-03-05,Uganda,Kenya,2,3,1,0.0,1.0,1538,1571
1966-03-06,Guinea,Senegal,5,0,5,1.0,0.0,1509,1535
1966-03-06,Morocco,Algeria,1,0,1,1.0,0.0,1534,1512
1966-03-06,Togo,Nigeria,2,2,0,0.5,0.5,1491,1538
1966-03-11,Libya,Morocco,4,0,4,1.0,0.0,1516,1526
1966-03-14,Libya,Iraq,0,2,2,0.0,1.0,1509,1525
1966-03-16,Iran,Turkey,0,0,0,0.5,0.5,1520,1573
1966-03-18,Iraq,Morocco,0,1,1,0.0,1.0,1518,1534
1966-03-19,France,Italy,0,0,0,0.5,0.5,1659,1784
1966-03-19,Iraq,Morocco,1,2,1,0.0,1.0,1511,1542
1966-03-23,Netherlands,Germany,2,4,2,0.0,1.0,1589,1748
1966-03-25,Panama,El Salvador,1,0,1,1.0,0.0,1459,1568
1966-03-27,Libya,Malta,0,1,1,0.0,1.0,1501,1516
1966-03-30,Wales,Northern Ireland,1,4,3,0.0,1.0,1599,1574
1966-04-01,Montenegro,Russia,0,1,1,0.0,1.0,1490,1792
1966-04-01,Libya,Palestine,0,0,0,0.5,0.5,1501,1501
1966-04-01,Iraq,Kuwait,3,1,2,1.0,0.0,1518,1460
1966-04-02,Scotland,England,3,4,1,0.0,1.0,1707,1808
1966-04-02,Syria,Yemen,4,1,3,1.0,0.0,1505,1492
1966-04-02,Iraq,Jordan,2,1,1,1.0,0.0,1525,1446
1966-04-02,Lebanon,Bahrain,6,1,5,1.0,0.0,1484,1492
1966-04-02,Guernsey,Alderney,10,0,10,1.0,0.0,1598,1327
1966-04-03,Libya,Oman,21,0,21,1.0,0.0,1509,1493
1966-04-03,Kenya,Uganda,3,3,0,0.5,0.5,1571,1539
1966-04-03,Kuwait,Lebanon,1,2,1,0.0,1.0,1453,1492
1966-04-04,Libya,Syria,0,0,0,0.5,0.5,1509,1506
1966-04-04,Palestine,Yemen,7,0,7,1.0,0.0,1509,1485
1966-04-05,Jordan,Lebanon,1,2,1,0.0,1.0,1440,1499
1966-04-05,Iraq,Bahrain,10,1,9,1.0,0.0,1533,1485
1966-04-06,Bahrain,Kuwait,4,4,0,0.5,0.5,1485,1454
1966-04-06,Israel,Finland,7,1,6,1.0,0.0,1531,1430
1966-04-06,Libya,Yemen,13,0,13,1.0,0.0,1517,1478
1966-04-06,Palestine,Syria,1,3,2,0.0,1.0,1501,1515
1966-04-07,Iraq,Lebanon,0,0,0,0.5,0.5,1533,1500
1966-04-07,Bahrain,Jordan,1,5,4,0.0,1.0,1476,1450
1966-04-08,Jordan,Kuwait,0,4,4,0.0,1.0,1443,1462
1966-04-09,Iraq,Libya,3,1,2,1.0,0.0,1541,1510
1966-04-09,Lebanon,Syria,0,1,1,0.0,1.0,1493,1523
1966-04-09,Nigeria,Togo,1,1,0,0.5,0.5,1537,1493
1966-04-10,Benin,Ghana,2,5,3,0.0,1.0,1519,1708
1966-04-10,Iraq,Syria,2,1,1,1.0,0.0,1549,1516
1966-04-10,Libya,Lebanon,6,1,5,1.0,0.0,1518,1486
1966-04-17,Chile,Brazil,0,1,1,0.0,1.0,1641,1874
1966-04-17,Netherlands,Belgium,3,1,2,1.0,0.0,1599,1638
1966-04-20,Chile,Brazil,2,1,1,1.0,0.0,1654,1862
1966-04-20,France,Belgium,0,3,3,0.0,1.0,1651,1647
1966-04-20,Switzerland,Russia,2,2,0,0.5,0.5,1572,1788
1966-04-24,Austria,Russia,0,1,1,0.0,1.0,1693,1794
1966-04-24,Mexico,Paraguay,7,0,7,1.0,0.0,1729,1641
1966-04-26,Togo,Benin,1,0,1,1.0,0.0,1502,1511
1966-04-27,German DR,Sweden,4,1,3,1.0,0.0,1592,1712
1966-05-03,Poland,Hungary,1,1,0,0.5,0.5,1617,1817
1966-05-04,England,Yugoslavia,2,0,2,1.0,0.0,1815,1737
1966-05-04,Republic of Ireland,Germany,0,4,4,0.0,1.0,1606,1753
1966-05-05,Jersey,Guernsey,1,1,0,0.5,0.5,1683,1600
1966-05-07,Northern Ireland,Germany,0,2,2,0.0,1.0,1570,1758
1966-05-08,Finland,Israel,0,3,3,0.0,1.0,1425,1537
1966-05-08,Yugoslavia,Hungary,2,0,2,1.0,0.0,1747,1808
1966-05-09,Guernsey,Jersey,3,1,2,1.0,0.0,1610,1674
1966-05-11,Mexico,Chile,1,0,1,1.0,0.0,1736,1648
1966-05-11,Scotland,Netherlands,0,3,3,0.0,1.0,1697,1610
1966-05-14,Brazil,Wales,3,1,2,1.0,0.0,1865,1597
1966-05-15,Brazil,Chile,1,1,0,0.5,0.5,1861,1653
1966-05-15,Paraguay,Uruguay,2,2,0,0.5,0.5,1643,1698
1966-05-18,Brazil,Wales,1,0,1,1.0,0.0,1864,1595
1966-05-18,Czechoslovakia,Russia,1,2,1,0.0,1.0,1706,1801
1966-05-18,Poland,Sweden,1,1,0,0.5,0.5,1620,1710
1966-05-18,Uruguay,Paraguay,3,1,2,1.0,0.0,1705,1637
1966-05-19,Brazil,Chile,1,0,1,1.0,0.0,1868,1650
1966-05-22,Austria,Republic of Ireland,1,0,1,1.0,0.0,1700,1600
1966-05-22,Belgium,Russia,0,1,1,0.0,1.0,1643,1806
1966-05-22,Chile,Wales,2,0,2,1.0,0.0,1657,1589
1966-05-25,Belgium,Republic of Ireland,2,3,1,0.0,1.0,1635,1609
1966-05-25,Lithuania,Libya,6,0,6,1.0,0.0,1458,1509
1966-05-29,Benin,Togo,2,2,0,0.5,0.5,1511,1503
1966-05-29,Chile,Mexico,0,1,1,0.0,1.0,1651,1743
1966-05-30,Denmark,Turkey,0,0,0,0.5,0.5,1590,1574
1966-06-01,Germany,Romania,1,0,1,1.0,0.0,1764,1619
1966-06-01,Yugoslavia,Bulgaria,0,2,2,0.0,1.0,1737,1669
1966-06-04,Brazil,Peru,4,0,4,1.0,0.0,1871,1561
1966-06-04,Finland,Sweden,1,0,1,1.0,0.0,1439,1697
1966-06-05,Brazil,Poland,4,1,3,1.0,0.0,1875,1617
1966-06-05,Hungary,Switzerland,3,1,2,1.0,0.0,1812,1569
1966-06-05,Russia,France,3,3,0,0.5,0.5,1803,1655
1966-06-08,Brazil,Poland,2,1,1,1.0,0.0,1878,1615
1966-06-08,Brazil,Peru,3,1,2,1.0,0.0,1881,1559
1966-06-10,Curaçao,Jamaica,0,0,0,0.5,0.5,1589,1510
1966-06-10,Trinidad and Tobago,Suriname,3,2,1,1.0,0.0,1595,1556
1966-06-11,Argentina,Poland,1,1,0,0.5,0.5,1821,1620
1966-06-11,Haiti,Guadeloupe,3,0,3,1.0,0.0,1566,1525
1966-06-12,Brazil,Czechoslovakia,2,1,1,1.0,0.0,1886,1702
1966-06-12,Portugal,Norway,4,0,4,1.0,0.0,1626,1562
1966-06-12,Trinidad and Tobago,Curaçao,1,0,1,1.0,0.0,1603,1582
1966-06-13,Haiti,Suriname,1,4,3,0.0,1.0,1558,1565
1966-06-13,Jamaica,Guadeloupe,0,0,0,0.5,0.5,1511,1525
1966-06-14,Italy,Bulgaria,6,1,5,1.0,0.0,1790,1664
1966-06-15,Brazil,Czechoslovakia,2,2,0,0.5,0.5,1883,1706
1966-06-15,Guadeloupe,Suriname,0,4,4,0.0,1.0,1518,1573
1966-06-15,Israel,Uruguay,1,2,1,0.0,1.0,1533,1710
1966-06-15,Trinidad and Tobago,Jamaica,4,1,3,1.0,0.0,1609,1506
1966-06-16,Haiti,Curaçao,3,0,3,1.0,0.0,1567,1574
1966-06-17,Jamaica,Suriname,3,5,2,0.0,1.0,1500,1580
1966-06-18,Guadeloupe,Curaçao,0,4,4,0.0,1.0,1512,1581
1966-06-18,Haiti,Trinidad and Tobago,1,0,1,1.0,0.0,1576,1601
1966-06-18,Italy,Austria,1,0,1,1.0,0.0,1796,1695
1966-06-18,Scotland,Portugal,0,1,1,0.0,1.0,1688,1636
1966-06-19,Romania,Uruguay,1,0,1,1.0,0.0,1630,1700
1966-06-19,Switzerland,Mexico,1,1,0,0.5,0.5,1573,1740
1966-06-20,Curaçao,Suriname,1,1,0,0.5,0.5,1581,1581
1966-06-20,Trinidad and Tobago,Guadeloupe,1,2,1,0.0,1.0,1591,1523
1966-06-21,Denmark,Portugal,1,3,2,0.0,1.0,1584,1643
1966-06-22,Haiti,Jamaica,3,0,3,1.0,0.0,1583,1494
1966-06-22,Italy,Argentina,3,0,3,1.0,0.0,1805,1813
1966-06-22,Northern Ireland,Mexico,4,1,3,1.0,0.0,1582,1729
1966-06-23,Germany,Yugoslavia,2,0,2,1.0,0.0,1772,1730
1966-06-23,Spain,Uruguay,1,1,0,0.5,0.5,1724,1701
1966-06-25,Scotland,Brazil,1,1,0,0.5,0.5,1693,1879
1966-06-26,Denmark,Norway,0,1,1,0.0,1.0,1576,1571
1966-06-26,Finland,England,0,3,3,0.0,1.0,1438,1817
1966-06-26,Portugal,Uruguay,3,0,3,1.0,0.0,1653,1692
1966-06-27,Sweden,Yugoslavia,1,1,0,0.5,0.5,1698,1730
1966-06-28,China PR,Tanzania,10,4,6,1.0,0.0,1637,1509
1966-06-29,Italy,Mexico,5,0,5,1.0,0.0,1812,1723
1966-06-29,Norway,England,1,6,5,0.0,1.0,1568,1821
1966-06-30,DR Congo,Ghana,0,3,3,0.0,1.0,1503,1712
1966-06-30,Sweden,Brazil,2,3,1,0.0,1.0,1694,1884
1966-07-01,Zambia,Malawi,4,1,3,1.0,0.0,1540,1462
1966-07-02,German DR,Chile,5,2,3,1.0,0.0,1602,1642
1966-07-03,Denmark,England,0,2,2,0.0,1.0,1573,1825
1966-07-03,Portugal,Romania,1,0,1,1.0,0.0,1661,1623
1966-07-04,Malawi,Zambia,0,3,3,0.0,1.0,1456,1547
1966-07-05,Madagascar,Zambia,0,3,3,0.0,1.0,1491,1554
1966-07-05,Poland,England,0,1,1,0.0,1.0,1617,1829
1966-07-06,Malawi,Zambia,0,6,6,0.0,1.0,1451,1560
1966-07-07,Ethiopia,Uganda,5,0,5,1.0,0.0,1564,1532
1966-07-08,Malawi,Zambia,1,5,4,0.0,1.0,1446,1566
1966-07-09,Malawi,Madagascar,1,6,5,0.0,1.0,1440,1498
1966-07-10,Ethiopia,Sudan,1,1,0,0.5,0.5,1564,1536
1966-07-11,England,Uruguay,0,0,0,0.5,0.5,1826,1696
1966-07-12,Brazil,Bulgaria,2,0,2,1.0,0.0,1888,1661
1966-07-12,Germany,Switzerland,5,0,5,1.0,0.0,1776,1570
1966-07-12,North Korea,Russia,0,3,3,0.0,1.0,1615,1808
1966-07-13,Argentina,Spain,2,1,1,1.0,0.0,1819,1719
1966-07-13,Chile,Italy,0,2,2,0.0,1.0,1638,1817
1966-07-13,France,Mexico,1,1,0,0.5,0.5,1657,1722
1966-07-13,Hungary,Portugal,1,3,2,0.0,1.0,1801,1673
1966-07-15,Brazil,Hungary,1,3,2,0.0,1.0,1879,1811
1966-07-15,Chile,North Korea,1,1,0,0.5,0.5,1638,1616
1966-07-15,France,Uruguay,1,2,1,0.0,1.0,1650,1704
1966-07-15,Spain,Switzerland,2,1,1,1.0,0.0,1724,1566
1966-07-16,Argentina,Germany,0,0,0,0.5,0.5,1819,1777
1966-07-16,Bulgaria,Portugal,0,3,3,0.0,1.0,1654,1681
1966-07-16,England,Mexico,2,0,2,1.0,0.0,1832,1717
1966-07-16,Italy,Russia,0,1,1,0.0,1.0,1809,1817
1966-07-18,Sudan,Uganda,2,1,1,1.0,0.0,1544,1525
1966-07-19,Argentina,Switzerland,2,0,2,1.0,0.0,1823,1563
1966-07-19,Brazil,Portugal,1,3,2,0.0,1.0,1867,1694
1966-07-19,Italy,North Korea,0,1,1,0.0,1.0,1797,1629
1966-07-19,Mexico,Uruguay,0,0,0,0.5,0.5,1717,1705
1966-07-20,Bulgaria,Hungary,1,3,2,0.0,1.0,1650,1816
1966-07-20,Chile,Russia,1,2,1,0.0,1.0,1634,1822
1966-07-20,England,France,2,0,2,1.0,0.0,1837,1646
1966-07-20,Germany,Spain,2,1,1,1.0,0.0,1784,1718
1966-07-23,China PR,Syria,6,0,6,1.0,0.0,1643,1511
1966-07-23,England,Argentina,1,0,1,1.0,0.0,1845,1816
1966-07-23,Germany,Uruguay,4,0,4,1.0,0.0,1791,1699
1966-07-23,Hungary,Russia,1,2,1,0.0,1.0,1809,1830
1966-07-23,North Korea,Portugal,3,5,2,0.0,1.0,1623,1701
1966-07-25,Germany,Russia,2,1,1,1.0,0.0,1800,1822
1966-07-26,England,Portugal,2,1,1,1.0,0.0,1850,1697
1966-07-28,Portugal,Russia,2,1,1,1.0,0.0,1708,1812
1966-07-30,England,Germany,4,2,2,1.0,0.0,1857,1794
1966-07-31,Cameroon,Congo,2,3,1,0.0,1.0,1542,1536
1966-08-07,DR Congo,Central African Republic,5,0,5,1.0,0.0,1511,1470
1966-08-13,Myanmar,Singapore,2,2,0,0.5,0.5,1523,1456
1966-08-13,Malaysia,Vietnam Republic,5,2,3,1.0,0.0,1508,1555
1966-08-14,Hong Kong,India,0,2,2,0.0,1.0,1485,1601
1966-08-14,South Korea,Japan,2,0,2,1.0,0.0,1638,1540
1966-08-14,Norway,Finland,1,1,0,0.5,0.5,1566,1441
1966-08-15,Taiwan,Thailand,2,1,1,1.0,0.0,1570,1455
1966-08-16,Togo,Ivory Coast,1,2,1,0.0,1.0,1497,1579
1966-08-17,Myanmar,Thailand,3,0,3,1.0,0.0,1530,1449
1966-08-17,Taiwan,Vietnam Republic,0,3,3,0.0,1.0,1562,1564
1966-08-17,India,Japan,3,0,3,1.0,0.0,1608,1534
1966-08-18,Togo,Ghana,1,1,0,0.5,0.5,1502,1708
1966-08-19,Hong Kong,South Korea,0,1,1,0.0,1.0,1481,1643
1966-08-19,Malaysia,Thailand,0,0,0,0.5,0.5,1507,1451
1966-08-20,Singapore,Taiwan,4,1,3,1.0,0.0,1467,1552
1966-08-20,Japan,Taiwan,5,2,3,1.0,0.0,1543,1544
1966-08-20,Singapore,Vietnam Republic,1,2,1,0.0,1.0,1462,1570
1966-08-21,Ghana,Togo,6,2,4,1.0,0.0,1712,1499
1966-08-21,South Korea,Thailand,2,1,1,1.0,0.0,1647,1448
1966-08-21,Hong Kong,Myanmar,0,2,2,0.0,1.0,1475,1537
1966-08-22,India,Singapore,0,1,1,0.0,1.0,1597,1474
1966-08-22,Japan,Vietnam Republic,0,2,2,0.0,1.0,1536,1578
1966-08-23,Myanmar,South Korea,2,0,2,1.0,0.0,1548,1637
1966-08-23,Hong Kong,Thailand,2,2,0,0.5,0.5,1475,1449
1966-08-23,India,Taiwan,1,0,1,1.0,0.0,1604,1538
1966-08-23,Malaysia,Myanmar,0,0,0,0.5,0.5,1508,1548
1966-08-25,Malaysia,Hong Kong,1,0,1,1.0,0.0,1516,1468
1966-08-25,Singapore,Japan,0,1,1,0.0,1.0,1468,1543
1966-08-26,India,Vietnam Republic,1,0,1,1.0,0.0,1612,1571
1966-08-27,Malaysia,South Korea,1,2,1,0.0,1.0,1511,1643
1966-08-28,Myanmar,Vietnam Republic,0,1,1,0.0,1.0,1541,1579
1966-08-28,China PR,Mali,4,0,4,1.0,0.0,1649,1514
1966-08-28,Guinea,Cameroon,2,2,0,0.5,0.5,1510,1542
1966-08-28,India,South Korea,1,0,1,1.0,0.0,1621,1635
1966-08-29,Singapore,Vietnam Republic,2,2,0,0.5,0.5,1471,1577
1966-08-30,Guinea,Mali,5,0,5,1.0,0.0,1519,1506
1966-08-31,Singapore,South Korea,1,3,2,0.0,1.0,1467,1640
1966-09-04,German DR,Egypt,6,0,6,1.0,0.0,1611,1608
1966-09-06,Zambia,Kenya,0,1,1,0.0,1.0,1559,1579
1966-09-07,Netherlands,Hungary,2,2,0,0.5,0.5,1615,1805
1966-09-09,Zambia,Kenya,2,1,1,1.0,0.0,1568,1571
1966-09-11,German DR,Poland,2,0,2,1.0,0.0,1620,1609
1966-09-13,Zambia,Kenya,5,4,1,1.0,0.0,1577,1563
1966-09-18,Austria,Netherlands,2,1,1,1.0,0.0,1702,1609
1966-09-18,Finland,Denmark,2,1,1,1.0,0.0,1452,1563
1966-09-18,Norway,Sweden,2,4,2,0.0,1.0,1561,1700
1966-09-18,Yugoslavia,Russia,1,2,1,0.0,1.0,1724,1819
1966-09-21,German DR,Romania,2,0,2,1.0,0.0,1629,1615
1966-09-21,Hungary,Denmark,6,0,6,1.0,0.0,1809,1560
1966-09-24,Zanzibar,Kenya,1,3,2,0.0,1.0,1365,1567
1966-09-25,Tanzania,Uganda,0,3,3,0.0,1.0,1502,1533
1966-09-27,Kenya,Uganda,0,0,0,0.5,0.5,1567,1534
1966-09-28,Hungary,France,4,2,2,1.0,0.0,1814,1642
1966-09-28,Zanzibar,Tanzania,0,4,4,0.0,1.0,1361,1507
1966-09-30,Tanzania,Kenya,2,3,1,0.0,1.0,1501,1574
1966-10-01,Zanzibar,Uganda,0,0,0,0.5,0.5,1365,1531
1966-10-02,Finland,Austria,0,0,0,0.5,0.5,1457,1698
1966-10-02,Poland,Luxembourg,4,0,4,1.0,0.0,1613,1411
1966-10-05,Sweden,Austria,4,1,3,1.0,0.0,1708,1691
1966-10-12,Israel,Yugoslavia,1,3,2,0.0,1.0,1530,1728
1966-10-12,Turkey,Germany,0,2,2,0.0,1.0,1571,1798
1966-10-15,French Guiana,Suriname,3,3,0,0.5,0.5,1465,1579
1966-10-16,French Guiana,Suriname,0,3,3,0.0,1.0,1460,1585
1966-10-16,Greece,Finland,2,1,1,1.0,0.0,1480,1450
1966-10-16,Russia,Turkey,0,2,2,0.0,1.0,1807,1584
1966-10-19,Yugoslavia,Czechoslovakia,1,0,1,1.0,0.0,1736,1699
1966-10-22,Belgium,Switzerland,1,0,1,1.0,0.0,1642,1557
1966-10-22,France,Poland,2,1,1,1.0,0.0,1650,1606
1966-10-22,Northern Ireland,England,0,2,2,0.0,1.0,1580,1860
1966-10-22,Wales,Scotland,1,1,0,0.5,0.5,1592,1691
1966-10-23,Republic of Ireland,Spain,0,0,0,0.5,0.5,1612,1716
1966-10-23,Russia,German DR,2,2,0,0.5,0.5,1804,1633
1966-10-26,Denmark,Israel,3,1,2,1.0,0.0,1568,1523
1966-10-30,Hungary,Austria,3,1,2,1.0,0.0,1820,1686
1966-10-31,Cameroon,Togo,2,0,2,1.0,0.0,1550,1492
1966-11-01,Italy,Russia,1,0,1,1.0,0.0,1806,1796
1966-11-01,Ivory Coast,Ghana,1,1,0,0.5,0.5,1582,1710
1966-11-01,Vietnam Republic,Malaysia,3,2,1,1.0,0.0,1584,1505
1966-11-02,England,Czechoslovakia,0,0,0,0.5,0.5,1857,1703
1966-11-02,Romania,Switzerland,4,2,2,1.0,0.0,1622,1551
1966-11-03,Malaysia,Thailand,1,1,0,0.5,0.5,1504,1451
1966-11-05,Dominica,Saint Vincent and the Grenadines,0,1,1,0.0,1.0,1488,1513
1966-11-05,Nigeria,DR Congo,3,2,1,1.0,0.0,1545,1504
1966-11-05,Vietnam Republic,Thailand,4,1,3,1.0,0.0,1590,1446
1966-11-06,Bulgaria,Yugoslavia,6,1,5,1.0,0.0,1660,1727
1966-11-06,Grenada,Saint Lucia,7,1,6,1.0,0.0,1528,1508
1966-11-06,Netherlands,Czechoslovakia,1,2,1,0.0,1.0,1604,1709
1966-11-06,Sweden,Denmark,2,1,1,1.0,0.0,1713,1564
1966-11-08,Grenada,Dominica,3,3,0,0.5,0.5,1528,1489
1966-11-09,Saint Lucia,Saint Vincent and the Grenadines,1,2,1,0.0,1.0,1501,1521
1966-11-10,Dominica,Saint Lucia,5,3,2,1.0,0.0,1498,1493
1966-11-11,Belgium,France,2,1,1,1.0,0.0,1651,1642
1966-11-12,Grenada,Saint Vincent and the Grenadines,1,3,2,0.0,1.0,1520,1530
1966-11-12,Sierra Leone,Liberia,1,1,0,0.5,0.5,1465,1467
1966-11-13,Bulgaria,Norway,4,2,2,1.0,0.0,1666,1556
1966-11-13,Portugal,Sweden,1,2,1,0.0,1.0,1701,1721
1966-11-16,England,Wales,5,1,4,1.0,0.0,1860,1590
1966-11-16,Republic of Ireland,Turkey,2,1,1,1.0,0.0,1620,1577
1966-11-16,Scotland,Northern Ireland,2,1,1,1.0,0.0,1697,1575
1966-11-17,Romania,Poland,4,3,1,1.0,0.0,1630,1599
1966-11-19,Germany,Norway,3,0,3,1.0,0.0,1802,1553
1966-11-19,Liberia,Sierra Leone,2,0,2,1.0,0.0,1475,1458
1966-11-20,Mali,Guinea,1,0,1,1.0,0.0,1515,1511
1966-11-24,Algeria,Morocco,2,2,0,0.5,0.5,1513,1542
1966-11-25,DR Congo,Nigeria,1,0,1,1.0,0.0,1513,1537
1966-11-25,Palestine,Yemen,5,3,2,1.0,0.0,1509,1471
1966-11-26,Cambodia,North Korea,0,2,2,0.0,1.0,1436,1628
1966-11-26,China PR,Palestine,7,0,7,1.0,0.0,1654,1505
1966-11-26,Italy,Romania,3,1,2,1.0,0.0,1811,1626
1966-11-26,Luxembourg,France,0,3,3,0.0,1.0,1408,1646
1966-11-26,North Vietnam,Yemen,9,0,9,1.0,0.0,1483,1464
1966-11-27,Cambodia,China PR,0,4,4,0.0,1.0,1433,1658
1966-11-27,Palestine,North Vietnam,0,4,4,0.0,1.0,1497,1492
1966-11-29,Cambodia,Yemen,8,0,8,1.0,0.0,1442,1456
1966-11-29,Palestine,North Korea,1,5,4,0.0,1.0,1492,1634
1966-11-30,Cambodia,North Vietnam,2,2,0,0.5,0.5,1444,1491
1966-11-30,Chile,Colombia,5,2,3,1.0,0.0,1639,1460
1966-11-30,China PR,North Vietnam,2,0,2,1.0,0.0,1663,1487
1966-11-30,North Korea,Yemen,14,0,14,1.0,0.0,1639,1452
1966-11-30,Netherlands,Denmark,2,0,2,1.0,0.0,1612,1557
1966-11-30,Uganda,Kenya,1,2,1,0.0,1.0,1524,1582
1966-12-02,DR Congo,Gabon,4,3,1,1.0,0.0,1521,1471
1966-12-03,Central African Republic,DR Congo,1,4,3,0.0,1.0,1464,1528
1966-12-03,China PR,North Korea,1,2,1,0.0,1.0,1655,1648
1966-12-03,Cyprus,Romania,1,5,4,0.0,1.0,1486,1632
1966-12-03,Israel,Poland,0,0,0,0.5,0.5,1525,1598
1966-12-06,China PR,Yemen,6,0,6,1.0,0.0,1659,1449
1966-12-06,North Korea,North Vietnam,3,1,2,1.0,0.0,1653,1483
1966-12-07,Israel,Romania,1,2,1,0.0,1.0,1520,1638
1966-12-07,Spain,Republic of Ireland,2,0,2,1.0,0.0,1722,1615
1966-12-09,Libya,Egypt,2,2,0,0.5,0.5,1512,1606
1966-12-09,Papua New Guinea,Tahiti,3,4,1,0.0,1.0,1484,1468
1966-12-10,Kenya,Sudan,0,1,1,0.0,1.0,1574,1553
1966-12-10,Thailand,South Korea,3,0,3,1.0,0.0,1459,1628
1966-12-10,Japan,India,2,1,1,1.0,0.0,1553,1612
1966-12-10,Iran,Malaysia,2,0,2,1.0,0.0,1528,1497
1966-12-10,Indonesia,Singapore,3,0,3,1.0,0.0,1581,1462
1966-12-11,Colombia,Chile,0,0,0,0.5,0.5,1464,1636
1966-12-11,Tahiti,Wallis Islands and Futuna,5,0,5,1.0,0.0,1477,1492
1966-12-11,Iran,Japan,1,3,2,0.0,1.0,1521,1561
1966-12-11,Indonesia,Vietnam Republic,0,0,0,0.5,0.5,1582,1590
1966-12-12,Kenya,Sudan,3,2,1,1.0,0.0,1582,1546
1966-12-12,New Caledonia,Vanuatu,5,0,5,1.0,0.0,1542,1457
1966-12-12,New Caledonia,Solomon Islands,8,0,8,1.0,0.0,1549,1486
1966-12-12,South Korea,Myanmar,0,1,1,0.0,1.0,1619,1551
1966-12-12,Malaysia,India,1,2,1,0.0,1.0,1492,1618
1966-12-12,Vietnam Republic,Taiwan,2,1,1,1.0,0.0,1597,1532
1966-12-13,Papua New Guinea,Wallis Islands and Futuna,9,1,8,1.0,0.0,1493,1484
1966-12-13,Solomon Islands,Vanuatu,4,4,0,0.5,0.5,1486,1458
1966-12-13,India,Iran,1,4,3,0.0,1.0,1608,1532
1966-12-13,Singapore,Taiwan,3,3,0,0.5,0.5,1464,1531
1966-12-14,Thailand,Myanmar,1,1,0,0.5,0.5,1462,1549
1966-12-14,Malaysia,Japan,0,1,1,0.0,1.0,1486,1568
1966-12-14,Taiwan,Indonesia,1,3,2,0.0,1.0,1525,1589
1966-12-14,Singapore,Vietnam Republic,5,0,5,1.0,0.0,1475,1587
1966-12-15,New Caledonia,Papua New Guinea,4,0,4,1.0,0.0,1556,1487
1966-12-15,Tahiti,Vanuatu,3,0,3,1.0,0.0,1485,1451
1966-12-15,Thailand,Singapore,0,2,2,0.0,1.0,1455,1483
1966-12-15,Myanmar,Indonesia,2,2,0,0.5,0.5,1550,1589
1966-12-16,Japan,Singapore,5,1,4,1.0,0.0,1575,1477
1966-12-16,Iran,Indonesia,1,0,1,1.0,0.0,1542,1580
1966-12-17,New Caledonia,Tahiti,0,2,2,0.0,1.0,1547,1495
1966-12-17,Papua New Guinea,Vanuatu,2,5,3,0.0,1.0,1479,1460
1966-12-17,Thailand,Japan,1,5,4,0.0,1.0,1450,1581
1966-12-17,Myanmar,Iran,1,0,1,1.0,0.0,1558,1535
1966-12-18,Japan,Iran,0,1,1,0.0,1.0,1572,1545
1966-12-18,Myanmar,Singapore,2,0,2,1.0,0.0,1565,1471
1966-12-19,Japan,Singapore,2,0,2,1.0,0.0,1578,1466
1966-12-20,Iran,Myanmar,0,1,1,0.0,1.0,1538,1573
1966-12-21,Ecuador,Paraguay,2,2,0,0.5,0.5,1418,1633
1966-12-28,Paraguay,Ecuador,3,1,2,1.0,0.0,1637,1415
1967-01-04,Gabon,DR Congo,1,0,1,1.0,0.0,1481,1519
1967-01-04,Uruguay,Romania,1,1,0,0.5,0.5,1698,1640
1967-01-05,Mexico,Switzerland,3,0,3,1.0,0.0,1722,1547
1967-01-08,Mexico,Switzerland,0,2,2,0.0,1.0,1711,1559
1967-01-11,Jamaica,Curaçao,1,1,0,0.5,0.5,1496,1580
1967-01-12,Cuba,Haiti,1,1,0,0.5,0.5,1428,1580
1967-01-13,Curaçao,Trinidad and Tobago,1,2,1,0.0,1.0,1573,1599
1967-01-14,Jamaica,Cuba,2,1,1,1.0,0.0,1503,1422
1967-01-16,Haiti,Trinidad and Tobago,4,2,2,1.0,0.0,1589,1591
1967-01-17,Uruguay,Bolivia,4,0,4,1.0,0.0,1703,1546
1967-01-17,Curaçao,Cuba,2,2,0,0.5,0.5,1570,1426
1967-01-17,Egypt,German DR,1,2,1,0.0,1.0,1599,1641
1967-01-18,Argentina,Paraguay,4,1,3,1.0,0.0,1821,1633
1967-01-18,Chile,Venezuela,2,0,2,1.0,0.0,1641,1481
1967-01-18,Guatemala,Honduras,3,1,2,1.0,0.0,1545,1498
1967-01-18,Jamaica,Trinidad and Tobago,1,1,0,0.5,0.5,1505,1590
1967-01-19,Curaçao,Haiti,0,1,1,0.0,1.0,1563,1597
1967-01-20,Cuba,Trinidad and Tobago,1,2,1,0.0,1.0,1422,1595
1967-01-20,Egypt,German DR,0,3,3,0.0,1.0,1592,1649
1967-01-21,Jamaica,Haiti,0,1,1,0.0,1.0,1500,1603
1967-01-21,Martinique,Guadeloupe,2,1,1,1.0,0.0,1558,1516
1967-01-21,Uruguay,Venezuela,4,0,4,1.0,0.0,1707,1478
1967-01-22,Bolivia,Argentina,0,1,1,0.0,1.0,1544,1824
1967-01-22,Chile,Paraguay,4,2,2,1.0,0.0,1649,1626
1967-01-22,DR Congo,Congo,4,1,3,1.0,0.0,1528,1528
1967-01-22,Honduras,Guatemala,1,1,0,0.5,0.5,1500,1544
1967-01-22,Tunisia,Turkey,0,0,0,0.5,0.5,1563,1577
1967-01-23,Martinique,French Guiana,2,1,1,1.0,0.0,1564,1455
1967-01-24,Egypt,German DR,2,2,0,0.5,0.5,1594,1648
1967-01-25,Argentina,Venezuela,5,1,4,1.0,0.0,1826,1477
1967-01-25,Paraguay,Bolivia,1,0,1,1.0,0.0,1633,1538
1967-01-26,Uruguay,Chile,2,2,0,0.5,0.5,1706,1651
1967-01-26,Liberia,Guinea,2,2,0,0.5,0.5,1476,1511
1967-01-28,Argentina,Chile,2,0,2,1.0,0.0,1831,1647
1967-01-28,Bolivia,Venezuela,0,3,3,0.0,1.0,1529,1487
1967-01-28,Nigeria,Ghana,2,2,0,0.5,0.5,1541,1707
1967-01-29,Burkina Faso,Niger,3,2,1,1.0,0.0,1492,1481
1967-01-29,Sudan,German DR,1,2,1,0.0,1.0,1541,1654
1967-01-29,Uruguay,Paraguay,2,0,2,1.0,0.0,1713,1627
1967-01-31,Niger,Congo,1,3,2,0.0,1.0,1475,1535
1967-02-01,Bolivia,Chile,0,0,0,0.5,0.5,1532,1645
1967-02-01,Turkey,Spain,0,0,0,0.5,0.5,1581,1719
1967-02-01,Venezuela,Paraguay,3,5,2,0.0,1.0,1483,1632
1967-02-02,Uruguay,Argentina,1,0,1,1.0,0.0,1724,1821
1967-02-03,Mali,Congo,1,0,1,1.0,0.0,1524,1527
1967-02-05,Mali,Algeria,0,3,3,0.0,1.0,1516,1522
1967-02-05,Tunisia,Cameroon,4,0,4,1.0,0.0,1571,1543
1967-02-09,Nicaragua,Panama,3,1,2,1.0,0.0,1381,1449
1967-02-12,Burkina Faso,Algeria,1,2,1,0.0,1.0,1485,1530
1967-02-12,Ghana,Nigeria,2,0,2,1.0,0.0,1712,1537
1967-02-12,Iraq,German DR,1,1,0,0.5,0.5,1552,1652
1967-02-12,Guatemala,Panama,3,1,2,1.0,0.0,1550,1444
1967-02-14,Guatemala,Nicaragua,3,1,2,1.0,0.0,1555,1377
1967-02-15,Greece,Libya,4,0,4,1.0,0.0,1489,1504
1967-02-18,Togo,DR Congo,2,4,2,0.0,1.0,1485,1536
1967-02-19,Ethiopia,Kenya,2,0,2,1.0,0.0,1573,1574
1967-02-19,Ghana,Ivory Coast,2,2,0,0.5,0.5,1710,1585
1967-02-19,Tunisia,Congo,1,1,0,0.5,0.5,1570,1529
1967-02-21,Sudan,Tanzania,1,0,1,1.0,0.0,1549,1494
1967-02-22,Germany,Morocco,5,1,4,1.0,0.0,1805,1540
1967-02-22,Turkey,Republic of Ireland,2,1,1,1.0,0.0,1590,1607
1967-02-23,Kenya,Tanzania,2,0,2,1.0,0.0,1581,1488
1967-02-24,Sudan,Ethiopia,1,1,0,0.5,0.5,1550,1573
1967-02-24,Uganda,DR Congo,0,5,5,0.0,1.0,1517,1544
1967-02-25,Guinea,Senegal,3,0,3,1.0,0.0,1520,1527
1967-02-26,Cameroon,Congo,1,1,0,0.5,0.5,1543,1530
1967-02-26,Sudan,Ethiopia,5,3,2,1.0,0.0,1559,1565
1967-02-28,Ethiopia,Sudan,2,1,1,1.0,0.0,1573,1552
1967-02-28,France,Corsica,0,2,2,0.0,1.0,1635,1512
1967-03-05,Benin,Congo,1,1,0,0.5,0.5,1512,1530
1967-03-05,Ivory Coast,Liberia,1,1,0,0.5,0.5,1583,1479
1967-03-05,Honduras,Trinidad and Tobago,1,0,1,1.0,0.0,1511,1585
1967-03-05,Uganda,Kenya,2,1,1,1.0,0.0,1527,1572
1967-03-06,Haiti,Guatemala,1,2,1,0.0,1.0,1594,1565
1967-03-06,Mexico,Nicaragua,4,0,4,1.0,0.0,1714,1375
1967-03-07,Libya,Sudan,1,1,0,0.5,0.5,1506,1551
1967-03-08,Greece,Romania,1,2,1,0.0,1.0,1485,1645
1967-03-08,Haiti,Trinidad and Tobago,2,3,1,0.0,1.0,1586,1594
1967-03-08,Honduras,Nicaragua,1,1,0,0.5,0.5,1509,1378
1967-03-10,Guatemala,Mexico,1,0,1,1.0,0.0,1577,1703
1967-03-10,Haiti,Nicaragua,2,1,1,1.0,0.0,1590,1375
1967-03-10,Iraq,Sudan,2,2,0,0.5,0.5,1552,1552
1967-03-12,Libya,Iraq,0,1,1,0.0,1.0,1500,1559
1967-03-12,Kenya,Uganda,3,3,0,0.5,0.5,1571,1529
1967-03-12,Honduras,Guatemala,0,0,0,0.5,0.5,1511,1576
1967-03-12,Mexico,Trinidad and Tobago,4,0,4,1.0,0.0,1709,1589
1967-03-12,Algeria,Mali,1,0,1,1.0,0.0,1538,1509
1967-03-12,Nigeria,Ivory Coast,0,0,0,0.5,0.5,1539,1582
1967-03-14,Haiti,Mexico,0,1,1,0.0,1.0,1585,1715
1967-03-14,Trinidad and Tobago,Guatemala,0,2,2,0.0,1.0,1581,1585
1967-03-17,Nicaragua,Trinidad and Tobago,1,3,2,0.0,1.0,1372,1585
1967-03-17,Honduras,Haiti,2,0,2,1.0,0.0,1521,1576
1967-03-18,DR Congo,Sudan,3,2,1,1.0,0.0,1553,1544
1967-03-19,Congo,Ghana,3,1,2,1.0,0.0,1542,1699
1967-03-19,Honduras,Mexico,0,1,1,0.0,1.0,1518,1719
1967-03-19,Guatemala,Nicaragua,2,0,2,1.0,0.0,1589,1369
1967-03-19,Luxembourg,Belgium,0,5,5,0.0,1.0,1405,1655
1967-03-19,Senegal,Guinea,4,1,3,1.0,0.0,1535,1513
1967-03-22,Algeria,Hungary,0,1,1,0.0,1.0,1536,1823
1967-03-22,Cyprus,Italy,0,2,2,0.0,1.0,1484,1814
1967-03-22,France,Romania,1,2,1,0.0,1.0,1628,1653
1967-03-22,Germany,Bulgaria,1,0,1,1.0,0.0,1810,1662
1967-03-22,Hong Kong,Vietnam Republic,2,0,2,1.0,0.0,1479,1577
1967-03-24,Egypt,Libya,3,2,1,1.0,0.0,1600,1495
1967-03-24,Thailand,Vietnam Republic,0,1,1,0.0,1.0,1445,1583
1967-03-27,Italy,Portugal,1,1,0,0.5,0.5,1812,1704
1967-03-28,Gabon,Ivory Coast,0,3,3,0.0,1.0,1476,1588
1967-03-29,Vietnam Republic,Malaysia,0,2,2,0.0,1.0,1573,1497
1967-04-02,Guinea,Liberia,3,0,3,1.0,0.0,1521,1472
1967-04-02,Sudan,DR Congo,1,0,1,1.0,0.0,1553,1545
1967-04-02,Togo,Niger,1,0,1,1.0,0.0,1493,1468
1967-04-02,Vietnam Republic,Singapore,3,0,3,1.0,0.0,1579,1461
1967-04-05,German DR,Netherlands,4,3,1,1.0,0.0,1660,1605
1967-04-06,Jersey,Alderney,3,1,2,1.0,0.0,1676,1326
1967-04-08,Germany,Albania,6,0,6,1.0,0.0,1813,1484
1967-04-09,Algeria,Burkina Faso,3,1,2,1.0,0.0,1543,1479
1967-04-09,Liberia,Senegal,1,1,0,0.5,0.5,1474,1534
1967-04-12,Northern Ireland,Wales,0,0,0,0.5,0.5,1576,1590
1967-04-15,England,Scotland,2,3,1,0.0,1.0,1849,1709
1967-04-15,Nigeria,Togo,4,2,2,1.0,0.0,1546,1487
1967-04-16,Belgium,Netherlands,1,0,1,1.0,0.0,1662,1599
1967-04-16,Luxembourg,Poland,0,0,0,0.5,0.5,1410,1594
1967-04-19,Congo,DR Congo,3,1,2,1.0,0.0,1551,1537
1967-04-23,Hungary,Yugoslavia,1,0,1,1.0,0.0,1829,1722
1967-04-23,Romania,Cyprus,7,0,7,1.0,0.0,1658,1480
1967-04-30,Ivory Coast,Togo,3,0,3,1.0,0.0,1594,1482
1967-05-03,Switzerland,Czechoslovakia,1,2,1,0.0,1.0,1555,1714
1967-05-03,Yugoslavia,Germany,1,0,1,1.0,0.0,1733,1803
1967-05-07,Ivory Coast,Nigeria,2,0,2,1.0,0.0,1601,1540
1967-05-09,Guernsey,Jersey,1,3,2,0.0,1.0,1604,1683
1967-05-10,Finland,Greece,1,1,0,0.5,0.5,1451,1485
1967-05-10,Hungary,Netherlands,2,1,1,1.0,0.0,1833,1596
1967-05-10,Scotland,Russia,0,2,2,0.0,1.0,1703,1803
1967-05-14,Albania,Yugoslavia,0,2,2,0.0,1.0,1481,1737
1967-05-14,Suriname,French Guiana,6,1,5,1.0,0.0,1591,1450
1967-05-15,Suriname,French Guiana,3,0,3,1.0,0.0,1596,1446
1967-05-16,Israel,Scotland,1,2,1,0.0,1.0,1516,1708
1967-05-17,Congo,Tanzania,6,1,5,1.0,0.0,1558,1482
1967-05-17,Sweden,German DR,0,1,1,0.0,1.0,1712,1670
1967-05-21,Congo,Cameroon,2,1,1,1.0,0.0,1566,1536
1967-05-21,Republic of Ireland,Czechoslovakia,0,2,2,0.0,1.0,1602,1720
1967-05-21,Poland,Belgium,3,1,2,1.0,0.0,1604,1653
1967-05-24,Denmark,Hungary,0,2,2,0.0,1.0,1555,1836
1967-05-24,England,Spain,2,0,2,1.0,0.0,1855,1714
1967-05-24,Ghana,DR Congo,2,0,2,1.0,0.0,1704,1533
1967-05-24,Switzerland,Romania,7,1,6,1.0,0.0,1566,1648
1967-05-27,Austria,England,0,1,1,0.0,1.0,1682,1860
1967-05-28,Russia,Mexico,2,0,2,1.0,0.0,1810,1713
1967-05-31,Spain,Turkey,2,0,2,1.0,0.0,1720,1585
1967-06-01,Finland,Norway,0,2,2,0.0,1.0,1446,1559
1967-06-01,Russia,Mexico,0,1,1,0.0,1.0,1800,1724
1967-06-01,Sweden,Portugal,1,1,0,0.5,0.5,1712,1705
1967-06-03,France,Russia,2,4,2,0.0,1.0,1624,1805
1967-06-04,Belarus,Mexico,2,1,1,1.0,0.0,1503,1712
1967-06-04,Denmark,German DR,1,1,0,0.5,0.5,1558,1668
1967-06-04,Uganda,Egypt,0,1,1,0.0,1.0,1523,1607
1967-06-08,Norway,Portugal,1,2,1,0.0,1.0,1555,1710
1967-06-11,Russia,Austria,4,3,1,1.0,0.0,1811,1677
1967-06-11,Sweden,Bulgaria,0,2,2,0.0,1.0,1703,1672
1967-06-18,Czechoslovakia,Turkey,3,0,3,1.0,0.0,1726,1580
1967-06-22,Uganda,Zambia,1,3,2,0.0,1.0,1517,1584
1967-06-25,Denmark,Sweden,1,1,0,0.5,0.5,1562,1700
1967-06-25,Romania,Italy,0,1,1,0.0,1.0,1644,1817
1967-06-25,Uruguay,Brazil,0,0,0,0.5,0.5,1728,1864
1967-06-28,Uruguay,Brazil,2,2,0,0.5,0.5,1731,1862
1967-06-29,Norway,Bulgaria,0,0,0,0.5,0.5,1558,1670
1967-07-01,Uruguay,Brazil,1,1,0,0.5,0.5,1734,1860
1967-07-02,Senegal,Liberia,4,1,3,1.0,0.0,1541,1468
1967-07-06,Tanzania,Zambia,2,2,0,0.5,0.5,1485,1582
1967-07-08,Benin,Ghana,2,1,1,1.0,0.0,1525,1692
1967-07-08,Tanzania,Zambia,2,1,1,1.0,0.0,1496,1572
1967-07-16,Russia,Greece,4,0,4,1.0,0.0,1814,1483
1967-07-28,Peru,Uruguay,0,1,1,0.0,1.0,1555,1739
1967-07-28,Peru,Japan,1,0,1,1.0,0.0,1564,1570
1967-07-29,South Korea,Indonesia,1,1,0,0.5,0.5,1619,1581
1967-07-30,Guyana,Suriname,2,2,0,0.5,0.5,1434,1593
1967-07-30,Peru,Uruguay,1,2,1,0.0,1.0,1560,1744
1967-07-30,Peru,Japan,0,0,0,0.5,0.5,1561,1570
1967-07-31,Guyana,Suriname,0,1,1,0.0,1.0,1430,1598
1967-08-01,Japan,South Korea,2,1,1,1.0,0.0,1580,1610
1967-08-01,Mauritania,Tanzania,1,1,0,0.5,0.5,1460,1496
1967-08-01,Niger,Burkina Faso,2,3,1,0.0,1.0,1461,1487
1967-08-02,DR Congo,Ethiopia,1,0,1,1.0,0.0,1542,1565
1967-08-02,Guyana,Suriname,0,2,2,0.0,1.0,1426,1603
1967-08-02,Tanzania,Mauritius,1,0,1,1.0,0.0,1507,1592
1967-08-03,Japan,Philippines,2,0,2,1.0,0.0,1584,1368
1967-08-05,Japan,Indonesia,2,1,1,1.0,0.0,1592,1574
1967-08-05,South Korea,Philippines,7,0,7,1.0,0.0,1614,1365
1967-08-07,Indonesia,Philippines,6,0,6,1.0,0.0,1578,1362
1967-08-10,DR Congo,Mali,2,2,0,0.5,0.5,1542,1510
1967-08-10,Hong Kong,Thailand,1,0,1,1.0,0.0,1487,1438
1967-08-10,Malaysia,Western Australia,3,2,1,1.0,0.0,1506,1492
1967-08-10,Sweden,Finland,2,0,2,1.0,0.0,1704,1443
1967-08-11,Indonesia,South Korea,1,3,2,0.0,1.0,1571,1622
1967-08-11,Singapore,Taiwan,3,3,0,0.5,0.5,1463,1524
1967-08-12,Hong Kong,Vietnam Republic,0,5,5,0.0,1.0,1482,1585
1967-08-12,India,Thailand,1,1,0,0.5,0.5,1605,1442
1967-08-13,Myanmar,South Korea,0,1,1,0.0,1.0,1567,1629
1967-08-13,DR Congo,Sudan,2,1,1,1.0,0.0,1551,1545
1967-08-13,India,Western Australia,3,1,2,1.0,0.0,1611,1487
1967-08-13,Indonesia,Singapore,4,1,3,1.0,0.0,1577,1458
1967-08-13,Malaysia,Hong Kong,3,0,3,1.0,0.0,1514,1475
1967-08-15,Myanmar,Singapore,3,0,3,1.0,0.0,1573,1453
1967-08-15,Chile,Argentina,1,0,1,1.0,0.0,1657,1810
1967-08-15,Indonesia,Taiwan,2,1,1,1.0,0.0,1584,1518
1967-08-15,Malaysia,Vietnam Republic,1,1,0,0.5,0.5,1516,1584
1967-08-15,Thailand,Western Australia,1,3,2,0.0,1.0,1436,1494
1967-08-16,Hong Kong,India,0,4,4,0.0,1.0,1470,1617
1967-08-16,Mauritius,Tanzania,1,1,0,0.5,0.5,1591,1509
1967-08-16,Togo,Ivory Coast,0,2,2,0.0,1.0,1477,1607
1967-08-16,Vietnam Republic,Western Australia,3,0,3,1.0,0.0,1590,1489
1967-08-18,Hong Kong,Western Australia,3,2,1,1.0,0.0,1479,1481
1967-08-18,South Korea,Taiwan,2,1,1,1.0,0.0,1635,1513
1967-08-19,Myanmar,Indonesia,5,0,5,1.0,0.0,1582,1576
1967-08-19,Kenya,DR Congo,5,4,1,1.0,0.0,1579,1544
1967-08-19,Malaysia,India,0,0,0,0.5,0.5,1519,1615
1967-08-19,Thailand,Vietnam Republic,2,5,3,0.0,1.0,1432,1595
1967-08-20,Myanmar,Taiwan,1,2,1,0.0,1.0,1573,1523
1967-08-20,Malaysia,Thailand,1,0,1,1.0,0.0,1526,1426
1967-08-20,India,Vietnam Republic,0,1,1,0.0,1.0,1607,1604
1967-08-20,Kenya,DR Congo,1,1,0,0.5,0.5,1579,1545
1967-08-20,South Korea,Singapore,3,0,3,1.0,0.0,1640,1449
1967-08-22,Myanmar,Vietnam Republic,3,0,3,1.0,0.0,1582,1596
1967-08-22,India,Taiwan,1,1,0,0.5,0.5,1606,1525
1967-08-22,Mexico,Argentina,2,1,1,1.0,0.0,1723,1800
1967-08-23,Denmark,Iceland,14,2,12,1.0,0.0,1568,1436
1967-08-23,Hong Kong,Indonesia,2,1,1,1.0,0.0,1490,1566
1967-08-23,Malaysia,South Korea,1,3,2,0.0,1.0,1521,1646
1967-08-24,Singapore,Western Australia,3,5,2,0.0,1.0,1442,1489
1967-08-25,Hong Kong,Taiwan,2,4,2,0.0,1.0,1483,1533
1967-08-25,Malaysia,Vietnam Republic,1,2,1,0.0,1.0,1515,1603
1967-08-26,Myanmar,South Korea,0,0,0,0.5,0.5,1584,1645
1967-08-26,India,Indonesia,0,3,3,0.0,1.0,1598,1575
1967-08-28,Singapore,Vietnam Republic,1,0,1,1.0,0.0,1454,1592
1967-08-30,Russia,Finland,2,0,2,1.0,0.0,1816,1442
1967-09-01,DR Congo,Ghana,0,2,2,0.0,1.0,1541,1697
1967-09-03,Norway,Sweden,3,1,2,1.0,0.0,1570,1693
1967-09-06,Austria,Hungary,1,3,2,0.0,1.0,1673,1841
1967-09-06,Finland,Russia,2,5,3,0.0,1.0,1441,1818
1967-09-13,Netherlands,German DR,1,0,1,1.0,0.0,1606,1659
1967-09-17,DR Congo,Tanzania,1,0,1,1.0,0.0,1549,1502
1967-09-17,Poland,France,1,4,3,0.0,1.0,1597,1632
1967-09-19,Chile,Brazil,0,1,1,0.0,1.0,1654,1864
1967-09-24,Austria,Finland,2,1,1,1.0,0.0,1677,1438
1967-09-24,Norway,Denmark,0,5,5,0.0,1.0,1562,1577
1967-09-27,Germany,France,5,1,4,1.0,0.0,1808,1628
1967-09-27,Hungary,German DR,3,1,2,1.0,0.0,1846,1655
1967-09-27,Mali,Burkina Faso,4,0,4,1.0,0.0,1518,1480
1967-09-28,Ghana,Nigeria,1,1,0,0.5,0.5,1694,1544
1967-09-30,Kenya,Uganda,3,1,2,1.0,0.0,1586,1511
1967-10-01,Czechoslovakia,Spain,1,0,1,1.0,0.0,1734,1713
1967-10-01,Ghana,Burkina Faso,5,2,3,1.0,0.0,1698,1477
1967-10-01,Russia,Switzerland,2,2,0,0.5,0.5,1814,1571
1967-10-03,Tanzania,Uganda,1,2,1,0.0,1.0,1495,1519
1967-10-04,Denmark,Netherlands,3,2,1,1.0,0.0,1586,1598
1967-10-04,Greece,Austria,4,1,3,1.0,0.0,1496,1665
1967-10-04,Kenya,Zanzibar,6,0,6,1.0,0.0,1590,1362
1967-10-05,Trinidad and Tobago,Martinique,2,2,0,0.5,0.5,1585,1565
1967-10-06,Uganda,Zanzibar,2,0,2,1.0,0.0,1524,1358
1967-10-07,Germany,Yugoslavia,3,1,2,1.0,0.0,1815,1731
1967-10-07,Singapore,Hong Kong,4,0,4,1.0,0.0,1463,1475
1967-10-08,Belgium,Poland,2,4,2,0.0,1.0,1644,1607
1967-10-08,Bulgaria,Russia,1,2,1,0.0,1.0,1666,1819
1967-10-09,Kenya,Tanzania,5,3,2,1.0,0.0,1596,1490
1967-10-10,El Salvador,Haiti,2,0,2,1.0,0.0,1577,1568
1967-10-10,Tanzania,Zanzibar,0,3,3,0.0,1.0,1480,1369
1967-10-11,German DR,Denmark,3,2,1,1.0,0.0,1662,1580
1967-10-13,Paraguay,Argentina,1,1,0,0.5,0.5,1636,1797
1967-10-14,Tanzania,DR Congo,0,1,1,0.0,1.0,1474,1556
1967-10-14,Sierra Leone,Nigeria,1,1,0,0.5,0.5,1460,1543
1967-10-15,Austria,Russia,1,0,1,1.0,0.0,1677,1808
1967-10-20,Liberia,DR Congo,1,4,3,0.0,1.0,1462,1563
1967-10-21,Ghana,Nigeria,2,1,1,1.0,0.0,1703,1539
1967-10-21,Northern Ireland,Scotland,1,0,1,1.0,0.0,1587,1698
1967-10-21,Wales,England,0,3,3,0.0,1.0,1588,1863
1967-10-22,Denmark,Finland,3,0,3,1.0,0.0,1585,1434
1967-10-22,Guatemala,El Salvador,1,0,1,1.0,0.0,1597,1570
1967-10-22,Spain,Czechoslovakia,2,1,1,1.0,0.0,1722,1726
1967-10-24,Trinidad and Tobago,Martinique,3,2,1,1.0,0.0,1593,1558
1967-10-28,France,Belgium,1,1,0,0.5,0.5,1629,1644
1967-10-29,El Salvador,Costa Rica,3,1,2,1.0,0.0,1582,1715
1967-10-29,German DR,Hungary,1,0,1,1.0,0.0,1674,1835
1967-10-29,Poland,Romania,0,0,0,0.5,0.5,1608,1644
1967-10-29,Uganda,Ethiopia,2,3,1,0.0,1.0,1517,1573
1967-10-31,Greece,Russia,0,1,1,0.0,1.0,1494,1811
1967-11-01,Italy,Cyprus,5,0,5,1.0,0.0,1820,1478
1967-11-01,Netherlands,Yugoslavia,1,2,1,0.0,1.0,1593,1737
1967-11-04,Malaysia,Thailand,3,2,1,1.0,0.0,1521,1421
1967-11-04,Vietnam Republic,Singapore,2,0,2,1.0,0.0,1598,1458
1967-11-05,Australia,New Zealand,5,3,2,1.0,0.0,1556,1539
1967-11-05,Austria,Greece,1,1,0,0.5,0.5,1674,1498
1967-11-05,El Salvador,Guatemala,1,3,2,0.0,1.0,1575,1605
1967-11-05,Hong Kong,South Korea,0,1,1,0.0,1.0,1471,1650
1967-11-05,Puerto Rico,Martinique,3,6,3,0.0,1.0,1402,1563
1967-11-05,Sweden,Norway,5,2,3,1.0,0.0,1699,1557
1967-11-07,South Korea,Thailand,3,1,2,1.0,0.0,1654,1418
1967-11-07,Vietnam Republic,Australia,0,1,1,0.0,1.0,1590,1565
1967-11-08,Chile,Argentina,3,1,2,1.0,0.0,1666,1786
1967-11-08,Hong Kong,Malaysia,0,2,2,0.0,1.0,1465,1528
1967-11-08,New Caledonia,New Zealand,4,0,4,1.0,0.0,1555,1532
1967-11-08,New Zealand,Singapore,3,1,2,1.0,0.0,1539,1452
1967-11-08,Puerto Rico,Guadeloupe,2,4,2,0.0,1.0,1397,1522
1967-11-08,Switzerland,Cyprus,5,0,5,1.0,0.0,1577,1473
1967-11-10,Hong Kong,Thailand,1,5,4,0.0,1.0,1456,1428
1967-11-10,Vietnam Republic,New Zealand,5,1,4,1.0,0.0,1597,1533
1967-11-11,Australia,Singapore,5,1,4,1.0,0.0,1571,1447
1967-11-11,Guadeloupe,Martinique,0,1,1,0.0,1.0,1515,1571
1967-11-11,South Korea,Malaysia,2,1,1,1.0,0.0,1660,1523
1967-11-12,Australia,Malaysia,1,0,1,1.0,0.0,1578,1517
1967-11-12,Bulgaria,Sweden,3,0,3,1.0,0.0,1675,1691
1967-11-12,Myanmar,India,2,0,2,1.0,0.0,1593,1590
1967-11-12,Portugal,Norway,2,1,1,1.0,0.0,1715,1553
1967-11-12,Vietnam Republic,South Korea,0,3,3,0.0,1.0,1591,1667
1967-11-12,Yugoslavia,Albania,4,0,4,1.0,0.0,1740,1479
1967-11-12,Zimbabwe,Malawi,1,0,1,1.0,0.0,1498,1434
1967-11-14,Australia,South Korea,3,2,1,1.0,0.0,1589,1657
1967-11-14,Vietnam Republic,Malaysia,4,1,3,1.0,0.0,1598,1511
1967-11-15,Burkina Faso,Mali,0,1,1,0.0,1.0,1470,1526
1967-11-15,India,Pakistan,1,1,0,0.5,0.5,1588,1496
1967-11-15,Turkey,Czechoslovakia,0,0,0,0.5,0.5,1584,1723
1967-11-16,Myanmar,Cambodia,1,0,1,1.0,0.0,1598,1440
1967-11-16,Malaysia,New Zealand,2,8,6,0.0,1.0,1504,1541
1967-11-18,Switzerland,Italy,2,2,0,0.5,0.5,1582,1816
1967-11-19,Myanmar,Pakistan,2,0,2,1.0,0.0,1604,1491
1967-11-22,Belgium,Luxembourg,3,0,3,1.0,0.0,1648,1407
1967-11-22,Czechoslovakia,Republic of Ireland,1,2,1,0.0,1.0,1713,1613
1967-11-22,England,Northern Ireland,2,0,2,1.0,0.0,1866,1585
1967-11-22,Romania,Germany,1,0,1,1.0,0.0,1656,1804
1967-11-22,Scotland,Wales,3,2,1,1.0,0.0,1704,1583
1967-11-22,Senegal,Guinea,2,1,1,1.0,0.0,1549,1514
1967-11-24,Benin,DR Congo,2,5,3,0.0,1.0,1518,1571
1967-11-25,Zimbabwe,Mauritius,1,2,1,0.0,1.0,1493,1597
1967-11-26,Bulgaria,Portugal,1,0,1,1.0,0.0,1684,1707
1967-11-26,Burkina Faso,Ivory Coast,3,2,1,1.0,0.0,1482,1596
1967-11-26,Grenada,Saint Vincent and the Grenadines,1,1,0,0.5,0.5,1521,1530
1967-11-26,Iran,Turkey,0,1,1,0.0,1.0,1532,1591
1967-11-26,Trinidad and Tobago,Jamaica,1,0,1,1.0,0.0,1599,1495
1967-11-26,Zimbabwe,Mauritius,2,3,1,0.0,1.0,1488,1603
1967-11-27,Dominica,Saint Lucia,2,4,2,0.0,1.0,1490,1502
1967-11-28,Pakistan,Turkey,4,7,3,0.0,1.0,1486,1597
1967-11-29,Netherlands,Russia,3,1,2,1.0,0.0,1606,1799
1967-11-29,Saint Lucia,Saint Vincent and the Grenadines,4,3,1,1.0,0.0,1511,1522
1967-11-30,Dominica,Grenada,2,4,2,0.0,1.0,1483,1529
1967-12-02,Grenada,Saint Lucia,2,1,1,1.0,0.0,1537,1504
1967-12-02,Sierra Leone,Guinea,2,1,1,1.0,0.0,1470,1505
1967-12-02,Trinidad and Tobago,Jamaica,1,0,1,1.0,0.0,1605,1490
1967-12-03,Dominica,Saint Vincent and the Grenadines,1,2,1,0.0,1.0,1476,1530
1967-12-03,Mali,Congo,1,1,0,0.5,0.5,1527,1566
1967-12-06,England,Russia,2,2,0,0.5,0.5,1865,1801
1967-12-06,Mauritius,Ethiopia,0,2,2,0.0,1.0,1595,1582
1967-12-06,Mexico,Hungary,2,1,1,1.0,0.0,1734,1825
1967-12-08,Mexico,Hungary,0,2,2,0.0,1.0,1729,1831
1967-12-10,Saudi Arabia,Tunisia,4,0,4,1.0,0.0,1504,1561
1967-12-10,Thailand,Malaysia,4,0,4,1.0,0.0,1438,1495
1967-12-11,Myanmar,Malaysia,2,1,1,1.0,0.0,1610,1490
1967-12-11,Laos,Vietnam Republic,0,5,5,0.0,1.0,1467,1604
1967-12-12,Thailand,Myanmar,0,1,1,0.0,1.0,1434,1615
1967-12-13,Chile,Hungary,4,5,1,0.0,1.0,1662,1836
1967-12-14,Myanmar,Laos,2,0,2,1.0,0.0,1620,1463
1967-12-14,Thailand,Vietnam Republic,0,5,5,0.0,1.0,1430,1609
1967-12-15,Thailand,Laos,5,2,3,1.0,0.0,1439,1455
1967-12-16,Chile,Russia,1,4,3,0.0,1.0,1658,1806
1967-12-16,Myanmar,Vietnam Republic,2,1,1,1.0,0.0,1628,1602
1967-12-17,Albania,Germany,0,0,0,0.5,0.5,1485,1799
1967-12-17,Kenya,Zambia,1,5,4,0.0,1.0,1588,1581
1967-12-17,Portugal,Bulgaria,0,0,0,0.5,0.5,1707,1685
1967-12-23,France,Luxembourg,3,1,2,1.0,0.0,1633,1404
1967-12-23,Italy,Switzerland,4,0,4,1.0,0.0,1820,1579
1967-12-23,Nigeria,Ghana,2,2,0,0.5,0.5,1543,1700
1967-12-24,DR Congo,Romania,1,1,0,0.5,0.5,1573,1655
1967-12-31,Ethiopia,Kenya,2,0,2,1.0,0.0,1591,1580
1968-01-10,Israel,Belgium,0,2,2,0.0,1.0,1511,1654
1968-01-12,Algeria,Ivory Coast,0,3,3,0.0,1.0,1537,1603
1968-01-12,Congo,DR Congo,0,3,3,0.0,1.0,1559,1581
1968-01-12,Ethiopia,Uganda,2,1,1,1.0,0.0,1598,1511
1968-01-12,Ghana,Senegal,2,2,0,0.5,0.5,1697,1553
1968-01-14,Algeria,Uganda,4,0,4,1.0,0.0,1545,1504
1968-01-14,Congo,Senegal,1,2,1,0.0,1.0,1551,1562
1968-01-14,DR Congo,Ghana,1,2,1,0.0,1.0,1576,1703
1968-01-14,Ethiopia,Ivory Coast,1,0,1,1.0,0.0,1607,1595
1968-01-16,Congo,Ghana,1,3,2,0.0,1.0,1547,1708
1968-01-16,DR Congo,Senegal,2,1,1,1.0,0.0,1584,1555
1968-01-16,Ethiopia,Algeria,3,1,2,1.0,0.0,1614,1539
1968-01-16,Ivory Coast,Uganda,2,1,1,1.0,0.0,1601,1499
1968-01-19,Ethiopia,DR Congo,2,3,1,0.0,1.0,1606,1593
1968-01-19,Ghana,Ivory Coast,4,3,1,1.0,0.0,1714,1596
1968-01-21,DR Congo,Ghana,1,0,1,1.0,0.0,1604,1704
1968-01-21,Ethiopia,Ivory Coast,0,1,1,0.0,1.0,1598,1605
1968-01-27,Nigeria,Sierra Leone,4,1,3,1.0,0.0,1550,1464
1968-02-14,Israel,Switzerland,2,1,1,1.0,0.0,1521,1570
1968-02-17,Cyprus,Switzerland,2,1,1,1.0,0.0,1484,1560
1968-02-19,Israel,Sweden,0,3,3,0.0,1.0,1517,1696
1968-02-24,Scotland,England,1,1,0,0.5,0.5,1708,1862
1968-02-25,Burkina Faso,Guinea,2,0,2,1.0,0.0,1491,1497
1968-02-28,Spain,Sweden,3,1,2,1.0,0.0,1730,1689
1968-02-28,Wales,Northern Ireland,2,0,2,1.0,0.0,1592,1577
1968-03-03,Mexico,Russia,0,0,0,0.5,0.5,1731,1805
1968-03-06,Belgium,Germany,1,3,2,0.0,1.0,1650,1804
1968-03-07,Guinea,DR Congo,1,0,1,1.0,0.0,1508,1594
1968-03-07,Mexico,Russia,1,1,0,0.5,0.5,1733,1804
1968-03-10,Mexico,Russia,0,0,0,0.5,0.5,1735,1803
1968-03-13,Turkey,Tunisia,0,0,0,0.5,0.5,1597,1562
1968-03-17,Morocco,Algeria,0,0,0,0.5,0.5,1540,1540
1968-03-26,Mexico,Japan,4,0,4,1.0,0.0,1740,1588
1968-03-30,Australia,Japan,2,2,0,0.5,0.5,1589,1589
1968-03-30,Guernsey,Alderney,2,0,2,1.0,0.0,1607,1324
1968-03-31,Australia,Japan,3,1,2,1.0,0.0,1597,1581
1968-03-31,Guinea,Burkina Faso,3,1,2,1.0,0.0,1516,1484
1968-04-02,Guinea,Burkina Faso,1,3,2,0.0,1.0,1508,1493
1968-04-03,England,Spain,1,0,1,1.0,0.0,1868,1725
1968-04-04,Australia,Japan,1,3,2,0.0,1.0,1589,1590
1968-04-06,Barbados,Suriname,0,2,2,0.0,1.0,1448,1608
1968-04-06,Bulgaria,Italy,3,2,1,1.0,0.0,1696,1810
1968-04-06,France,Yugoslavia,1,1,0,0.5,0.5,1636,1738
1968-04-07,Netherlands,Belgium,1,2,1,0.0,1.0,1600,1657
1968-04-07,Togo,Guinea,1,1,0,0.5,0.5,1478,1508
1968-04-08,Barbados,Suriname,0,0,0,0.5,0.5,1452,1605
1968-04-10,Benin,Guinea,2,5,3,0.0,1.0,1510,1517
1968-04-11,Martinique,Suriname,1,3,2,0.0,1.0,1564,1613
1968-04-14,Martinique,Suriname,3,2,1,1.0,0.0,1574,1604
1968-04-17,Switzerland,Germany,0,0,0,0.5,0.5,1565,1800
1968-04-20,Italy,Bulgaria,2,0,2,1.0,0.0,1816,1691
1968-04-24,Poland,Turkey,8,0,8,1.0,0.0,1616,1590
1968-04-24,Russia,Belgium,1,0,1,1.0,0.0,1808,1653
1968-04-24,Yugoslavia,France,5,1,4,1.0,0.0,1744,1631
1968-04-27,Czechoslovakia,Yugoslavia,3,0,3,1.0,0.0,1722,1736
1968-05-01,Austria,Romania,1,1,0,0.5,0.5,1674,1656
1968-05-01,Poland,Netherlands,0,0,0,0.5,0.5,1616,1601
1968-05-01,Eswatini,Malawi,2,0,2,1.0,0.0,1507,1428
1968-05-02,Sweden,Spain,1,1,0,0.5,0.5,1690,1725
1968-05-04,Hungary,Russia,2,0,2,1.0,0.0,1844,1801
1968-05-07,El Salvador,Guatemala,3,0,3,1.0,0.0,1584,1597
1968-05-08,Kenya,Nigeria,1,2,1,0.0,1.0,1572,1559
1968-05-08,Spain,England,1,2,1,0.0,1.0,1721,1873
1968-05-08,Wales,Germany,1,1,0,0.5,0.5,1597,1796
1968-05-09,Jersey,Guernsey,2,1,1,1.0,0.0,1690,1601
1968-05-10,Iran,Hong Kong,2,0,2,1.0,0.0,1539,1450
1968-05-11,Myanmar,Taiwan,1,1,0,0.5,0.5,1626,1536
1968-05-11,Russia,Hungary,3,0,3,1.0,0.0,1810,1836
1968-05-12,Hong Kong,Israel,1,6,5,0.0,1.0,1444,1524
1968-05-13,Iran,Taiwan,4,0,4,1.0,0.0,1547,1529
1968-05-14,Myanmar,Israel,1,0,1,1.0,0.0,1632,1519
1968-05-15,Hong Kong,Taiwan,1,1,0,0.5,0.5,1446,1528
1968-05-15,Republic of Ireland,Poland,2,2,0,0.5,0.5,1614,1616
1968-05-15,Paraguay,Argentina,2,0,2,1.0,0.0,1648,1775
1968-05-16,Iran,Myanmar,3,1,2,1.0,0.0,1557,1623
1968-05-17,Israel,Taiwan,4,1,3,1.0,0.0,1528,1520
1968-05-18,Myanmar,Hong Kong,2,0,2,1.0,0.0,1628,1442
1968-05-19,Austria,Cyprus,7,1,6,1.0,0.0,1679,1480
1968-05-19,Ghana,Ivory Coast,2,1,1,1.0,0.0,1710,1600
1968-05-19,Iran,Israel,2,1,1,1.0,0.0,1565,1521
1968-05-21,Mexico,Uruguay,3,3,0,0.5,0.5,1741,1744
1968-05-22,England,Sweden,3,1,2,1.0,0.0,1878,1686
1968-05-28,Mexico,Uruguay,2,2,0,0.5,0.5,1742,1744
1968-05-30,Netherlands,Scotland,0,0,0,0.5,0.5,1604,1706
1968-06-01,Germany,England,1,0,1,1.0,0.0,1806,1869
1968-06-02,Paraguay,Uruguay,0,0,0,0.5,0.5,1651,1742
1968-06-04,Finland,Denmark,1,3,2,0.0,1.0,1430,1590
1968-06-05,Argentina,Uruguay,2,0,2,1.0,0.0,1783,1735
1968-06-05,England,Yugoslavia,0,1,1,0.0,1.0,1859,1747
1968-06-05,Italy,Russia,0,0,0,0.5,0.5,1816,1811
1968-06-05,Romania,Netherlands,0,0,0,0.5,0.5,1655,1606
1968-06-08,England,Russia,2,0,2,1.0,0.0,1866,1805
1968-06-08,Italy,Yugoslavia,1,1,0,0.5,0.5,1815,1749
1968-06-09,Brazil,Uruguay,2,0,2,1.0,0.0,1870,1730
1968-06-09,Norway,Poland,1,6,5,0.0,1.0,1547,1623
1968-06-10,Italy,Yugoslavia,2,0,2,1.0,0.0,1822,1743
1968-06-12,Brazil,Uruguay,4,0,4,1.0,0.0,1875,1726
1968-06-16,Germany,Brazil,2,1,1,1.0,0.0,1816,1866
1968-06-16,Russia,Austria,3,1,2,1.0,0.0,1811,1674
1968-06-19,Finland,Belgium,1,2,1,0.0,1.0,1427,1657
1968-06-20,Poland,Brazil,3,6,3,0.0,1.0,1620,1870
1968-06-20,Uruguay,Argentina,2,1,1,1.0,0.0,1736,1774
1968-06-23,Czechoslovakia,Brazil,3,2,1,1.0,0.0,1734,1859
1968-06-23,Denmark,Norway,5,1,4,1.0,0.0,1598,1540
1968-06-25,Yugoslavia,Brazil,0,2,2,0.0,1.0,1738,1865
1968-06-27,Sweden,Denmark,2,1,1,1.0,0.0,1693,1592
1968-06-29,Zambia,Uganda,2,1,1,1.0,0.0,1588,1493
1968-06-30,Portugal,Brazil,0,2,2,0.0,1.0,1703,1870
1968-06-30,Zambia,Uganda,1,1,0,0.5,0.5,1586,1496
1968-07-02,Zambia,Uganda,2,1,1,1.0,0.0,1592,1491
1968-07-04,Zambia,Uganda,2,2,0,0.5,0.5,1590,1494
1968-07-06,Malawi,Kenya,2,2,0,0.5,0.5,1432,1569
1968-07-07,Mexico,Brazil,0,2,2,0.0,1.0,1737,1876
1968-07-10,Mexico,Brazil,2,1,1,1.0,0.0,1749,1865
1968-07-13,Malawi,Botswana,8,1,7,1.0,0.0,1442,1491
1968-07-14,Peru,Brazil,3,4,1,0.0,1.0,1559,1868
1968-07-17,Honduras,El Salvador,0,0,0,0.5,0.5,1520,1583
1968-07-17,Peru,Brazil,0,4,4,0.0,1.0,1557,1871
1968-07-18,Iceland,Norway,0,4,4,0.0,1.0,1431,1546
1968-07-20,Eswatini,Malawi,2,0,2,1.0,0.0,1514,1436
1968-07-25,Paraguay,Brazil,0,4,4,0.0,1.0,1648,1875
1968-07-28,Paraguay,Brazil,1,0,1,1.0,0.0,1661,1863
1968-07-31,El Salvador,Honduras,2,1,1,1.0,0.0,1590,1514
1968-08-01,Sweden,Russia,2,2,0,0.5,0.5,1696,1809
1968-08-07,Brazil,Argentina,4,1,3,1.0,0.0,1869,1769
1968-08-09,Malaysia,Hong Kong,1,1,0,0.5,0.5,1489,1444
1968-08-10,Myanmar,Vietnam Republic,3,0,3,1.0,0.0,1636,1595
1968-08-10,South Korea,Western Australia,0,3,3,0.0,1.0,1646,1501
1968-08-11,Brazil,Argentina,3,2,1,1.0,0.0,1875,1764
1968-08-11,Hong Kong,Thailand,0,0,0,0.5,0.5,1444,1440
1968-08-11,Singapore,Taiwan,0,2,2,0.0,1.0,1441,1527
1968-08-11,Malaysia,India,2,1,1,1.0,0.0,1500,1578
1968-08-12,Myanmar,Hong Kong,3,0,3,1.0,0.0,1640,1441
1968-08-12,India,Vietnam Republic,3,2,1,1.0,0.0,1587,1587
1968-08-12,Indonesia,Western Australia,4,5,1,0.0,1.0,1566,1511
1968-08-12,South Korea,Singapore,3,2,1,1.0,0.0,1650,1438
1968-08-14,Myanmar,Thailand,0,0,0,0.5,0.5,1636,1445
1968-08-14,South Korea,Taiwan,2,1,1,1.0,0.0,1656,1522
1968-08-14,Malaysia,Vietnam Republic,4,0,4,1.0,0.0,1510,1578
1968-08-15,El Salvador,Guatemala,1,0,1,1.0,0.0,1599,1589
1968-08-15,Hong Kong,India,1,1,0,0.5,0.5,1445,1584
1968-08-15,Western Australia,Taiwan,3,2,1,1.0,0.0,1520,1514
1968-08-15,Indonesia,Singapore,4,0,4,1.0,0.0,1572,1433
1968-08-15,Thailand,Vietnam Republic,2,3,1,0.0,1.0,1440,1584
1968-08-17,Malaysia,Thailand,4,1,3,1.0,0.0,1517,1434
1968-08-17,Myanmar,India,1,3,2,0.0,1.0,1627,1594
1968-08-17,Indonesia,South Korea,4,2,2,1.0,0.0,1582,1647
1968-08-18,Hong Kong,Vietnam Republic,1,3,2,0.0,1.0,1441,1589
1968-08-18,Malaysia,Myanmar,1,1,0,0.5,0.5,1520,1625
1968-08-18,Norway,Finland,4,1,3,1.0,0.0,1552,1422
1968-08-18,Peru,Chile,1,2,1,0.0,1.0,1552,1664
1968-08-18,Singapore,Western Australia,4,4,0,0.5,0.5,1435,1519
1968-08-19,India,Thailand,0,1,1,0.0,1.0,1583,1446
1968-08-19,Indonesia,Taiwan,10,1,9,1.0,0.0,1589,1508
1968-08-21,Myanmar,Indonesia,2,1,1,1.0,0.0,1633,1582
1968-08-21,South Korea,Thailand,2,1,1,1.0,0.0,1651,1443
1968-08-21,Peru,Chile,0,0,0,0.5,0.5,1555,1662
1968-08-22,Malaysia,Western Australia,4,3,1,1.0,0.0,1528,1512
1968-08-24,India,South Korea,0,1,1,0.0,1.0,1577,1658
1968-08-24,Indonesia,Western Australia,1,3,2,0.0,1.0,1573,1522
1968-08-25,Malaysia,Myanmar,3,0,3,1.0,0.0,1539,1623
1968-08-27,Singapore,South Korea,4,3,1,1.0,0.0,1448,1646
1968-08-28,Singapore,Vietnam Republic,1,0,1,1.0,0.0,1460,1578
1968-08-29,India,Indonesia,1,3,2,0.0,1.0,1569,1582
1968-08-29,Peru,Argentina,2,2,0,0.5,0.5,1560,1760
1968-08-30,India,Vietnam Republic,0,2,2,0.0,1.0,1562,1586
1968-08-30,Singapore,Indonesia,1,0,1,1.0,0.0,1471,1572
1968-09-01,Peru,Argentina,1,1,0,0.5,0.5,1565,1756
1968-09-01,Suriname,French Guiana,2,1,1,1.0,0.0,1609,1442
1968-09-04,Netherlands,Luxembourg,2,0,2,1.0,0.0,1610,1401
1968-09-10,Israel,Northern Ireland,2,3,1,0.0,1.0,1515,1584
1968-09-11,El Salvador,Costa Rica,1,1,0,0.5,0.5,1602,1713
1968-09-11,Finland,Sweden,0,3,3,0.0,1.0,1420,1699
1968-09-15,Norway,Sweden,1,1,0,0.5,0.5,1556,1696
1968-09-15,United States,Israel,3,3,0,0.5,0.5,1463,1514
1968-09-17,New Zealand,Fiji,5,0,5,1.0,0.0,1548,1472
1968-09-19,New Caledonia,Fiji,2,1,1,1.0,0.0,1562,1466
1968-09-22,Ghana,Benin,3,0,3,1.0,0.0,1714,1507
1968-09-22,Switzerland,Austria,1,0,1,1.0,0.0,1576,1664
1968-09-25,Denmark,Czechoslovakia,0,3,3,0.0,1.0,1588,1739
1968-09-25,France,Germany,1,1,0,0.5,0.5,1635,1813
1968-09-25,United States,Israel,0,4,4,0.0,1.0,1457,1521
1968-09-25,Yugoslavia,Finland,9,1,8,1.0,0.0,1741,1418
1968-09-28,Tanzania,Uganda,0,2,2,0.0,1.0,1467,1502
1968-09-29,Kenya,Zanzibar,3,0,3,1.0,0.0,1573,1366
1968-09-29,Mexico,Ethiopia,3,0,3,1.0,0.0,1754,1594
1968-10-01,Tanzania,Kenya,3,3,0,0.5,0.5,1470,1571
1968-10-02,Uganda,Zanzibar,2,0,2,1.0,0.0,1508,1361
1968-10-04,Curaçao,Costa Rica,1,1,0,0.5,0.5,1567,1710
1968-10-04,Kenya,Uganda,1,1,0,0.5,0.5,1570,1510
1968-10-05,Tanzania,Zanzibar,3,0,3,1.0,0.0,1476,1356
1968-10-06,Canada,Bermuda,4,0,4,1.0,0.0,1508,1477
1968-10-06,Suriname,Martinique,7,0,7,1.0,0.0,1617,1567
1968-10-08,New Zealand,New Caledonia,1,3,2,0.0,1.0,1541,1570
1968-10-08,Suriname,Martinique,0,0,0,0.5,0.5,1616,1569
1968-10-09,Belgium,Finland,6,1,5,1.0,0.0,1661,1415
1968-10-09,Sweden,Norway,5,0,5,1.0,0.0,1701,1552
1968-10-09,Turkey,Bulgaria,0,2,2,0.0,1.0,1585,1697
1968-10-09,Uganda,Zambia,2,3,1,0.0,1.0,1504,1597
1968-10-12,Switzerland,Greece,1,0,1,1.0,0.0,1583,1492
1968-10-12,Uganda,Zambia,1,1,0,0.5,0.5,1507,1595
1968-10-13,Austria,Germany,0,2,2,0.0,1.0,1660,1818
1968-10-13,Canada,United States,4,2,2,1.0,0.0,1515,1451
1968-10-13,Kenya,Zambia,2,1,1,1.0,0.0,1579,1587
1968-10-15,Ethiopia,Thailand,6,0,6,1.0,0.0,1599,1439
1968-10-16,Belgium,Yugoslavia,3,0,3,1.0,0.0,1671,1732
1968-10-16,Colombia,Mexico,0,1,1,0.0,1.0,1462,1757
1968-10-16,Denmark,Scotland,0,1,1,0.0,1.0,1583,1712
1968-10-17,France,Spain,1,3,2,0.0,1.0,1629,1728
1968-10-20,Bermuda,Canada,0,0,0,0.5,0.5,1478,1515
1968-10-20,Czechoslovakia,Denmark,1,0,1,1.0,0.0,1744,1579
1968-10-20,Haiti,United States,3,6,3,0.0,1.0,1558,1462
1968-10-20,Peru,Mexico,3,3,0,0.5,0.5,1570,1753
1968-10-20,Poland,German DR,1,1,0,0.5,0.5,1622,1673
1968-10-21,Haiti,United States,5,2,3,1.0,0.0,1564,1457
1968-10-22,Zambia,Tanzania,7,1,6,1.0,0.0,1593,1471
1968-10-23,Chile,Mexico,3,1,2,1.0,0.0,1673,1743
1968-10-23,Haiti,United States,1,0,1,1.0,0.0,1570,1452
1968-10-23,Northern Ireland,Turkey,4,1,3,1.0,0.0,1593,1577
1968-10-23,Wales,Italy,0,1,1,0.0,1.0,1594,1826
1968-10-24,Zambia,Tanzania,2,1,1,1.0,0.0,1599,1466
1968-10-26,Uruguay,Mexico,0,2,2,0.0,1.0,1729,1751
1968-10-26,United States,Canada,1,0,1,1.0,0.0,1462,1506
1968-10-27,Bulgaria,Netherlands,2,0,2,1.0,0.0,1704,1604
1968-10-27,Portugal,Romania,3,0,3,1.0,0.0,1710,1649
1968-10-27,Yugoslavia,Spain,0,0,0,0.5,0.5,1732,1729
1968-10-27,Zambia,Sudan,4,2,2,1.0,0.0,1606,1539
1968-10-28,Nigeria,Thailand,7,2,5,1.0,0.0,1565,1434
1968-10-30,Poland,Republic of Ireland,1,0,1,1.0,0.0,1630,1607
1968-10-31,Brazil,Mexico,1,2,1,0.0,1.0,1865,1762
1968-11-02,United States,Bermuda,6,2,4,1.0,0.0,1471,1470
1968-11-03,Brazil,Mexico,2,1,1,1.0,0.0,1871,1757
1968-11-03,Morocco,Senegal,1,0,1,1.0,0.0,1549,1547
1968-11-06,France,Norway,0,1,1,0.0,1.0,1620,1562
1968-11-06,Romania,England,0,0,0,0.5,0.5,1654,1862
1968-11-06,Scotland,Austria,2,1,1,1.0,0.0,1719,1654
1968-11-08,Sudan,Zambia,4,2,2,1.0,0.0,1549,1597
1968-11-10,Republic of Ireland,Austria,2,2,0,0.5,0.5,1609,1653
1968-11-11,Bermuda,United States,0,2,2,0.0,1.0,1463,1479
1968-11-11,Guadeloupe,Martinique,3,1,2,1.0,0.0,1525,1560
1968-11-14,Costa Rica,El Salvador,3,0,3,1.0,0.0,1716,1597
1968-11-14,Guadeloupe,Puerto Rico,2,0,2,1.0,0.0,1531,1392
1968-11-16,Martinique,Puerto Rico,7,0,7,1.0,0.0,1565,1388
1968-11-16,Sierra Leone,Gambia,2,1,1,1.0,0.0,1473,1484
1968-11-17,Algeria,Tunisia,1,2,1,0.0,1.0,1533,1570
1968-11-17,Guatemala,Trinidad and Tobago,4,0,4,1.0,0.0,1598,1597
1968-11-17,Zambia,Mauritius,2,2,0,0.5,0.5,1597,1596
1968-11-18,Saint Lucia,Dominica,4,0,4,1.0,0.0,1512,1469
1968-11-20,Myanmar,Laos,3,0,3,1.0,0.0,1628,1451
1968-11-20,Denmark,Luxembourg,5,1,4,1.0,0.0,1584,1397
1968-11-20,Dominica,Grenada,2,6,4,0.0,1.0,1463,1544
1968-11-20,Guatemala,Trinidad and Tobago,0,0,0,0.5,0.5,1598,1598
1968-11-20,Thailand,Singapore,3,0,3,1.0,0.0,1443,1463
1968-11-21,Indonesia,Malaysia,1,0,1,1.0,0.0,1580,1532
1968-11-22,Myanmar,Singapore,2,0,2,1.0,0.0,1633,1459
1968-11-22,Thailand,Laos,1,0,1,1.0,0.0,1452,1443
1968-11-23,Cyprus,Germany,0,1,1,0.0,1.0,1478,1821
1968-11-23,Dominica,Saint Vincent and the Grenadines,1,1,0,0.5,0.5,1465,1529
1968-11-23,Haiti,Trinidad and Tobago,4,0,4,1.0,0.0,1579,1590
1968-11-23,Romania,Switzerland,2,0,2,1.0,0.0,1661,1577
1968-11-24,Myanmar,Indonesia,1,3,2,0.0,1.0,1624,1590
1968-11-24,DR Congo,Tunisia,1,0,1,1.0,0.0,1602,1563
1968-11-24,Laos,Malaysia,0,5,5,0.0,1.0,1438,1538
1968-11-24,Suriname,Curaçao,6,0,6,1.0,0.0,1623,1561
1968-11-25,Haiti,Trinidad and Tobago,2,4,2,0.0,1.0,1572,1598
1968-11-26,Indonesia,Singapore,7,0,7,1.0,0.0,1596,1454
1968-11-26,Thailand,Malaysia,3,0,3,1.0,0.0,1462,1529
1968-11-27,Argentina,Chile,4,0,4,1.0,0.0,1763,1667
1968-11-27,Costa Rica,Jamaica,3,0,3,1.0,0.0,1720,1487
1968-11-28,Indonesia,Malaysia,6,1,5,1.0,0.0,1603,1523
1968-11-29,Thailand,Myanmar,0,2,2,0.0,1.0,1458,1629
1968-12-01,Cameroon,Tunisia,4,2,2,1.0,0.0,1545,1555
1968-12-01,Costa Rica,Jamaica,3,1,2,1.0,0.0,1724,1484
1968-12-01,El Salvador,Suriname,6,0,6,1.0,0.0,1606,1615
1968-12-01,Ghana,Senegal,2,0,2,1.0,0.0,1719,1543
1968-12-01,Thailand,Malaysia,6,0,6,1.0,0.0,1468,1514
1968-12-02,Myanmar,Indonesia,0,1,1,0.0,1.0,1621,1612
1968-12-04,Chile,Argentina,2,1,1,1.0,0.0,1678,1753
1968-12-04,Republic of Ireland,Denmark,1,1,0,0.5,0.5,1609,1585
1968-12-05,Curaçao,Suriname,2,0,2,1.0,0.0,1571,1606
1968-12-05,Honduras,Jamaica,3,1,2,1.0,0.0,1522,1477
1968-12-07,Nigeria,Cameroon,1,1,0,0.5,0.5,1565,1546
1968-12-08,Haiti,Guatemala,2,0,2,1.0,0.0,1581,1590
1968-12-08,Honduras,Jamaica,2,0,2,1.0,0.0,1529,1471
1968-12-08,Mauritius,Zambia,2,3,1,0.0,1.0,1589,1605
1968-12-09,New Caledonia,Tahiti,0,1,1,0.0,1.0,1561,1505
1968-12-11,Cyprus,Scotland,0,5,5,0.0,1.0,1475,1723
1968-12-11,England,Bulgaria,1,1,0,0.5,0.5,1859,1708
1968-12-11,Greece,Portugal,4,2,2,1.0,0.0,1505,1698
1968-12-11,Spain,Belgium,1,1,0,0.5,0.5,1728,1673
1968-12-11,Turkey,Northern Ireland,0,3,3,0.0,1.0,1570,1601
1968-12-12,El Salvador,Curaçao,1,0,1,1.0,0.0,1614,1564
1968-12-12,Kenya,Sudan,1,1,0,0.5,0.5,1579,1550
1968-12-14,Brazil,Germany,2,2,0,0.5,0.5,1870,1823
1968-12-14,Sierra Leone,Guinea,1,1,0,0.5,0.5,1475,1516
1968-12-15,El Salvador,Curaçao,2,1,1,1.0,0.0,1621,1558
1968-12-15,New Caledonia,Tahiti,1,1,0,0.5,0.5,1560,1507
1968-12-17,Argentina,Poland,1,0,1,1.0,0.0,1759,1625
1968-12-17,Brazil,Yugoslavia,3,3,0,0.5,0.5,1867,1736
1968-12-18,Chile,Germany,2,1,1,1.0,0.0,1690,1812
1968-12-19,Brazil,Yugoslavia,3,2,1,1.0,0.0,1873,1731
1968-12-22,Argentina,Yugoslavia,1,1,0,0.5,0.5,1759,1732
1968-12-22,Cameroon,Nigeria,2,3,1,0.0,1.0,1539,1573
1968-12-22,Honduras,Costa Rica,1,0,1,1.0,0.0,1542,1712
1968-12-22,Mexico,Germany,0,0,0,0.5,0.5,1759,1811
1968-12-22,Suriname,El Salvador,4,1,3,1.0,0.0,1615,1613
1968-12-29,Costa Rica,Honduras,1,1,0,0.5,0.5,1709,1546
1968-12-29,Tunisia,Algeria,0,0,0,0.5,0.5,1555,1534
1969-01-01,Mexico,Italy,2,3,1,0.0,1.0,1753,1833
1969-01-05,Ethiopia,Somalia,7,0,7,1.0,0.0,1605,1489
1969-01-05,Mexico,Italy,1,1,0,0.5,0.5,1755,1832
1969-01-05,Senegal,Morocco,2,1,1,1.0,0.0,1552,1541
1969-01-06,Kenya,Tanzania,2,1,1,1.0,0.0,1585,1461
1969-01-07,Somalia,Uganda,1,7,6,0.0,1.0,1482,1515
1969-01-08,Kenya,Sudan,0,1,1,0.0,1.0,1577,1559
1969-01-10,Sudan,Tanzania,3,0,3,1.0,0.0,1565,1456
1969-01-11,Ethiopia,Uganda,4,0,4,1.0,0.0,1611,1510
1969-01-12,Bermuda,Denmark,1,5,4,0.0,1.0,1458,1591
1969-01-12,Ethiopia,Sudan,0,1,1,0.0,1.0,1602,1575
1969-01-15,England,Romania,1,1,0,0.5,0.5,1855,1666
1969-01-15,Suriname,Denmark,2,1,1,1.0,0.0,1623,1584
1969-01-17,Saudi Arabia,Turkey,1,2,1,0.0,1.0,1498,1577
1969-01-19,Benin,Niger,1,1,0,0.5,0.5,1506,1463
1969-01-22,Congo,Senegal,1,0,1,1.0,0.0,1556,1544
1969-01-22,Mexico,Denmark,3,0,3,1.0,0.0,1760,1580
1969-01-24,Senegal,Cameroon,3,2,1,1.0,0.0,1552,1532
1969-01-26,DR Congo,Senegal,4,0,4,1.0,0.0,1609,1546
1969-01-26,Libya,Ethiopia,2,0,2,1.0,0.0,1506,1592
1969-01-30,DR Congo,Cameroon,2,1,1,1.0,0.0,1616,1526
1969-02-01,Malawi,Zimbabwe,2,2,0,0.5,0.5,1438,1487
1969-02-02,Guinea,Sierra Leone,1,1,0,0.5,0.5,1516,1476
1969-02-02,Uganda,Cameroon,2,1,1,1.0,0.0,1519,1518
1969-02-02,Cameroon,Uganda,2,0,2,1.0,0.0,1527,1511
1969-02-04,Mexico,Colombia,1,0,1,1.0,0.0,1763,1460
1969-02-06,Haiti,Jamaica,1,2,1,0.0,1.0,1571,1482
1969-02-08,Haiti,Jamaica,3,0,3,1.0,0.0,1577,1477
1969-02-08,Zimbabwe,Malawi,4,0,4,1.0,0.0,1494,1432
1969-02-09,Ethiopia,Libya,5,1,4,1.0,0.0,1599,1500
1969-02-09,Morocco,Hungary,1,4,3,0.0,1.0,1539,1839
1969-02-09,Zimbabwe,Malawi,1,1,0,0.5,0.5,1493,1434
1969-02-12,France,Hungary,2,2,0,0.5,0.5,1625,1835
1969-02-13,Morocco,Senegal,2,0,2,1.0,0.0,1548,1538
1969-02-16,Kenya,Tanzania,0,1,1,0.0,1.0,1567,1467
1969-02-20,Colombia,Russia,1,3,2,0.0,1.0,1459,1811
1969-02-23,Belgium,Spain,2,1,1,1.0,0.0,1683,1719
1969-02-23,Guatemala,Haiti,1,1,0,0.5,0.5,1590,1578
1969-02-26,Yugoslavia,Sweden,2,1,1,1.0,0.0,1740,1694
1969-03-01,Tanzania,Kenya,1,1,0,0.5,0.5,1470,1565
1969-03-07,Iran,Iraq,2,1,1,1.0,0.0,1573,1552
1969-03-09,Algeria,Morocco,2,0,2,1.0,0.0,1543,1540
1969-03-10,Iraq,Pakistan,1,2,1,0.0,1.0,1543,1496
1969-03-12,England,France,5,0,5,1.0,0.0,1859,1622
1969-03-12,Iran,Pakistan,9,1,8,1.0,0.0,1580,1490
1969-03-12,Israel,Greece,3,3,0,0.5,0.5,1521,1506
1969-03-19,Argentina,Paraguay,1,1,0,0.5,0.5,1757,1664
1969-03-22,Morocco,Algeria,2,0,2,1.0,0.0,1549,1535
1969-03-25,Greece,Cyprus,1,0,1,1.0,0.0,1514,1468
1969-03-26,Germany,Wales,1,1,0,0.5,0.5,1807,1599
1969-03-26,Netherlands,Luxembourg,4,0,4,1.0,0.0,1608,1394
1969-03-26,Spain,Switzerland,1,0,1,1.0,0.0,1724,1573
1969-03-27,Jersey,Alderney,5,0,5,1.0,0.0,1692,1323
1969-03-29,German DR,Italy,2,2,0,0.5,0.5,1677,1829
1969-04-06,Portugal,Mexico,0,0,0,0.5,0.5,1700,1762
1969-04-07,Brazil,Peru,2,1,1,1.0,0.0,1876,1568
1969-04-09,Brazil,Peru,3,2,1,1.0,0.0,1879,1566
1969-04-09,Paraguay,Argentina,0,0,0,0.5,0.5,1667,1755
1969-04-10,Luxembourg,Mexico,2,1,1,1.0,0.0,1409,1748
1969-04-16,Belgium,Mexico,2,0,2,1.0,0.0,1693,1739
1969-04-16,German DR,Wales,2,1,1,1.0,0.0,1684,1593
1969-04-16,Greece,Romania,2,2,0,0.5,0.5,1518,1663
1969-04-16,Netherlands,Czechoslovakia,2,0,2,1.0,0.0,1619,1734
1969-04-16,Portugal,Switzerland,0,2,2,0.0,1.0,1690,1584
1969-04-16,Scotland,Germany,1,1,0,0.5,0.5,1725,1806
1969-04-19,Cyprus,Austria,1,2,1,0.0,1.0,1464,1658
1969-04-20,Haiti,United States,2,0,2,1.0,0.0,1584,1474
1969-04-20,Poland,Luxembourg,8,1,7,1.0,0.0,1629,1406
1969-04-23,Bulgaria,Luxembourg,2,1,1,1.0,0.0,1711,1404
1969-04-23,Israel,Austria,1,1,0,0.5,0.5,1525,1655
1969-04-23,Spain,Mexico,0,0,0,0.5,0.5,1725,1739
1969-04-26,French Guiana,Suriname,1,2,1,0.0,1.0,1438,1628
1969-04-27,Malta,Austria,1,3,2,0.0,1.0,1512,1660
1969-04-27,Tunisia,Morocco,0,0,0,0.5,0.5,1555,1550
1969-04-30,France,Romania,1,0,1,1.0,0.0,1631,1655
1969-04-30,Spain,Yugoslavia,2,1,1,1.0,0.0,1734,1732
1969-04-30,Turkey,Poland,1,3,2,0.0,1.0,1571,1636
1969-05-01,Sweden,Mexico,1,0,1,1.0,0.0,1704,1730
1969-05-03,Northern Ireland,England,1,3,2,0.0,1.0,1599,1862
1969-05-03,Wales,Scotland,3,5,2,0.0,1.0,1588,1731
1969-05-04,Ethiopia,Sudan,1,1,0,0.5,0.5,1599,1576
1969-05-04,Republic of Ireland,Czechoslovakia,1,2,1,0.0,1.0,1604,1740
1969-05-04,Portugal,Greece,2,2,0,0.5,0.5,1687,1522
1969-05-06,Denmark,Mexico,3,1,2,1.0,0.0,1592,1719
1969-05-06,Scotland,Northern Ireland,1,1,0,0.5,0.5,1729,1602
1969-05-07,England,Wales,2,1,1,1.0,0.0,1865,1586
1969-05-07,Netherlands,Poland,1,0,1,1.0,0.0,1628,1628
1969-05-08,Colombia,Peru,1,3,2,0.0,1.0,1454,1572
1969-05-08,Norway,Mexico,0,2,2,0.0,1.0,1558,1724
1969-05-09,Guernsey,Jersey,2,1,1,1.0,0.0,1612,1682
1969-05-10,England,Scotland,4,1,3,1.0,0.0,1871,1724
1969-05-10,Germany,Austria,1,0,1,1.0,0.0,1811,1656
1969-05-10,Nigeria,Ghana,2,1,1,1.0,0.0,1585,1708
1969-05-10,Northern Ireland,Wales,0,0,0,0.5,0.5,1602,1587
1969-05-11,Sudan,Ethiopia,3,1,2,1.0,0.0,1585,1591
1969-05-11,United States,Haiti,0,1,1,0.0,1.0,1469,1590
1969-05-14,El Salvador,Peru,1,4,3,0.0,1.0,1605,1581
1969-05-14,Switzerland,Romania,0,1,1,0.0,1.0,1578,1662
1969-05-17,Scotland,Cyprus,8,0,8,1.0,0.0,1727,1462
1969-05-18,Ghana,Nigeria,1,1,0,0.5,0.5,1706,1588
1969-05-18,Morocco,Tunisia,0,0,0,0.5,0.5,1551,1555
1969-05-20,Mexico,Peru,0,1,1,0.0,1.0,1713,1593
1969-05-21,Germany,Cyprus,12,0,12,1.0,0.0,1813,1461
1969-05-22,Guinea,Gambia,6,2,4,1.0,0.0,1524,1477
1969-05-22,Mexico,Peru,3,0,3,1.0,0.0,1719,1588
1969-05-22,Sweden,Finland,4,0,4,1.0,0.0,1707,1413
1969-05-24,Italy,Bulgaria,0,0,0,0.5,0.5,1827,1714
1969-05-25,Ethiopia,Tanzania,7,0,7,1.0,0.0,1597,1465
1969-05-25,Hungary,Czechoslovakia,2,0,2,1.0,0.0,1841,1735
1969-05-27,Denmark,Republic of Ireland,2,0,2,1.0,0.0,1601,1596
1969-05-28,Chile,Argentina,1,1,0,0.5,0.5,1692,1754
1969-05-31,Tanzania,Ethiopia,1,2,1,0.0,1.0,1460,1603
1969-06-01,Mexico,England,0,0,0,0.5,0.5,1723,1868
1969-06-01,Sweden,Norway,4,2,2,1.0,0.0,1712,1554
1969-06-03,Mexico,England,0,4,4,0.0,1.0,1719,1873
1969-06-04,Finland,Yugoslavia,1,5,4,0.0,1.0,1411,1735
1969-06-08,Honduras,El Salvador,1,0,1,1.0,0.0,1556,1596
1969-06-08,Republic of Ireland,Hungary,1,2,1,0.0,1.0,1593,1845
1969-06-08,Paraguay,Chile,0,1,1,0.0,1.0,1660,1700
1969-06-08,Uruguay,England,1,2,1,0.0,1.0,1725,1878
1969-06-11,Argentina,Chile,2,1,1,1.0,0.0,1761,1694
1969-06-12,Brazil,England,2,1,1,1.0,0.0,1887,1871
1969-06-13,Tunisia,Morocco,2,2,0,0.5,0.5,1555,1552
1969-06-15,Bulgaria,Poland,4,1,3,1.0,0.0,1721,1622
1969-06-15,Colombia,Chile,3,3,0,0.5,0.5,1459,1690
1969-06-15,Denmark,Hungary,3,2,1,1.0,0.0,1614,1833
1969-06-15,El Salvador,Honduras,3,0,3,1.0,0.0,1604,1549
1969-06-18,Peru,Colombia,1,1,0,0.5,0.5,1586,1462
1969-06-19,Norway,Sweden,2,5,3,0.0,1.0,1550,1717
1969-06-22,Ecuador,Colombia,4,1,3,1.0,0.0,1425,1453
1969-06-22,German DR,Chile,0,1,1,0.0,1.0,1677,1698
1969-06-23,Iceland,Bermuda,2,1,1,1.0,0.0,1440,1450
1969-06-25,Denmark,Sweden,0,1,1,0.0,1.0,1609,1723
1969-06-25,Finland,Spain,2,0,2,1.0,0.0,1425,1721
1969-06-25,German DR,Chile,2,1,1,1.0,0.0,1686,1690
1969-06-27,Honduras,El Salvador,2,3,1,0.0,1.0,1543,1611
1969-06-27,Peru,Uruguay,1,0,1,1.0,0.0,1598,1714
1969-06-29,Zambia,Cameroon,2,2,0,0.5,0.5,1604,1529
1969-06-29,Cameroon,Zambia,2,1,1,1.0,0.0,1539,1595
1969-07-01,Denmark,Bermuda,6,0,6,1.0,0.0,1614,1446
1969-07-01,Madagascar,Malawi,3,0,3,1.0,0.0,1505,1428
1969-07-02,Colombia,Uruguay,0,1,1,0.0,1.0,1451,1717
1969-07-03,Norway,Bermuda,3,0,3,1.0,0.0,1556,1441
1969-07-06,Chile,Paraguay,0,0,0,0.5,0.5,1690,1661
1969-07-06,Ecuador,Uruguay,0,2,2,0.0,1.0,1423,1720
1969-07-06,Malawi,Eswatini,3,0,3,1.0,0.0,1438,1505
1969-07-09,German DR,Egypt,7,0,7,1.0,0.0,1693,1601
1969-07-09,Peru,Paraguay,2,1,1,1.0,0.0,1608,1652
1969-07-13,Chile,Uruguay,0,0,0,0.5,0.5,1691,1720
1969-07-18,Peru,Paraguay,2,1,1,1.0,0.0,1618,1643
1969-07-20,Uruguay,Ecuador,1,0,1,1.0,0.0,1723,1421
1969-07-21,Congo,Tunisia,4,1,3,1.0,0.0,1564,1548
1969-07-21,Norway,Iceland,2,1,1,1.0,0.0,1562,1435
1969-07-23,Australia,Greece,2,2,0,0.5,0.5,1588,1524
1969-07-24,Finland,Iceland,3,1,2,1.0,0.0,1434,1427
1969-07-25,German DR,Russia,2,2,0,0.5,0.5,1696,1809
1969-07-25,New Caledonia,New Zealand,0,0,0,0.5,0.5,1560,1542
1969-07-27,Bolivia,Argentina,3,1,2,1.0,0.0,1545,1749
1969-07-27,Chile,Ecuador,4,1,3,1.0,0.0,1694,1419
1969-07-27,Colombia,Venezuela,3,0,3,1.0,0.0,1460,1475
1969-07-27,New Caledonia,New Zealand,2,0,2,1.0,0.0,1568,1535
1969-07-29,New Caledonia,New Zealand,3,2,1,1.0,0.0,1576,1528
1969-08-02,Venezuela,Colombia,1,1,0,0.5,0.5,1475,1461
1969-08-03,Ecuador,Chile,1,1,0,0.5,0.5,1425,1689
1969-08-03,Peru,Argentina,1,0,1,1.0,0.0,1629,1739
1969-08-06,Colombia,Brazil,0,2,2,0.0,1.0,1460,1889
1969-08-06,Russia,Sweden,0,1,1,0.0,1.0,1800,1733
1969-08-06,Venezuela,Paraguay,0,2,2,0.0,1.0,1471,1648
1969-08-10,Bolivia,Peru,2,1,1,1.0,0.0,1555,1620
1969-08-10,Colombia,Paraguay,0,1,1,0.0,1.0,1456,1653
1969-08-10,Uruguay,Chile,2,0,2,1.0,0.0,1731,1682
1969-08-10,Venezuela,Brazil,0,5,5,0.0,1.0,1470,1891
1969-08-10,Guinea,Togo,4,0,4,1.0,0.0,1531,1472
1969-08-14,Fiji,Solomon Islands,5,1,4,1.0,0.0,1475,1478
1969-08-14,Tahiti,Vanuatu,3,3,0,0.5,0.5,1506,1462
1969-08-14,Papua New Guinea,New Caledonia,1,4,3,0.0,1.0,1474,1582
1969-08-15,Congo,Ivory Coast,1,1,0,0.5,0.5,1565,1600
1969-08-15,New Caledonia,Solomon Islands,1,1,0,0.5,0.5,1580,1481
1969-08-15,Papua New Guinea,Tahiti,1,3,2,0.0,1.0,1467,1514
1969-08-15,Fiji,Vanuatu,5,2,3,1.0,0.0,1483,1455
1969-08-16,Fiji,Tahiti,0,2,2,0.0,1.0,1476,1522
1969-08-16,Papua New Guinea,Solomon Islands,4,0,4,1.0,0.0,1476,1473
1969-08-16,New Caledonia,Vanuatu,2,0,2,1.0,0.0,1586,1450
1969-08-17,Ghana,Niger,6,0,6,1.0,0.0,1710,1460
1969-08-17,Paraguay,Brazil,0,3,3,0.0,1.0,1650,1895
1969-08-17,Peru,Bolivia,3,0,3,1.0,0.0,1627,1549
1969-08-18,Fiji,New Caledonia,0,11,11,0.0,1.0,1471,1592
1969-08-18,Solomon Islands,Tahiti,0,7,7,0.0,1.0,1467,1529
1969-08-18,Papua New Guinea,Vanuatu,2,1,1,1.0,0.0,1484,1443
1969-08-20,Vanuatu,Solomon Islands,7,2,5,1.0,0.0,1452,1459
1969-08-20,Papua New Guinea,Fiji,1,1,0,0.5,0.5,1484,1472
1969-08-21,Brazil,Colombia,6,2,4,1.0,0.0,1897,1455
1969-08-21,Paraguay,Venezuela,1,0,1,1.0,0.0,1655,1466
1969-08-22,New Caledonia,Tahiti,2,1,1,1.0,0.0,1599,1523
1969-08-22,Papua New Guinea,Fiji,2,1,1,1.0,0.0,1492,1465
1969-08-24,Argentina,Bolivia,1,0,1,1.0,0.0,1744,1545
1969-08-24,Benin,Gabon,1,0,1,1.0,0.0,1514,1469
1969-08-24,Togo,Guinea,1,1,0,0.5,0.5,1474,1530
1969-08-24,Brazil,Venezuela,6,0,6,1.0,0.0,1899,1465
1969-08-24,Finland,Norway,2,2,0,0.5,0.5,1437,1560
1969-08-24,Paraguay,Colombia,2,1,1,1.0,0.0,1659,1452
1969-08-25,Sweden,Israel,3,1,2,1.0,0.0,1737,1522
1969-08-27,Poland,Norway,6,1,5,1.0,0.0,1629,1554
1969-08-30,Zambia,Malawi,4,0,4,1.0,0.0,1600,1434
1969-08-31,Argentina,Peru,2,2,0,0.5,0.5,1742,1630
1969-08-31,Brazil,Paraguay,1,0,1,1.0,0.0,1903,1656
1969-08-31,Zambia,Malawi,5,0,5,1.0,0.0,1605,1430
1969-09-02,Zambia,Malawi,7,0,7,1.0,0.0,1610,1426
1969-09-03,Yugoslavia,Romania,1,1,0,0.5,0.5,1734,1664
1969-09-07,Poland,Netherlands,2,1,1,1.0,0.0,1637,1621
1969-09-10,Denmark,Finland,5,2,3,1.0,0.0,1619,1433
1969-09-10,Northern Ireland,Russia,0,0,0,0.5,0.5,1607,1796
1969-09-10,Norway,France,1,3,2,0.0,1.0,1548,1638
1969-09-10,Turkey,Pakistan,4,2,2,1.0,0.0,1578,1484
1969-09-13,Iran,Pakistan,4,2,2,1.0,0.0,1586,1479
1969-09-13,Nigeria,Sudan,2,2,0,0.5,0.5,1588,1586
1969-09-14,Czechoslovakia,Hungary,3,3,0,0.5,0.5,1738,1831
1969-09-14,El Salvador,Costa Rica,2,1,1,1.0,0.0,1622,1699
1969-09-16,Singapore,New Zealand,0,2,2,0.0,1.0,1448,1535
1969-09-17,Turkey,Iran,4,0,4,1.0,0.0,1587,1578
1969-09-19,Egypt,Algeria,1,0,1,1.0,0.0,1608,1529
1969-09-21,Austria,Germany,1,1,0,0.5,0.5,1660,1810
1969-09-21,Haiti,El Salvador,1,2,1,0.0,1.0,1583,1630
1969-09-21,Republic of Ireland,Scotland,1,1,0,0.5,0.5,1596,1725
1969-09-21,Morocco,Nigeria,2,1,1,1.0,0.0,1561,1580
1969-09-21,Niger,Ghana,1,9,8,0.0,1.0,1457,1714
1969-09-21,Norway,Denmark,2,0,2,1.0,0.0,1558,1610
1969-09-24,Bulgaria,Germany,0,1,1,0.0,1.0,1716,1816
1969-09-24,Sweden,Hungary,2,0,2,1.0,0.0,1748,1821
1969-09-24,Turkey,Switzerland,3,0,3,1.0,0.0,1595,1571
1969-09-24,Yugoslavia,Russia,1,3,2,0.0,1.0,1728,1803
1969-09-27,Uganda,Tanzania,3,0,3,1.0,0.0,1518,1454
1969-09-28,Algeria,Egypt,1,1,0,0.5,0.5,1531,1607
1969-09-28,El Salvador,Haiti,0,3,3,0.0,1.0,1621,1593
1969-09-28,Israel,New Zealand,4,0,4,1.0,0.0,1531,1527
1969-09-28,Kenya,Zanzibar,2,1,1,1.0,0.0,1569,1353
1969-09-30,Uganda,Zanzibar,7,0,7,1.0,0.0,1523,1349
1969-10-01,Israel,New Zealand,2,0,2,1.0,0.0,1539,1520
1969-10-01,Kenya,Tanzania,0,3,3,0.0,1.0,1559,1465
1969-10-03,Sudan,Nigeria,3,3,0,0.5,0.5,1586,1581
1969-10-03,Tanzania,Zanzibar,3,0,3,1.0,0.0,1471,1344
1969-10-04,Uganda,Kenya,1,0,1,1.0,0.0,1532,1551
1969-10-05,Suriname,French Guiana,1,1,0,0.5,0.5,1625,1442
1969-10-07,Czechoslovakia,Republic of Ireland,3,0,3,1.0,0.0,1743,1592
1969-10-08,Haiti,El Salvador,0,1,1,0.0,1.0,1586,1629
1969-10-09,Uganda,Ethiopia,4,0,4,1.0,0.0,1542,1594
1969-10-10,Japan,Australia,1,3,2,0.0,1.0,1582,1597
1969-10-10,Sudan,Morocco,0,0,0,0.5,0.5,1586,1562
1969-10-10,Luxembourg,Poland,1,5,4,0.0,1.0,1401,1641
1969-10-12,South Korea,Japan,2,2,0,0.5,0.5,1645,1584
1969-10-12,Mali,Ivory Coast,0,0,0,0.5,0.5,1529,1599
1969-10-12,Guinea,Senegal,4,3,1,1.0,0.0,1539,1530
1969-10-12,Romania,Portugal,1,0,1,1.0,0.0,1673,1679
1969-10-14,Dominica,Suriname,1,3,2,0.0,1.0,1461,1630
1969-10-14,South Korea,Australia,1,2,1,0.0,1.0,1636,1607
1969-10-15,Greece,Switzerland,4,1,3,1.0,0.0,1534,1562
1969-10-15,Republic of Ireland,Denmark,1,1,0,0.5,0.5,1593,1610
1969-10-15,Russia,Turkey,3,0,3,1.0,0.0,1807,1592
1969-10-15,Spain,Finland,6,0,6,1.0,0.0,1724,1431
1969-10-15,Sweden,France,2,0,2,1.0,0.0,1754,1633
1969-10-15,Tunisia,Palestine,1,1,0,0.5,0.5,1547,1494
1969-10-16,Australia,Japan,1,1,0,0.5,0.5,1607,1585
1969-10-16,Dominica,Suriname,1,9,8,0.0,1.0,1457,1635
1969-10-18,South Korea,Japan,2,0,2,1.0,0.0,1643,1579
1969-10-19,Yugoslavia,Belgium,4,0,4,1.0,0.0,1736,1686
1969-10-20,South Korea,Australia,1,1,0,0.5,0.5,1643,1608
1969-10-21,Mexico,Bermuda,3,0,3,1.0,0.0,1722,1439
1969-10-22,Germany,Scotland,3,2,1,1.0,0.0,1822,1720
1969-10-22,Hungary,Denmark,3,0,3,1.0,0.0,1825,1607
1969-10-22,Netherlands,Bulgaria,1,1,0,0.5,0.5,1624,1714
1969-10-22,Russia,Northern Ireland,2,0,2,1.0,0.0,1811,1604
1969-10-22,Wales,German DR,1,3,2,0.0,1.0,1582,1702
1969-10-23,Algeria,Palestine,2,0,2,1.0,0.0,1539,1487
1969-10-23,French Guiana,Martinique,0,0,0,0.5,0.5,1445,1563
1969-10-26,Senegal,Guinea,1,1,0,0.5,0.5,1531,1539
1969-10-26,Ivory Coast,Mali,4,0,4,1.0,0.0,1606,1523
1969-10-26,Morocco,Sudan,3,0,3,1.0,0.0,1571,1578
1969-10-30,Algeria,Morocco,1,0,1,1.0,0.0,1548,1563
1969-10-30,Malaysia,Thailand,1,0,1,1.0,0.0,1521,1462
1969-10-31,Myanmar,Singapore,3,1,2,1.0,0.0,1626,1444
1969-10-31,India,Western Australia,0,1,1,0.0,1.0,1554,1531
1969-11-01,France,Sweden,3,0,3,1.0,0.0,1644,1744
1969-11-01,Indonesia,Thailand,4,0,4,1.0,0.0,1617,1458
1969-11-01,Indonesia,South Korea,3,0,3,1.0,0.0,1626,1635
1969-11-02,Bermuda,Mexico,2,1,1,1.0,0.0,1453,1709
1969-11-02,Myanmar,India,6,0,6,1.0,0.0,1633,1548
1969-11-02,Egypt,Sudan,3,1,2,1.0,0.0,1615,1571
1969-11-02,Singapore,Western Australia,4,2,2,1.0,0.0,1454,1522
1969-11-02,Switzerland,Portugal,1,1,0,0.5,0.5,1565,1677
1969-11-03,Malaysia,South Korea,4,1,3,1.0,0.0,1532,1625
1969-11-03,Jamaica,Panama,1,1,0,0.5,0.5,1477,1445
1969-11-04,Myanmar,Western Australia,5,2,3,1.0,0.0,1639,1517
1969-11-04,India,Singapore,3,0,3,1.0,0.0,1554,1449
1969-11-04,Italy,Wales,4,1,3,1.0,0.0,1831,1579
1969-11-05,Austria,Scotland,2,0,2,1.0,0.0,1670,1711
1969-11-05,Hungary,Republic of Ireland,4,0,4,1.0,0.0,1829,1590
1969-11-05,Jamaica,Panama,2,1,1,1.0,0.0,1485,1438
1969-11-05,Mexico,Belgium,1,0,1,1.0,0.0,1717,1679
1969-11-05,Netherlands,England,0,1,1,0.0,1.0,1621,1875
1969-11-05,South Korea,Thailand,3,0,3,1.0,0.0,1630,1454
1969-11-06,South Korea,Western Australia,3,2,1,1.0,0.0,1636,1512
1969-11-06,Indonesia,Singapore,9,2,7,1.0,0.0,1631,1445
1969-11-07,India,Thailand,0,1,1,0.0,1.0,1544,1465
1969-11-07,Malaysia,Myanmar,3,1,2,1.0,0.0,1543,1629
1969-11-07,South Korea,Thailand,2,1,1,1.0,0.0,1641,1461
1969-11-08,India,Western Australia,2,1,1,1.0,0.0,1552,1505
1969-11-08,Nigeria,Morocco,2,0,2,1.0,0.0,1589,1556
1969-11-09,Myanmar,Singapore,9,0,9,1.0,0.0,1634,1441
1969-11-09,Ivory Coast,Morocco,1,0,1,1.0,0.0,1613,1550
1969-11-09,Malaysia,Indonesia,2,3,1,0.0,1.0,1537,1638
1969-11-09,Poland,Bulgaria,3,0,3,1.0,0.0,1651,1705
1969-11-09,Saint Vincent and the Grenadines,Dominica,1,0,1,1.0,0.0,1536,1451
1969-11-11,Bermuda,Iceland,3,2,1,1.0,0.0,1461,1420
1969-11-11,French Guiana,Suriname,3,2,1,1.0,0.0,1457,1624
1969-11-11,Grenada,Saint Lucia,6,0,6,1.0,0.0,1552,1505
1969-11-11,Mexico,Norway,4,0,4,1.0,0.0,1722,1554
1969-11-11,Singapore,India,7,3,4,1.0,0.0,1452,1542
1969-11-12,Congo,Guinea,1,1,0,0.5,0.5,1565,1540
1969-11-12,Saint Vincent and the Grenadines,Saint Lucia,2,1,1,1.0,0.0,1544,1498
1969-11-13,Dominica,Grenada,0,1,1,0.0,1.0,1446,1558
1969-11-13,Guatemala,Norway,1,3,2,0.0,1.0,1582,1563
1969-11-14,Dominica,Saint Lucia,1,3,2,0.0,1.0,1440,1505
1969-11-15,Saint Vincent and the Grenadines,Grenada,0,0,0,0.5,0.5,1545,1558
1969-11-16,Romania,Greece,1,1,0,0.5,0.5,1670,1538
1969-11-16,Turkey,Russia,1,3,2,0.0,1.0,1589,1815
1969-11-18,Iraq,Poland,1,1,0,0.5,0.5,1546,1649
1969-11-19,South Korea,Laos,2,0,2,1.0,0.0,1645,1435
1969-11-19,Thailand,Malaysia,2,2,0,0.5,0.5,1463,1536
1969-11-19,Vietnam Republic,Western Australia,3,1,2,1.0,0.0,1593,1499
1969-11-19,Indonesia,Singapore,2,3,1,0.0,1.0,1627,1464
1969-11-21,South Korea,Malaysia,2,0,2,1.0,0.0,1651,1531
1969-11-21,Thailand,Laos,3,4,1,0.0,1.0,1455,1444
1969-11-21,Indonesia,Vietnam Republic,3,1,2,1.0,0.0,1635,1586
1969-11-21,Singapore,Western Australia,1,3,2,0.0,1.0,1457,1507
1969-11-22,DR Congo,Zambia,10,1,9,1.0,0.0,1624,1603
1969-11-22,Italy,German DR,3,0,3,1.0,0.0,1837,1697
1969-11-23,Laos,Malaysia,1,1,0,0.5,0.5,1446,1530
1969-11-23,Thailand,South Korea,0,0,0,0.5,0.5,1460,1647
1969-11-23,Zimbabwe,Australia,1,1,0,0.5,0.5,1496,1606
1969-11-23,Costa Rica,Jamaica,3,0,3,1.0,0.0,1703,1482
1969-11-23,Indonesia,Western Australia,3,1,2,1.0,0.0,1641,1502
1969-11-23,Singapore,Vietnam Republic,1,1,0,0.5,0.5,1460,1584
1969-11-26,Indonesia,Laos,3,1,2,1.0,0.0,1645,1443
1969-11-26,South Korea,Vietnam Republic,3,0,3,1.0,0.0,1654,1578
1969-11-27,Australia,Zimbabwe,0,0,0,0.5,0.5,1604,1499
1969-11-27,Costa Rica,Curaçao,2,1,1,1.0,0.0,1708,1554
1969-11-27,Mexico,Jamaica,2,0,2,1.0,0.0,1726,1479
1969-11-27,Guatemala,Trinidad and Tobago,2,0,2,1.0,0.0,1591,1590
1969-11-28,Indonesia,South Korea,0,1,1,0.0,1.0,1638,1662
1969-11-28,Laos,Vietnam Republic,0,7,7,0.0,1.0,1438,1584
1969-11-29,Guatemala,Curaçao,6,1,5,1.0,0.0,1599,1547
1969-11-29,Zimbabwe,Australia,1,3,2,0.0,1.0,1494,1610
1969-11-30,Jamaica,Trinidad and Tobago,2,3,1,0.0,1.0,1474,1596
1969-11-30,Costa Rica,Mexico,2,0,2,1.0,0.0,1717,1718
1969-12-01,Malawi,Zimbabwe,2,2,0,0.5,0.5,1428,1493
1969-12-02,Curaçao,Trinidad and Tobago,3,1,2,1.0,0.0,1557,1587
1969-12-02,Mexico,Guatemala,0,1,1,0.0,1.0,1708,1610
1969-12-03,Czechoslovakia,Hungary,4,1,3,1.0,0.0,1753,1820
1969-12-04,Costa Rica,Trinidad and Tobago,5,0,5,1.0,0.0,1723,1582
1969-12-04,Israel,Australia,1,0,1,1.0,0.0,1549,1601
1969-12-04,Jamaica,Guatemala,0,0,0,0.5,0.5,1477,1608
1969-12-04,Mexico,Curaçao,2,2,0,0.5,0.5,1705,1561
1969-12-05,Algeria,North Korea,1,3,2,0.0,1.0,1543,1659
1969-12-06,Jamaica,Curaçao,1,2,1,0.0,1.0,1471,1568
1969-12-06,Malaysia,Laos,2,1,1,1.0,0.0,1536,1433
1969-12-07,Mexico,Trinidad and Tobago,0,0,0,0.5,0.5,1703,1585
1969-12-07,Costa Rica,Guatemala,1,1,0,0.5,0.5,1721,1611
1969-12-07,Luxembourg,Bulgaria,1,3,2,0.0,1.0,1399,1708
1969-12-07,Malaysia,Vietnam Republic,2,1,1,1.0,0.0,1546,1575
1969-12-08,Iraq,German DR,1,1,0,0.5,0.5,1550,1694
1969-12-08,Myanmar,Thailand,1,1,0,0.5,0.5,1631,1464
1969-12-09,Laos,Vietnam Republic,0,0,0,0.5,0.5,1437,1572
1969-12-10,England,Portugal,1,0,1,1.0,0.0,1879,1674
1969-12-10,Malaysia,Thailand,0,3,3,0.0,1.0,1537,1474
1969-12-11,Myanmar,Laos,4,0,4,1.0,0.0,1635,1434
1969-12-13,Myanmar,Thailand,3,0,3,1.0,0.0,1640,1470
1969-12-14,Australia,Israel,1,1,0,0.5,0.5,1600,1551
1969-12-14,DR Congo,Nigeria,5,0,5,1.0,0.0,1632,1582
1969-12-19,Egypt,German DR,1,3,2,0.0,1.0,1609,1701
1969-12-28,Morocco,Bulgaria,3,0,3,1.0,0.0,1562,1697
1970-01-04,Malta,Luxembourg,1,1,0,0.5,0.5,1510,1402
1970-01-14,England,Netherlands,0,0,0,0.5,0.5,1874,1627
1970-01-28,Israel,Netherlands,0,1,1,0.0,1.0,1545,1634
1970-02-04,Peru,Czechoslovakia,0,2,2,0.0,1.0,1625,1759
1970-02-06,Cameroon,Ivory Coast,3,2,1,1.0,0.0,1549,1604
1970-02-06,Sudan,Ethiopia,3,0,3,1.0,0.0,1580,1586
1970-02-07,DR Congo,Ghana,0,2,2,0.0,1.0,1626,1721
1970-02-07,Egypt,Guinea,4,1,3,1.0,0.0,1616,1534
1970-02-07,Peru,Czechoslovakia,2,1,1,1.0,0.0,1636,1749
1970-02-08,Cameroon,Ethiopia,3,2,1,1.0,0.0,1558,1578
1970-02-08,Sudan,Ivory Coast,0,1,1,0.0,1.0,1573,1612
1970-02-09,DR Congo,Guinea,2,2,0,0.5,0.5,1624,1537
1970-02-09,Egypt,Ghana,1,1,0,0.5,0.5,1619,1719
1970-02-09,Peru,Romania,1,1,0,0.5,0.5,1637,1670
1970-02-10,Ethiopia,Ivory Coast,1,6,5,0.0,1.0,1571,1620
1970-02-10,Sudan,Cameroon,2,1,1,1.0,0.0,1581,1551
1970-02-11,DR Congo,Egypt,0,1,1,0.0,1.0,1616,1628
1970-02-11,Ghana,Guinea,1,1,0,0.5,0.5,1716,1541
1970-02-11,Spain,Germany,2,0,2,1.0,0.0,1735,1812
1970-02-14,Ghana,Ivory Coast,2,1,1,1.0,0.0,1722,1615
1970-02-14,Peru,Russia,0,0,0,0.5,0.5,1641,1812
1970-02-14,Sudan,Egypt,2,1,1,1.0,0.0,1591,1619
1970-02-15,Mexico,Bulgaria,1,1,0,0.5,0.5,1703,1698
1970-02-16,Egypt,Ivory Coast,3,1,2,1.0,0.0,1627,1608
1970-02-16,Sudan,Ghana,1,0,1,1.0,0.0,1602,1712
1970-02-18,Mexico,Bulgaria,2,0,2,1.0,0.0,1711,1691
1970-02-20,Peru,Russia,0,2,2,0.0,1.0,1637,1817
1970-02-21,Peru,Bulgaria,1,3,2,0.0,1.0,1631,1698
1970-02-21,Spain,Italy,2,2,0,0.5,0.5,1738,1835
1970-02-22,El Salvador,Russia,0,2,2,0.0,1.0,1625,1822
1970-02-22,Mexico,Sweden,0,0,0,0.5,0.5,1712,1744
1970-02-24,Peru,Bulgaria,5,3,2,1.0,0.0,1641,1689
1970-02-25,Belgium,England,1,3,2,0.0,1.0,1676,1878
1970-02-26,Costa Rica,El Salvador,2,0,2,1.0,0.0,1727,1620
1970-02-26,Mexico,Russia,0,0,0,0.5,0.5,1715,1820
1970-03-01,Mexico,Sweden,0,1,1,0.0,1.0,1708,1752
1970-03-04,Brazil,Argentina,0,2,2,0.0,1.0,1892,1754
1970-03-05,Peru,Mexico,0,1,1,0.0,1.0,1635,1715
1970-03-08,Brazil,Argentina,2,1,1,1.0,0.0,1897,1750
1970-03-08,Peru,Mexico,1,0,1,1.0,0.0,1645,1706
1970-03-15,Mexico,Peru,3,1,2,1.0,0.0,1713,1639
1970-03-18,Mexico,Peru,3,3,0,0.5,0.5,1712,1641
1970-03-22,Brazil,Chile,5,0,5,1.0,0.0,1901,1679
1970-03-22,Burkina Faso,Niger,3,3,0,0.5,0.5,1493,1458
1970-03-22,Ethiopia,Israel,1,5,4,0.0,1.0,1563,1554
1970-03-22,Guinea,Ivory Coast,4,2,2,1.0,0.0,1551,1599
1970-03-26,Brazil,Chile,2,1,1,1.0,0.0,1905,1676
1970-03-26,Guinea,Mali,2,1,1,1.0,0.0,1559,1516
1970-03-27,Bahrain,Qatar,2,1,1,1.0,0.0,1485,1492
1970-03-28,Saudi Arabia,Kuwait,1,3,2,0.0,1.0,1490,1471
1970-03-30,Bahrain,Saudi Arabia,0,0,0,0.5,0.5,1486,1490
1970-03-31,Kuwait,Qatar,4,2,2,1.0,0.0,1480,1484
1970-03-31,Uruguay,Peru,2,0,2,1.0,0.0,1737,1636
1970-04-02,Saudi Arabia,Qatar,1,1,0,0.5,0.5,1490,1485
1970-04-03,Bahrain,Kuwait,1,3,2,0.0,1.0,1478,1489
1970-04-04,Guernsey,Alderney,5,0,5,1.0,0.0,1615,1321
1970-04-08,Argentina,Uruguay,2,1,1,1.0,0.0,1758,1730
1970-04-08,France,Bulgaria,1,1,0,0.5,0.5,1646,1688
1970-04-08,Germany,Romania,1,1,0,0.5,0.5,1809,1674
1970-04-08,Yugoslavia,Austria,1,1,0,0.5,0.5,1735,1672
1970-04-12,Austria,Czechoslovakia,1,3,2,0.0,1.0,1666,1756
1970-04-12,Brazil,Paraguay,0,0,0,0.5,0.5,1901,1661
1970-04-12,Yugoslavia,Hungary,2,2,0,0.5,0.5,1737,1819
1970-04-14,Haiti,Bermuda,1,1,0,0.5,0.5,1584,1464
1970-04-15,Ghana,Ivory Coast,3,0,3,1.0,0.0,1718,1594
1970-04-15,Uruguay,Argentina,2,1,1,1.0,0.0,1739,1750
1970-04-18,Northern Ireland,Scotland,0,1,1,0.0,1.0,1599,1717
1970-04-18,Wales,England,1,1,0,0.5,0.5,1585,1873
1970-04-19,Ghana,Ivory Coast,1,1,0,0.5,0.5,1716,1597
1970-04-21,England,Northern Ireland,3,1,2,1.0,0.0,1876,1597
1970-04-21,Peru,El Salvador,3,0,3,1.0,0.0,1644,1613
1970-04-22,Scotland,Wales,0,0,0,0.5,0.5,1715,1588
1970-04-22,Switzerland,Spain,0,1,1,0.0,1.0,1561,1743
1970-04-25,Scotland,England,0,0,0,0.5,0.5,1719,1873
1970-04-25,Wales,Northern Ireland,1,0,1,1.0,0.0,1597,1589
1970-04-28,France,Romania,2,0,2,1.0,0.0,1655,1666
1970-04-29,Brazil,Austria,1,0,1,1.0,0.0,1905,1663
1970-04-29,Mexico,Ecuador,4,2,2,1.0,0.0,1715,1423
1970-05-02,Hungary,Poland,2,0,2,1.0,0.0,1824,1645
1970-05-03,Switzerland,France,2,1,1,1.0,0.0,1572,1645
1970-05-05,Bulgaria,Russia,3,3,0,0.5,0.5,1691,1818
1970-05-06,Bulgaria,Russia,0,0,0,0.5,0.5,1694,1816
1970-05-06,Poland,Republic of Ireland,2,1,1,1.0,0.0,1652,1584
1970-05-06,Romania,Yugoslavia,0,0,0,0.5,0.5,1668,1736
1970-05-09,Germany,Republic of Ireland,2,1,1,1.0,0.0,1813,1581
1970-05-09,Luxembourg,Czechoslovakia,0,1,1,0.0,1.0,1401,1758
1970-05-09,Jersey,Guernsey,2,0,2,1.0,0.0,1689,1609
1970-05-10,Portugal,Italy,1,2,1,0.0,1.0,1670,1840
1970-05-13,Germany,Yugoslavia,1,0,1,1.0,0.0,1820,1730
1970-05-13,Norway,Czechoslovakia,0,2,2,0.0,1.0,1560,1762
1970-05-14,Guinea,Senegal,3,1,2,1.0,0.0,1567,1524
1970-05-16,Hungary,Sweden,1,2,1,0.0,1.0,1815,1762
1970-05-16,Poland,German DR,1,1,0,0.5,0.5,1654,1700
1970-05-17,Guinea,Senegal,4,0,4,1.0,0.0,1575,1517
1970-05-19,Denmark,Poland,0,2,2,0.0,1.0,1601,1661
1970-05-20,Colombia,England,0,4,4,0.0,1.0,1451,1875
1970-05-24,Ecuador,England,0,2,2,0.0,1.0,1422,1877
1970-05-31,Mexico,Russia,0,0,0,0.5,0.5,1718,1814
1970-06-02,Bulgaria,Peru,2,3,1,0.0,1.0,1685,1654
1970-06-02,England,Romania,1,0,1,1.0,0.0,1881,1665
1970-06-02,Israel,Uruguay,0,2,2,0.0,1.0,1550,1744
1970-06-03,Belgium,El Salvador,3,0,3,1.0,0.0,1683,1607
1970-06-03,Brazil,Czechoslovakia,4,1,3,1.0,0.0,1910,1758
1970-06-03,Finland,Denmark,1,1,0,0.5,0.5,1435,1598
1970-06-03,Germany,Morocco,2,1,1,1.0,0.0,1823,1560
1970-06-03,Italy,Sweden,1,0,1,1.0,0.0,1847,1756
1970-06-06,Belgium,Russia,1,4,3,0.0,1.0,1678,1820
1970-06-06,Czechoslovakia,Romania,1,2,1,0.0,1.0,1748,1676
1970-06-06,Italy,Uruguay,0,0,0,0.5,0.5,1845,1747
1970-06-06,Morocco,Peru,0,3,3,0.0,1.0,1555,1660
1970-06-06,Uganda,Tanzania,1,1,0,0.5,0.5,1541,1473
1970-06-07,Brazil,England,1,0,1,1.0,0.0,1918,1874
1970-06-07,Bulgaria,Germany,2,5,3,0.0,1.0,1681,1828
1970-06-07,Israel,Sweden,1,1,0,0.5,0.5,1555,1752
1970-06-07,Mexico,El Salvador,4,0,4,1.0,0.0,1724,1602
1970-06-10,Brazil,Romania,3,2,1,1.0,0.0,1922,1673
1970-06-10,El Salvador,Russia,0,2,2,0.0,1.0,1599,1824
1970-06-10,Germany,Peru,3,1,2,1.0,0.0,1833,1656
1970-06-10,Sweden,Uruguay,1,0,1,1.0,0.0,1760,1740
1970-06-11,Bulgaria,Morocco,1,1,0,0.5,0.5,1679,1558
1970-06-11,Czechoslovakia,England,0,1,1,0.0,1.0,1743,1880
1970-06-11,Israel,Italy,0,0,0,0.5,0.5,1561,1840
1970-06-11,Mexico,Belgium,1,0,1,1.0,0.0,1731,1672
1970-06-13,Honduras,Panama,1,0,1,1.0,0.0,1549,1433
1970-06-14,Brazil,Peru,4,2,2,1.0,0.0,1925,1654
1970-06-14,England,Germany,2,3,1,0.0,1.0,1871,1843
1970-06-14,Mexico,Italy,1,4,3,0.0,1.0,1726,1846
1970-06-14,Russia,Uruguay,0,1,1,0.0,1.0,1815,1750
1970-06-17,Brazil,Uruguay,3,1,2,1.0,0.0,1930,1746
1970-06-17,Germany,Italy,3,4,1,0.0,1.0,1836,1854
1970-06-17,Norway,Finland,2,0,2,1.0,0.0,1566,1430
1970-06-20,Germany,Uruguay,1,0,1,1.0,0.0,1842,1741
1970-06-20,Malaysia,Singapore,5,0,5,1.0,0.0,1544,1454
1970-06-21,Brazil,Italy,4,1,3,1.0,0.0,1937,1848
1970-06-21,Indonesia,Hong Kong,2,1,1,1.0,0.0,1642,1438
1970-06-21,South Korea,Singapore,8,0,8,1.0,0.0,1666,1451
1970-06-23,Indonesia,Western Australia,3,1,2,1.0,0.0,1647,1498
1970-06-23,South Korea,Malaysia,0,1,1,0.0,1.0,1656,1555
1970-06-24,Hong Kong,Western Australia,3,1,2,1.0,0.0,1448,1489
1970-06-25,Sweden,Denmark,1,1,0,0.5,0.5,1757,1602
1970-06-26,Hong Kong,Malaysia,1,1,0,0.5,0.5,1451,1553
1970-06-26,Indonesia,South Korea,2,2,0,0.5,0.5,1648,1656
1970-06-27,Indonesia,Hong Kong,3,2,1,1.0,0.0,1652,1448
1970-06-28,South Korea,Malaysia,0,2,2,0.0,1.0,1646,1564
1970-06-30,DR Congo,Sudan,3,0,3,1.0,0.0,1624,1595
1970-07-06,Malawi,Mauritius,1,0,1,1.0,0.0,1440,1578
1970-07-07,Iceland,Denmark,0,0,0,0.5,0.5,1424,1599
1970-07-09,Malawi,Mauritius,0,0,0,0.5,0.5,1444,1575
1970-07-11,Gabon,Cameroon,1,1,0,0.5,0.5,1471,1550
1970-07-11,Tahiti,New Caledonia,3,1,2,1.0,0.0,1533,1590
1970-07-18,Tahiti,New Caledonia,0,2,2,0.0,1.0,1527,1597
1970-07-20,Iceland,Norway,2,0,2,1.0,0.0,1436,1555
1970-07-22,Poland,Iraq,2,0,2,1.0,0.0,1667,1545
1970-07-26,German DR,Iraq,5,0,5,1.0,0.0,1705,1541
1970-07-26,Ivory Coast,Guinea,3,2,1,1.0,0.0,1605,1568
1970-07-30,India,Taiwan,0,1,1,0.0,1.0,1534,1517
1970-07-30,Malaysia,Vietnam Republic,0,0,0,0.5,0.5,1565,1572
1970-07-31,Hong Kong,Japan,2,1,1,1.0,0.0,1459,1569
1970-07-31,South Korea,Thailand,0,0,0,0.5,0.5,1643,1474
1970-08-01,Myanmar,Western Australia,1,0,1,1.0,0.0,1645,1485
1970-08-01,Taiwan,Vietnam Republic,2,1,1,1.0,0.0,1527,1563
1970-08-01,Malaysia,India,1,3,2,0.0,1.0,1557,1543
1970-08-01,Cameroon,Gabon,0,3,3,0.0,1.0,1541,1481
1970-08-01,Indonesia,Singapore,3,1,2,1.0,0.0,1656,1448
1970-08-02,Hong Kong,Thailand,2,0,2,1.0,0.0,1468,1466
1970-08-02,Japan,South Korea,1,1,0,0.5,0.5,1571,1642
1970-08-03,Myanmar,India,2,0,2,1.0,0.0,1651,1538
1970-08-03,Vietnam Republic,Western Australia,1,3,2,0.0,1.0,1554,1495
1970-08-04,Malaysia,Taiwan,3,1,2,1.0,0.0,1565,1520
1970-08-04,Hong Kong,Indonesia,1,3,2,0.0,1.0,1464,1661
1970-08-04,Japan,Thailand,0,0,0,0.5,0.5,1569,1469
1970-08-04,South Korea,Singapore,4,0,4,1.0,0.0,1646,1445
1970-08-05,Myanmar,Vietnam Republic,4,2,2,1.0,0.0,1657,1549
1970-08-05,India,Western Australia,2,0,2,1.0,0.0,1546,1488
1970-08-06,Hong Kong,Singapore,3,2,1,1.0,0.0,1472,1438
1970-08-06,Indonesia,South Korea,1,2,1,0.0,1.0,1653,1655
1970-08-07,Myanmar,Taiwan,1,1,0,0.5,0.5,1654,1524
1970-08-07,Malaysia,Western Australia,4,1,3,1.0,0.0,1572,1482
1970-08-08,Indonesia,Japan,3,4,1,0.0,1.0,1644,1579
1970-08-08,Malawi,Lesotho,1,2,1,0.0,1.0,1438,1507
1970-08-08,Singapore,Thailand,4,5,1,0.0,1.0,1431,1477
1970-08-09,Hong Kong,South Korea,0,0,0,0.5,0.5,1476,1652
1970-08-09,India,Vietnam Republic,2,1,1,1.0,0.0,1555,1541
1970-08-09,Taiwan,Western Australia,1,3,2,0.0,1.0,1516,1491
1970-08-09,Malaysia,Myanmar,1,2,1,0.0,1.0,1566,1661
1970-08-10,Indonesia,Thailand,6,3,3,1.0,0.0,1649,1473
1970-08-10,Japan,Singapore,4,0,4,1.0,0.0,1584,1427
1970-08-10,Malawi,Lesotho,6,1,5,1.0,0.0,1448,1498
1970-08-12,Myanmar,Hong Kong,5,0,5,1.0,0.0,1666,1472
1970-08-12,Thailand,Western Australia,2,0,2,1.0,0.0,1482,1483
1970-08-13,India,South Korea,2,3,1,0.0,1.0,1550,1658
1970-08-13,Singapore,Vietnam Republic,0,4,4,0.0,1.0,1422,1547
1970-08-15,Hong Kong,India,2,3,1,0.0,1.0,1466,1557
1970-08-15,Malaysia,Indonesia,4,0,4,1.0,0.0,1576,1640
1970-08-16,Myanmar,South Korea,0,1,1,0.0,1.0,1658,1667
1970-08-16,Japan,Taiwan,3,2,1,1.0,0.0,1591,1510
1970-08-19,Singapore,India,3,8,5,0.0,1.0,1417,1563
1970-08-26,Finland,Sweden,1,2,1,0.0,1.0,1428,1760
1970-09-01,Libya,Tunisia,2,2,0,0.5,0.5,1502,1546
1970-09-02,Poland,Denmark,5,0,5,1.0,0.0,1674,1593
1970-09-04,Libya,Tunisia,3,2,1,1.0,0.0,1512,1537
1970-09-05,France,Czechoslovakia,3,0,3,1.0,0.0,1656,1733
1970-09-06,German DR,Poland,5,0,5,1.0,0.0,1713,1667
1970-09-06,Iran,Pakistan,7,0,7,1.0,0.0,1584,1474
1970-09-09,Germany,Hungary,3,1,2,1.0,0.0,1850,1808
1970-09-09,Pakistan,Turkey,1,3,2,0.0,1.0,1469,1595
1970-09-10,Austria,Yugoslavia,0,1,1,0.0,1.0,1657,1737
1970-09-11,Iran,Turkey,1,1,0,0.5,0.5,1585,1595
1970-09-20,North Vietnam,Cuba,2,1,1,1.0,0.0,1490,1416
1970-09-23,Denmark,Norway,0,1,1,0.0,1.0,1585,1564
1970-09-23,Republic of Ireland,Poland,0,2,2,0.0,1.0,1575,1674
1970-09-24,Tunisia,Libya,2,0,2,1.0,0.0,1545,1505
1970-09-26,Zanzibar,Uganda,0,1,1,0.0,1.0,1341,1545
1970-09-27,Hungary,Austria,1,1,0,0.5,0.5,1805,1661
1970-09-27,Tanzania,Kenya,2,0,2,1.0,0.0,1483,1542
1970-09-29,Kenya,Uganda,1,2,1,0.0,1.0,1535,1553
1970-09-30,Brazil,Mexico,2,1,1,1.0,0.0,1941,1723
1970-09-30,Zanzibar,Tanzania,1,2,1,0.0,1.0,1337,1488
1970-10-02,Tanzania,Uganda,1,4,3,0.0,1.0,1482,1560
1970-10-03,Zanzibar,Kenya,3,2,1,1.0,0.0,1350,1523
1970-10-04,Chile,Brazil,1,5,4,0.0,1.0,1674,1944
1970-10-04,Suriname,Trinidad and Tobago,3,2,1,1.0,0.0,1632,1578
1970-10-07,Austria,France,1,0,1,1.0,0.0,1669,1649
1970-10-07,Curaçao,Trinidad and Tobago,1,1,0,0.5,0.5,1569,1578
1970-10-07,Czechoslovakia,Finland,1,1,0,0.5,0.5,1728,1434
1970-10-07,Norway,Hungary,1,3,2,0.0,1.0,1561,1809
1970-10-08,Guyana,Trinidad and Tobago,1,1,0,0.5,0.5,1430,1575
1970-10-09,Suriname,Curaçao,5,1,4,1.0,0.0,1639,1563
1970-10-10,Guyana,Trinidad and Tobago,1,1,0,0.5,0.5,1434,1572
1970-10-11,Malta,Greece,1,1,0,0.5,0.5,1511,1538
1970-10-11,Netherlands,Yugoslavia,1,1,0,0.5,0.5,1637,1735
1970-10-11,Romania,Finland,3,0,3,1.0,0.0,1677,1431
1970-10-11,Sierra Leone,Senegal,1,0,1,1.0,0.0,1485,1509
1970-10-14,Denmark,Portugal,0,1,1,0.0,1.0,1579,1677
1970-10-14,Republic of Ireland,Sweden,1,1,0,0.5,0.5,1579,1757
1970-10-14,Luxembourg,Yugoslavia,0,2,2,0.0,1.0,1399,1738
1970-10-14,Poland,Albania,3,0,3,1.0,0.0,1679,1481
1970-10-17,Germany,Turkey,1,1,0,0.5,0.5,1845,1601
1970-10-17,Switzerland,Italy,1,1,0,0.5,0.5,1578,1843
1970-10-17,Tanzania,Zambia,1,1,0,0.5,0.5,1485,1601
1970-10-18,Ivory Coast,Senegal,0,1,1,0.0,1.0,1595,1520
1970-10-22,Paraguay,Argentina,1,1,0,0.5,0.5,1664,1748
1970-10-23,New Caledonia,Australia,1,3,2,0.0,1.0,1590,1608
1970-10-25,Czechoslovakia,Poland,2,2,0,0.5,0.5,1727,1681
1970-10-25,New Caledonia,Australia,0,1,1,0.0,1.0,1583,1616
1970-10-25,Togo,Senegal,3,0,3,1.0,0.0,1484,1511
1970-10-28,Russia,Yugoslavia,4,0,4,1.0,0.0,1822,1732
1970-10-28,Spain,Greece,2,1,1,1.0,0.0,1747,1535
1970-10-28,Sweden,Republic of Ireland,1,0,1,1.0,0.0,1762,1575
1970-10-29,Indonesia,Thailand,1,2,1,0.0,1.0,1629,1494
1970-10-29,Vietnam Republic,Malaysia,1,1,0,0.5,0.5,1548,1576
1970-10-30,Macau,Australia,0,9,9,0.0,1.0,1487,1622
1970-10-31,Austria,Italy,1,2,1,0.0,1.0,1665,1848
1970-10-31,Malaysia,Thailand,1,4,3,0.0,1.0,1567,1504
1970-10-31,Vietnam Republic,Indonesia,3,1,2,1.0,0.0,1558,1620
1970-11-01,Benin,Congo,3,2,1,1.0,0.0,1524,1556
1970-11-01,Indonesia,Malaysia,1,3,2,0.0,1.0,1611,1577
1970-11-01,Sierra Leone,Guinea,1,2,1,0.0,1.0,1479,1575
1970-11-01,Vietnam Republic,Thailand,1,0,1,1.0,0.0,1565,1498
1970-11-01,Zambia,Tanzania,5,1,4,1.0,0.0,1607,1480
1970-11-04,Iran,Australia,1,2,1,0.0,1.0,1578,1630
1970-11-08,Gabon,Ivory Coast,1,2,1,0.0,1.0,1476,1601
1970-11-08,Hong Kong,Singapore,0,1,1,0.0,1.0,1457,1427
1970-11-08,Nigeria,Congo,0,0,0,0.5,0.5,1582,1557
1970-11-08,Thailand,Laos,1,0,1,1.0,0.0,1505,1428
1970-11-08,Togo,Benin,2,1,1,1.0,0.0,1493,1516
1970-11-08,Uganda,DR Congo,1,4,3,0.0,1.0,1554,1631
1970-11-09,Cambodia,Malaysia,1,1,0,0.5,0.5,1444,1574
1970-11-10,Hong Kong,South Korea,0,3,3,0.0,1.0,1454,1671
1970-11-10,Thailand,Singapore,3,1,2,1.0,0.0,1512,1421
1970-11-11,France,Norway,3,1,2,1.0,0.0,1656,1555
1970-11-11,German DR,Netherlands,1,0,1,1.0,0.0,1720,1631
1970-11-11,Indonesia,Vietnam Republic,5,3,2,1.0,0.0,1618,1559
1970-11-11,Scotland,Denmark,1,0,1,1.0,0.0,1724,1575
1970-11-11,Spain,Northern Ireland,3,0,3,1.0,0.0,1752,1585
1970-11-11,Suriname,French Guiana,3,2,1,1.0,0.0,1644,1453
1970-11-11,Wales,Romania,0,0,0,0.5,0.5,1599,1676
1970-11-12,South Korea,Laos,4,0,4,1.0,0.0,1675,1425
1970-11-12,Thailand,Hong Kong,2,1,1,1.0,0.0,1519,1448
1970-11-13,Cambodia,Vietnam Republic,2,2,0,0.5,0.5,1447,1557
1970-11-13,Indonesia,Malaysia,3,0,3,1.0,0.0,1625,1568
1970-11-14,Laos,Singapore,3,0,3,1.0,0.0,1433,1414
1970-11-14,Thailand,South Korea,0,0,0,0.5,0.5,1523,1672
1970-11-15,Belgium,France,1,2,1,0.0,1.0,1664,1665
1970-11-15,Bulgaria,Norway,1,1,0,0.5,0.5,1677,1558
1970-11-15,Cyprus,Russia,1,3,2,0.0,1.0,1460,1824
1970-11-15,Guinea,Senegal,1,0,1,1.0,0.0,1582,1505
1970-11-15,Indonesia,Cambodia,4,1,3,1.0,0.0,1630,1443
1970-11-15,Luxembourg,German DR,0,5,5,0.0,1.0,1397,1723
1970-11-15,Madagascar,Mauritius,2,1,1,1.0,0.0,1515,1566
1970-11-15,Malaysia,Vietnam Republic,2,1,1,1.0,0.0,1576,1550
1970-11-15,Switzerland,Hungary,0,1,1,0.0,1.0,1575,1813
1970-11-16,Hong Kong,Laos,4,2,2,1.0,0.0,1456,1426
1970-11-16,South Korea,Singapore,4,0,4,1.0,0.0,1675,1412
1970-11-18,South Korea,Malaysia,2,0,2,1.0,0.0,1681,1571
1970-11-18,Thailand,Indonesia,2,1,1,1.0,0.0,1534,1620
1970-11-18,Yugoslavia,Germany,2,0,2,1.0,0.0,1743,1835
1970-11-20,Indonesia,Malaysia,1,3,2,0.0,1.0,1611,1581
1970-11-20,Thailand,South Korea,0,1,1,0.0,1.0,1530,1686
1970-11-21,Dominica,Saint Lucia,1,1,0,0.5,0.5,1442,1504
1970-11-22,Kenya,Ethiopia,2,0,2,1.0,0.0,1532,1555
1970-11-22,Benin,Togo,0,0,0,0.5,0.5,1516,1494
1970-11-22,Congo,Nigeria,2,1,1,1.0,0.0,1566,1574
1970-11-22,Greece,Germany,1,3,2,0.0,1.0,1533,1838
1970-11-22,Grenada,Saint Vincent and the Grenadines,5,3,2,1.0,0.0,1566,1538
1970-11-22,Ivory Coast,Gabon,1,0,1,1.0,0.0,1607,1471
1970-11-24,DR Congo,Uganda,1,0,1,1.0,0.0,1638,1548
1970-11-24,Dominica,Saint Vincent and the Grenadines,0,1,1,0.0,1.0,1437,1544
1970-11-25,Belgium,Denmark,2,0,2,1.0,0.0,1670,1570
1970-11-25,England,German DR,3,1,2,1.0,0.0,1876,1719
1970-11-25,Grenada,Saint Lucia,6,1,5,1.0,0.0,1573,1498
1970-11-27,Grenada,Dominica,2,1,1,1.0,0.0,1579,1432
1970-11-29,Mauritius,Madagascar,4,1,3,1.0,0.0,1573,1509
1970-12-02,Netherlands,Romania,2,0,2,1.0,0.0,1641,1667
1970-12-08,Italy,Republic of Ireland,3,0,3,1.0,0.0,1851,1573
1970-12-09,Greece,Cyprus,1,1,0,0.5,0.5,1532,1462
1970-12-10,Algeria,Morocco,3,1,2,1.0,0.0,1552,1550
1970-12-10,Thailand,India,2,2,0,0.5,0.5,1531,1563
1970-12-10,Japan,Malaysia,1,0,1,1.0,0.0,1599,1574
1970-12-10,Myanmar,Cambodia,2,1,1,1.0,0.0,1662,1440
1970-12-10,Indonesia,Iran,2,2,0,0.5,0.5,1611,1579
1970-12-11,India,Vietnam Republic,2,0,2,1.0,0.0,1571,1543
1970-12-11,Iran,South Korea,0,1,1,0.0,1.0,1574,1692
1970-12-12,Niger,Mali,0,1,1,0.0,1.0,1452,1523
1970-12-12,Japan,Cambodia,1,0,1,1.0,0.0,1604,1436
1970-12-12,Myanmar,Malaysia,1,0,1,1.0,0.0,1669,1568
1970-12-13,Turkey,Albania,2,1,1,1.0,0.0,1607,1476
1970-12-13,Thailand,Vietnam Republic,1,0,1,1.0,0.0,1540,1535
1970-12-13,Indonesia,South Korea,0,0,0,0.5,0.5,1613,1691
1970-12-14,Japan,Myanmar,2,1,1,1.0,0.0,1614,1660
1970-12-14,Malaysia,Cambodia,0,2,2,0.0,1.0,1558,1447
1970-12-15,Ethiopia,Kenya,0,1,1,0.0,1.0,1547,1541
1970-12-15,India,Indonesia,3,0,3,1.0,0.0,1580,1605
1970-12-15,Thailand,South Korea,1,2,1,0.0,1.0,1536,1696
1970-12-16,Greece,Switzerland,0,1,1,0.0,1.0,1525,1583
1970-12-16,Indonesia,Japan,1,2,1,0.0,1.0,1598,1622
1970-12-16,Thailand,Myanmar,2,2,0,0.5,0.5,1539,1658
1970-12-17,Japan,India,1,0,1,1.0,0.0,1630,1573
1970-12-17,Myanmar,South Korea,1,0,1,1.0,0.0,1667,1688
1970-12-18,Japan,South Korea,1,2,1,0.0,1.0,1624,1695
1970-12-18,Myanmar,India,2,0,2,1.0,0.0,1673,1568
1970-12-19,Senegal,Malawi,4,1,3,1.0,0.0,1512,1442
1970-12-19,Thailand,Indonesia,0,1,1,0.0,1.0,1533,1605
1970-12-19,Japan,India,0,1,1,0.0,1.0,1615,1578
1970-12-20,Malta,Switzerland,1,2,1,0.0,1.0,1505,1590
1970-12-20,South Korea,Myanmar,0,0,0,0.5,0.5,1695,1674
1970-12-27,Libya,Egypt,0,1,1,0.0,1.0,1500,1633
1970-12-27,Mali,Niger,3,1,2,1.0,0.0,1530,1446
1970-12-27,Morocco,Algeria,3,0,3,1.0,0.0,1559,1544
1971-01-03,Egypt,Libya,2,1,1,1.0,0.0,1639,1495
1971-01-08,Argentina,France,3,4,1,0.0,1.0,1739,1675
1971-01-10,Ghana,DR Congo,1,1,0,0.5,0.5,1715,1640
1971-01-13,Argentina,France,2,0,2,1.0,0.0,1746,1669
1971-01-28,Kuwait,Iraq,0,2,2,0.0,1.0,1483,1548
1971-01-31,Ghana,Sierra Leone,1,2,1,0.0,1.0,1703,1492
1971-02-02,Chile,German DR,0,1,1,0.0,1.0,1668,1726
1971-02-03,Belgium,Scotland,3,0,3,1.0,0.0,1680,1715
1971-02-03,Cyprus,Northern Ireland,0,3,3,0.0,1.0,1457,1591
1971-02-03,Malta,England,0,1,1,0.0,1.0,1504,1878
1971-02-07,Ghana,Sierra Leone,1,2,1,0.0,1.0,1691,1505
1971-02-08,Uruguay,German DR,0,3,3,0.0,1.0,1733,1735
1971-02-10,Uruguay,German DR,1,1,0,0.5,0.5,1734,1735
1971-02-13,Nigeria,Sierra Leone,1,0,1,1.0,0.0,1581,1499
1971-02-17,Albania,Germany,0,1,1,0.0,1.0,1475,1840
1971-02-17,Belgium,Portugal,3,0,3,1.0,0.0,1688,1670
1971-02-17,Mexico,Russia,0,0,0,0.5,0.5,1726,1822
1971-02-20,Italy,Spain,1,2,1,0.0,1.0,1841,1763
1971-02-20,Mexico,Russia,0,0,0,0.5,0.5,1729,1820
1971-02-21,Basque Country,Catalonia,1,2,1,0.0,1.0,1595,1501
1971-02-24,Netherlands,Luxembourg,6,0,6,1.0,0.0,1645,1394
1971-02-28,El Salvador,Russia,0,1,1,0.0,1.0,1596,1824
1971-03-01,Madagascar,Liberia,2,1,1,1.0,0.0,1516,1456
1971-03-04,Cameroon,Senegal,1,1,0,0.5,0.5,1541,1513
1971-03-07,Cameroon,Senegal,1,2,1,0.0,1.0,1533,1522
1971-03-07,Lesotho,Madagascar,1,2,1,0.0,1.0,1491,1524
1971-03-10,Senegal,Cameroon,3,0,3,1.0,0.0,1531,1525
1971-03-14,Cameroon,Congo,7,1,6,1.0,0.0,1534,1558
1971-03-17,Spain,France,2,2,0,0.5,0.5,1761,1672
1971-03-18,Malawi,Zambia,5,4,1,1.0,0.0,1454,1596
1971-03-20,Malawi,Zambia,1,3,2,0.0,1.0,1450,1601
1971-03-23,Malawi,Zambia,0,3,3,0.0,1.0,1446,1606
1971-03-24,Togo,Liberia,0,2,2,0.0,1.0,1486,1465
1971-03-25,Jersey,Alderney,11,0,11,1.0,0.0,1691,1320
1971-03-28,Madagascar,Mauritius,3,0,3,1.0,0.0,1534,1564
1971-04-04,Austria,Hungary,0,2,2,0.0,1.0,1661,1818
1971-04-04,Yugoslavia,Netherlands,2,0,2,1.0,0.0,1749,1640
1971-04-07,Greece,Bulgaria,0,1,1,0.0,1.0,1521,1682
1971-04-14,Haiti,Bahamas,8,0,8,1.0,0.0,1591,1494
1971-04-21,England,Greece,3,0,3,1.0,0.0,1880,1520
1971-04-21,Northern Ireland,Cyprus,5,0,5,1.0,0.0,1597,1452
1971-04-21,Portugal,Scotland,2,0,2,1.0,0.0,1680,1706
1971-04-21,Switzerland,Malta,5,0,5,1.0,0.0,1597,1498
1971-04-21,Wales,Czechoslovakia,1,3,2,0.0,1.0,1594,1733
1971-04-21,Yugoslavia,Romania,0,1,1,0.0,1.0,1740,1677
1971-04-24,German DR,Luxembourg,2,1,1,1.0,0.0,1737,1393
1971-04-24,Hungary,France,1,1,0,0.5,0.5,1815,1676
1971-04-24,Sierra Leone,Gambia,3,1,2,1.0,0.0,1507,1470
1971-04-25,Turkey,Germany,0,3,3,0.0,1.0,1604,1844
1971-04-26,Tanzania,DR Congo,0,1,1,0.0,1.0,1476,1645
1971-04-28,Bulgaria,Russia,1,1,0,0.5,0.5,1686,1821
1971-05-02,Guinea,Gambia,4,2,2,1.0,0.0,1588,1465
1971-05-02,Indonesia,Vietnam Republic,9,1,8,1.0,0.0,1612,1529
1971-05-02,Ivory Coast,Ghana,2,6,4,0.0,1.0,1601,1698
1971-05-02,South Korea,Thailand,1,0,1,1.0,0.0,1700,1529
1971-05-03,Myanmar,Taiwan,2,0,2,1.0,0.0,1679,1506
1971-05-03,Cambodia,Malaysia,1,3,2,0.0,1.0,1442,1564
1971-05-05,Cambodia,Thailand,3,4,1,0.0,1.0,1436,1536
1971-05-05,Switzerland,Poland,2,4,2,0.0,1.0,1591,1688
1971-05-06,Myanmar,Vietnam Republic,2,0,2,1.0,0.0,1684,1525
1971-05-06,South Korea,Malaysia,5,1,4,1.0,0.0,1706,1559
1971-05-08,Myanmar,Indonesia,3,1,2,1.0,0.0,1691,1606
1971-05-08,Malaysia,Thailand,4,1,3,1.0,0.0,1567,1529
1971-05-09,Cyprus,Spain,0,2,2,0.0,1.0,1450,1764
1971-05-09,German DR,Yugoslavia,1,2,1,0.0,1.0,1730,1748
1971-05-09,South Korea,Cambodia,2,0,2,1.0,0.0,1709,1434
1971-05-10,Republic of Ireland,Italy,1,2,1,0.0,1.0,1571,1844
1971-05-11,Myanmar,Malaysia,6,1,5,1.0,0.0,1697,1562
1971-05-11,South Korea,Indonesia,3,0,3,1.0,0.0,1715,1601
1971-05-12,Albania,Poland,1,1,0,0.5,0.5,1480,1684
1971-05-12,England,Malta,5,0,5,1.0,0.0,1882,1497
1971-05-12,Portugal,Denmark,5,0,5,1.0,0.0,1686,1565
1971-05-12,Switzerland,Greece,1,0,1,1.0,0.0,1598,1514
1971-05-13,Indonesia,Malaysia,4,2,2,1.0,0.0,1609,1555
1971-05-13,South Korea,Myanmar,0,0,0,0.5,0.5,1715,1698
1971-05-15,South Korea,Myanmar,0,0,0,0.5,0.5,1715,1699
1971-05-15,Malaysia,Thailand,0,3,3,0.0,1.0,1547,1538
1971-05-15,Northern Ireland,England,0,1,1,0.0,1.0,1595,1885
1971-05-15,Wales,Scotland,0,0,0,0.5,0.5,1597,1704
1971-05-15,Guernsey,Jersey,0,1,1,0.0,1.0,1603,1698
1971-05-16,Czechoslovakia,Romania,1,0,1,1.0,0.0,1740,1671
1971-05-18,Scotland,Northern Ireland,0,1,1,0.0,1.0,1694,1606
1971-05-19,Bulgaria,Hungary,3,0,3,1.0,0.0,1697,1805
1971-05-19,England,Wales,0,0,0,0.5,0.5,1880,1603
1971-05-20,Luxembourg,Belgium,0,4,4,0.0,1.0,1391,1691
1971-05-20,Sweden,Finland,4,1,3,1.0,0.0,1765,1429
1971-05-21,China PR,Cuba,1,0,1,1.0,0.0,1663,1413
1971-05-21,Thailand,Cambodia,1,1,0,0.5,0.5,1536,1437
1971-05-22,England,Scotland,3,1,2,1.0,0.0,1885,1690
1971-05-22,Indonesia,Hong Kong,2,1,1,1.0,0.0,1614,1452
1971-05-22,Malaysia,Brunei,8,0,8,1.0,0.0,1554,1494
1971-05-22,Northern Ireland,Wales,1,0,1,1.0,0.0,1614,1596
1971-05-24,Cambodia,Hong Kong,2,1,1,1.0,0.0,1446,1444
1971-05-24,Thailand,Brunei,10,0,10,1.0,0.0,1544,1487
1971-05-25,Uganda,Malawi,3,3,0,0.5,0.5,1546,1449
1971-05-26,Denmark,Belgium,1,2,1,0.0,1.0,1560,1697
1971-05-26,Finland,Wales,0,1,1,0.0,1.0,1425,1601
1971-05-26,Malaysia,Cambodia,2,1,1,1.0,0.0,1560,1441
1971-05-26,Norway,Iceland,3,1,2,1.0,0.0,1564,1431
1971-05-26,Sweden,Austria,1,0,1,1.0,0.0,1771,1656
1971-05-26,Thailand,Indonesia,0,1,1,0.0,1.0,1538,1621
1971-05-28,Indonesia,Brunei,9,0,9,1.0,0.0,1627,1482
1971-05-28,Malaysia,Hong Kong,2,1,1,1.0,0.0,1566,1439
1971-05-30,Cambodia,Indonesia,2,0,2,1.0,0.0,1453,1616
1971-05-30,Republic of Ireland,Austria,1,4,3,0.0,1.0,1565,1663
1971-05-30,Russia,Spain,2,1,1,1.0,0.0,1828,1758
1971-05-30,Thailand,Malaysia,1,0,1,1.0,0.0,1547,1558
1971-06-01,Malaysia,Indonesia,3,0,3,1.0,0.0,1568,1607
1971-06-01,Thailand,Cambodia,4,2,2,1.0,0.0,1553,1448
1971-06-01,Zambia,Ethiopia,5,1,4,1.0,0.0,1613,1541
1971-06-05,Indonesia,Singapore,3,0,3,1.0,0.0,1611,1409
1971-06-05,South Korea,Thailand,0,1,1,0.0,1.0,1704,1565
1971-06-06,Cambodia,Western Australia,2,2,0,0.5,0.5,1449,1483
1971-06-06,India,Thailand,0,1,1,0.0,1.0,1570,1574
1971-06-07,Indonesia,Myanmar,1,1,0,0.5,0.5,1613,1698
1971-06-07,Russia,Cyprus,6,1,5,1.0,0.0,1830,1449
1971-06-08,Cambodia,Malaysia,1,1,0,0.5,0.5,1452,1566
1971-06-08,India,South Korea,2,3,1,0.0,1.0,1565,1710
1971-06-09,Myanmar,Singapore,6,0,6,1.0,0.0,1701,1407
1971-06-09,Denmark,Scotland,1,0,1,1.0,0.0,1571,1680
1971-06-09,Malaysia,Western Australia,3,2,1,1.0,0.0,1573,1477
1971-06-09,Norway,Bulgaria,1,4,3,0.0,1.0,1559,1703
1971-06-09,Sweden,Italy,0,0,0,0.5,0.5,1773,1843
1971-06-11,Myanmar,Malaysia,5,1,4,1.0,0.0,1707,1568
1971-06-11,Indonesia,Thailand,0,0,0,0.5,0.5,1613,1575
1971-06-12,Myanmar,South Korea,1,0,1,1.0,0.0,1716,1702
1971-06-12,Cambodia,Thailand,3,0,3,1.0,0.0,1463,1565
1971-06-12,Germany,Albania,2,0,2,1.0,0.0,1846,1479
1971-06-13,Indonesia,Cambodia,1,0,1,1.0,0.0,1618,1459
1971-06-13,South Korea,Malaysia,1,2,1,0.0,1.0,1692,1579
1971-06-14,Myanmar,Cambodia,8,0,8,1.0,0.0,1719,1457
1971-06-14,Indonesia,Malaysia,2,1,1,1.0,0.0,1626,1572
1971-06-14,Russia,Scotland,1,0,1,1.0,0.0,1835,1676
1971-06-15,Cambodia,Malaysia,1,2,1,0.0,1.0,1452,1578
1971-06-16,Finland,Czechoslovakia,0,4,4,0.0,1.0,1423,1743
1971-06-16,Indonesia,Myanmar,0,1,1,0.0,1.0,1621,1725
1971-06-18,Greece,Malta,2,0,2,1.0,0.0,1522,1490
1971-06-20,Denmark,Sweden,1,3,2,0.0,1.0,1568,1777
1971-06-22,Norway,Germany,1,7,6,0.0,1.0,1557,1849
1971-06-24,Kenya,Sudan,3,3,0,0.5,0.5,1543,1594
1971-06-26,Hong Kong,Thailand,6,0,6,1.0,0.0,1450,1555
1971-06-27,Madagascar,Mauritius,1,1,0,0.5,0.5,1535,1564
1971-06-27,Sweden,Germany,1,0,1,1.0,0.0,1787,1840
1971-06-30,Denmark,Germany,1,3,2,0.0,1.0,1566,1843
1971-07-04,Kenya,Mauritius,2,1,1,1.0,0.0,1552,1556
1971-07-04,Paraguay,Argentina,1,1,0,0.5,0.5,1666,1745
1971-07-05,Zambia,Cyprus,3,0,3,1.0,0.0,1618,1445
1971-07-06,Malawi,Uganda,3,1,2,1.0,0.0,1460,1536
1971-07-06,Mexico,Greece,1,1,0,0.5,0.5,1725,1527
1971-07-08,Zambia,Cyprus,3,0,3,1.0,0.0,1623,1441
1971-07-09,Argentina,Paraguay,1,0,1,1.0,0.0,1752,1660
1971-07-09,Libya,Syria,2,1,1,1.0,0.0,1504,1503
1971-07-10,Malawi,Uganda,0,1,1,0.0,1.0,1454,1543
1971-07-11,Brazil,Austria,1,1,0,0.5,0.5,1939,1669
1971-07-11,Egypt,Syria,1,0,1,1.0,0.0,1645,1498
1971-07-11,Sudan,Palestine,1,1,0,0.5,0.5,1592,1490
1971-07-11,Zambia,Cyprus,3,0,3,1.0,0.0,1628,1437
1971-07-13,Libya,Egypt,0,2,2,0.0,1.0,1500,1650
1971-07-14,Argentina,Uruguay,1,0,1,1.0,0.0,1760,1727
1971-07-14,Brazil,Czechoslovakia,1,0,1,1.0,0.0,1943,1740
1971-07-14,Chile,Paraguay,3,2,1,1.0,0.0,1676,1653
1971-07-14,Martinique,Guadeloupe,2,1,1,1.0,0.0,1571,1524
1971-07-14,Tanzania,Guinea,3,2,1,1.0,0.0,1487,1578
1971-07-16,Libya,Sudan,4,6,2,0.0,1.0,1495,1598
1971-07-18,Brazil,Yugoslavia,2,2,0,0.5,0.5,1939,1753
1971-07-18,Libya,Egypt,2,0,2,1.0,0.0,1507,1639
1971-07-18,Mauritius,Kenya,0,0,0,0.5,0.5,1556,1553
1971-07-18,New Caledonia,New Zealand,4,2,2,1.0,0.0,1590,1514
1971-07-18,Uruguay,Argentina,1,1,0,0.5,0.5,1728,1760
1971-07-18,Zambia,Guinea,4,2,2,1.0,0.0,1635,1572
1971-07-20,New Caledonia,New Zealand,2,1,1,1.0,0.0,1597,1508
1971-07-21,Chile,Argentina,2,2,0,0.5,0.5,1678,1759
1971-07-21,Guadeloupe,Martinique,1,1,0,0.5,0.5,1526,1570
1971-07-21,Zambia,Guinea,1,5,4,0.0,1.0,1626,1582
1971-07-24,Brazil,Paraguay,1,0,1,1.0,0.0,1942,1651
1971-07-25,Senegal,Sierra Leone,2,1,1,1.0,0.0,1539,1500
1971-07-25,Zambia,Guinea,2,1,1,1.0,0.0,1633,1576
1971-07-27,Peru,Paraguay,0,0,0,0.5,0.5,1654,1652
1971-07-28,Argentina,Brazil,1,1,0,0.5,0.5,1763,1939
1971-07-28,Denmark,Japan,3,2,1,1.0,0.0,1576,1606
1971-07-31,Argentina,Brazil,2,2,0,0.5,0.5,1767,1936
1971-08-04,Argentina,Chile,1,0,1,1.0,0.0,1773,1673
1971-08-04,Malaysia,Vietnam Republic,2,0,2,1.0,0.0,1585,1519
1971-08-05,Hong Kong,Singapore,1,2,1,0.0,1.0,1442,1416
1971-08-05,India,Philippines,5,1,4,1.0,0.0,1569,1359
1971-08-07,Myanmar,Singapore,0,1,1,0.0,1.0,1712,1430
1971-08-07,India,Indonesia,1,3,2,0.0,1.0,1563,1628
1971-08-07,Malaysia,Taiwan,0,0,0,0.5,0.5,1584,1508
1971-08-07,Malaysia,Thailand,0,2,2,0.0,1.0,1576,1564
1971-08-08,Paraguay,Chile,2,0,2,1.0,0.0,1661,1665
1971-08-08,Sweden,Norway,3,0,3,1.0,0.0,1791,1554
1971-08-09,Myanmar,Indonesia,2,2,0,0.5,0.5,1711,1630
1971-08-09,Taiwan,Thailand,4,0,4,1.0,0.0,1518,1555
1971-08-09,Hong Kong,Philippines,2,1,1,1.0,0.0,1449,1353
1971-08-10,India,Singapore,2,2,0,0.5,0.5,1561,1433
1971-08-10,Thailand,Vietnam Republic,2,4,2,0.0,1.0,1547,1528
1971-08-11,Myanmar,Hong Kong,4,0,4,1.0,0.0,1714,1447
1971-08-11,Indonesia,Philippines,3,1,2,1.0,0.0,1633,1351
1971-08-11,Peru,Chile,1,0,1,1.0,0.0,1663,1657
1971-08-12,Taiwan,Vietnam Republic,3,2,1,1.0,0.0,1527,1520
1971-08-13,Myanmar,Philippines,2,0,2,1.0,0.0,1716,1350
1971-08-13,Hong Kong,India,2,1,1,1.0,0.0,1458,1551
1971-08-13,Iceland,Japan,0,2,2,0.0,1.0,1427,1611
1971-08-13,Indonesia,Singapore,4,0,4,1.0,0.0,1637,1430
1971-08-15,Bolivia,Chile,3,4,1,0.0,1.0,1540,1663
1971-08-15,Myanmar,India,9,1,8,1.0,0.0,1721,1547
1971-08-15,Hong Kong,Indonesia,0,3,3,0.0,1.0,1454,1642
1971-08-15,Paraguay,Peru,2,0,2,1.0,0.0,1670,1655
1971-08-15,Philippines,Singapore,4,4,0,0.5,0.5,1352,1429
1971-08-17,Philippines,Thailand,3,1,2,1.0,0.0,1365,1535
1971-08-18,Chile,Peru,1,0,1,1.0,0.0,1671,1648
1971-08-18,Guinea,Senegal,1,0,1,1.0,0.0,1584,1532
1971-08-18,Indonesia,Taiwan,1,0,1,1.0,0.0,1648,1522
1971-08-18,Mexico,German DR,0,1,1,0.0,1.0,1718,1738
1971-08-21,Myanmar,Indonesia,1,0,1,1.0,0.0,1728,1642
1971-08-21,Hong Kong,Vietnam Republic,1,3,2,0.0,1.0,1448,1527
1971-08-22,Saint Lucia,Saint Vincent and the Grenadines,1,5,4,0.0,1.0,1492,1551
1971-08-23,India,Indonesia,2,1,1,1.0,0.0,1558,1632
1971-08-23,Singapore,Malaysia,2,4,2,0.0,1.0,1425,1581
1971-08-24,Philippines,Thailand,0,1,1,0.0,1.0,1361,1540
1971-08-25,Finland,Norway,1,1,0,0.5,0.5,1426,1552
1971-08-26,India,Malaysia,6,0,6,1.0,0.0,1567,1573
1971-08-26,Thailand,Vietnam Republic,1,2,1,0.0,1.0,1532,1536
1971-08-27,Singapore,Indonesia,3,2,1,1.0,0.0,1438,1620
1971-08-28,India,Vietnam Republic,0,0,0,0.5,0.5,1567,1537
1971-08-30,Tahiti,Fiji,5,2,3,1.0,0.0,1534,1459
1971-09-01,Hungary,Yugoslavia,2,1,1,1.0,0.0,1812,1747
1971-09-01,Senegal,Guinea,0,0,0,0.5,0.5,1534,1583
1971-09-04,Austria,Sweden,1,0,1,1.0,0.0,1680,1781
1971-09-05,Honduras,Guatemala,1,0,1,1.0,0.0,1559,1602
1971-09-08,Denmark,Finland,0,0,0,0.5,0.5,1573,1430
1971-09-08,Germany,Mexico,5,0,5,1.0,0.0,1849,1713
1971-09-08,Norway,France,1,3,2,0.0,1.0,1547,1682
1971-09-09,Fiji,New Caledonia,1,5,4,0.0,1.0,1455,1602
1971-09-09,Tahiti,Papua New Guinea,2,2,0,0.5,0.5,1534,1493
1971-09-09,El Salvador,Nicaragua,3,2,1,1.0,0.0,1600,1366
1971-09-10,South Korea,Iran,2,0,2,1.0,0.0,1698,1569
1971-09-11,Cook Islands,Papua New Guinea,1,16,15,0.0,1.0,1492,1502
1971-09-11,Fiji,Vanuatu,4,6,2,0.0,1.0,1447,1461
1971-09-12,South Korea,Iran,0,2,2,0.0,1.0,1688,1580
1971-09-12,Guatemala,Honduras,1,1,0,0.5,0.5,1602,1560
1971-09-13,New Caledonia,Vanuatu,0,0,0,0.5,0.5,1599,1465
1971-09-13,Tahiti,Cook Islands,30,0,30,1.0,0.0,1542,1485
1971-09-15,Cook Islands,Fiji,1,15,14,0.0,1.0,1477,1456
1971-09-15,El Salvador,Nicaragua,1,0,1,1.0,0.0,1604,1363
1971-09-15,Suriname,Guyana,4,1,3,1.0,0.0,1648,1431
1971-09-16,New Caledonia,Papua New Guinea,4,0,4,1.0,0.0,1605,1497
1971-09-16,Tahiti,Vanuatu,1,2,1,0.0,1.0,1533,1475
1971-09-18,German DR,Mexico,1,1,0,0.5,0.5,1738,1714
1971-09-18,Russia,India,5,0,5,1.0,0.0,1838,1565
1971-09-18,Tahiti,Papua New Guinea,8,1,7,1.0,0.0,1541,1490
1971-09-18,New Caledonia,Vanuatu,7,1,6,1.0,0.0,1611,1470
1971-09-21,Guyana,Suriname,2,3,1,0.0,1.0,1428,1652
1971-09-22,Finland,Romania,0,4,4,0.0,1.0,1427,1675
1971-09-22,Poland,Turkey,5,1,4,1.0,0.0,1691,1598
1971-09-22,Russia,Northern Ireland,1,0,1,1.0,0.0,1842,1611
1971-09-22,Yugoslavia,Mexico,4,0,4,1.0,0.0,1755,1707
1971-09-25,German DR,Czechoslovakia,1,1,0,0.5,0.5,1739,1740
1971-09-25,Hungary,Bulgaria,2,0,2,1.0,0.0,1818,1698
1971-09-25,Italy,Mexico,2,0,2,1.0,0.0,1849,1702
1971-09-25,Kenya,Tanzania,1,1,0,0.5,0.5,1552,1489
1971-09-26,Norway,Denmark,1,4,3,0.0,1.0,1540,1581
1971-09-26,Switzerland,Turkey,4,0,4,1.0,0.0,1606,1590
1971-09-26,Uganda,Zanzibar,3,1,2,1.0,0.0,1547,1347
1971-09-29,Uganda,Tanzania,0,0,0,0.5,0.5,1546,1491
1971-09-30,Greece,Mexico,0,1,1,0.0,1.0,1523,1707
1971-09-30,Kenya,Zanzibar,4,0,4,1.0,0.0,1556,1344
1971-10-01,Jamaica,Cuba,0,1,1,0.0,1.0,1462,1423
1971-10-02,Tanzania,Zanzibar,1,1,0,0.5,0.5,1488,1348
1971-10-03,Kenya,Uganda,2,0,2,1.0,0.0,1564,1539
1971-10-04,Cuba,Jamaica,0,0,0,0.5,0.5,1424,1462
1971-10-06,Bermuda,Mexico,0,2,2,0.0,1.0,1461,1711
1971-10-06,Mexico,Bermuda,4,0,4,1.0,0.0,1715,1458
1971-10-08,Lesotho,Malawi,0,0,0,0.5,0.5,1491,1455
1971-10-09,France,Hungary,0,2,2,0.0,1.0,1677,1824
1971-10-09,Italy,Sweden,3,0,3,1.0,0.0,1856,1775
1971-10-10,Austria,Republic of Ireland,6,0,6,1.0,0.0,1686,1560
1971-10-10,Lesotho,Malawi,0,2,2,0.0,1.0,1483,1464
1971-10-10,Netherlands,German DR,3,2,1,1.0,0.0,1651,1729
1971-10-10,Poland,Germany,1,3,2,0.0,1.0,1687,1854
1971-10-13,Morocco,Egypt,3,0,3,1.0,0.0,1569,1630
1971-10-13,Zambia,DR Congo,2,1,1,1.0,0.0,1642,1637
1971-10-13,Togo,Ghana,0,0,0,0.5,0.5,1491,1694
1971-10-13,Ivory Coast,Congo,3,2,1,1.0,0.0,1609,1551
1971-10-13,Northern Ireland,Russia,1,1,0,0.5,0.5,1616,1838
1971-10-13,Scotland,Portugal,2,1,1,1.0,0.0,1685,1678
1971-10-13,Switzerland,England,2,3,1,0.0,1.0,1604,1888
1971-10-13,Wales,Finland,3,0,3,1.0,0.0,1606,1423
1971-10-13,Guinea,Mali,0,0,0,0.5,0.5,1582,1532
1971-10-16,Yugoslavia,German DR,0,0,0,0.5,0.5,1755,1730
1971-10-17,Zambia,Kenya,0,2,2,0.0,1.0,1633,1574
1971-10-20,Zambia,Kenya,3,1,2,1.0,0.0,1640,1568
1971-10-23,Zambia,Kenya,0,1,1,0.0,1.0,1631,1578
1971-10-27,Egypt,Morocco,3,2,1,1.0,0.0,1637,1563
1971-10-27,Ghana,Togo,0,1,1,0.0,1.0,1682,1504
1971-10-27,DR Congo,Zambia,3,0,3,1.0,0.0,1645,1624
1971-10-27,Congo,Ivory Coast,2,0,2,1.0,0.0,1561,1600
1971-10-27,Mali,Guinea,3,1,2,1.0,0.0,1542,1573
1971-10-27,Czechoslovakia,Wales,1,0,1,1.0,0.0,1746,1601
1971-10-27,Hungary,Norway,4,0,4,1.0,0.0,1827,1538
1971-10-27,Spain,Russia,0,0,0,0.5,0.5,1760,1837
1971-10-27,Uruguay,Chile,3,0,3,1.0,0.0,1735,1665
1971-10-27,Yugoslavia,Luxembourg,0,0,0,0.5,0.5,1749,1398
1971-10-28,Singapore,Thailand,0,1,1,0.0,1.0,1433,1538
1971-10-28,Vietnam Republic,Malaysia,0,1,1,0.0,1.0,1530,1581
1971-10-30,Malaysia,Singapore,1,1,0,0.5,0.5,1578,1437
1971-10-30,Vietnam Republic,Thailand,3,0,3,1.0,0.0,1539,1530
1971-10-31,Martinique,Haiti,2,2,0,0.5,0.5,1571,1591
1971-10-31,Singapore,Thailand,3,1,2,1.0,0.0,1448,1520
1971-10-31,Vietnam Republic,Malaysia,1,1,0,0.5,0.5,1540,1578
1971-11-03,Chile,Uruguay,5,0,5,1.0,0.0,1675,1726
1971-11-07,Belgium,Luxembourg,1,0,1,1.0,0.0,1700,1396
1971-11-07,Thailand,Singapore,2,0,2,1.0,0.0,1527,1442
1971-11-08,South Korea,Malaysia,2,2,0,0.5,0.5,1686,1581
1971-11-09,Singapore,Vietnam Republic,4,5,1,0.0,1.0,1437,1546
1971-11-10,England,Switzerland,1,1,0,0.5,0.5,1883,1610
1971-11-10,France,Bulgaria,2,1,1,1.0,0.0,1686,1690
1971-11-10,Indonesia,Malaysia,2,0,2,1.0,0.0,1628,1574
1971-11-10,Scotland,Belgium,1,0,1,1.0,0.0,1694,1692
1971-11-11,Australia,Israel,2,2,0,0.5,0.5,1629,1563
1971-11-11,Thailand,Vietnam Republic,0,1,1,0.0,1.0,1520,1554
1971-11-12,Indonesia,South Korea,0,0,0,0.5,0.5,1630,1685
1971-11-14,Albania,Turkey,3,0,3,1.0,0.0,1490,1580
1971-11-14,Australia,Israel,1,0,1,1.0,0.0,1636,1557
1971-11-14,Guinea,Tanzania,3,2,1,1.0,0.0,1580,1482
1971-11-14,South Korea,Vietnam Republic,1,1,0,0.5,0.5,1683,1557
1971-11-14,Malta,Hungary,0,2,2,0.0,1.0,1488,1830
1971-11-14,Romania,Czechoslovakia,2,1,1,1.0,0.0,1685,1737
1971-11-14,Thailand,Indonesia,1,0,1,1.0,0.0,1531,1620
1971-11-16,Thailand,South Korea,0,1,1,0.0,1.0,1527,1688
1971-11-17,Bulgaria,Greece,2,2,0,0.5,0.5,1687,1527
1971-11-17,Germany,Poland,0,0,0,0.5,0.5,1851,1691
1971-11-17,Netherlands,Luxembourg,8,0,8,1.0,0.0,1654,1394
1971-11-19,Iraq,Kuwait,3,1,2,1.0,0.0,1555,1477
1971-11-20,Italy,Austria,2,2,0,0.5,0.5,1853,1690
1971-11-20,Cuba,Costa Rica,0,3,3,0.0,1.0,1422,1730
1971-11-21,Australia,Israel,1,3,2,0.0,1.0,1627,1567
1971-11-21,Haiti,Mexico,0,0,0,0.5,0.5,1594,1713
1971-11-21,Trinidad and Tobago,Honduras,1,1,0,0.5,0.5,1572,1561
1971-11-21,Portugal,Belgium,1,1,0,0.5,0.5,1679,1692
1971-11-23,Cuba,Honduras,3,1,2,1.0,0.0,1434,1550
1971-11-24,Costa Rica,Haiti,0,0,0,0.5,0.5,1728,1597
1971-11-24,Libya,Algeria,0,0,0,0.5,0.5,1508,1544
1971-11-24,Romania,Wales,2,0,2,1.0,0.0,1692,1595
1971-11-24,Spain,Cyprus,7,0,7,1.0,0.0,1763,1435
1971-11-26,Trinidad and Tobago,Mexico,0,2,2,0.0,1.0,1568,1718
1971-11-27,Costa Rica,Honduras,2,1,1,1.0,0.0,1733,1546
1971-11-27,Grenada,Saint Lucia,5,2,3,1.0,0.0,1586,1486
1971-11-27,Nigeria,Burkina Faso,4,0,4,1.0,0.0,1588,1487
1971-11-28,Cuba,Mexico,0,1,1,0.0,1.0,1432,1721
1971-11-28,Dominica,Saint Vincent and the Grenadines,3,0,3,1.0,0.0,1443,1541
1971-11-28,Trinidad and Tobago,Haiti,1,6,5,0.0,1.0,1561,1605
1971-11-30,Trinidad and Tobago,Cuba,2,2,0,0.5,0.5,1559,1435
1971-11-30,Barbados,Curaçao,1,3,2,0.0,1.0,1447,1569
1971-11-30,Grenada,Saint Vincent and the Grenadines,1,1,0,0.5,0.5,1585,1543
1971-11-30,Togo,Burkina Faso,1,0,1,1.0,0.0,1512,1480
1971-12-01,Dominica,Saint Lucia,2,2,0,0.5,0.5,1444,1486
1971-12-01,Greece,England,0,2,2,0.0,1.0,1526,1885
1971-12-01,Guinea,Nigeria,3,0,3,1.0,0.0,1589,1580
1971-12-01,Haiti,Honduras,3,1,2,1.0,0.0,1612,1540
1971-12-01,Netherlands,Scotland,2,1,1,1.0,0.0,1663,1686
1971-12-02,Costa Rica,Mexico,0,1,1,0.0,1.0,1725,1730
1971-12-04,Bulgaria,France,2,1,1,1.0,0.0,1695,1679
1971-12-04,Cuba,Haiti,0,0,0,0.5,0.5,1439,1609
1971-12-04,Dominica,Grenada,3,0,3,1.0,0.0,1456,1574
1971-12-04,Honduras,Mexico,1,2,1,0.0,1.0,1536,1735
1971-12-04,Sierra Leone,Nigeria,0,1,1,0.0,1.0,1494,1587
1971-12-05,Trinidad and Tobago,Costa Rica,3,1,2,1.0,0.0,1571,1714
1971-12-05,Kenya,Zambia,1,0,1,1.0,0.0,1588,1615
1971-12-05,Tanzania,Burundi,4,1,3,1.0,0.0,1491,1480
1971-12-05,Turkey,Poland,1,0,1,1.0,0.0,1591,1681
1971-12-08,Kenya,Zambia,3,2,1,1.0,0.0,1597,1607
1971-12-08,Malta,Algeria,1,1,0,0.5,0.5,1490,1543
1971-12-09,Tanzania,China PR,1,1,0,0.5,0.5,1495,1660
1971-12-10,Kuwait,Iraq,1,1,0,0.5,0.5,1479,1554
1971-12-11,Bahrain,Lebanon,3,0,3,1.0,0.0,1487,1478
1971-12-11,Syria,Jordan,0,0,0,0.5,0.5,1497,1445
1971-12-12,Burkina Faso,Togo,1,2,1,0.0,1.0,1473,1520
1971-12-12,Kenya,Zambia,0,2,2,0.0,1.0,1590,1615
1971-12-12,Tanzania,China PR,3,4,1,0.0,1.0,1491,1665
1971-12-12,Cambodia,Thailand,1,1,0,0.5,0.5,1454,1526
1971-12-12,Malaysia,Laos,5,0,5,1.0,0.0,1579,1422
1971-12-12,Myanmar,Vietnam Republic,0,0,0,0.5,0.5,1725,1561
1971-12-13,Iraq,Sri Lanka,5,0,5,1.0,0.0,1560,1439
1971-12-13,Jordan,Bahrain,3,2,1,1.0,0.0,1454,1479
1971-12-14,Kuwait,Lebanon,1,0,1,1.0,0.0,1487,1471
1971-12-14,Laos,Cambodia,0,2,2,0.0,1.0,1415,1462
1971-12-14,Malaysia,Thailand,4,2,2,1.0,0.0,1586,1520
1971-12-14,Malaysia,Cambodia,3,0,3,1.0,0.0,1592,1457
1971-12-14,Vietnam Republic,Singapore,3,1,2,1.0,0.0,1567,1432
1971-12-15,Iraq,Bahrain,1,0,1,1.0,0.0,1567,1473
1971-12-15,Thailand,Laos,3,0,3,1.0,0.0,1526,1410
1971-12-15,Myanmar,Singapore,8,1,7,1.0,0.0,1728,1430
1971-12-16,Jordan,Sri Lanka,2,1,1,1.0,0.0,1462,1432
1971-12-17,Kuwait,Syria,2,2,0,0.5,0.5,1488,1497
1971-12-17,Malaysia,Vietnam Republic,3,2,1,1.0,0.0,1600,1560
1971-12-17,Myanmar,Thailand,3,1,2,1.0,0.0,1732,1523
1971-12-18,Iraq,Jordan,2,0,2,1.0,0.0,1573,1457
1971-12-18,Thailand,Vietnam Republic,0,0,0,0.5,0.5,1524,1560
1971-12-18,Malaysia,Myanmar,1,2,1,0.0,1.0,1595,1738
1971-12-19,Lebanon,Syria,3,2,1,1.0,0.0,1480,1489
1971-12-19,Niger,Libya,0,1,1,0.0,1.0,1440,1515
1971-12-19,Senegal,Mali,4,1,3,1.0,0.0,1543,1534
1971-12-20,Bahrain,Sri Lanka,3,0,3,1.0,0.0,1481,1425
1971-12-21,Kuwait,Jordan,2,0,2,1.0,0.0,1496,1450
1971-12-22,Iraq,Lebanon,4,1,3,1.0,0.0,1579,1475
1971-12-24,Kuwait,Iraq,0,1,1,0.0,1.0,1490,1586
1971-12-24,Lebanon,Jordan,2,0,2,1.0,0.0,1483,1443
1972-01-01,Algeria,Palestine,2,0,2,1.0,0.0,1550,1484
1972-01-01,Iraq,Egypt,0,0,0,0.5,0.5,1588,1636
1972-01-01,Kuwait,Libya,3,2,1,1.0,0.0,1499,1507
1972-01-01,Syria,Yemen DPR,1,0,1,1.0,0.0,1498,1492
1972-01-01,Zambia,China PR,3,3,0,0.5,0.5,1617,1664
1972-01-04,Algeria,Qatar,3,0,3,1.0,0.0,1557,1479
1972-01-04,Palestine,Syria,1,3,2,0.0,1.0,1477,1506
1972-01-05,Egypt,Kuwait,2,0,2,1.0,0.0,1641,1495
1972-01-05,Iraq,Libya,3,0,3,1.0,0.0,1595,1501
1972-01-06,Palestine,Yemen DPR,1,2,1,0.0,1.0,1470,1500
1972-01-06,Syria,Qatar,3,2,1,1.0,0.0,1514,1472
1972-01-07,Egypt,Libya,1,1,0,0.5,0.5,1638,1505
1972-01-07,Iraq,Kuwait,3,1,2,1.0,0.0,1601,1490
1972-01-08,Algeria,Syria,0,1,1,0.0,1.0,1549,1523
1972-01-08,Qatar,Yemen DPR,1,2,1,0.0,1.0,1465,1508
1972-01-09,Burkina Faso,Nigeria,3,3,0,0.5,0.5,1476,1585
1972-01-09,Senegal,Congo,0,2,2,0.0,1.0,1536,1569
1972-01-10,Algeria,Yemen DPR,4,1,3,1.0,0.0,1557,1501
1972-01-10,Palestine,Qatar,7,2,5,1.0,0.0,1478,1458
1972-01-12,Guinea,Congo,0,1,1,0.0,1.0,1581,1578
1972-01-12,Iraq,Algeria,3,1,2,1.0,0.0,1608,1551
1972-01-12,Spain,Hungary,1,0,1,1.0,0.0,1773,1821
1972-01-12,Egypt,Syria,4,2,2,1.0,0.0,1644,1518
1972-01-13,Algeria,Syria,3,1,2,1.0,0.0,1559,1511
1972-01-14,Iraq,Egypt,1,3,2,0.0,1.0,1601,1652
1972-01-18,Somalia,China PR,1,3,2,0.0,1.0,1478,1669
1972-01-20,Togo,Benin,4,0,4,1.0,0.0,1528,1509
1972-01-27,Mexico,Chile,2,0,2,1.0,0.0,1742,1669
1972-01-30,Nigeria,Guinea,1,1,0,0.5,0.5,1585,1582
1972-02-06,Congo,Benin,2,2,0,0.5,0.5,1577,1511
1972-02-07,Congo,Guinea,2,2,0,0.5,0.5,1578,1582
1972-02-09,Haiti,Chile,1,0,1,1.0,0.0,1619,1660
1972-02-13,Cameroon,Nigeria,1,2,1,0.0,1.0,1528,1592
1972-02-13,Guadeloupe,Haiti,4,4,0,0.5,0.5,1529,1617
1972-02-15,Martinique,Haiti,2,2,0,0.5,0.5,1573,1616
1972-02-16,Greece,Netherlands,0,5,5,0.0,1.0,1522,1668
1972-02-16,Northern Ireland,Spain,1,1,0,0.5,0.5,1620,1770
1972-02-17,Senegal,Morocco,1,3,2,0.0,1.0,1529,1571
1972-02-20,Nigeria,Morocco,3,0,3,1.0,0.0,1600,1564
1972-02-20,Tunisia,Austria,3,3,0,0.5,0.5,1549,1687
1972-02-23,Cameroon,Kenya,2,1,1,1.0,0.0,1538,1581
1972-02-23,Israel,Norway,2,1,1,1.0,0.0,1575,1531
1972-02-24,Mali,Togo,3,3,0,0.5,0.5,1534,1529
1972-02-25,Congo,Morocco,1,1,0,0.5,0.5,1578,1565
1972-02-25,Sudan,DR Congo,1,1,0,0.5,0.5,1600,1644
1972-02-26,Cameroon,Togo,2,0,2,1.0,0.0,1546,1522
1972-02-26,Kenya,Mali,1,1,0,0.5,0.5,1580,1536
1972-02-27,Congo,DR Congo,0,2,2,0.0,1.0,1572,1651
1972-02-27,Morocco,Sudan,1,1,0,0.5,0.5,1566,1600
1972-02-28,Cameroon,Mali,1,1,0,0.5,0.5,1546,1537
1972-02-28,Kenya,Togo,1,1,0,0.5,0.5,1579,1524
1972-02-29,Congo,Sudan,4,2,2,1.0,0.0,1581,1592
1972-02-29,Morocco,DR Congo,1,1,0,0.5,0.5,1568,1650
1972-03-02,Algeria,Guinea,1,0,1,1.0,0.0,1568,1574
1972-03-02,Cameroon,Congo,0,1,1,0.0,1.0,1539,1589
1972-03-02,Mali,DR Congo,4,3,1,1.0,0.0,1548,1640
1972-03-04,Cameroon,DR Congo,5,2,3,1.0,0.0,1550,1630
1972-03-04,Greece,Italy,2,1,1,1.0,0.0,1536,1840
1972-03-05,Congo,Mali,3,2,1,1.0,0.0,1597,1541
1972-03-12,Guinea,Algeria,5,1,4,1.0,0.0,1582,1561
1972-03-15,Algeria,Malta,1,0,1,1.0,0.0,1568,1484
1972-03-16,Saudi Arabia,Kuwait,2,2,0,0.5,0.5,1490,1490
1972-03-17,Qatar,United Arab Emirates,0,1,1,0.0,1.0,1451,1508
1972-03-18,Bahrain,Kuwait,0,2,2,0.0,1.0,1474,1498
1972-03-19,Saudi Arabia,United Arab Emirates,4,0,4,1.0,0.0,1499,1500
1972-03-21,Bahrain,Qatar,6,2,4,1.0,0.0,1482,1444
1972-03-22,Kuwait,United Arab Emirates,7,0,7,1.0,0.0,1507,1492
1972-03-24,Saudi Arabia,Qatar,4,0,4,1.0,0.0,1506,1438
1972-03-25,Bahrain,United Arab Emirates,2,0,2,1.0,0.0,1491,1484
1972-03-26,Kuwait,Qatar,5,0,5,1.0,0.0,1514,1432
1972-03-28,Saudi Arabia,Bahrain,2,1,1,1.0,0.0,1514,1484
1972-03-29,Bulgaria,Russia,1,1,0,0.5,0.5,1699,1834
1972-03-29,Colombia,Peru,1,1,0,0.5,0.5,1456,1644
1972-03-29,Hungary,Germany,0,2,2,0.0,1.0,1814,1859
1972-03-29,Portugal,Cyprus,4,0,4,1.0,0.0,1683,1432
1972-04-02,Jamaica,Cuba,2,0,2,1.0,0.0,1470,1432
1972-04-03,Guernsey,Alderney,5,0,5,1.0,0.0,1606,1318
1972-04-05,Mexico,Peru,2,1,1,1.0,0.0,1748,1639
1972-04-08,Czechoslovakia,Austria,2,0,2,1.0,0.0,1744,1681
1972-04-08,Poland,German DR,2,1,1,1.0,0.0,1691,1721
1972-04-08,Romania,France,2,0,2,1.0,0.0,1700,1672
1972-04-12,Greece,Spain,0,0,0,0.5,0.5,1541,1766
1972-04-15,Haiti,Puerto Rico,7,0,7,1.0,0.0,1620,1385
1972-04-19,Ghana,Ivory Coast,1,2,1,0.0,1.0,1673,1610
1972-04-19,Russia,Peru,2,0,2,1.0,0.0,1838,1636
1972-04-23,Puerto Rico,Haiti,0,5,5,0.0,1.0,1382,1624
1972-04-23,Romania,Peru,2,2,0,0.5,0.5,1699,1638
1972-04-26,Brazil,Paraguay,3,2,1,1.0,0.0,1939,1668
1972-04-26,Czechoslovakia,Luxembourg,6,0,6,1.0,0.0,1746,1393
1972-04-26,Scotland,Peru,2,0,2,1.0,0.0,1693,1632
1972-04-26,Switzerland,Sweden,1,1,0,0.5,0.5,1614,1772
1972-04-29,England,Germany,1,3,2,0.0,1.0,1877,1868
1972-04-29,Hungary,Romania,1,1,0,0.5,0.5,1812,1702
1972-04-29,Italy,Belgium,0,0,0,0.5,0.5,1837,1696
1972-04-29,Madagascar,Tanzania,0,1,1,0.0,1.0,1526,1501
1972-04-30,Austria,Malta,4,0,4,1.0,0.0,1685,1481
1972-04-30,Lesotho,Zambia,0,0,0,0.5,0.5,1486,1615
1972-04-30,Yugoslavia,Russia,0,0,0,0.5,0.5,1752,1836
1972-05-03,Netherlands,Peru,3,0,3,1.0,0.0,1676,1625
1972-05-06,Hungary,Malta,3,0,3,1.0,0.0,1815,1479
1972-05-07,Ethiopia,Greece,0,1,1,0.0,1.0,1533,1549
1972-05-07,Iran,Cambodia,2,0,2,1.0,0.0,1586,1452
1972-05-07,South Korea,Iraq,0,0,0,0.5,0.5,1687,1603
1972-05-08,Thailand,Kuwait,0,2,2,0.0,1.0,1516,1523
1972-05-09,Iran,Iraq,3,0,3,1.0,0.0,1595,1595
1972-05-09,Jersey,Guernsey,0,3,3,0.0,1.0,1688,1617
1972-05-10,Cambodia,South Korea,1,4,3,0.0,1.0,1449,1691
1972-05-10,Cyprus,Portugal,0,1,1,0.0,1.0,1429,1687
1972-05-10,Poland,Switzerland,0,0,0,0.5,0.5,1690,1616
1972-05-11,Thailand,Iraq,1,1,0,0.5,0.5,1518,1594
1972-05-12,South Korea,Kuwait,1,2,1,0.0,1.0,1680,1535
1972-05-13,Belgium,Italy,2,1,1,1.0,0.0,1708,1826
1972-05-13,Germany,England,0,0,0,0.5,0.5,1869,1877
1972-05-13,Russia,Yugoslavia,3,0,3,1.0,0.0,1843,1746
1972-05-13,Thailand,Iran,2,3,1,0.0,1.0,1512,1602
1972-05-14,Cambodia,Kuwait,4,0,4,1.0,0.0,1459,1526
1972-05-14,Romania,Hungary,2,2,0,0.5,0.5,1705,1813
1972-05-14,Sweden,Czechoslovakia,1,2,1,0.0,1.0,1764,1755
1972-05-16,Iran,Cambodia,2,1,1,1.0,0.0,1607,1455
1972-05-17,Hungary,Romania,2,1,1,1.0,0.0,1819,1700
1972-05-17,Kenya,Madagascar,1,3,2,0.0,1.0,1570,1536
1972-05-17,Thailand,South Korea,1,1,0,0.5,0.5,1516,1677
1972-05-18,Belgium,Iceland,4,0,4,1.0,0.0,1711,1425
1972-05-19,Iran,South Korea,2,1,1,1.0,0.0,1617,1668
1972-05-19,Thailand,Cambodia,2,2,0,0.5,0.5,1515,1457
1972-05-20,Scotland,Northern Ireland,2,0,2,1.0,0.0,1700,1614
1972-05-20,Wales,England,0,3,3,0.0,1.0,1593,1880
1972-05-22,Belgium,Iceland,4,0,4,1.0,0.0,1714,1423
1972-05-22,Mauritius,Uganda,1,2,1,0.0,1.0,1548,1548
1972-05-23,England,Northern Ireland,0,1,1,0.0,1.0,1867,1628
1972-05-23,Spain,Uruguay,2,0,2,1.0,0.0,1774,1719
1972-05-24,Scotland,Wales,1,0,1,1.0,0.0,1706,1588
1972-05-25,Argentina,Paraguay,0,0,0,0.5,0.5,1771,1671
1972-05-25,Sweden,Hungary,0,0,0,0.5,0.5,1766,1818
1972-05-26,Germany,Russia,4,1,3,1.0,0.0,1877,1836
1972-05-27,German DR,Uruguay,1,0,1,1.0,0.0,1729,1712
1972-05-27,Scotland,England,0,1,1,0.0,1.0,1702,1872
1972-05-27,Wales,Northern Ireland,0,0,0,0.5,0.5,1589,1628
1972-05-28,Finland,Norway,0,0,0,0.5,0.5,1426,1529
1972-05-28,Mauritius,Uganda,1,3,2,0.0,1.0,1540,1556
1972-05-31,Chile,Argentina,3,4,1,0.0,1.0,1655,1777
1972-05-31,German DR,Uruguay,0,0,0,0.5,0.5,1729,1713
1972-05-31,Liberia,Guinea,0,2,2,0.0,1.0,1460,1588
1972-05-31,Sierra Leone,Ghana,3,1,2,1.0,0.0,1506,1662
1972-06-01,Puerto Rico,Panama,0,0,0,0.5,0.5,1384,1432
1972-06-04,Zambia,Lesotho,6,1,5,1.0,0.0,1621,1481
1972-06-05,Indonesia,Myanmar,1,0,1,1.0,0.0,1631,1728
1972-06-05,Tunisia,Algeria,3,1,2,1.0,0.0,1558,1560
1972-06-06,Cambodia,Singapore,3,0,3,1.0,0.0,1465,1423
1972-06-06,Togo,DR Congo,0,0,0,0.5,0.5,1527,1628
1972-06-06,Peru,Colombia,0,0,0,0.5,0.5,1622,1460
1972-06-07,Denmark,Finland,3,0,3,1.0,0.0,1586,1422
1972-06-07,Russia,Bulgaria,1,0,1,1.0,0.0,1841,1695
1972-06-08,Cambodia,Thailand,2,0,2,1.0,0.0,1475,1506
1972-06-08,Philippines,Singapore,2,0,2,1.0,0.0,1371,1414
1972-06-09,Myanmar,Sri Lanka,4,2,2,1.0,0.0,1731,1423
1972-06-09,Laos,Malaysia,1,2,1,0.0,1.0,1406,1600
1972-06-10,Austria,Sweden,2,0,2,1.0,0.0,1695,1757
1972-06-10,Kenya,Uganda,2,0,2,1.0,0.0,1578,1549
1972-06-11,Bolivia,Peru,0,3,3,0.0,1.0,1534,1629
1972-06-11,Myanmar,Laos,6,1,5,1.0,0.0,1734,1404
1972-06-11,Ecuador,Portugal,0,3,3,0.0,1.0,1420,1690
1972-06-11,Iran,Republic of Ireland,1,2,1,0.0,1.0,1608,1570
1972-06-11,Paraguay,Venezuela,4,1,3,1.0,0.0,1675,1462
1972-06-12,Philippines,Thailand,1,0,1,1.0,0.0,1382,1496
1972-06-13,Laos,Sri Lanka,1,3,2,0.0,1.0,1397,1431
1972-06-14,Belgium,Germany,1,2,1,0.0,1.0,1710,1882
1972-06-14,Chile,Ecuador,2,1,1,1.0,0.0,1659,1417
1972-06-14,Hungary,Russia,0,1,1,0.0,1.0,1811,1849
1972-06-14,Iran,Portugal,0,3,3,0.0,1.0,1602,1697
1972-06-14,Norway,Uruguay,0,1,1,0.0,1.0,1525,1718
1972-06-14,Paraguay,Peru,1,0,1,1.0,0.0,1682,1623
1972-06-14,Venezuela,Yugoslavia,0,10,10,0.0,1.0,1460,1749
1972-06-15,Myanmar,Malaysia,2,2,0,0.5,0.5,1732,1603
1972-06-16,Benin,Congo,5,3,2,1.0,0.0,1521,1588
1972-06-17,Belgium,Hungary,2,1,1,1.0,0.0,1721,1801
1972-06-17,Romania,Italy,3,3,0,0.5,0.5,1703,1824
1972-06-18,Benin,Ghana,0,5,5,0.0,1.0,1517,1667
1972-06-18,Bolivia,Yugoslavia,1,1,0,0.5,0.5,1539,1745
1972-06-18,Chile,Portugal,1,4,3,0.0,1.0,1652,1705
1972-06-18,Colombia,France,2,3,1,0.0,1.0,1457,1676
1972-06-18,Ecuador,Republic of Ireland,2,3,1,0.0,1.0,1413,1575
1972-06-18,Germany,Russia,3,0,3,1.0,0.0,1890,1842
1972-06-18,Peru,Venezuela,1,0,1,1.0,0.0,1628,1456
1972-06-19,Myanmar,Cambodia,0,3,3,0.0,1.0,1719,1489
1972-06-20,DR Congo,Togo,4,0,4,1.0,0.0,1634,1522
1972-06-21,Bolivia,Venezuela,2,2,0,0.5,0.5,1538,1458
1972-06-21,Bulgaria,Italy,1,1,0,0.5,0.5,1698,1822
1972-06-21,Chile,Republic of Ireland,2,1,1,1.0,0.0,1659,1569
1972-06-21,Ecuador,Iran,1,1,0,0.5,0.5,1417,1599
1972-06-21,Finland,Albania,1,0,1,1.0,0.0,1432,1481
1972-06-22,Argentina,Colombia,4,1,3,1.0,0.0,1780,1455
1972-06-22,Paraguay,Yugoslavia,1,2,1,0.0,1.0,1676,1752
1972-06-23,Singapore,Sri Lanka,3,1,2,1.0,0.0,1423,1423
1972-06-25,Argentina,France,0,0,0,0.5,0.5,1778,1679
1972-06-25,Bolivia,Paraguay,1,6,5,0.0,1.0,1534,1681
1972-06-25,Chile,Iran,2,1,1,1.0,0.0,1666,1593
1972-06-25,Republic of Ireland,Portugal,1,2,1,0.0,1.0,1564,1711
1972-06-25,Peru,Yugoslavia,1,2,1,0.0,1.0,1623,1758
1972-06-28,Brazil,Czechoslovakia,0,0,0,0.5,0.5,1936,1759
1972-06-29,Argentina,Portugal,1,3,2,0.0,1.0,1769,1721
1972-06-29,Scotland,Yugoslavia,2,2,0,0.5,0.5,1704,1757
1972-06-29,Sweden,Denmark,2,0,2,1.0,0.0,1762,1582
1972-06-29,Uruguay,Russia,0,1,1,0.0,1.0,1713,1848
1972-07-02,Argentina,Russia,1,0,1,1.0,0.0,1779,1839
1972-07-02,Brazil,Yugoslavia,3,0,3,1.0,0.0,1941,1753
1972-07-02,DR Congo,Guinea,6,0,6,1.0,0.0,1641,1582
1972-07-02,Czechoslovakia,Scotland,0,0,0,0.5,0.5,1758,1706
1972-07-02,Ghana,Benin,5,1,4,1.0,0.0,1672,1513
1972-07-02,Portugal,Uruguay,1,1,0,0.5,0.5,1721,1714
1972-07-03,Iceland,Denmark,2,5,3,0.0,1.0,1419,1587
1972-07-04,Tanzania,Sudan,3,0,3,1.0,0.0,1512,1582
1972-07-05,Brazil,Scotland,1,0,1,1.0,0.0,1945,1703
1972-07-06,Argentina,Uruguay,1,0,1,1.0,0.0,1786,1708
1972-07-06,Czechoslovakia,Yugoslavia,1,2,1,0.0,1.0,1750,1762
1972-07-06,Malawi,Lesotho,1,0,1,1.0,0.0,1473,1473
1972-07-06,Portugal,Russia,1,0,1,1.0,0.0,1732,1829
1972-07-06,Tanzania,Nigeria,0,0,0,0.5,0.5,1514,1599
1972-07-08,Malawi,Lesotho,4,0,4,1.0,0.0,1481,1465
1972-07-09,Argentina,Yugoslavia,2,4,2,0.0,1.0,1778,1771
1972-07-09,Brazil,Portugal,1,0,1,1.0,0.0,1949,1729
1972-07-09,Uganda,Sudan,4,0,4,1.0,0.0,1558,1574
1972-07-11,Zanzibar,Nigeria,1,4,3,0.0,1.0,1345,1603
1972-07-12,Iceland,Faroe Islands,3,0,3,1.0,0.0,1429,1491
1972-07-12,Malaysia,Sri Lanka,4,1,3,1.0,0.0,1608,1419
1972-07-12,Japan,Cambodia,4,1,3,1.0,0.0,1617,1484
1972-07-13,Indonesia,Singapore,0,0,0,0.5,0.5,1627,1428
1972-07-14,Malaysia,Philippines,1,0,1,1.0,0.0,1612,1379
1972-07-15,Hong Kong,South Korea,0,0,0,0.5,0.5,1453,1664
1972-07-15,Singapore,Thailand,0,2,2,0.0,1.0,1422,1503
1972-07-16,Cambodia,Philippines,2,2,0,0.5,0.5,1482,1382
1972-07-16,Finland,Russia,1,1,0,0.5,0.5,1439,1823
1972-07-16,Japan,Sri Lanka,5,0,5,1.0,0.0,1621,1416
1972-07-16,Kenya,Sudan,2,0,2,1.0,0.0,1586,1567
1972-07-17,Hong Kong,Singapore,4,1,3,1.0,0.0,1461,1415
1972-07-17,South Korea,Thailand,2,0,2,1.0,0.0,1669,1499
1972-07-18,Japan,Philippines,5,1,4,1.0,0.0,1625,1379
1972-07-19,Indonesia,Thailand,3,2,1,1.0,0.0,1633,1494
1972-07-19,Malaysia,Cambodia,6,1,5,1.0,0.0,1618,1477
1972-07-19,South Korea,Singapore,4,1,3,1.0,0.0,1673,1412
1972-07-20,Philippines,Sri Lanka,4,1,3,1.0,0.0,1388,1408
1972-07-21,Hong Kong,Indonesia,1,0,1,1.0,0.0,1473,1622
1972-07-22,Cambodia,Sri Lanka,6,1,5,1.0,0.0,1484,1402
1972-07-22,Malaysia,Japan,3,1,2,1.0,0.0,1627,1617
1972-07-23,Hong Kong,Thailand,2,2,0,0.5,0.5,1474,1494
1972-07-23,Indonesia,South Korea,0,2,2,0.0,1.0,1616,1680
1972-07-23,Sudan,Kenya,1,0,1,1.0,0.0,1576,1578
1972-07-25,Singapore,Sri Lanka,6,1,5,1.0,0.0,1420,1395
1972-07-26,Japan,South Korea,0,3,3,0.0,1.0,1611,1687
1972-07-27,Uganda,Tanzania,1,1,0,0.5,0.5,1557,1516
1972-07-28,Cambodia,Hong Kong,1,0,1,1.0,0.0,1492,1467
1972-07-29,Philippines,Thailand,0,4,4,0.0,1.0,1383,1500
1972-07-29,Malaysia,South Korea,1,2,1,0.0,1.0,1621,1694
1972-08-02,Indonesia,Philippines,3,0,3,1.0,0.0,1620,1380
1972-08-02,Singapore,Sri Lanka,6,1,5,1.0,0.0,1428,1388
1972-08-03,Norway,Iceland,4,1,3,1.0,0.0,1531,1424
1972-08-04,Hong Kong,Sri Lanka,2,1,1,1.0,0.0,1474,1382
1972-08-04,Japan,Philippines,4,1,3,1.0,0.0,1615,1377
1972-08-05,Nigeria,Congo,2,1,1,1.0,0.0,1611,1581
1972-08-06,Costa Rica,Mexico,1,0,1,1.0,0.0,1723,1740
1972-08-06,Indonesia,Japan,1,0,1,1.0,0.0,1628,1608
1972-08-06,Singapore,Hong Kong,0,2,2,0.0,1.0,1422,1481
1972-08-06,Sweden,Russia,4,4,0,0.5,0.5,1764,1822
1972-08-08,Cambodia,Indonesia,0,5,5,0.0,1.0,1487,1634
1972-08-09,Peru,Mexico,3,2,1,1.0,0.0,1634,1730
1972-08-10,Hong Kong,Cambodia,2,1,1,1.0,0.0,1490,1479
1972-08-15,Congo,Nigeria,1,1,0,0.5,0.5,1582,1611
1972-08-16,Chile,Mexico,0,2,2,0.0,1.0,1660,1737
1972-08-20,Canada,United States,3,2,1,1.0,0.0,1514,1462
1972-08-24,Canada,Mexico,0,1,1,0.0,1.0,1511,1741
1972-08-29,United States,Canada,2,2,0,0.5,0.5,1464,1510
1972-08-30,Czechoslovakia,Netherlands,1,2,1,0.0,1.0,1741,1686
1972-09-02,Greece,France,1,3,2,0.0,1.0,1544,1685
1972-09-02,Guatemala,Canada,2,2,0,0.5,0.5,1600,1513
1972-09-03,Mexico,United States,3,1,2,1.0,0.0,1744,1462
1972-09-03,Romania,Austria,1,1,0,0.5,0.5,1703,1696
1972-09-03,Sri Lanka,China PR,2,3,1,0.0,1.0,1380,1672
1972-09-06,Mexico,Canada,2,1,1,1.0,0.0,1748,1510
1972-09-10,United States,Mexico,1,2,1,0.0,1.0,1460,1751
1972-09-12,Sri Lanka,China PR,0,1,1,0.0,1.0,1378,1675
1972-09-14,Japan,South Korea,2,2,0,0.5,0.5,1610,1693
1972-09-17,New Zealand,New Caledonia,4,1,3,1.0,0.0,1519,1601
1972-09-17,Norway,Sweden,1,3,2,0.0,1.0,1528,1768
1972-09-20,Cambodia,Malaysia,0,1,1,0.0,1.0,1475,1626
1972-09-20,Finland,Romania,1,1,0,0.5,0.5,1445,1698
1972-09-20,Italy,Yugoslavia,3,1,2,1.0,0.0,1829,1765
1972-09-20,South Korea,Thailand,3,0,3,1.0,0.0,1697,1497
1972-09-21,Myanmar,Philippines,4,0,4,1.0,0.0,1721,1376
1972-09-22,South Korea,Cambodia,3,1,2,1.0,0.0,1701,1472
1972-09-22,Malaysia,Thailand,1,1,0,0.5,0.5,1624,1500
1972-09-23,Myanmar,Indonesia,1,1,0,0.5,0.5,1720,1636
1972-09-23,Philippines,Singapore,0,5,5,0.0,1.0,1370,1429
1972-09-24,Cambodia,Thailand,0,0,0,0.5,0.5,1473,1500
1972-09-24,South Korea,Malaysia,2,0,2,1.0,0.0,1708,1618
1972-09-25,Myanmar,Singapore,1,0,1,1.0,0.0,1723,1427
1972-09-27,Cambodia,Philippines,1,0,1,1.0,0.0,1479,1365
1972-09-27,South Korea,Myanmar,0,1,1,0.0,1.0,1701,1731
1972-09-28,Indonesia,Malaysia,3,1,2,1.0,0.0,1644,1611
1972-09-28,Singapore,Thailand,1,4,3,0.0,1.0,1421,1507
1972-09-30,Myanmar,Indonesia,3,1,2,1.0,0.0,1738,1638
1972-09-30,South Korea,Malaysia,1,0,1,1.0,0.0,1707,1606
1972-09-30,Martinique,Trinidad and Tobago,1,2,1,0.0,1.0,1565,1580
1972-09-30,New Zealand,New Caledonia,2,1,1,1.0,0.0,1529,1592
1972-10-01,Costa Rica,El Salvador,2,0,2,1.0,0.0,1729,1599
1972-10-03,Martinique,Trinidad and Tobago,1,2,1,0.0,1.0,1558,1588
1972-10-04,Algeria,Turkey,1,0,1,1.0,0.0,1569,1583
1972-10-04,Denmark,Switzerland,1,1,0,0.5,0.5,1588,1616
1972-10-04,Lesotho,Zambia,1,1,0,0.5,0.5,1469,1618
1972-10-04,Norway,Belgium,0,2,2,0.0,1.0,1525,1725
1972-10-05,Hong Kong,Singapore,2,3,1,0.0,1.0,1481,1431
1972-10-07,German DR,Finland,5,0,5,1.0,0.0,1732,1443
1972-10-07,Indonesia,Australia,1,4,3,0.0,1.0,1630,1636
1972-10-07,Luxembourg,Italy,0,4,4,0.0,1.0,1392,1831
1972-10-08,El Salvador,Costa Rica,0,1,1,0.0,1.0,1594,1735
1972-10-08,Lesotho,Zambia,1,1,0,0.5,0.5,1473,1615
1972-10-09,Australia,New Zealand,3,1,2,1.0,0.0,1642,1524
1972-10-11,England,Yugoslavia,1,1,0,0.5,0.5,1870,1768
1972-10-11,Indonesia,New Zealand,1,1,0,0.5,0.5,1628,1527
1972-10-11,Spain,Argentina,1,0,1,1.0,0.0,1783,1770
1972-10-11,Saint Kitts and Nevis,Trinidad and Tobago,0,3,3,0.0,1.0,1480,1594
1972-10-12,Mexico,Costa Rica,3,1,2,1.0,0.0,1759,1728
1972-10-13,China PR,Nepal,6,2,4,1.0,0.0,1680,1496
1972-10-13,France,Russia,1,0,1,1.0,0.0,1697,1811
1972-10-14,New Caledonia,New Zealand,3,1,2,1.0,0.0,1599,1521
1972-10-15,Austria,Hungary,2,2,0,0.5,0.5,1699,1799
1972-10-15,Guatemala,Costa Rica,0,0,0,0.5,0.5,1603,1726
1972-10-15,Malawi,Kenya,0,1,1,0.0,1.0,1476,1584
1972-10-15,Poland,Czechoslovakia,3,0,3,1.0,0.0,1700,1732
1972-10-15,Sierra Leone,Ivory Coast,0,1,1,0.0,1.0,1501,1616
1972-10-15,Sweden,Malta,7,0,7,1.0,0.0,1771,1477
1972-10-15,Vietnam Republic,Australia,0,1,1,0.0,1.0,1554,1649
1972-10-18,Bulgaria,Northern Ireland,3,0,3,1.0,0.0,1705,1622
1972-10-18,Denmark,Scotland,1,4,3,0.0,1.0,1583,1709
1972-10-18,Republic of Ireland,Russia,1,2,1,0.0,1.0,1561,1815
1972-10-19,Spain,Yugoslavia,2,2,0,0.5,0.5,1783,1769
1972-10-21,Switzerland,Italy,0,0,0,0.5,0.5,1621,1827
1972-10-22,South Korea,Australia,1,1,0,0.5,0.5,1706,1651
1972-10-22,Luxembourg,Turkey,2,0,2,1.0,0.0,1405,1571
1972-10-22,Malawi,Kenya,2,1,1,1.0,0.0,1487,1574
1972-10-24,South Korea,Australia,0,2,2,0.0,1.0,1697,1661
1972-10-25,Peru,Argentina,0,2,2,0.0,1.0,1629,1776
1972-10-28,Cambodia,Singapore,0,1,1,0.0,1.0,1470,1441
1972-10-28,Vietnam Republic,Malaysia,0,0,0,0.5,0.5,1556,1605
1972-10-29,Cambodia,Malaysia,1,0,1,1.0,0.0,1481,1595
1972-10-29,Ivory Coast,Sierra Leone,2,0,2,1.0,0.0,1622,1496
1972-10-29,Philippines,Australia,0,6,6,0.0,1.0,1363,1664
1972-10-29,Romania,Albania,2,0,2,1.0,0.0,1702,1478
1972-10-29,Vietnam Republic,Singapore,4,1,3,1.0,0.0,1562,1436
1972-11-01,Czechoslovakia,German DR,1,3,2,0.0,1.0,1724,1740
1972-11-01,Malaysia,Singapore,1,3,2,0.0,1.0,1584,1448
1972-11-01,Netherlands,Norway,9,0,9,1.0,0.0,1691,1521
1972-11-01,Vietnam Republic,Cambodia,1,2,1,0.0,1.0,1553,1491
1972-11-06,Nigeria,Tanzania,2,1,1,1.0,0.0,1617,1511
1972-11-10,Trinidad and Tobago,Antigua and Barbuda,11,1,10,1.0,0.0,1600,1495
1972-11-11,Nigeria,Tanzania,3,2,1,1.0,0.0,1623,1506
1972-11-12,Costa Rica,Guatemala,1,1,0,0.5,0.5,1724,1606
1972-11-15,Germany,Switzerland,5,1,4,1.0,0.0,1893,1619
1972-11-15,Republic of Ireland,France,2,1,1,1.0,0.0,1572,1687
1972-11-15,Scotland,Denmark,2,0,2,1.0,0.0,1715,1578
1972-11-15,Wales,England,0,1,1,0.0,1.0,1587,1873
1972-11-16,Tunisia,Algeria,1,2,1,0.0,1.0,1551,1577
1972-11-18,South Korea,Malaysia,4,1,3,1.0,0.0,1703,1579
1972-11-18,Sierra Leone,Tanzania,2,2,0,0.5,0.5,1497,1506
1972-11-18,Thailand,Singapore,4,0,4,1.0,0.0,1514,1442
1972-11-18,Yugoslavia,Greece,1,0,1,1.0,0.0,1773,1541
1972-11-19,Antigua and Barbuda,Trinidad and Tobago,1,2,1,0.0,1.0,1490,1606
1972-11-19,Belgium,Netherlands,0,0,0,0.5,0.5,1725,1692
1972-11-19,Cyprus,Bulgaria,0,4,4,0.0,1.0,1427,1708
1972-11-19,Morocco,Senegal,0,0,0,0.5,0.5,1568,1530
1972-11-20,Indonesia,Singapore,1,2,1,0.0,1.0,1617,1454
1972-11-20,Thailand,Malaysia,0,2,2,0.0,1.0,1508,1586
1972-11-22,Indonesia,South Korea,1,1,0,0.5,0.5,1619,1702
1972-11-22,Malaysia,Singapore,2,0,2,1.0,0.0,1592,1449
1972-11-22,Mali,Nigeria,2,1,1,1.0,0.0,1551,1614
1972-11-24,Guinea,China PR,1,1,0,0.5,0.5,1585,1678
1972-11-24,South Korea,Singapore,2,0,2,1.0,0.0,1706,1446
1972-11-24,Liberia,Nigeria,1,3,2,0.0,1.0,1456,1619
1972-11-24,Thailand,Indonesia,3,0,3,1.0,0.0,1519,1609
1972-11-25,Dominica,Grenada,1,2,1,0.0,1.0,1451,1580
1972-11-25,Malta,Austria,0,2,2,0.0,1.0,1474,1703
1972-11-25,Tanzania,Ethiopia,1,1,0,0.5,0.5,1507,1533
1972-11-26,Indonesia,Malaysia,0,2,2,0.0,1.0,1601,1601
1972-11-26,Sierra Leone,Nigeria,0,1,1,0.0,1.0,1492,1625
1972-11-26,Saint Lucia,Saint Vincent and the Grenadines,2,1,1,1.0,0.0,1496,1534
1972-11-26,Thailand,South Korea,1,0,1,1.0,0.0,1531,1695
1972-11-28,Dominica,Saint Vincent and the Grenadines,1,2,1,0.0,1.0,1445,1541
1972-11-28,South Korea,Singapore,0,0,0,0.5,0.5,1691,1451
1972-11-28,Thailand,Malaysia,0,1,1,0.0,1.0,1525,1608
1972-11-28,Trinidad and Tobago,Suriname,2,1,1,1.0,0.0,1616,1643
1972-11-29,Senegal,China PR,0,0,0,0.5,0.5,1534,1675
1972-11-29,Saint Lucia,Grenada,1,0,1,1.0,0.0,1506,1571
1972-11-30,Trinidad and Tobago,Suriname,1,1,0,0.5,0.5,1617,1643
1972-12-01,Grenada,Saint Vincent and the Grenadines,0,0,0,0.5,0.5,1571,1542
1972-12-02,Saint Lucia,Dominica,1,0,1,1.0,0.0,1513,1439
1972-12-03,Antigua and Barbuda,Suriname,0,6,6,0.0,1.0,1486,1648
1972-12-03,Ethiopia,Tanzania,0,0,0,0.5,0.5,1533,1508
1972-12-03,Guatemala,El Salvador,1,0,1,1.0,0.0,1614,1587
1972-12-03,Honduras,Costa Rica,2,1,1,1.0,0.0,1548,1713
1972-12-03,Senegal,Morocco,1,2,1,0.0,1.0,1527,1576
1972-12-04,Nigeria,Mali,3,0,3,1.0,0.0,1632,1545
1972-12-05,Antigua and Barbuda,Suriname,1,3,2,0.0,1.0,1482,1653
1972-12-08,Egypt,Tunisia,2,1,1,1.0,0.0,1658,1546
1972-12-10,Costa Rica,Honduras,3,3,0,0.5,0.5,1710,1552
1972-12-10,El Salvador,Guatemala,0,1,1,0.0,1.0,1580,1622
1972-12-10,Ethiopia,Tanzania,3,0,3,1.0,0.0,1541,1501
1972-12-10,Mauritius,Kenya,1,3,2,0.0,1.0,1533,1582
1972-12-10,Turkey,Luxembourg,3,0,3,1.0,0.0,1576,1401
1972-12-12,Nigeria,Sierra Leone,4,0,4,1.0,0.0,1637,1488
1972-12-14,Haiti,Curaçao,3,0,3,1.0,0.0,1631,1563
1972-12-14,Panama,Puerto Rico,5,0,5,1.0,0.0,1439,1378
1972-12-16,Panama,Puerto Rico,0,1,1,0.0,1.0,1430,1388
1972-12-17,Haiti,Curaçao,4,1,3,1.0,0.0,1638,1557
1972-12-17,Kenya,Mauritius,2,2,0,0.5,0.5,1581,1535
1972-12-17,Tunisia,Egypt,2,0,2,1.0,0.0,1557,1648
1972-12-20,Nigeria,Benin,3,0,3,1.0,0.0,1643,1508
1972-12-24,Bermuda,Jamaica,0,0,0,0.5,0.5,1459,1470
1972-12-27,Bermuda,Jamaica,0,3,3,0.0,1.0,1452,1478
1972-12-28,Ghana,Togo,2,2,0,0.5,0.5,1669,1526
1972-12-29,Liberia,Ghana,2,2,0,0.5,0.5,1461,1665
1973-01-01,Gambia,Senegal,2,1,1,1.0,0.0,1475,1518
1973-01-08,Nigeria,Ghana,4,2,2,1.0,0.0,1652,1657
1973-01-08,Algeria,Tanzania,4,2,2,1.0,0.0,1584,1495
1973-01-08,Congo,Burkina Faso,3,0,3,1.0,0.0,1588,1471
1973-01-08,Guinea,Egypt,4,1,3,1.0,0.0,1595,1639
1973-01-10,Nigeria,Algeria,2,2,0,0.5,0.5,1651,1586
1973-01-10,Ghana,Tanzania,1,0,1,1.0,0.0,1662,1491
1973-01-10,Egypt,Congo,3,1,2,1.0,0.0,1646,1582
1973-01-10,Guinea,Burkina Faso,3,2,1,1.0,0.0,1601,1466
1973-01-12,Nigeria,Tanzania,2,1,1,1.0,0.0,1656,1487
1973-01-12,Ghana,Algeria,2,0,2,1.0,0.0,1669,1580
1973-01-12,Guinea,Congo,5,1,4,1.0,0.0,1609,1575
1973-01-12,Egypt,Burkina Faso,4,2,2,1.0,0.0,1651,1462
1973-01-13,Italy,Turkey,0,0,0,0.5,0.5,1823,1581
1973-01-14,Nigeria,Egypt,4,2,2,1.0,0.0,1664,1644
1973-01-14,Guinea,Ghana,2,1,1,1.0,0.0,1619,1660
1973-01-16,Egypt,Ghana,2,1,1,1.0,0.0,1653,1652
1973-01-16,Nigeria,Guinea,2,0,2,1.0,0.0,1671,1613
1973-01-17,Greece,Spain,2,3,1,0.0,1.0,1538,1787
1973-01-24,England,Wales,1,1,0,0.5,0.5,1868,1593
1973-01-26,Uganda,Congo,3,1,2,1.0,0.0,1566,1567
1973-01-28,Cyprus,Bulgaria,0,3,3,0.0,1.0,1425,1711
1973-01-30,Guyana,Haiti,1,3,2,0.0,1.0,1425,1642
1973-01-31,Greece,Bulgaria,2,2,0,0.5,0.5,1542,1708
1973-02-01,Guyana,Haiti,1,0,1,1.0,0.0,1438,1630
1973-02-04,Cameroon,DR Congo,0,1,1,0.0,1.0,1545,1647
1973-02-04,Haiti,Trinidad and Tobago,0,0,0,0.5,0.5,1630,1618
1973-02-04,Indonesia,Bulgaria,0,4,4,0.0,1.0,1596,1714
1973-02-04,Tunisia,Yugoslavia,0,5,5,0.0,1.0,1554,1777
1973-02-06,Haiti,Trinidad and Tobago,4,2,2,1.0,0.0,1638,1611
1973-02-06,Mexico,Argentina,2,0,2,1.0,0.0,1768,1768
1973-02-08,Barbados,Haiti,3,2,1,1.0,0.0,1460,1626
1973-02-08,New Caledonia,Bulgaria,3,5,2,0.0,1.0,1594,1720
1973-02-10,Nigeria,Ghana,2,3,1,0.0,1.0,1663,1661
1973-02-11,Guinea,Morocco,1,1,0,0.5,0.5,1613,1577
1973-02-11,Tunisia,Ivory Coast,1,1,0,0.5,0.5,1556,1621
1973-02-14,Australia,Bulgaria,2,2,0,0.5,0.5,1666,1719
1973-02-14,Chile,Tahiti,10,1,9,1.0,0.0,1666,1536
1973-02-14,Cyprus,Northern Ireland,1,0,1,1.0,0.0,1438,1610
1973-02-14,Germany,Argentina,2,3,1,0.0,1.0,1883,1779
1973-02-14,Scotland,England,0,5,5,0.0,1.0,1711,1873
1973-02-14,Turkey,Algeria,4,0,4,1.0,0.0,1589,1573
1973-02-15,Colombia,German DR,0,2,2,0.0,1.0,1453,1743
1973-02-16,Australia,Bulgaria,1,3,2,0.0,1.0,1660,1726
1973-02-17,Morocco,Senegal,3,1,2,1.0,0.0,1584,1512
1973-02-17,New Caledonia,Tahiti,1,2,1,0.0,1.0,1585,1546
1973-02-17,New Zealand,Fiji,5,1,4,1.0,0.0,1528,1450
1973-02-18,Australia,Bulgaria,0,2,2,0.0,1.0,1654,1733
1973-02-18,Ecuador,German DR,1,1,0,0.5,0.5,1423,1738
1973-02-18,New Caledonia,Vanuatu,4,1,3,1.0,0.0,1591,1465
1973-02-18,New Zealand,Tahiti,1,1,0,0.5,0.5,1529,1546
1973-02-20,Fiji,New Caledonia,0,2,2,0.0,1.0,1446,1596
1973-02-20,Israel,Argentina,1,1,0,0.5,0.5,1580,1775
1973-02-20,Vanuatu,Tahiti,0,1,1,0.0,1.0,1459,1553
1973-02-21,Fiji,Vanuatu,1,2,1,0.0,1.0,1439,1467
1973-02-21,New Zealand,New Caledonia,2,1,1,1.0,0.0,1539,1587
1973-02-21,Spain,Greece,3,1,2,1.0,0.0,1791,1539
1973-02-23,Fiji,Tahiti,0,4,4,0.0,1.0,1434,1559
1973-02-23,New Zealand,Vanuatu,3,1,2,1.0,0.0,1546,1461
1973-02-24,New Caledonia,Vanuatu,2,1,1,1.0,0.0,1593,1456
1973-02-24,New Zealand,Tahiti,2,0,2,1.0,0.0,1555,1551
1973-02-25,DR Congo,Cameroon,0,1,1,0.0,1.0,1637,1556
1973-02-25,Ghana,Nigeria,0,0,0,0.5,0.5,1662,1663
1973-02-25,Ivory Coast,Tunisia,2,1,1,1.0,0.0,1628,1550
1973-02-25,Morocco,Guinea,2,0,2,1.0,0.0,1593,1605
1973-02-25,Turkey,Italy,0,1,1,0.0,1.0,1586,1827
1973-02-27,DR Congo,Cameroon,2,0,2,1.0,0.0,1644,1550
1973-03-03,France,Portugal,1,2,1,0.0,1.0,1680,1737
1973-03-04,New Zealand,Australia,1,1,0,0.5,0.5,1558,1652
1973-03-04,Peru,Guatemala,5,1,4,1.0,0.0,1637,1615
1973-03-10,Sudan,Ethiopia,1,0,1,1.0,0.0,1584,1534
1973-03-11,Australia,Iraq,3,1,2,1.0,0.0,1659,1588
1973-03-11,Indonesia,New Zealand,1,1,0,0.5,0.5,1596,1559
1973-03-13,Australia,Indonesia,2,1,1,1.0,0.0,1666,1590
1973-03-13,Iraq,New Zealand,2,0,2,1.0,0.0,1596,1552
1973-03-16,Australia,New Zealand,3,3,0,0.5,0.5,1664,1555
1973-03-16,Iraq,Indonesia,1,1,0,0.5,0.5,1596,1591
1973-03-17,Bermuda,United States,4,0,4,1.0,0.0,1461,1452
1973-03-18,Australia,Iraq,0,0,0,0.5,0.5,1663,1598
1973-03-18,Indonesia,New Zealand,1,0,1,1.0,0.0,1599,1548
1973-03-20,Poland,United States,4,0,4,1.0,0.0,1704,1449
1973-03-21,Iraq,Indonesia,3,2,1,1.0,0.0,1607,1591
1973-03-24,Australia,Indonesia,6,0,6,1.0,0.0,1670,1585
1973-03-24,Iraq,New Zealand,4,0,4,1.0,0.0,1614,1542
1973-03-24,Peru,Bolivia,2,0,2,1.0,0.0,1643,1529
1973-03-28,Austria,Netherlands,1,0,1,1.0,0.0,1711,1685
1973-03-28,Bulgaria,Russia,1,0,1,1.0,0.0,1743,1806
1973-03-28,Germany,Czechoslovakia,3,0,3,1.0,0.0,1888,1720
1973-03-28,Northern Ireland,Portugal,1,1,0,0.5,0.5,1613,1735
1973-03-28,Peru,Paraguay,1,0,1,1.0,0.0,1652,1673
1973-03-28,Wales,Poland,2,0,2,1.0,0.0,1604,1694
1973-03-29,Jersey,Alderney,6,1,5,1.0,0.0,1690,1317
1973-03-31,Sierra Leone,Mali,1,1,0,0.5,0.5,1490,1544
1973-03-31,Bolivia,Paraguay,1,1,0,0.5,0.5,1533,1670
1973-03-31,Italy,Luxembourg,5,0,5,1.0,0.0,1829,1400
1973-04-01,Ethiopia,Zambia,0,0,0,0.5,0.5,1536,1614
1973-04-08,Central African Republic,Ivory Coast,4,2,2,1.0,0.0,1476,1617
1973-04-08,German DR,Albania,2,0,2,1.0,0.0,1741,1476
1973-04-08,Luxembourg,Switzerland,0,1,1,0.0,1.0,1397,1623
1973-04-08,Paraguay,Peru,1,1,0,0.5,0.5,1670,1653
1973-04-08,Ghana,Senegal,3,2,1,1.0,0.0,1667,1508
1973-04-08,Lesotho,Mauritius,0,0,0,0.5,0.5,1475,1534
1973-04-08,Ethiopia,Tanzania,2,1,1,1.0,0.0,1543,1481
1973-04-08,Tanzania,Ethiopia,3,0,3,1.0,0.0,1491,1534
1973-04-12,Kuwait,Qatar,9,0,9,1.0,0.0,1532,1427
1973-04-13,Sudan,Nigeria,1,1,0,0.5,0.5,1586,1662
1973-04-14,Haiti,Chile,1,1,0,0.5,0.5,1627,1666
1973-04-15,Uganda,Kenya,1,0,1,1.0,0.0,1575,1573
1973-04-15,Burkina Faso,DR Congo,0,5,5,0.0,1.0,1458,1649
1973-04-15,Zambia,Ethiopia,4,2,2,1.0,0.0,1621,1528
1973-04-17,Kuwait,Qatar,4,1,3,1.0,0.0,1538,1422
1973-04-18,Belgium,German DR,3,0,3,1.0,0.0,1734,1733
1973-04-18,Russia,Romania,2,0,2,1.0,0.0,1812,1697
1973-04-18,Turkey,Bulgaria,5,2,3,1.0,0.0,1598,1732
1973-04-21,Nigeria,Sudan,2,1,1,1.0,0.0,1669,1580
1973-04-21,Senegal,Ghana,1,0,1,1.0,0.0,1520,1656
1973-04-22,Mauritius,Lesotho,5,1,4,1.0,0.0,1541,1469
1973-04-22,DR Congo,Burkina Faso,4,1,3,1.0,0.0,1653,1455
1973-04-23,Peru,Panama,4,0,4,1.0,0.0,1657,1427
1973-04-24,Ecuador,Chile,1,1,0,0.5,0.5,1428,1662
1973-04-26,Denmark,Sweden,1,2,1,0.0,1.0,1575,1775
1973-04-28,Kenya,Uganda,1,2,1,0.0,1.0,1566,1583
1973-04-28,Mali,Sierra Leone,4,2,2,1.0,0.0,1551,1484
1973-04-29,Bolivia,Ecuador,3,3,0,0.5,0.5,1531,1431
1973-04-29,Hungary,Austria,2,2,0,0.5,0.5,1798,1713
1973-04-29,Peru,Chile,2,0,2,1.0,0.0,1666,1654
1973-05-02,Bulgaria,Portugal,2,1,1,1.0,0.0,1741,1727
1973-05-02,Denmark,Czechoslovakia,1,1,0,0.5,0.5,1579,1717
1973-05-02,Netherlands,Spain,3,2,1,1.0,0.0,1696,1781
1973-05-04,Iran,North Korea,0,0,0,0.5,0.5,1595,1658
1973-05-04,Syria,Kuwait,2,1,1,1.0,0.0,1520,1530
1973-05-06,Albania,Romania,1,4,3,0.0,1.0,1473,1701
1973-05-06,Ecuador,Bolivia,0,0,0,0.5,0.5,1434,1529
1973-05-06,Iran,Kuwait,2,1,1,1.0,0.0,1602,1524
1973-05-06,North Korea,Syria,1,1,0,0.5,0.5,1655,1524
1973-05-08,Iran,Syria,1,0,1,1.0,0.0,1609,1518
1973-05-08,North Korea,Kuwait,0,0,0,0.5,0.5,1653,1527
1973-05-08,Northern Ireland,Cyprus,3,0,3,1.0,0.0,1618,1434
1973-05-09,Germany,Yugoslavia,0,1,1,0.0,1.0,1878,1788
1973-05-09,Switzerland,Turkey,0,0,0,0.5,0.5,1623,1599
1973-05-09,Guernsey,Jersey,1,4,3,0.0,1.0,1611,1697
1973-05-11,Iran,North Korea,2,1,1,1.0,0.0,1619,1644
1973-05-11,Syria,Kuwait,2,0,2,1.0,0.0,1527,1519
1973-05-12,England,Northern Ireland,2,1,1,1.0,0.0,1876,1616
1973-05-12,Germany,Bulgaria,3,0,3,1.0,0.0,1883,1737
1973-05-12,Haiti,Ecuador,1,2,1,0.0,1.0,1615,1447
1973-05-12,Wales,Scotland,0,2,2,0.0,1.0,1599,1717
1973-05-13,Chile,Peru,2,0,2,1.0,0.0,1663,1658
1973-05-13,Iran,Kuwait,2,0,2,1.0,0.0,1625,1514
1973-05-13,North Korea,Syria,3,0,3,1.0,0.0,1650,1522
1973-05-13,Poland,Yugoslavia,2,2,0,0.5,0.5,1697,1786
1973-05-13,Russia,Republic of Ireland,1,0,1,1.0,0.0,1816,1569
1973-05-15,England,Wales,3,0,3,1.0,0.0,1879,1597
1973-05-15,Haiti,Ecuador,1,0,1,1.0,0.0,1620,1443
1973-05-15,Iran,Syria,0,1,1,0.0,1.0,1615,1533
1973-05-15,North Korea,Kuwait,0,2,2,0.0,1.0,1640,1525
1973-05-16,German DR,Hungary,2,1,1,1.0,0.0,1743,1789
1973-05-16,Israel,Japan,2,1,1,1.0,0.0,1589,1602
1973-05-16,Poland,Republic of Ireland,2,0,2,1.0,0.0,1703,1564
1973-05-16,Scotland,Northern Ireland,1,2,1,0.0,1.0,1707,1627
1973-05-16,Thailand,Vietnam Republic,0,1,1,0.0,1.0,1518,1561
1973-05-17,Argentina,Uruguay,1,1,0,0.5,0.5,1774,1710
1973-05-17,Hong Kong,Malaysia,1,0,1,1.0,0.0,1492,1598
1973-05-19,England,Scotland,1,0,1,1.0,0.0,1884,1703
1973-05-19,France,Republic of Ireland,1,1,0,0.5,0.5,1678,1567
1973-05-19,Israel,Malaysia,3,0,3,1.0,0.0,1598,1590
1973-05-19,South Korea,Thailand,4,0,4,1.0,0.0,1696,1514
1973-05-19,Northern Ireland,Wales,1,0,1,1.0,0.0,1635,1590
1973-05-20,Ivory Coast,Morocco,1,1,0,0.5,0.5,1617,1594
1973-05-20,Vietnam Republic,Japan,0,4,4,0.0,1.0,1554,1610
1973-05-21,Israel,Thailand,6,0,6,1.0,0.0,1605,1508
1973-05-21,South Korea,Malaysia,0,0,0,0.5,0.5,1694,1593
1973-05-22,Japan,Hong Kong,0,1,1,0.0,1.0,1600,1503
1973-05-23,South Korea,Israel,0,0,0,0.5,0.5,1692,1608
1973-05-23,Sweden,Austria,3,2,1,1.0,0.0,1782,1707
1973-05-23,Thailand,Malaysia,0,2,2,0.0,1.0,1502,1600
1973-05-23,Uruguay,Argentina,1,1,0,0.5,0.5,1712,1773
1973-05-24,Hong Kong,Vietnam Republic,1,0,1,1.0,0.0,1513,1545
1973-05-26,Israel,Japan,1,0,1,1.0,0.0,1616,1593
1973-05-26,South Korea,Hong Kong,3,1,2,1.0,0.0,1697,1509
1973-05-26,Russia,France,2,0,2,1.0,0.0,1821,1674
1973-05-27,Brazil,Bolivia,5,0,5,1.0,0.0,1951,1528
1973-05-27,Cameroon,DR Congo,2,1,1,1.0,0.0,1561,1643
1973-05-27,Mali,Guinea,2,2,0,0.5,0.5,1553,1604
1973-05-27,Uganda,Algeria,2,1,1,1.0,0.0,1591,1566
1973-05-27,Tanzania,Mauritius,1,1,0,0.5,0.5,1493,1540
1973-05-27,Czechoslovakia,England,1,1,0,0.5,0.5,1721,1881
1973-05-27,Haiti,Colombia,1,2,1,0.0,1.0,1609,1465
1973-05-27,Romania,German DR,1,0,1,1.0,0.0,1710,1735
1973-05-28,South Korea,Israel,1,0,1,1.0,0.0,1704,1610
1973-05-29,Haiti,Colombia,2,1,1,1.0,0.0,1614,1461
1973-06-02,Czechoslovakia,Denmark,6,0,6,1.0,0.0,1726,1575
1973-06-03,Algeria,Brazil,0,2,2,0.0,1.0,1565,1953
1973-06-03,Morocco,Ivory Coast,4,1,3,1.0,0.0,1603,1609
1973-06-05,Zambia,Madagascar,3,1,2,1.0,0.0,1628,1530
1973-06-05,Madagascar,Zambia,2,1,1,1.0,0.0,1541,1618
1973-06-06,Finland,German DR,1,5,4,0.0,1.0,1441,1738
1973-06-06,Haiti,Uruguay,0,0,0,0.5,0.5,1617,1710
1973-06-06,Norway,Republic of Ireland,1,1,0,0.5,0.5,1523,1566
1973-06-06,Poland,England,2,0,2,1.0,0.0,1715,1870
1973-06-06,Tunisia,Brazil,1,4,3,0.0,1.0,1549,1955
1973-06-08,Faroe Islands,Iceland,0,4,4,0.0,1.0,1482,1434
1973-06-09,Italy,Brazil,2,0,2,1.0,0.0,1840,1945
1973-06-10,China PR,Pakistan,7,4,3,1.0,0.0,1679,1466
1973-06-10,Russia,England,1,2,1,0.0,1.0,1815,1877
1973-06-12,Myanmar,Malaysia,2,2,0,0.5,0.5,1735,1604
1973-06-13,Austria,Brazil,1,1,0,0.5,0.5,1712,1941
1973-06-13,Hungary,Sweden,3,3,0,0.5,0.5,1789,1783
1973-06-14,Algeria,Uganda,1,1,0,0.5,0.5,1566,1591
1973-06-14,Guinea,Mali,1,1,0,0.5,0.5,1603,1555
1973-06-14,Mauritius,Tanzania,1,1,0,0.5,0.5,1539,1495
1973-06-14,DR Congo,Cameroon,2,0,2,1.0,0.0,1650,1555
1973-06-14,Indonesia,Malaysia,2,0,2,1.0,0.0,1594,1596
1973-06-14,Italy,England,2,0,2,1.0,0.0,1849,1869
1973-06-16,Germany,Brazil,0,1,1,0.0,1.0,1877,1948
1973-06-17,China PR,Somalia,7,4,3,1.0,0.0,1683,1475
1973-06-18,Indonesia,Myanmar,0,0,0,0.5,0.5,1598,1732
1973-06-21,Colombia,Ecuador,1,1,0,0.5,0.5,1461,1444
1973-06-21,Denmark,Norway,1,0,1,1.0,0.0,1582,1517
1973-06-21,Russia,Brazil,0,1,1,0.0,1.0,1810,1954
1973-06-22,Switzerland,Scotland,1,0,1,1.0,0.0,1633,1694
1973-06-23,South Korea,Japan,2,0,2,1.0,0.0,1710,1588
1973-06-24,Colombia,Uruguay,0,0,0,0.5,0.5,1466,1706
1973-06-25,Sweden,Brazil,1,0,1,1.0,0.0,1795,1943
1973-06-28,Ecuador,Colombia,1,1,0,0.5,0.5,1445,1466
1973-06-30,Scotland,Brazil,0,1,1,0.0,1.0,1691,1947
1973-07-01,Ecuador,Uruguay,1,2,1,0.0,1.0,1443,1709
1973-07-01,Peru,Colombia,3,1,2,1.0,0.0,1662,1463
1973-07-03,Republic of Ireland,Brazil,3,4,1,0.0,1.0,1565,1949
1973-07-05,Tanzania,Congo,2,1,1,1.0,0.0,1505,1558
1973-07-05,Uruguay,Colombia,0,1,1,0.0,1.0,1697,1476
1973-07-06,Malawi,Mauritius,4,1,3,1.0,0.0,1497,1530
1973-07-08,Malawi,Mauritius,1,0,1,1.0,0.0,1506,1522
1973-07-08,Sweden,Finland,1,1,0,0.5,0.5,1789,1448
1973-07-08,Uruguay,Ecuador,4,0,4,1.0,0.0,1701,1440
1973-07-11,Sweden,Iceland,1,0,1,1.0,0.0,1791,1433
1973-07-13,Argentina,Chile,5,4,1,1.0,0.0,1779,1658
1973-07-15,Bolivia,Peru,2,0,2,1.0,0.0,1539,1652
1973-07-15,Ghana,Ivory Coast,0,3,3,0.0,1.0,1647,1619
1973-07-15,Zambia,Nigeria,5,1,4,1.0,0.0,1628,1660
1973-07-15,Mauritius,Réunion,1,1,0,0.5,0.5,1520,1412
1973-07-15,Nigeria,Zambia,3,2,1,1.0,0.0,1668,1621
1973-07-16,Egypt,Tanzania,10,1,9,1.0,0.0,1658,1501
1973-07-17,Iceland,German DR,1,2,1,0.0,1.0,1431,1741
1973-07-18,Chile,Argentina,3,1,2,1.0,0.0,1669,1769
1973-07-19,Iceland,German DR,0,2,2,0.0,1.0,1429,1744
1973-07-19,Israel,Uruguay,1,2,1,0.0,1.0,1605,1707
1973-07-21,Syria,Palestine,1,1,0,0.5,0.5,1532,1480
1973-07-24,Chile,Bolivia,3,0,3,1.0,0.0,1675,1534
1973-07-25,Norway,North Korea,3,0,3,1.0,0.0,1528,1630
1973-07-26,Cambodia,Singapore,1,1,0,0.5,0.5,1491,1452
1973-07-26,Malaysia,Kuwait,0,0,0,0.5,0.5,1595,1527
1973-07-27,Argentina,Peru,3,1,2,1.0,0.0,1775,1647
1973-07-27,Bangladesh,Thailand,2,2,0,0.5,0.5,1501,1502
1973-07-27,India,Vietnam Republic,2,1,1,1.0,0.0,1573,1538
1973-07-28,Myanmar,South Korea,0,0,0,0.5,0.5,1732,1711
1973-07-28,Kuwait,Singapore,2,0,2,1.0,0.0,1534,1446
1973-07-29,Ivory Coast,Central African Republic,5,1,4,1.0,0.0,1624,1472
1973-07-29,Bangladesh,Vietnam Republic,1,1,0,0.5,0.5,1502,1538
1973-07-29,India,Thailand,2,0,2,1.0,0.0,1580,1496
1973-07-29,Ivory Coast,Ghana,1,0,1,1.0,0.0,1633,1639
1973-07-30,Malaysia,South Korea,1,2,1,0.0,1.0,1590,1717
1973-07-30,Myanmar,Singapore,1,0,1,1.0,0.0,1735,1444
1973-07-31,Bangladesh,Kuwait,1,2,1,0.0,1.0,1495,1542
1973-08-01,Canada,Poland,1,3,2,0.0,1.0,1507,1719
1973-08-01,South Korea,Thailand,0,0,0,0.5,0.5,1713,1501
1973-08-02,Bangladesh,Singapore,1,1,0,0.5,0.5,1494,1446
1973-08-02,Myanmar,Vietnam Republic,2,1,1,1.0,0.0,1739,1535
1973-08-02,Iceland,Norway,0,4,4,0.0,1.0,1424,1534
1973-08-03,China PR,Guinea,5,2,3,1.0,0.0,1690,1597
1973-08-03,Cambodia,South Korea,0,1,1,0.0,1.0,1488,1717
1973-08-03,United States,Poland,0,1,1,0.0,1.0,1447,1722
1973-08-03,Malaysia,Thailand,2,2,0,0.5,0.5,1588,1504
1973-08-03,Malaysia,Cambodia,1,0,1,1.0,0.0,1594,1483
1973-08-03,Malaysia,India,4,0,4,1.0,0.0,1602,1573
1973-08-05,India,Cambodia,3,0,3,1.0,0.0,1579,1478
1973-08-05,Myanmar,Kuwait,2,0,2,1.0,0.0,1743,1539
1973-08-05,India,South Korea,0,0,0,0.5,0.5,1583,1714
1973-08-05,Canada,United States,0,2,2,0.0,1.0,1498,1457
1973-08-05,Chile,Peru,2,1,1,1.0,0.0,1683,1640
1973-08-05,Ghana,DR Congo,1,0,1,1.0,0.0,1648,1642
1973-08-05,Mexico,Poland,0,1,1,0.0,1.0,1759,1732
1973-08-05,Russia,Sweden,0,0,0,0.5,0.5,1810,1792
1973-08-05,Singapore,Vietnam Republic,0,1,1,0.0,1.0,1441,1541
1973-08-06,Cambodia,Thailand,1,4,3,0.0,1.0,1471,1512
1973-08-06,Eswatini,Malawi,0,1,1,0.0,1.0,1498,1514
1973-08-08,Bangladesh,Myanmar,0,6,6,0.0,1.0,1491,1747
1973-08-08,Kuwait,Vietnam Republic,2,1,1,1.0,0.0,1548,1533
1973-08-08,Mexico,Poland,1,2,1,0.0,1.0,1751,1741
1973-08-09,India,Vietnam Republic,1,1,0,0.5,0.5,1582,1535
1973-08-10,Cambodia,Singapore,0,3,3,0.0,1.0,1463,1450
1973-08-10,Malaysia,Myanmar,2,1,1,1.0,0.0,1614,1736
1973-08-10,United States,Poland,0,4,4,0.0,1.0,1455,1744
1973-08-11,Libya,United Arab Emirates,2,2,0,0.5,0.5,1505,1485
1973-08-11,South Korea,Kuwait,0,1,1,0.0,1.0,1703,1560
1973-08-11,South Korea,Myanmar,1,2,1,0.0,1.0,1696,1744
1973-08-12,Bangladesh,Thailand,0,2,2,0.0,1.0,1484,1520
1973-08-12,Egypt,Yemen DPR,6,1,5,1.0,0.0,1663,1497
1973-08-12,Malaysia,Kuwait,3,1,2,1.0,0.0,1621,1554
1973-08-12,New Zealand,Iran,0,0,0,0.5,0.5,1544,1614
1973-08-12,United States,Poland,1,0,1,1.0,0.0,1469,1731
1973-08-12,Zambia,Kenya,2,0,2,1.0,0.0,1628,1560
1973-08-13,Algeria,United Arab Emirates,2,0,2,1.0,0.0,1573,1479
1973-08-13,Iraq,Yemen,2,0,2,1.0,0.0,1619,1445
1973-08-13,Singapore,Bangladesh,0,1,1,0.0,1.0,1443,1492
1973-08-13,Palestine,Yemen DPR,1,0,1,1.0,0.0,1489,1489
1973-08-13,Syria,Tunisia,1,4,3,0.0,1.0,1525,1557
1973-08-14,Libya,Yemen,10,0,10,1.0,0.0,1512,1439
1973-08-15,Algeria,Iraq,0,0,0,0.5,0.5,1575,1618
1973-08-15,Congo,Uganda,3,2,1,1.0,0.0,1567,1583
1973-08-15,Egypt,Tunisia,0,1,1,0.0,1.0,1653,1568
1973-08-15,Singapore,India,4,5,1,0.0,1.0,1439,1587
1973-08-16,Yemen,United Arab Emirates,1,1,0,0.5,0.5,1440,1479
1973-08-16,Syria,Yemen DPR,7,1,6,1.0,0.0,1533,1482
1973-08-16,Egypt,Palestine,2,0,2,1.0,0.0,1658,1485
1973-08-17,Algeria,Yemen,15,1,14,1.0,0.0,1581,1435
1973-08-18,Australia,Iran,3,0,3,1.0,0.0,1677,1608
1973-08-18,Libya,Iraq,0,0,0,0.5,0.5,1515,1616
1973-08-19,Bulgaria,Poland,0,2,2,0.0,1.0,1729,1740
1973-08-19,DR Congo,Ghana,4,1,3,1.0,0.0,1651,1640
1973-08-19,Kenya,Zambia,2,2,0,0.5,0.5,1562,1627
1973-08-19,Tunisia,Yemen DPR,2,0,2,1.0,0.0,1575,1476
1973-08-20,Egypt,Syria,0,2,2,0.0,1.0,1648,1544
1973-08-20,Iraq,United Arab Emirates,3,1,2,1.0,0.0,1621,1475
1973-08-21,Libya,Algeria,0,2,2,0.0,1.0,1509,1588
1973-08-21,Palestine,Tunisia,2,6,4,0.0,1.0,1480,1581
1973-08-22,Netherlands,Iceland,5,0,5,1.0,0.0,1699,1422
1973-08-23,Algeria,Syria,0,0,0,0.5,0.5,1587,1546
1973-08-23,Iraq,Tunisia,0,2,2,0.0,1.0,1613,1590
1973-08-24,Iran,Australia,2,0,2,1.0,0.0,1618,1668
1973-08-25,Algeria,Iraq,0,0,0,0.5,0.5,1588,1613
1973-08-26,Syria,Tunisia,0,4,4,0.0,1.0,1540,1597
1973-08-29,Finland,Sweden,1,2,1,0.0,1.0,1447,1794
1973-08-29,Netherlands,Iceland,8,1,7,1.0,0.0,1702,1420
1973-09-01,Singapore,Thailand,1,0,1,1.0,0.0,1449,1511
1973-09-02,Bolivia,Paraguay,1,2,1,0.0,1.0,1529,1676
1973-09-02,Malaysia,Thailand,1,1,0,0.5,0.5,1619,1514
1973-09-02,Myanmar,Laos,8,0,8,1.0,0.0,1746,1396
1973-09-03,Myanmar,Vietnam Republic,3,2,1,1.0,0.0,1750,1532
1973-09-04,Singapore,Malaysia,0,0,0,0.5,0.5,1453,1616
1973-09-04,Vietnam Republic,Laos,5,1,4,1.0,0.0,1538,1391
1973-09-04,Singapore,Malaysia,0,3,3,0.0,1.0,1449,1621
1973-09-05,Russia,Germany,0,1,1,0.0,1.0,1804,1884
1973-09-06,Myanmar,Malaysia,1,0,1,1.0,0.0,1756,1616
1973-09-06,Singapore,Vietnam Republic,1,1,0,0.5,0.5,1452,1536
1973-09-08,France,Greece,3,1,2,1.0,0.0,1680,1534
1973-09-08,Myanmar,Vietnam Republic,3,2,1,1.0,0.0,1760,1533
1973-09-09,Argentina,Bolivia,4,0,4,1.0,0.0,1779,1526
1973-09-09,United States,Bermuda,1,0,1,1.0,0.0,1477,1454
1973-09-12,Norway,Netherlands,1,2,1,0.0,1.0,1530,1707
1973-09-16,Paraguay,Argentina,1,1,0,0.5,0.5,1679,1777
1973-09-20,Mexico,Chile,1,2,1,0.0,1.0,1742,1693
1973-09-22,Myanmar,Thailand,2,2,0,0.5,0.5,1756,1519
1973-09-22,South Korea,Cambodia,6,0,6,1.0,0.0,1700,1460
1973-09-22,Uganda,Somalia,6,1,5,1.0,0.0,1589,1470
1973-09-23,Bolivia,Argentina,0,1,1,0.0,1.0,1523,1781
1973-09-23,Kenya,Zanzibar,2,0,2,1.0,0.0,1566,1342
1973-09-23,Norway,Denmark,0,1,1,0.0,1.0,1524,1589
1973-09-24,South Korea,Indonesia,3,1,2,1.0,0.0,1706,1593
1973-09-24,Malaysia,Thailand,5,1,4,1.0,0.0,1622,1514
1973-09-24,Somalia,Zambia,1,6,5,0.0,1.0,1466,1632
1973-09-25,Tanzania,Zanzibar,1,0,1,1.0,0.0,1506,1338
1973-09-26,Myanmar,Malaysia,1,3,2,0.0,1.0,1746,1633
1973-09-26,England,Austria,7,0,7,1.0,0.0,1874,1708
1973-09-26,German DR,Romania,2,0,2,1.0,0.0,1752,1703
1973-09-26,Indonesia,Cambodia,2,3,1,0.0,1.0,1583,1471
1973-09-26,Northern Ireland,Bulgaria,0,0,0,0.5,0.5,1638,1727
1973-09-26,Poland,Wales,3,0,3,1.0,0.0,1745,1586
1973-09-26,Russia,Chile,0,0,0,0.5,0.5,1802,1696
1973-09-26,Scotland,Czechoslovakia,2,1,1,1.0,0.0,1700,1718
1973-09-26,Switzerland,Luxembourg,1,0,1,1.0,0.0,1637,1394
1973-09-26,Uganda,Zambia,1,1,0,0.5,0.5,1590,1632
1973-09-26,Yugoslavia,Hungary,1,1,0,0.5,0.5,1787,1789
1973-09-27,Kenya,Tanzania,1,2,1,0.0,1.0,1557,1516
1973-09-28,Cambodia,Malaysia,2,0,2,1.0,0.0,1483,1622
1973-09-28,South Korea,Myanmar,0,1,1,0.0,1.0,1699,1754
1973-09-28,Malta,Canada,2,0,2,1.0,0.0,1483,1490
1973-09-28,Uganda,Zambia,2,1,1,1.0,0.0,1599,1624
1973-09-29,Italy,Sweden,2,0,2,1.0,0.0,1856,1788
1973-09-29,Uganda,Tanzania,2,1,1,1.0,0.0,1606,1510
1973-09-30,Myanmar,Cambodia,0,0,0,0.5,0.5,1749,1489
1973-09-30,South Korea,Malaysia,2,0,2,1.0,0.0,1706,1616
1973-09-30,Malta,Canada,0,0,0,0.5,0.5,1484,1490
1973-09-30,Paraguay,Bolivia,4,0,4,1.0,0.0,1684,1519
1973-10-07,Argentina,Paraguay,3,1,2,1.0,0.0,1787,1679
1973-10-07,Luxembourg,Canada,0,2,2,0.0,1.0,1389,1496
1973-10-10,Albania,Finland,1,0,1,1.0,0.0,1481,1440
1973-10-10,Germany,Austria,4,0,4,1.0,0.0,1889,1704
1973-10-10,Netherlands,Poland,1,1,0,0.5,0.5,1708,1745
1973-10-11,Trinidad and Tobago,Martinique,2,0,2,1.0,0.0,1618,1552
1973-10-13,Denmark,Hungary,2,2,0,0.5,0.5,1594,1785
1973-10-13,Germany,France,2,1,1,1.0,0.0,1893,1677
1973-10-13,Portugal,Bulgaria,2,2,0,0.5,0.5,1727,1727
1973-10-14,Romania,Finland,9,0,9,1.0,0.0,1706,1438
1973-10-16,Mexico,United States,2,0,2,1.0,0.0,1745,1475
1973-10-17,Czechoslovakia,Scotland,1,0,1,1.0,0.0,1726,1693
1973-10-17,England,Poland,1,1,0,0.5,0.5,1872,1748
1973-10-17,German DR,Russia,1,0,1,1.0,0.0,1762,1793
1973-10-17,Turkey,Spain,0,0,0,0.5,0.5,1603,1778
1973-10-20,Italy,Switzerland,2,0,2,1.0,0.0,1860,1634
1973-10-21,Republic of Ireland,Poland,1,0,1,1.0,0.0,1577,1737
1973-10-21,Yugoslavia,Spain,0,0,0,0.5,0.5,1787,1779
1973-10-21,Zambia,Morocco,4,0,4,1.0,0.0,1632,1596
1973-10-27,Curaçao,Suriname,1,1,0,0.5,0.5,1560,1651
1973-10-28,Australia,South Korea,0,0,0,0.5,0.5,1669,1706
1973-10-29,Curaçao,Suriname,2,2,0,0.5,0.5,1563,1649
1973-10-31,Algeria,Morocco,2,0,2,1.0,0.0,1597,1588
1973-10-31,Belgium,Norway,2,0,2,1.0,0.0,1738,1521
1973-11-01,Vietnam Republic,Malaysia,1,5,4,0.0,1.0,1527,1623
1973-11-03,Haiti,United States,1,0,1,1.0,0.0,1622,1471
1973-11-03,Malaysia,Singapore,2,1,1,1.0,0.0,1628,1448
1973-11-04,Guyana,Jamaica,2,1,1,1.0,0.0,1447,1470
1973-11-04,Vietnam Republic,Singapore,4,2,2,1.0,0.0,1534,1442
1973-11-04,Zambia,DR Congo,0,2,2,0.0,1.0,1625,1659
1973-11-05,Haiti,United States,1,0,1,1.0,0.0,1627,1467
1973-11-06,Barbados,Suriname,0,2,2,0.0,1.0,1456,1654
1973-11-06,Guadeloupe,Martinique,0,2,2,0.0,1.0,1522,1560
1973-11-07,Albania,China PR,1,1,0,0.5,0.5,1486,1686
1973-11-07,Dominica,Grenada,4,2,2,1.0,0.0,1450,1561
1973-11-09,Guyana,Suriname,0,2,2,0.0,1.0,1444,1658
1973-11-10,Haiti,Canada,5,1,4,1.0,0.0,1633,1491
1973-11-10,South Korea,Australia,2,2,0,0.5,0.5,1706,1670
1973-11-11,Dominica,Saint Lucia,1,0,1,1.0,0.0,1460,1504
1973-11-11,Malta,Sweden,1,2,1,0.0,1.0,1482,1791
1973-11-11,Saint Vincent and the Grenadines,Grenada,4,1,3,1.0,0.0,1551,1553
1973-11-12,Haiti,Canada,0,1,1,0.0,1.0,1622,1503
1973-11-13,Albania,German DR,1,4,3,0.0,1.0,1484,1765
1973-11-13,Australia,South Korea,1,0,1,1.0,0.0,1679,1698
1973-11-13,Israel,United States,3,1,2,1.0,0.0,1610,1463
1973-11-14,England,Italy,0,1,1,0.0,1.0,1864,1869
1973-11-14,Portugal,Northern Ireland,1,1,0,0.5,0.5,1725,1641
1973-11-14,Scotland,Germany,1,1,0,0.5,0.5,1698,1889
1973-11-15,Israel,United States,2,0,2,1.0,0.0,1615,1459
1973-11-15,Saint Lucia,Grenada,1,3,2,0.0,1.0,1498,1560
1973-11-16,Saint Lucia,Dominica,2,1,1,1.0,0.0,1506,1453
1973-11-18,Bulgaria,Cyprus,2,0,2,1.0,0.0,1730,1432
1973-11-18,DR Congo,Zambia,2,1,1,1.0,0.0,1667,1618
1973-11-18,Netherlands,Belgium,0,0,0,0.5,0.5,1709,1738
1973-11-18,Turkey,Switzerland,2,0,2,1.0,0.0,1612,1626
1973-11-19,Saint Vincent and the Grenadines,Dominica,2,2,0,0.5,0.5,1549,1456
1973-11-21,France,Denmark,3,0,3,1.0,0.0,1684,1588
1973-11-21,Grenada,Dominica,1,1,0,0.5,0.5,1558,1459
1973-11-21,Hungary,German DR,0,1,1,0.0,1.0,1777,1774
1973-11-23,Saint Vincent and the Grenadines,Saint Lucia,2,0,2,1.0,0.0,1557,1499
1973-11-24,Germany,Spain,2,1,1,1.0,0.0,1895,1774
1973-11-25,Morocco,Zambia,2,0,2,1.0,0.0,1597,1610
1973-11-27,Austria,Sweden,1,2,1,0.0,1.0,1698,1798
1973-11-27,Saint Lucia,Saint Vincent and the Grenadines,0,1,1,0.0,1.0,1493,1564
1973-11-29,Grenada,Saint Lucia,2,0,2,1.0,0.0,1565,1487
1973-11-29,Honduras,Trinidad and Tobago,2,1,1,1.0,0.0,1562,1609
1973-11-30,Dominica,Saint Vincent and the Grenadines,0,0,0,0.5,0.5,1462,1562
1973-11-30,Guatemala,Mexico,0,0,0,0.5,0.5,1618,1743
1973-12-01,Haiti,Curaçao,3,0,3,1.0,0.0,1629,1557
1973-12-02,Panama,Nicaragua,2,0,2,1.0,0.0,1434,1357
1973-12-03,Myanmar,Vietnam Republic,0,1,1,0.0,1.0,1737,1547
1973-12-03,Honduras,Mexico,1,1,0,0.5,0.5,1566,1740
1973-12-04,Haiti,Trinidad and Tobago,2,1,1,1.0,0.0,1637,1602
1973-12-05,Guatemala,Curaçao,2,2,0,0.5,0.5,1617,1559
1973-12-07,Haiti,Honduras,1,0,1,1.0,0.0,1644,1560
1973-12-08,Kenya,Uganda,2,2,0,0.5,0.5,1559,1605
1973-12-08,Mexico,Curaçao,8,0,8,1.0,0.0,1745,1555
1973-12-09,DR Congo,Morocco,3,0,3,1.0,0.0,1674,1591
1973-12-10,Guatemala,Trinidad and Tobago,0,1,1,0.0,1.0,1609,1611
1973-12-10,Uganda,Zambia,2,0,2,1.0,0.0,1614,1602
1973-12-12,Honduras,Curaçao,2,2,0,0.5,0.5,1560,1556
1973-12-12,Kenya,Zambia,3,1,2,1.0,0.0,1568,1594
1973-12-13,Haiti,Guatemala,2,1,1,1.0,0.0,1652,1602
1973-12-14,Mexico,Trinidad and Tobago,0,4,4,0.0,1.0,1735,1622
1973-12-15,Guatemala,Honduras,1,1,0,0.5,0.5,1602,1561
1973-12-15,Laos,Singapore,3,2,1,1.0,0.0,1401,1433
1973-12-15,Thailand,Myanmar,2,1,1,1.0,0.0,1527,1725
1973-12-16,Cambodia,South Korea,0,5,5,0.0,1.0,1486,1702
1973-12-17,Myanmar,Singapore,6,1,5,1.0,0.0,1728,1431
1973-12-17,Curaçao,Trinidad and Tobago,0,4,4,0.0,1.0,1550,1629
1973-12-17,Thailand,Laos,5,0,5,1.0,0.0,1533,1396
1973-12-18,Haiti,Mexico,0,1,1,0.0,1.0,1646,1742
1973-12-18,South Korea,Malaysia,0,0,0,0.5,0.5,1701,1630
1973-12-19,Myanmar,Laos,2,1,1,1.0,0.0,1731,1394
1973-12-19,Greece,Yugoslavia,2,4,2,0.0,1.0,1531,1791
1973-12-19,Thailand,Singapore,3,0,3,1.0,0.0,1539,1426
1973-12-20,Cambodia,Malaysia,2,3,1,0.0,1.0,1482,1635
1973-12-21,Congo,Tunisia,0,1,1,0.0,1.0,1560,1605
1973-12-22,Myanmar,South Korea,0,2,2,0.0,1.0,1723,1710
1973-12-23,Thailand,Malaysia,0,1,1,0.0,1.0,1534,1641
1973-12-25,South Korea,Malaysia,2,1,1,1.0,0.0,1717,1635
1973-12-25,Thailand,Myanmar,1,0,1,1.0,0.0,1546,1712
1973-12-30,Guinea,Tunisia,0,0,0,0.5,0.5,1598,1605
1974-01-01,Uganda,Congo,0,2,2,0.0,1.0,1605,1570
1974-01-06,Mali,Tunisia,1,0,1,1.0,0.0,1565,1596
1974-01-13,Mauritius,Malawi,4,1,3,1.0,0.0,1528,1507
1974-01-17,Mauritius,Malawi,2,1,1,1.0,0.0,1536,1500
1974-01-17,Pakistan,Iran,1,2,1,0.0,1.0,1462,1623
1974-01-18,Pakistan,Turkey,2,2,0,0.5,0.5,1466,1609
1974-01-20,Iran,Turkey,0,1,1,0.0,1.0,1615,1618
1974-01-20,Mauritius,Malawi,2,2,0,0.5,0.5,1536,1501
1974-01-25,Panama,El Salvador,1,0,1,1.0,0.0,1446,1569
1974-02-06,Cyprus,Bulgaria,1,4,3,0.0,1.0,1430,1733
1974-02-08,Kuwait,Bulgaria,1,3,2,0.0,1.0,1550,1738
1974-02-10,Kuwait,Bulgaria,1,2,1,0.0,1.0,1546,1743
1974-02-12,Singapore,Japan,0,1,1,0.0,1.0,1422,1593
1974-02-13,Yugoslavia,Spain,1,0,1,1.0,0.0,1799,1767
1974-02-15,Ghana,Guinea,5,2,3,1.0,0.0,1648,1591
1974-02-17,Congo,Mali,2,2,0,0.5,0.5,1570,1566
1974-02-17,Ghana,Guinea,3,1,2,1.0,0.0,1655,1585
1974-02-17,Tahiti,New Caledonia,2,1,1,1.0,0.0,1560,1585
1974-02-17,Tahiti,New Caledonia,1,2,1,0.0,1.0,1553,1593
1974-02-20,Hong Kong,Japan,0,0,0,0.5,0.5,1511,1592
1974-02-20,Tahiti,New Caledonia,2,2,0,0.5,0.5,1554,1593
1974-02-22,Iraq,Morocco,0,0,0,0.5,0.5,1613,1592
1974-02-23,Spain,Germany,1,0,1,1.0,0.0,1778,1885
1974-02-24,Iraq,Morocco,0,0,0,0.5,0.5,1613,1593
1974-02-25,Kuwait,Morocco,0,2,2,0.0,1.0,1540,1600
1974-02-26,Italy,Germany,0,0,0,0.5,0.5,1870,1885
1974-02-26,Tunisia,German DR,0,4,4,0.0,1.0,1592,1779
1974-02-27,Qatar,Morocco,0,1,1,0.0,1.0,1418,1605
1974-02-28,Algeria,German DR,1,3,2,0.0,1.0,1593,1784
1974-03-01,Bahrain,Morocco,0,1,1,0.0,1.0,1479,1611
1974-03-01,Egypt,Uganda,2,1,1,1.0,0.0,1656,1598
1974-03-02,Ivory Coast,Zambia,0,1,1,0.0,1.0,1625,1603
1974-03-03,Congo,Mauritius,2,0,2,1.0,0.0,1578,1529
1974-03-03,Guinea,DR Congo,1,2,1,0.0,1.0,1580,1680
1974-03-04,Egypt,Zambia,3,1,2,1.0,0.0,1663,1597
1974-03-04,Ivory Coast,Uganda,2,2,0,0.5,0.5,1625,1599
1974-03-05,Congo,DR Congo,2,1,1,1.0,0.0,1589,1670
1974-03-05,Guinea,Mauritius,2,1,1,1.0,0.0,1587,1523
1974-03-06,Egypt,Ivory Coast,2,0,2,1.0,0.0,1671,1618
1974-03-06,Saudi Arabia,Morocco,0,0,0,0.5,0.5,1517,1609
1974-03-06,Togo,Denmark,0,2,2,0.0,1.0,1520,1595
1974-03-06,Uganda,Zambia,0,1,1,0.0,1.0,1591,1606
1974-03-07,Congo,Guinea,1,1,0,0.5,0.5,1589,1588
1974-03-07,Mauritius,DR Congo,1,4,3,0.0,1.0,1519,1675
1974-03-09,Congo,Zambia,2,4,2,0.0,1.0,1582,1614
1974-03-09,Egypt,DR Congo,2,3,1,0.0,1.0,1664,1683
1974-03-10,Benin,Denmark,2,0,2,1.0,0.0,1518,1586
1974-03-11,Egypt,Congo,4,0,4,1.0,0.0,1671,1576
1974-03-12,DR Congo,Zambia,2,2,0,0.5,0.5,1682,1616
1974-03-13,German DR,Belgium,1,0,1,1.0,0.0,1791,1732
1974-03-13,Réunion,Seychelles,2,0,2,1.0,0.0,1422,1491
1974-03-14,DR Congo,Zambia,2,0,2,1.0,0.0,1689,1610
1974-03-14,Puerto Rico,Panama,0,1,1,0.0,1.0,1382,1453
1974-03-15,Kuwait,United Arab Emirates,2,0,2,1.0,0.0,1547,1469
1974-03-16,Bahrain,Oman,4,0,4,1.0,0.0,1488,1485
1974-03-16,Qatar,Saudi Arabia,0,2,2,0.0,1.0,1413,1523
1974-03-18,Bahrain,United Arab Emirates,0,4,4,0.0,1.0,1480,1478
1974-03-19,Kuwait,Oman,5,0,5,1.0,0.0,1554,1479
1974-03-21,Bahrain,Saudi Arabia,1,4,3,0.0,1.0,1473,1531
1974-03-22,Oman,Qatar,0,4,4,0.0,1.0,1470,1423
1974-03-23,France,Romania,1,0,1,1.0,0.0,1693,1698
1974-03-23,Haiti,Uruguay,0,1,1,0.0,1.0,1640,1714
1974-03-23,Saudi Arabia,United Arab Emirates,2,0,2,1.0,0.0,1538,1472
1974-03-24,Kuwait,Qatar,1,0,1,1.0,0.0,1560,1418
1974-03-25,Haiti,Uruguay,0,0,0,0.5,0.5,1642,1713
1974-03-26,Kuwait,United Arab Emirates,6,0,6,1.0,0.0,1567,1466
1974-03-26,Qatar,Saudi Arabia,1,3,2,0.0,1.0,1413,1544
1974-03-27,German DR,Czechoslovakia,1,0,1,1.0,0.0,1798,1720
1974-03-27,Germany,Scotland,2,1,1,1.0,0.0,1890,1694
1974-03-27,Netherlands,Austria,1,1,0,0.5,0.5,1709,1699
1974-03-28,Jamaica,Uruguay,0,3,3,0.0,1.0,1467,1717
1974-03-28,Qatar,United Arab Emirates,1,1,0,0.5,0.5,1415,1465
1974-03-29,Kuwait,Saudi Arabia,4,0,4,1.0,0.0,1575,1537
1974-03-30,Guernsey,Alderney,6,0,6,1.0,0.0,1614,1315
1974-03-31,Brazil,Mexico,1,1,0,0.5,0.5,1945,1747
1974-03-31,Hungary,Bulgaria,3,1,2,1.0,0.0,1785,1736
1974-04-03,Portugal,England,0,0,0,0.5,0.5,1729,1861
1974-04-07,Brazil,Czechoslovakia,1,0,1,1.0,0.0,1949,1717
1974-04-07,Morocco,Algeria,2,0,2,1.0,0.0,1617,1586
1974-04-12,Bermuda,Canada,0,0,0,0.5,0.5,1456,1502
1974-04-13,Bulgaria,Czechoslovakia,0,1,1,0.0,1.0,1728,1726
1974-04-13,Haiti,Poland,2,1,1,1.0,0.0,1653,1727
1974-04-14,Brazil,Bulgaria,1,0,1,1.0,0.0,1953,1725
1974-04-15,Haiti,Poland,1,3,2,0.0,1.0,1647,1734
1974-04-17,Belgium,Poland,1,1,0,0.5,0.5,1733,1734
1974-04-17,Brazil,Romania,2,0,2,1.0,0.0,1956,1696
1974-04-17,Germany,Hungary,5,0,5,1.0,0.0,1896,1780
1974-04-17,Yugoslavia,Russia,0,1,1,0.0,1.0,1791,1802
1974-04-19,Indonesia,Uruguay,2,1,1,1.0,0.0,1594,1707
1974-04-21,Brazil,Haiti,4,0,4,1.0,0.0,1959,1645
1974-04-21,Indonesia,Uruguay,2,3,1,0.0,1.0,1589,1713
1974-04-22,Argentina,Romania,2,1,1,1.0,0.0,1793,1691
1974-04-24,Haiti,Chile,0,1,1,0.0,1.0,1639,1703
1974-04-26,Haiti,Chile,0,0,0,0.5,0.5,1641,1702
1974-04-27,Czechoslovakia,France,3,3,0,0.5,0.5,1726,1694
1974-04-28,Brazil,Greece,0,0,0,0.5,0.5,1953,1538
1974-05-01,Brazil,Austria,0,0,0,0.5,0.5,1949,1704
1974-05-01,Germany,Sweden,2,0,2,1.0,0.0,1902,1793
1974-05-01,Switzerland,Belgium,0,1,1,0.0,1.0,1621,1739
1974-05-02,Yemen DPR,Iraq,2,0,2,1.0,0.0,1488,1602
1974-05-05,Brazil,Republic of Ireland,2,1,1,1.0,0.0,1951,1576
1974-05-05,China PR,Sierra Leone,4,1,3,1.0,0.0,1690,1481
1974-05-08,Bulgaria,Turkey,5,1,4,1.0,0.0,1731,1613
1974-05-08,Uruguay,Republic of Ireland,2,0,2,1.0,0.0,1718,1572
1974-05-09,Jersey,Guernsey,1,2,1,0.0,1.0,1688,1624
1974-05-11,Scotland,Northern Ireland,0,1,1,0.0,1.0,1685,1651
1974-05-11,Wales,England,0,2,2,0.0,1.0,1584,1864
1974-05-12,Brazil,Paraguay,2,0,2,1.0,0.0,1954,1677
1974-05-12,Chile,Republic of Ireland,1,2,1,0.0,1.0,1692,1583
1974-05-13,South Korea,Cambodia,0,1,1,0.0,1.0,1705,1495
1974-05-14,Scotland,Wales,2,0,2,1.0,0.0,1691,1579
1974-05-15,England,Northern Ireland,1,0,1,1.0,0.0,1868,1648
1974-05-15,Poland,Greece,2,0,2,1.0,0.0,1738,1535
1974-05-16,Myanmar,Thailand,2,1,1,1.0,0.0,1717,1542
1974-05-18,France,Argentina,0,1,1,0.0,1.0,1689,1799
1974-05-18,South Korea,Myanmar,3,0,3,1.0,0.0,1714,1709
1974-05-18,Scotland,England,2,0,2,1.0,0.0,1703,1857
1974-05-18,Wales,Northern Ireland,1,0,1,1.0,0.0,1589,1639
1974-05-20,Myanmar,Cambodia,6,0,6,1.0,0.0,1713,1492
1974-05-20,Russia,Czechoslovakia,0,1,1,0.0,1.0,1793,1736
1974-05-21,Indonesia,Australia,1,2,1,0.0,1.0,1584,1685
1974-05-22,England,Argentina,2,2,0,0.5,0.5,1856,1801
1974-05-23,German DR,Norway,1,0,1,1.0,0.0,1801,1519
1974-05-25,Bulgaria,North Korea,6,1,5,1.0,0.0,1737,1625
1974-05-26,Netherlands,Argentina,4,1,3,1.0,0.0,1720,1791
1974-05-28,Israel,Australia,2,1,1,1.0,0.0,1625,1676
1974-05-29,German DR,England,1,1,0,0.5,0.5,1803,1855
1974-05-29,Hungary,Yugoslavia,3,2,1,1.0,0.0,1789,1783
1974-05-29,Romania,Greece,3,1,2,1.0,0.0,1696,1531
1974-06-01,Belgium,Scotland,2,1,1,1.0,0.0,1747,1696
1974-06-01,Bulgaria,England,0,1,1,0.0,1.0,1732,1861
1974-06-01,Indonesia,Myanmar,2,4,2,0.0,1.0,1579,1719
1974-06-02,Tunisia,Iraq,2,1,1,1.0,0.0,1601,1594
1974-06-03,Myanmar,Malaysia,3,0,3,1.0,0.0,1726,1629
1974-06-03,Denmark,Sweden,0,2,2,0.0,1.0,1583,1797
1974-06-05,Netherlands,Romania,0,0,0,0.5,0.5,1720,1697
1974-06-05,Yugoslavia,England,2,2,0,0.5,0.5,1785,1860
1974-06-06,Finland,Denmark,1,1,0,0.5,0.5,1442,1580
1974-06-06,Norway,Scotland,1,2,1,0.0,1.0,1515,1701
1974-06-07,Indonesia,Malaysia,4,3,1,1.0,0.0,1589,1620
1974-06-07,Libya,Iraq,1,0,1,1.0,0.0,1519,1585
1974-06-08,Austria,Italy,0,0,0,0.5,0.5,1708,1867
1974-06-09,South Korea,Malaysia,0,0,0,0.5,0.5,1712,1623
1974-06-09,Sweden,Switzerland,0,0,0,0.5,0.5,1794,1625
1974-06-13,Brazil,Yugoslavia,0,0,0,0.5,0.5,1951,1789
1974-06-14,DR Congo,Scotland,0,2,2,0.0,1.0,1682,1709
1974-06-14,German DR,Australia,2,0,2,1.0,0.0,1809,1671
1974-06-14,Germany,Chile,1,0,1,1.0,0.0,1906,1689
1974-06-15,Italy,Haiti,3,1,2,1.0,0.0,1871,1638
1974-06-15,Poland,Argentina,3,2,1,1.0,0.0,1748,1782
1974-06-15,Sweden,Bulgaria,0,0,0,0.5,0.5,1793,1734
1974-06-15,Uruguay,Netherlands,0,2,2,0.0,1.0,1711,1728
1974-06-18,Chile,German DR,1,1,0,0.5,0.5,1692,1807
1974-06-18,Germany,Australia,3,0,3,1.0,0.0,1910,1668
1974-06-18,Scotland,Brazil,0,0,0,0.5,0.5,1714,1947
1974-06-18,Yugoslavia,DR Congo,9,0,9,1.0,0.0,1795,1677
1974-06-19,Argentina,Italy,1,1,0,0.5,0.5,1785,1869
1974-06-19,Bulgaria,Uruguay,1,1,0,0.5,0.5,1734,1712
1974-06-19,Haiti,Poland,0,7,7,0.0,1.0,1633,1754
1974-06-19,Netherlands,Sweden,0,0,0,0.5,0.5,1730,1792
1974-06-22,Australia,Chile,0,0,0,0.5,0.5,1669,1692
1974-06-22,DR Congo,Brazil,0,3,3,0.0,1.0,1675,1950
1974-06-22,Germany,German DR,0,1,1,0.0,1.0,1900,1818
1974-06-22,Scotland,Yugoslavia,1,1,0,0.5,0.5,1716,1794
1974-06-23,Argentina,Haiti,4,1,3,1.0,0.0,1790,1629
1974-06-23,Bulgaria,Netherlands,1,4,3,0.0,1.0,1726,1739
1974-06-23,Poland,Italy,2,1,1,1.0,0.0,1765,1859
1974-06-23,Sweden,Uruguay,3,0,3,1.0,0.0,1799,1706
1974-06-26,Brazil,German DR,1,0,1,1.0,0.0,1956,1813
1974-06-26,Germany,Yugoslavia,2,0,2,1.0,0.0,1906,1789
1974-06-26,Mali,Congo,1,1,0,0.5,0.5,1567,1576
1974-06-26,Netherlands,Argentina,4,0,4,1.0,0.0,1749,1781
1974-06-26,Sweden,Poland,0,1,1,0.0,1.0,1791,1774
1974-06-30,Argentina,Brazil,1,2,1,0.0,1.0,1777,1961
1974-06-30,German DR,Netherlands,0,2,2,0.0,1.0,1804,1759
1974-06-30,Germany,Sweden,4,2,2,1.0,0.0,1912,1786
1974-06-30,Poland,Yugoslavia,2,1,1,1.0,0.0,1783,1781
1974-07-03,Argentina,German DR,1,1,0,0.5,0.5,1778,1804
1974-07-03,Faroe Islands,Iceland,2,3,1,0.0,1.0,1473,1430
1974-07-03,Germany,Poland,1,0,1,1.0,0.0,1918,1778
1974-07-03,Netherlands,Brazil,2,0,2,1.0,0.0,1772,1949
1974-07-03,Sweden,Yugoslavia,2,1,1,1.0,0.0,1794,1774
1974-07-04,China PR,Togo,4,2,2,1.0,0.0,1695,1516
1974-07-06,Brazil,Poland,0,1,1,0.0,1.0,1938,1790
1974-07-06,Malawi,Ivory Coast,5,1,4,1.0,0.0,1512,1608
1974-07-07,Germany,Netherlands,2,1,1,1.0,0.0,1923,1768
1974-07-07,Malawi,Tanzania,1,0,1,1.0,0.0,1520,1503
1974-07-08,Malawi,Zambia,0,1,1,0.0,1.0,1515,1616
1974-07-10,China PR,Yemen DPR,6,5,1,1.0,0.0,1699,1485
1974-07-14,Nigeria,Ivory Coast,2,0,2,1.0,0.0,1675,1602
1974-07-22,Silesia,Tanzania,7,2,5,1.0,0.0,1513,1496
1974-07-24,Hong Kong,Indonesia,2,2,0,0.5,0.5,1513,1588
1974-07-24,India,Thailand,4,2,2,1.0,0.0,1594,1536
1974-07-25,Malaysia,India,4,1,3,1.0,0.0,1631,1587
1974-07-26,Indonesia,Thailand,1,2,1,0.0,1.0,1579,1546
1974-07-28,Indonesia,Singapore,5,0,5,1.0,0.0,1584,1418
1974-07-29,Hong Kong,India,2,2,0,0.5,0.5,1515,1586
1974-07-30,Singapore,Thailand,1,1,0,0.5,0.5,1421,1544
1974-08-01,India,Indonesia,0,0,0,0.5,0.5,1586,1585
1974-08-01,Malaysia,Thailand,3,2,1,1.0,0.0,1638,1538
1974-08-04,Hong Kong,Thailand,1,0,1,1.0,0.0,1524,1530
1974-08-07,Singapore,Hong Kong,0,1,1,0.0,1.0,1416,1530
1974-08-08,Sweden,Norway,2,1,1,1.0,0.0,1797,1513
1974-08-10,Somalia,Burundi,0,2,2,0.0,1.0,1459,1488
1974-08-11,China PR,Senegal,5,2,3,1.0,0.0,1704,1516
1974-08-11,Nigeria,Ghana,1,1,0,0.5,0.5,1675,1656
1974-08-14,Iraq,Bahrain,4,0,4,1.0,0.0,1591,1468
1974-08-15,Norway,Finland,1,2,1,0.0,1.0,1504,1452
1974-08-17,Nigeria,Ghana,0,1,1,0.0,1.0,1667,1665
1974-08-19,Iceland,Finland,2,2,0,0.5,0.5,1431,1452
1974-08-24,Burundi,Somalia,0,1,1,0.0,1.0,1480,1468
1974-08-24,Malta,Libya,0,1,1,0.0,1.0,1475,1527
1974-08-30,Haiti,Jamaica,0,1,1,0.0,1.0,1618,1479
1974-08-31,Jamaica,Trinidad and Tobago,2,1,1,1.0,0.0,1491,1618
1974-09-01,Finland,Poland,1,2,1,0.0,1.0,1450,1793
1974-09-02,Kuwait,Thailand,3,2,1,1.0,0.0,1582,1524
1974-09-02,India,Iraq,0,3,3,0.0,1.0,1579,1599
1974-09-02,North Korea,China PR,2,0,2,1.0,0.0,1635,1695
1974-09-03,Denmark,Indonesia,9,0,9,1.0,0.0,1589,1577
1974-09-03,Japan,Philippines,4,0,4,1.0,0.0,1596,1360
1974-09-03,Israel,Malaysia,8,3,5,1.0,0.0,1634,1630
1974-09-03,Iran,Pakistan,7,0,7,1.0,0.0,1620,1462
1974-09-03,Myanmar,Bahrain,4,0,4,1.0,0.0,1729,1466
1974-09-04,Austria,Wales,2,1,1,1.0,0.0,1714,1584
1974-09-04,Libya,Malta,0,0,0,0.5,0.5,1526,1477
1974-09-04,Norway,Northern Ireland,2,1,1,1.0,0.0,1515,1629
1974-09-04,Poland,German DR,1,3,2,0.0,1.0,1786,1812
1974-09-04,Sweden,Netherlands,1,5,4,0.0,1.0,1789,1777
1974-09-04,Switzerland,Germany,1,2,1,0.0,1.0,1623,1926
1974-09-04,South Korea,Thailand,1,0,1,1.0,0.0,1717,1520
1974-09-04,China PR,India,7,1,6,1.0,0.0,1701,1574
1974-09-04,North Korea,Iraq,0,1,1,0.0,1.0,1627,1608
1974-09-05,Mexico,United States,3,1,2,1.0,0.0,1750,1457
1974-09-05,Israel,Philippines,6,0,6,1.0,0.0,1637,1358
1974-09-05,Japan,Malaysia,1,1,0,0.5,0.5,1597,1630
1974-09-05,Pakistan,Bahrain,5,1,4,1.0,0.0,1471,1458
1974-09-05,Iran,Myanmar,2,1,1,1.0,0.0,1631,1719
1974-09-06,Libya,DR Congo,0,2,2,0.0,1.0,1522,1680
1974-09-06,South Korea,Kuwait,0,4,4,0.0,1.0,1707,1593
1974-09-06,China PR,Iraq,0,1,1,0.0,1.0,1691,1619
1974-09-06,India,North Korea,1,4,3,0.0,1.0,1568,1634
1974-09-07,Poland,France,0,2,2,0.0,1.0,1776,1700
1974-09-07,Malaysia,Philippines,11,0,11,1.0,0.0,1633,1356
1974-09-07,Japan,Israel,0,3,3,0.0,1.0,1590,1645
1974-09-07,Myanmar,Pakistan,5,1,4,1.0,0.0,1723,1468
1974-09-07,Iran,Bahrain,6,0,6,1.0,0.0,1636,1454
1974-09-08,Iceland,Belgium,0,2,2,0.0,1.0,1429,1750
1974-09-08,United States,Mexico,0,1,1,0.0,1.0,1455,1753
1974-09-09,Iran,Malaysia,1,0,1,1.0,0.0,1644,1626
1974-09-09,Iraq,South Korea,1,1,0,0.5,0.5,1621,1706
1974-09-10,Libya,Somalia,3,2,1,1.0,0.0,1529,1462
1974-09-10,Kuwait,North Korea,0,2,2,0.0,1.0,1586,1642
1974-09-10,Israel,Myanmar,3,0,3,1.0,0.0,1655,1714
1974-09-11,Ivory Coast,Ghana,1,1,0,0.5,0.5,1604,1664
1974-09-11,Iran,South Korea,2,0,2,1.0,0.0,1654,1697
1974-09-11,Malaysia,Iraq,0,0,0,0.5,0.5,1626,1622
1974-09-12,Kuwait,Myanmar,5,2,3,1.0,0.0,1597,1704
1974-09-12,Israel,North Korea,2,0,2,1.0,0.0,1663,1635
1974-09-13,Libya,Somalia,3,2,1,1.0,0.0,1536,1456
1974-09-13,Iran,Iraq,1,0,1,1.0,0.0,1662,1615
1974-09-13,South Korea,Malaysia,2,3,1,0.0,1.0,1688,1636
1974-09-14,North Korea,Myanmar,2,2,0,0.5,0.5,1637,1703
1974-09-14,Israel,Kuwait,2,0,2,1.0,0.0,1670,1591
1974-09-15,North Korea,Malaysia,1,2,1,0.0,1.0,1629,1645
1974-09-15,Iran,Israel,1,0,1,1.0,0.0,1671,1662
1974-09-25,Bulgaria,Romania,0,0,0,0.5,0.5,1726,1698
1974-09-25,Czechoslovakia,German DR,3,1,2,1.0,0.0,1746,1803
1974-09-25,Denmark,Spain,1,2,1,0.0,1.0,1585,1783
1974-09-25,Finland,Netherlands,1,3,2,0.0,1.0,1448,1780
1974-09-26,Syria,Palestine,2,0,2,1.0,0.0,1547,1474
1974-09-27,Algeria,Lebanon,4,1,3,1.0,0.0,1592,1478
1974-09-28,Austria,Hungary,1,0,1,1.0,0.0,1724,1780
1974-09-28,Japan,South Korea,4,1,3,1.0,0.0,1601,1678
1974-09-28,Yemen,Sudan,0,6,6,0.0,1.0,1431,1585
1974-09-28,Yugoslavia,Italy,1,0,1,1.0,0.0,1784,1850
1974-09-29,Algeria,Jordan,6,0,6,1.0,0.0,1597,1439
1974-09-30,Libya,Yemen,9,1,8,1.0,0.0,1542,1426
1974-09-30,Palestine,Sudan,1,3,2,0.0,1.0,1469,1591
1974-10-01,Morocco,Tunisia,3,1,2,1.0,0.0,1625,1594
1974-10-02,Libya,Palestine,0,0,0,0.5,0.5,1541,1471
1974-10-03,Algeria,Tunisia,0,1,1,0.0,1.0,1589,1603
1974-10-04,Libya,Sudan,1,3,2,0.0,1.0,1535,1598
1974-10-04,Syria,Yemen,6,0,6,1.0,0.0,1553,1421
1974-10-06,Palestine,Yemen,7,1,6,1.0,0.0,1478,1415
1974-10-07,Morocco,Sudan,2,0,2,1.0,0.0,1633,1591
1974-10-09,Denmark,Iceland,2,1,1,1.0,0.0,1590,1425
1974-10-09,German DR,Canada,2,0,2,1.0,0.0,1806,1500
1974-10-09,Netherlands,Switzerland,1,0,1,1.0,0.0,1785,1619
1974-10-09,Poland,Finland,3,0,3,1.0,0.0,1779,1446
1974-10-09,Sudan,Tunisia,1,3,2,0.0,1.0,1584,1611
1974-10-09,Syria,Morocco,1,1,0,0.5,0.5,1555,1632
1974-10-12,Argentina,Spain,1,1,0,0.5,0.5,1779,1783
1974-10-12,Belgium,France,2,1,1,1.0,0.0,1757,1694
1974-10-12,German DR,Iceland,1,1,0,0.5,0.5,1800,1432
1974-10-13,Bulgaria,Greece,3,3,0,0.5,0.5,1722,1536
1974-10-13,Czechoslovakia,Sweden,4,0,4,1.0,0.0,1755,1781
1974-10-13,Denmark,Romania,0,0,0,0.5,0.5,1593,1696
1974-10-13,Luxembourg,Hungary,2,4,2,0.0,1.0,1388,1782
1974-10-30,England,Czechoslovakia,3,0,3,1.0,0.0,1866,1750
1974-10-30,Republic of Ireland,Russia,3,0,3,1.0,0.0,1596,1781
1974-10-30,Scotland,German DR,3,0,3,1.0,0.0,1726,1791
1974-10-30,Sweden,Northern Ireland,0,2,2,0.0,1.0,1770,1641
1974-10-30,Wales,Hungary,2,0,2,1.0,0.0,1597,1770
1974-10-30,Yugoslavia,Norway,3,1,2,1.0,0.0,1787,1513
1974-10-30,Zanzibar,Somalia,2,1,1,1.0,0.0,1349,1446
1974-10-31,Algeria,Morocco,0,0,0,0.5,0.5,1590,1632
1974-10-31,Poland,Canada,2,0,2,1.0,0.0,1782,1498
1974-11-01,Vietnam Republic,Laos,1,0,1,1.0,0.0,1552,1390
1974-11-02,Laos,Malaysia,0,0,0,0.5,0.5,1396,1640
1974-11-02,Zanzibar,Uganda,1,2,1,0.0,1.0,1346,1595
1974-11-03,Cambodia,Thailand,2,2,0,0.5,0.5,1493,1520
1974-11-03,Kenya,Zambia,2,3,1,0.0,1.0,1562,1623
1974-11-03,Malaysia,Taiwan,0,0,0,0.5,0.5,1638,1525
1974-11-03,Singapore,China PR,1,1,0,0.5,0.5,1422,1686
1974-11-04,Somalia,Uganda,1,1,0,0.5,0.5,1450,1592
1974-11-05,Laos,Taiwan,1,2,1,0.0,1.0,1391,1531
1974-11-05,Vietnam Republic,Malaysia,1,0,1,1.0,0.0,1562,1629
1974-11-06,Chile,Argentina,0,2,2,0.0,1.0,1686,1786
1974-11-07,Tanzania,Uganda,1,1,0,0.5,0.5,1499,1590
1974-11-07,Vietnam Republic,Taiwan,1,1,0,0.5,0.5,1562,1532
1974-11-09,Vietnam Republic,Thailand,3,2,1,1.0,0.0,1570,1513
1974-11-10,Bulgaria,Hungary,0,0,0,0.5,0.5,1724,1769
1974-11-10,Togo,Liberia,1,0,1,1.0,0.0,1523,1455
1974-11-10,Tunisia,Libya,1,0,1,1.0,0.0,1618,1529
1974-11-13,Czechoslovakia,Poland,2,2,0,0.5,0.5,1751,1782
1974-11-13,Switzerland,Portugal,3,0,3,1.0,0.0,1630,1719
1974-11-13,Turkey,Austria,0,1,1,0.0,1.0,1608,1730
1974-11-15,Greece,Cyprus,3,1,2,1.0,0.0,1542,1425
1974-11-16,France,German DR,2,2,0,0.5,0.5,1697,1789
1974-11-20,Argentina,Chile,1,1,0,0.5,0.5,1784,1689
1974-11-20,England,Portugal,0,0,0,0.5,0.5,1863,1723
1974-11-20,Greece,Germany,2,2,0,0.5,0.5,1549,1920
1974-11-20,Netherlands,Italy,3,1,2,1.0,0.0,1795,1841
1974-11-20,Scotland,Spain,1,2,1,0.0,1.0,1720,1790
1974-11-20,Turkey,Republic of Ireland,1,1,0,0.5,0.5,1608,1597
1974-11-20,Wales,Luxembourg,5,0,5,1.0,0.0,1601,1385
1974-11-22,Liberia,Togo,0,2,2,0.0,1.0,1449,1530
1974-11-22,Libya,Tunisia,1,0,1,1.0,0.0,1540,1608
1974-11-23,Suriname,Trinidad and Tobago,0,0,0,0.5,0.5,1658,1619
1974-11-24,Morocco,Gambia,3,0,3,1.0,0.0,1637,1471
1974-11-25,Suriname,Trinidad and Tobago,2,1,1,1.0,0.0,1666,1612
1974-12-01,Grenada,Saint Vincent and the Grenadines,1,0,1,1.0,0.0,1573,1555
1974-12-01,Turkey,Switzerland,2,1,1,1.0,0.0,1617,1622
1974-12-02,Saint Lucia,Dominica,0,3,3,0.0,1.0,1479,1471
1974-12-04,Dominica,Grenada,0,0,0,0.5,0.5,1474,1571
1974-12-04,Hungary,Switzerland,1,0,1,1.0,0.0,1774,1618
1974-12-04,Israel,Romania,0,1,1,0.0,1.0,1655,1704
1974-12-05,Saint Lucia,Saint Vincent and the Grenadines,1,2,1,0.0,1.0,1473,1562
1974-12-07,Dominica,Saint Vincent and the Grenadines,1,2,1,0.0,1.0,1468,1569
1974-12-07,Gambia,Morocco,0,3,3,0.0,1.0,1467,1642
1974-12-07,German DR,Belgium,0,0,0,0.5,0.5,1789,1758
1974-12-08,Saint Lucia,Grenada,1,2,1,0.0,1.0,1468,1577
1974-12-10,Laos,Singapore,0,2,2,0.0,1.0,1384,1430
1974-12-10,Thailand,Malaysia,0,2,2,0.0,1.0,1508,1635
1974-12-11,Cambodia,Vietnam Republic,3,2,1,1.0,0.0,1503,1561
1974-12-12,Kenya,Seychelles,2,3,1,0.0,1.0,1553,1501
1974-12-12,Malaysia,Singapore,0,0,0,0.5,0.5,1631,1435
1974-12-12,Thailand,Laos,6,1,5,1.0,0.0,1514,1379
1974-12-13,Cambodia,South Korea,1,2,1,0.0,1.0,1499,1683
1974-12-14,Laos,Malaysia,2,2,0,0.5,0.5,1384,1627
1974-12-14,Thailand,Singapore,2,1,1,1.0,0.0,1521,1429
1974-12-15,Ghana,Guinea,1,1,0,0.5,0.5,1663,1590
1974-12-15,South Korea,Vietnam Republic,2,2,0,0.5,0.5,1681,1564
1974-12-16,Cambodia,Vietnam Republic,2,0,2,1.0,0.0,1509,1555
1974-12-16,Thailand,Malaysia,4,1,3,1.0,0.0,1532,1617
1974-12-18,Greece,Bulgaria,2,1,1,1.0,0.0,1561,1713
1974-12-18,South Korea,Malaysia,0,0,0,0.5,0.5,1680,1619
1974-12-18,Thailand,Cambodia,1,0,1,1.0,0.0,1540,1502
1974-12-20,Cambodia,Malaysia,0,3,3,0.0,1.0,1497,1625
1974-12-20,Iran,Czechoslovakia,0,1,1,0.0,1.0,1665,1758
1974-12-20,Thailand,South Korea,1,3,2,0.0,1.0,1536,1685
1974-12-22,Chile,Paraguay,1,0,1,1.0,0.0,1697,1670
1974-12-22,Malta,Germany,0,1,1,0.0,1.0,1476,1922
1974-12-22,Suriname,Trinidad and Tobago,2,3,1,0.0,1.0,1657,1622
1974-12-25,Indonesia,South Korea,1,3,2,0.0,1.0,1572,1691
1974-12-26,Bermuda,Suriname,2,1,1,1.0,0.0,1469,1645
1974-12-29,Bermuda,Suriname,1,3,2,0.0,1.0,1465,1650
1974-12-29,Cameroon,Guinea,1,1,0,0.5,0.5,1556,1590
1974-12-29,Italy,Bulgaria,0,0,0,0.5,0.5,1839,1716
1974-12-29,Kuwait,Tunisia,2,0,2,1.0,0.0,1600,1600
1974-12-29,Malawi,Tanzania,1,1,0,0.5,0.5,1515,1500
1974-12-31,Malawi,Tanzania,3,3,0,0.5,0.5,1515,1501
1975-01-01,Cameroon,Guinea,1,0,1,1.0,0.0,1565,1582
1975-01-01,Iraq,Tunisia,0,0,0,0.5,0.5,1615,1601
1975-01-03,Bermuda,Suriname,2,5,3,0.0,1.0,1461,1655
1975-01-05,Cuba,Canada,4,0,4,1.0,0.0,1442,1489
1975-01-09,Iraq,Libya,3,1,2,1.0,0.0,1622,1534
1975-01-14,Kuwait,Libya,1,0,1,1.0,0.0,1607,1528
1975-01-19,Mali,Guinea,0,2,2,0.0,1.0,1560,1590
1975-01-22,Nigeria,Cameroon,1,0,1,1.0,0.0,1673,1560
1975-01-26,Guinea,Cameroon,3,0,3,1.0,0.0,1598,1553
1975-01-29,Malawi,Mauritius,1,0,1,1.0,0.0,1524,1511
1975-01-30,Liberia,Cameroon,2,0,2,1.0,0.0,1460,1543
1975-01-31,Malawi,Mauritius,1,1,0,0.5,0.5,1524,1512
1975-02-02,Jamaica,Haiti,1,0,1,1.0,0.0,1502,1608
1975-02-02,Malawi,Mauritius,3,0,3,1.0,0.0,1532,1505
1975-02-02,Mali,Cameroon,1,2,1,0.0,1.0,1552,1552
1975-02-02,Senegal,Nigeria,0,1,1,0.0,1.0,1512,1678
1975-02-05,Jamaica,Haiti,0,1,1,0.0,1.0,1497,1614
1975-02-05,Spain,Scotland,1,1,0,0.5,0.5,1789,1722
1975-02-09,Liberia,Nigeria,0,1,1,0.0,1.0,1457,1682
1975-02-16,Mali,Senegal,2,1,1,1.0,0.0,1560,1505
1975-02-19,Italy,Norway,4,1,3,1.0,0.0,1842,1511
1975-02-22,Haiti,Jamaica,0,1,1,0.0,1.0,1604,1508
1975-02-22,Nigeria,Senegal,1,1,0,0.5,0.5,1679,1509
1975-02-23,Burkina Faso,Niger,4,1,3,1.0,0.0,1463,1433
1975-02-23,Malta,Greece,2,0,2,1.0,0.0,1486,1552
1975-02-23,Tanzania,Malawi,3,1,2,1.0,0.0,1510,1524
1975-02-25,Haiti,Jamaica,3,2,1,1.0,0.0,1610,1503
1975-02-25,Tanzania,Malawi,2,0,2,1.0,0.0,1519,1516
1975-02-27,Zanzibar,Malawi,2,7,5,0.0,1.0,1342,1521
1975-03-02,Morocco,Tunisia,0,0,0,0.5,0.5,1642,1602
1975-03-09,Brazil,Portugal,2,1,1,1.0,0.0,1942,1720
1975-03-12,England,Germany,2,0,2,1.0,0.0,1873,1913
1975-03-13,Guadeloupe,Puerto Rico,2,1,1,1.0,0.0,1527,1378
1975-03-15,Thailand,Indonesia,3,1,2,1.0,0.0,1545,1564
1975-03-16,Luxembourg,Austria,1,2,1,0.0,1.0,1384,1732
1975-03-16,Malaysia,South Korea,2,1,1,1.0,0.0,1635,1682
1975-03-17,Indonesia,Vietnam Republic,2,1,1,1.0,0.0,1572,1548
1975-03-18,Thailand,Malaysia,0,1,1,0.0,1.0,1540,1641
1975-03-18,Jersey,Alderney,3,1,2,1.0,0.0,1690,1314
1975-03-19,South Korea,Vietnam Republic,1,0,1,1.0,0.0,1688,1543
1975-03-19,Turkey,Romania,1,1,0,0.5,0.5,1619,1703
1975-03-20,Malaysia,Indonesia,0,0,0,0.5,0.5,1640,1574
1975-03-21,Thailand,Vietnam Republic,4,0,4,1.0,0.0,1549,1535
1975-03-22,South Korea,Indonesia,1,0,1,1.0,0.0,1694,1569
1975-03-22,Morocco,Senegal,4,0,4,1.0,0.0,1648,1504
1975-03-22,Senegal,Morocco,2,1,1,1.0,0.0,1516,1637
1975-03-23,Tunisia,Algeria,1,1,0,0.5,0.5,1602,1591
1975-03-23,Sudan,Kenya,1,0,1,1.0,0.0,1592,1546
1975-03-23,Niger,Guinea,2,4,2,0.0,1.0,1429,1603
1975-03-23,Uganda,Mauritius,4,0,4,1.0,0.0,1597,1499
1975-03-23,Ghana,Burkina Faso,3,1,2,1.0,0.0,1667,1460
1975-03-23,Malaysia,Vietnam Republic,3,0,3,1.0,0.0,1646,1530
1975-03-23,Kenya,Sudan,0,2,2,0.0,1.0,1540,1599
1975-03-24,Burundi,Egypt,0,3,3,0.0,1.0,1477,1675
1975-03-24,Thailand,South Korea,1,0,1,1.0,0.0,1561,1683
1975-03-26,France,Hungary,2,0,2,1.0,0.0,1707,1765
1975-03-26,German DR,Bulgaria,0,0,0,0.5,0.5,1788,1718
1975-03-26,Poland,United States,7,0,7,1.0,0.0,1785,1453
1975-03-30,Congo,Ivory Coast,1,0,1,1.0,0.0,1585,1596
1975-03-30,Ghana,Mali,4,0,4,1.0,0.0,1673,1555
1975-03-30,Malawi,Zambia,1,6,5,0.0,1.0,1516,1629
1975-03-30,Guadeloupe,Suriname,4,2,2,1.0,0.0,1538,1645
1975-03-31,Barbados,Suriname,1,0,1,1.0,0.0,1468,1634
1975-03-31,Czechoslovakia,Romania,1,1,0,0.5,0.5,1757,1705
1975-04-01,Cyprus,Greece,1,2,1,0.0,1.0,1420,1558
1975-04-02,Austria,Hungary,0,0,0,0.5,0.5,1733,1765
1975-04-02,Iraq,Qatar,1,0,1,1.0,0.0,1626,1412
1975-04-02,Italy,United States,10,0,10,1.0,0.0,1844,1452
1975-04-02,Russia,Turkey,3,0,3,1.0,0.0,1786,1615
1975-04-02,Saudi Arabia,Afghanistan,2,0,2,1.0,0.0,1544,1453
1975-04-04,Iraq,Afghanistan,4,0,4,1.0,0.0,1631,1449
1975-04-04,Macau,Panama,2,1,1,1.0,0.0,1495,1446
1975-04-04,Saudi Arabia,Qatar,2,1,1,1.0,0.0,1550,1407
1975-04-06,Mauritius,Uganda,1,1,0,0.5,0.5,1502,1595
1975-04-06,Guinea,Niger,3,0,3,1.0,0.0,1608,1425
1975-04-06,Algeria,Tunisia,1,2,1,0.0,1.0,1584,1610
1975-04-06,Iraq,Saudi Arabia,1,1,0,0.5,0.5,1630,1552
1975-04-06,Qatar,Afghanistan,2,1,1,1.0,0.0,1416,1441
1975-04-10,Iraq,Qatar,3,0,3,1.0,0.0,1634,1413
1975-04-10,Saudi Arabia,Afghanistan,6,0,6,1.0,0.0,1558,1436
1975-04-12,Iraq,Saudi Arabia,2,1,1,1.0,0.0,1641,1552
1975-04-12,Qatar,Afghanistan,1,1,0,0.5,0.5,1414,1436
1975-04-13,Ivory Coast,Congo,2,1,1,1.0,0.0,1604,1578
1975-04-13,Mali,Ghana,3,1,2,1.0,0.0,1566,1663
1975-04-13,Cameroon,Togo,3,0,3,1.0,0.0,1560,1523
1975-04-14,Iraq,Afghanistan,3,1,2,1.0,0.0,1645,1433
1975-04-14,Zambia,Malawi,3,3,0,0.5,0.5,1627,1519
1975-04-14,Saudi Arabia,Qatar,0,1,1,0.0,1.0,1541,1426
1975-04-16,England,Cyprus,5,0,5,1.0,0.0,1875,1419
1975-04-16,Hungary,Wales,1,2,1,0.0,1.0,1754,1613
1975-04-16,Northern Ireland,Yugoslavia,1,0,1,1.0,0.0,1653,1776
1975-04-16,Sweden,Scotland,1,1,0,0.5,0.5,1769,1724
1975-04-17,Spain,Romania,1,1,0,0.5,0.5,1788,1707
1975-04-19,Italy,Poland,0,0,0,0.5,0.5,1843,1787
1975-04-19,Egypt,Burundi,2,0,2,1.0,0.0,1679,1474
1975-04-20,Togo,Cameroon,4,0,4,1.0,0.0,1532,1552
1975-04-20,Czechoslovakia,Cyprus,4,0,4,1.0,0.0,1760,1417
1975-04-26,France,Portugal,0,2,2,0.0,1.0,1700,1728
1975-04-26,Nigeria,Togo,1,0,1,1.0,0.0,1684,1528
1975-04-26,Senegal,Ivory Coast,1,0,1,1.0,0.0,1526,1595
1975-04-27,Bulgaria,Germany,1,1,0,0.5,0.5,1723,1909
1975-04-27,Ivory Coast,Togo,0,3,3,0.0,1.0,1586,1538
1975-04-27,Senegal,Nigeria,1,0,1,1.0,0.0,1538,1673
1975-04-30,Belgium,Netherlands,1,0,1,1.0,0.0,1767,1787
1975-04-30,Czechoslovakia,Portugal,5,0,5,1.0,0.0,1768,1721
1975-04-30,Switzerland,Turkey,1,1,0,0.5,0.5,1618,1616
1975-05-01,Luxembourg,Wales,1,3,2,0.0,1.0,1381,1617
1975-05-09,Guernsey,Jersey,2,2,0,0.5,0.5,1626,1689
1975-05-10,Republic of Ireland,Switzerland,2,1,1,1.0,0.0,1606,1610
1975-05-10,Martinique,Guadeloupe,8,2,6,1.0,0.0,1568,1531
1975-05-11,Cyprus,England,0,1,1,0.0,1.0,1416,1877
1975-05-11,Romania,Denmark,6,1,5,1.0,0.0,1713,1588
1975-05-13,Scotland,Portugal,1,0,1,1.0,0.0,1732,1714
1975-05-15,Myanmar,Thailand,4,1,3,1.0,0.0,1708,1557
1975-05-15,Finland,Norway,3,5,2,0.0,1.0,1440,1518
1975-05-16,South Korea,Lebanon,1,0,1,1.0,0.0,1687,1475
1975-05-17,Germany,Netherlands,1,1,0,0.5,0.5,1907,1790
1975-05-17,Northern Ireland,England,0,0,0,0.5,0.5,1658,1873
1975-05-17,Wales,Scotland,2,2,0,0.5,0.5,1620,1730
1975-05-18,Russia,Republic of Ireland,2,1,1,1.0,0.0,1791,1602
1975-05-19,Sweden,Algeria,4,0,4,1.0,0.0,1774,1580
1975-05-20,Scotland,Northern Ireland,3,0,3,1.0,0.0,1737,1652
1975-05-21,England,Wales,2,2,0,0.5,0.5,1869,1625
1975-05-21,Switzerland,Republic of Ireland,1,0,1,1.0,0.0,1618,1595
1975-05-22,South Korea,Myanmar,1,0,1,1.0,0.0,1696,1700
1975-05-23,China PR,Equatorial Guinea,6,2,4,1.0,0.0,1691,1496
1975-05-23,Northern Ireland,Wales,1,0,1,1.0,0.0,1660,1618
1975-05-24,England,Scotland,5,1,4,1.0,0.0,1875,1732
1975-05-25,Iceland,France,0,0,0,0.5,0.5,1438,1695
1975-05-26,Jersey,Guernsey,2,3,1,0.0,1.0,1680,1636
1975-05-28,German DR,Poland,1,2,1,0.0,1.0,1780,1796
1975-06-01,Romania,Scotland,1,1,0,0.5,0.5,1714,1732
1975-06-04,Greece,Malta,4,0,4,1.0,0.0,1565,1480
1975-06-04,Sweden,Yugoslavia,1,2,1,0.0,1.0,1767,1784
1975-06-04,Uruguay,Chile,1,0,1,1.0,0.0,1714,1690
1975-06-05,Finland,Italy,0,1,1,0.0,1.0,1439,1845
1975-06-05,Iceland,German DR,2,1,1,1.0,0.0,1453,1766
1975-06-05,Kenya,Ethiopia,2,1,1,1.0,0.0,1548,1521
1975-06-07,Austria,Czechoslovakia,0,0,0,0.5,0.5,1734,1768
1975-06-08,Cyprus,Portugal,0,2,2,0.0,1.0,1414,1717
1975-06-08,Guinea-Bissau,Gambia,1,0,1,1.0,0.0,1516,1460
1975-06-08,Russia,Italy,1,0,1,1.0,0.0,1801,1836
1975-06-09,Norway,Yugoslavia,1,3,2,0.0,1.0,1516,1787
1975-06-11,Bulgaria,Malta,5,0,5,1.0,0.0,1727,1477
1975-06-11,Kenya,Congo,2,1,1,1.0,0.0,1557,1570
1975-06-12,Myanmar,South Korea,0,2,2,0.0,1.0,1692,1705
1975-06-12,Indonesia,Thailand,5,0,5,1.0,0.0,1577,1550
1975-06-12,Paraguay,Uruguay,0,1,1,0.0,1.0,1664,1721
1975-06-13,Malaysia,Thailand,1,0,1,1.0,0.0,1652,1545
1975-06-13,Panama,Costa Rica,1,1,0,0.5,0.5,1452,1705
1975-06-13,Uganda,Congo,0,1,1,0.0,1.0,1587,1579
1975-06-14,Hong Kong,Japan,0,0,0,0.5,0.5,1532,1600
1975-06-14,Indonesia,Malaysia,3,1,2,1.0,0.0,1587,1643
1975-06-15,China PR,North Korea,1,0,1,1.0,0.0,1698,1623
1975-06-16,Indonesia,Myanmar,0,2,2,0.0,1.0,1582,1698
1975-06-16,South Korea,Malaysia,1,1,0,0.5,0.5,1704,1645
1975-06-17,North Korea,Japan,1,0,1,1.0,0.0,1631,1593
1975-06-18,Myanmar,Malaysia,2,0,2,1.0,0.0,1705,1639
1975-06-18,Indonesia,South Korea,3,2,1,1.0,0.0,1593,1694
1975-06-19,China PR,Brunei,10,1,9,1.0,0.0,1702,1479
1975-06-19,North Korea,Singapore,1,0,1,1.0,0.0,1635,1426
1975-06-19,Uruguay,Paraguay,0,1,1,0.0,1.0,1712,1674
1975-06-21,Hong Kong,China PR,0,1,1,0.0,1.0,1528,1707
1975-06-22,Ecuador,Peru,6,0,6,1.0,0.0,1453,1628
1975-06-22,Tanzania,Zambia,1,1,0,0.5,0.5,1522,1625
1975-06-23,China PR,Japan,2,1,1,1.0,0.0,1713,1588
1975-06-23,Iceland,Faroe Islands,6,0,6,1.0,0.0,1462,1465
1975-06-24,Hong Kong,North Korea,3,3,0,0.5,0.5,1531,1633
1975-06-24,United States,Poland,0,4,4,0.0,1.0,1451,1798
1975-06-25,Chile,Uruguay,1,3,2,0.0,1.0,1683,1720
1975-06-25,Denmark,Finland,2,0,2,1.0,0.0,1593,1435
1975-06-25,Ecuador,Peru,1,0,1,1.0,0.0,1465,1617
1975-06-25,Mozambique,Zambia,2,1,1,1.0,0.0,1511,1615
1975-06-26,North Korea,China PR,2,0,2,1.0,0.0,1643,1704
1975-06-27,Bolivia,Argentina,1,2,1,0.0,1.0,1517,1787
1975-06-29,Mozambique,Tanzania,2,1,1,1.0,0.0,1520,1514
1975-06-29,Ghana,Morocco,2,0,2,1.0,0.0,1671,1630
1975-06-30,Sweden,Norway,3,1,2,1.0,0.0,1771,1513
1975-07-01,Peru,Ecuador,2,0,2,1.0,0.0,1622,1461
1975-07-03,China PR,Thailand,2,2,0,0.5,0.5,1701,1549
1975-07-03,Togo,Guinea,2,2,0,0.5,0.5,1540,1607
1975-07-06,Canada,Poland,1,8,7,0.0,1.0,1487,1801
1975-07-06,Malawi,Kenya,3,3,0,0.5,0.5,1520,1557
1975-07-06,Tunisia,Sudan,3,2,1,1.0,0.0,1618,1592
1975-07-07,Bolivia,Paraguay,1,2,1,0.0,1.0,1513,1679
1975-07-08,Hong Kong,Thailand,1,1,0,0.5,0.5,1532,1549
1975-07-08,Malawi,Kenya,1,2,1,0.0,1.0,1513,1565
1975-07-09,Bolivia,Ecuador,1,0,1,1.0,0.0,1520,1455
1975-07-09,Canada,Poland,1,4,3,0.0,1.0,1485,1804
1975-07-10,Malawi,Kenya,3,1,2,1.0,0.0,1523,1556
1975-07-10,Peru,Paraguay,2,0,2,1.0,0.0,1632,1670
1975-07-12,Zambia,Uganda,2,1,1,1.0,0.0,1623,1580
1975-07-12,Egypt,DR Congo,3,2,1,1.0,0.0,1688,1672
1975-07-13,Congo,Nigeria,0,1,1,0.0,1.0,1574,1679
1975-07-13,Morocco,Ghana,2,0,2,1.0,0.0,1639,1663
1975-07-17,Chile,Peru,1,1,0,0.5,0.5,1682,1634
1975-07-17,Guinea,Togo,2,0,2,1.0,0.0,1614,1534
1975-07-18,Uruguay,Argentina,2,3,1,0.0,1.0,1714,1794
1975-07-20,Bolivia,Chile,2,1,1,1.0,0.0,1532,1671
1975-07-20,Colombia,Paraguay,1,0,1,1.0,0.0,1489,1658
1975-07-20,New Zealand,China PR,2,1,1,1.0,0.0,1556,1690
1975-07-23,New Zealand,China PR,2,2,0,0.5,0.5,1559,1688
1975-07-24,Ecuador,Paraguay,2,2,0,0.5,0.5,1460,1654
1975-07-26,New Zealand,China PR,2,0,2,1.0,0.0,1570,1678
1975-07-27,Nigeria,Congo,2,1,1,1.0,0.0,1685,1569
1975-07-27,Bolivia,Peru,0,1,1,0.0,1.0,1527,1640
1975-07-27,Ecuador,Colombia,1,3,2,0.0,1.0,1453,1497
1975-07-27,Malaysia,Thailand,1,0,1,1.0,0.0,1645,1544
1975-07-28,Fiji,China PR,1,4,3,0.0,1.0,1431,1682
1975-07-29,Bangladesh,Indonesia,0,4,4,0.0,1.0,1487,1599
1975-07-29,Canada,German DR,0,3,3,0.0,1.0,1483,1769
1975-07-29,Malaysia,South Korea,1,3,2,0.0,1.0,1639,1701
1975-07-30,Myanmar,Thailand,1,0,1,1.0,0.0,1710,1540
1975-07-30,Hong Kong,Japan,2,0,2,1.0,0.0,1542,1579
1975-07-30,Paraguay,Colombia,0,1,1,0.0,1.0,1643,1509
1975-07-31,Canada,German DR,1,7,6,0.0,1.0,1481,1772
1975-07-31,Venezuela,Brazil,0,4,4,0.0,1.0,1458,1943
1975-07-31,Malaysia,Hong Kong,3,1,2,1.0,0.0,1645,1537
1975-08-01,Myanmar,Indonesia,2,0,2,1.0,0.0,1716,1594
1975-08-01,Hong Kong,South Korea,0,1,1,0.0,1.0,1533,1706
1975-08-01,Mexico,German DR,2,3,1,0.0,1.0,1746,1780
1975-08-01,Panama,Guatemala,2,0,2,1.0,0.0,1464,1591
1975-08-02,Bangladesh,Thailand,1,1,0,0.5,0.5,1489,1539
1975-08-02,New Caledonia,Tahiti,3,0,3,1.0,0.0,1601,1547
1975-08-02,Vanuatu,Papua New Guinea,3,0,3,1.0,0.0,1465,1482
1975-08-02,Guam,Solomon Islands,1,5,4,0.0,1.0,1492,1468
1975-08-02,Malaysia,Japan,2,0,2,1.0,0.0,1652,1573
1975-08-03,Myanmar,South Korea,2,3,1,0.0,1.0,1708,1715
1975-08-03,Hong Kong,Indonesia,2,3,1,0.0,1.0,1527,1601
1975-08-03,Mexico,German DR,0,1,1,0.0,1.0,1739,1788
1975-08-03,Venezuela,Argentina,1,5,4,0.0,1.0,1456,1797
1975-08-04,Bangladesh,Japan,0,3,3,0.0,1.0,1483,1580
1975-08-04,New Caledonia,Vanuatu,3,1,2,1.0,0.0,1607,1460
1975-08-04,Papua New Guinea,Tahiti,2,4,2,0.0,1.0,1476,1554
1975-08-04,Guam,Fiji,0,11,11,0.0,1.0,1483,1441
1975-08-05,Malaysia,Indonesia,2,1,1,1.0,0.0,1659,1595
1975-08-05,New Caledonia,Papua New Guinea,5,1,4,1.0,0.0,1613,1471
1975-08-05,Vanuatu,Tahiti,0,3,3,0.0,1.0,1455,1560
1975-08-05,Fiji,Solomon Islands,1,1,0,0.5,0.5,1442,1468
1975-08-06,Australia,China PR,1,0,1,1.0,0.0,1678,1674
1975-08-06,Brazil,Argentina,2,1,1,1.0,0.0,1948,1793
1975-08-06,Myanmar,Hong Kong,5,0,5,1.0,0.0,1713,1523
1975-08-06,Ghana,Ivory Coast,3,1,2,1.0,0.0,1670,1580
1975-08-06,Mexico,German DR,1,0,1,1.0,0.0,1749,1779
1975-08-07,Malaysia,Bangladesh,3,0,3,1.0,0.0,1664,1479
1975-08-07,Colombia,Ecuador,2,0,2,1.0,0.0,1516,1447
1975-08-07,Fiji,Tahiti,0,3,3,0.0,1.0,1437,1566
1975-08-07,Indonesia,Japan,1,4,3,0.0,1.0,1587,1589
1975-08-07,South Korea,Thailand,6,0,6,1.0,0.0,1720,1535
1975-08-07,New Caledonia,Solomon Islands,4,0,4,1.0,0.0,1618,1464
1975-08-07,Peru,Bolivia,3,1,2,1.0,0.0,1646,1522
1975-08-08,Bangladesh,Myanmar,1,7,6,0.0,1.0,1476,1717
1975-08-08,Fiji,Solomon Islands,2,3,1,0.0,1.0,1430,1472
1975-08-09,Indonesia,Thailand,2,1,1,1.0,0.0,1594,1529
1975-08-09,Japan,South Korea,1,3,2,0.0,1.0,1584,1726
1975-08-09,New Caledonia,Tahiti,1,2,1,0.0,1.0,1609,1576
1975-08-10,Argentina,Venezuela,11,0,11,1.0,0.0,1796,1454
1975-08-10,Bangladesh,Hong Kong,1,9,8,0.0,1.0,1470,1530
1975-08-10,Ghana,Ivory Coast,0,0,0,0.5,0.5,1668,1583
1975-08-10,Iran,Hungary,1,2,1,0.0,1.0,1660,1760
1975-08-10,Malaysia,Myanmar,2,1,1,1.0,0.0,1674,1708
1975-08-10,Paraguay,Ecuador,3,1,2,1.0,0.0,1647,1444
1975-08-11,Indonesia,South Korea,1,5,4,0.0,1.0,1589,1732
1975-08-11,Japan,Thailand,4,0,4,1.0,0.0,1591,1523
1975-08-13,Brazil,Venezuela,6,0,6,1.0,0.0,1949,1454
1975-08-13,Chile,Bolivia,4,0,4,1.0,0.0,1676,1518
1975-08-13,Norway,Sweden,0,2,2,0.0,1.0,1511,1774
1975-08-14,Myanmar,Japan,0,2,2,0.0,1.0,1698,1602
1975-08-14,China PR,Kuwait,3,3,0,0.5,0.5,1673,1609
1975-08-15,Sudan,Tunisia,2,1,1,1.0,0.0,1601,1610
1975-08-15,Uganda,Zambia,3,0,3,1.0,0.0,1589,1615
1975-08-15,Bangladesh,South Korea,0,4,4,0.0,1.0,1468,1735
1975-08-15,Hong Kong,Thailand,3,0,3,1.0,0.0,1538,1516
1975-08-15,Panama,Haiti,2,0,2,1.0,0.0,1476,1599
1975-08-16,Argentina,Brazil,0,1,1,0.0,1.0,1792,1954
1975-08-17,Malaysia,South Korea,0,1,1,0.0,1.0,1668,1742
1975-08-17,Mexico,Costa Rica,7,0,7,1.0,0.0,1756,1699
1975-08-17,Panama,Haiti,1,1,0,0.5,0.5,1479,1597
1975-08-19,Costa Rica,United States,3,1,2,1.0,0.0,1703,1448
1975-08-20,Peru,Chile,3,1,2,1.0,0.0,1655,1668
1975-08-21,Argentina,United States,6,0,6,1.0,0.0,1794,1447
1975-08-24,Ghana,Nigeria,1,2,1,0.0,1.0,1661,1693
1975-08-24,Mexico,United States,2,0,2,1.0,0.0,1759,1445
1975-08-31,Ghana,Nigeria,3,0,3,1.0,0.0,1670,1685
1975-08-31,Mexico,Argentina,1,1,0,0.5,0.5,1760,1794
1975-09-03,Austria,Germany,0,2,2,0.0,1.0,1730,1912
1975-09-03,Denmark,Scotland,0,1,1,0.0,1.0,1589,1737
1975-09-03,France,Iceland,3,0,3,1.0,0.0,1699,1459
1975-09-03,Netherlands,Finland,4,1,3,1.0,0.0,1792,1434
1975-09-03,Northern Ireland,Sweden,1,2,1,0.0,1.0,1655,1780
1975-09-03,Switzerland,England,1,2,1,0.0,1.0,1616,1878
1975-09-05,Mali,Nigeria,4,1,3,1.0,0.0,1577,1675
1975-09-05,Panama,Cuba,0,1,1,0.0,1.0,1471,1451
1975-09-06,Belgium,Iceland,1,0,1,1.0,0.0,1770,1457
1975-09-07,Ivory Coast,Nigeria,1,1,0,0.5,0.5,1586,1673
1975-09-07,Panama,Cuba,2,2,0,0.5,0.5,1471,1452
1975-09-08,South Korea,Japan,3,0,3,1.0,0.0,1747,1598
1975-09-10,Poland,Netherlands,4,1,3,1.0,0.0,1812,1785
1975-09-16,Panama,Cuba,2,3,1,0.0,1.0,1463,1461
1975-09-21,Colombia,Uruguay,3,0,3,1.0,0.0,1529,1702
1975-09-24,Czechoslovakia,Switzerland,1,1,0,0.5,0.5,1765,1620
1975-09-24,Greece,Romania,1,1,0,0.5,0.5,1569,1711
1975-09-24,Hungary,Austria,2,1,1,1.0,0.0,1768,1723
1975-09-25,Sweden,Denmark,0,0,0,0.5,0.5,1776,1594
1975-09-26,Haiti,Guadeloupe,3,0,3,1.0,0.0,1604,1525
1975-09-27,Belgium,German DR,1,2,1,0.0,1.0,1763,1787
1975-09-27,Italy,Finland,0,0,0,0.5,0.5,1830,1441
1975-09-30,Brazil,Peru,1,3,2,0.0,1.0,1941,1669
1975-10-01,Uruguay,Colombia,1,0,1,1.0,0.0,1707,1525
1975-10-04,Peru,Brazil,0,2,2,0.0,1.0,1667,1944
1975-10-05,Antigua and Barbuda,Barbados,1,0,1,1.0,0.0,1490,1461
1975-10-08,Poland,Hungary,4,2,2,1.0,0.0,1819,1762
1975-10-09,Uganda,DR Congo,1,2,1,0.0,1.0,1583,1679
1975-10-11,Germany,Greece,1,1,0,0.5,0.5,1906,1576
1975-10-12,German DR,France,2,1,1,1.0,0.0,1794,1693
1975-10-12,Romania,Turkey,2,2,0,0.5,0.5,1709,1619
1975-10-12,Spain,Denmark,2,0,2,1.0,0.0,1792,1591
1975-10-12,Switzerland,Russia,0,1,1,0.0,1.0,1616,1806
1975-10-15,Austria,Luxembourg,6,2,4,1.0,0.0,1725,1380
1975-10-15,Czechoslovakia,Hungary,1,1,0,0.5,0.5,1765,1763
1975-10-15,Netherlands,Poland,3,0,3,1.0,0.0,1794,1811
1975-10-15,Yugoslavia,Sweden,3,0,3,1.0,0.0,1795,1769
1975-10-16,Colombia,Peru,1,0,1,1.0,0.0,1537,1656
1975-10-18,Tanzania,Kenya,1,2,1,0.0,1.0,1507,1564
1975-10-19,China PR,New Zealand,2,1,1,1.0,0.0,1679,1565
1975-10-19,Hungary,Luxembourg,8,1,7,1.0,0.0,1765,1379
1975-10-20,Israel,Mexico,1,0,1,1.0,0.0,1666,1750
1975-10-22,Peru,Colombia,2,0,2,1.0,0.0,1662,1532
1975-10-24,Zambia,Mozambique,3,0,3,1.0,0.0,1621,1515
1975-10-26,Poland,Italy,0,0,0,0.5,0.5,1812,1830
1975-10-28,Colombia,Peru,0,1,1,0.0,1.0,1527,1668
1975-10-29,Republic of Ireland,Turkey,4,0,4,1.0,0.0,1604,1611
1975-10-29,Northern Ireland,Norway,3,0,3,1.0,0.0,1660,1507
1975-10-29,Scotland,Denmark,3,1,2,1.0,0.0,1742,1587
1975-10-30,Czechoslovakia,England,2,1,1,1.0,0.0,1776,1868
1975-10-31,Zambia,Kenya,1,2,1,0.0,1.0,1612,1574
1975-11-01,Malawi,Tanzania,3,1,2,1.0,0.0,1531,1500
1975-11-02,Zambia,Uganda,0,1,1,0.0,1.0,1604,1592
1975-11-03,Malawi,Zanzibar,4,2,2,1.0,0.0,1536,1338
1975-11-04,Kenya,Uganda,1,1,0,0.5,0.5,1575,1592
1975-11-05,French Guiana,Martinique,1,2,1,0.0,1.0,1448,1574
1975-11-05,Macau,New Zealand,1,1,0,0.5,0.5,1497,1564
1975-11-05,Tanzania,Zanzibar,4,0,4,1.0,0.0,1505,1334
1975-11-07,Kenya,Tanzania,3,2,1,1.0,0.0,1582,1499
1975-11-07,Malawi,Uganda,2,1,1,1.0,0.0,1546,1583
1975-11-09,Kenya,Malawi,2,2,0,0.5,0.5,1582,1547
1975-11-09,Singapore,New Zealand,2,2,0,0.5,0.5,1430,1561
1975-11-12,Portugal,Czechoslovakia,1,1,0,0.5,0.5,1719,1775
1975-11-12,Russia,Switzerland,4,1,3,1.0,0.0,1811,1612
1975-11-15,France,Belgium,0,0,0,0.5,0.5,1695,1762
1975-11-16,Romania,Spain,2,2,0,0.5,0.5,1711,1791
1975-11-19,Cameroon,DR Congo,2,1,1,1.0,0.0,1563,1669
1975-11-19,Germany,Bulgaria,1,0,1,1.0,0.0,1911,1723
1975-11-19,Portugal,England,1,1,0,0.5,0.5,1723,1865
1975-11-19,Wales,Austria,1,0,1,1.0,0.0,1629,1715
1975-11-19,Yugoslavia,Northern Ireland,1,0,1,1.0,0.0,1801,1655
1975-11-22,Cameroon,DR Congo,2,2,0,0.5,0.5,1566,1667
1975-11-22,Italy,Netherlands,1,0,1,1.0,0.0,1838,1787
1975-11-23,Cyprus,Czechoslovakia,0,3,3,0.0,1.0,1413,1777
1975-11-23,Turkey,Russia,1,0,1,1.0,0.0,1624,1799
1975-11-29,Romania,Russia,2,2,0,0.5,0.5,1713,1798
1975-12-03,Portugal,Cyprus,1,0,1,1.0,0.0,1726,1411
1975-12-09,Thailand,Malaysia,1,1,0,0.5,0.5,1520,1665
1975-12-10,Myanmar,Singapore,1,0,1,1.0,0.0,1701,1428
1975-12-12,Thailand,Singapore,2,2,0,0.5,0.5,1518,1431
1975-12-13,Myanmar,Malaysia,0,1,1,0.0,1.0,1693,1674
1975-12-15,Myanmar,Singapore,2,2,0,0.5,0.5,1688,1437
1975-12-16,Thailand,Malaysia,2,1,1,1.0,0.0,1530,1663
1975-12-17,Scotland,Romania,1,1,0,0.5,0.5,1742,1714
1975-12-19,Egypt,Yemen DPR,5,0,5,1.0,0.0,1692,1482
1975-12-19,Palestine,Sudan,0,0,0,0.5,0.5,1481,1599
1975-12-19,Tunisia,United Arab Emirates,3,0,3,1.0,0.0,1615,1461
1975-12-20,Malawi,Eswatini,2,0,2,1.0,0.0,1554,1492
1975-12-20,Turkey,Germany,0,5,5,0.0,1.0,1622,1914
1975-12-21,Myanmar,South Korea,1,3,2,0.0,1.0,1682,1754
1975-12-21,Iraq,United Arab Emirates,5,0,5,1.0,0.0,1650,1457
1975-12-21,Libya,Syria,2,3,1,0.0,1.0,1521,1563
1975-12-21,Malaysia,Singapore,0,0,0,0.5,0.5,1659,1442
1975-12-21,Malta,Bulgaria,0,2,2,0.0,1.0,1474,1727
1975-12-21,Palestine,Sudan,0,1,1,0.0,1.0,1476,1605
1975-12-21,Saudi Arabia,Yemen DPR,0,1,1,0.0,1.0,1532,1492
1975-12-22,Malawi,Eswatini,0,0,0,0.5,0.5,1553,1494
1975-12-23,Egypt,Saudi Arabia,2,1,1,1.0,0.0,1697,1528
1975-12-23,Libya,Syria,1,0,1,1.0,0.0,1530,1555
1975-12-23,Thailand,South Korea,2,1,1,1.0,0.0,1543,1742
1975-12-23,Tunisia,Iraq,1,1,0,0.5,0.5,1616,1650
1975-12-24,Myanmar,Singapore,6,0,6,1.0,0.0,1686,1439
1975-12-26,Bermuda,Suriname,1,5,4,0.0,1.0,1457,1639
1975-12-26,Egypt,Sudan,3,1,2,1.0,0.0,1703,1600
1975-12-26,Iraq,Syria,4,0,4,1.0,0.0,1656,1550
1975-12-26,Thailand,Singapore,0,1,1,0.0,1.0,1533,1450
1975-12-27,Myanmar,Malaysia,2,1,1,1.0,0.0,1694,1652
1975-12-28,Egypt,Iraq,1,0,1,1.0,0.0,1710,1650
1975-12-28,Sudan,Syria,1,0,1,1.0,0.0,1607,1544
1975-12-29,Thailand,Malaysia,1,0,1,1.0,0.0,1544,1642
1975-12-30,Italy,Greece,3,2,1,1.0,0.0,1841,1574
1975-12-30,South Korea,Singapore,5,0,5,1.0,0.0,1745,1448
1976-01-01,Libya,Sudan,1,0,1,1.0,0.0,1540,1598
1976-01-01,Thailand,Myanmar,0,0,0,0.5,0.5,1548,1691
1976-01-02,South Korea,Malaysia,4,0,4,1.0,0.0,1751,1637
1976-01-04,Myanmar,South Korea,0,1,1,0.0,1.0,1685,1758
1976-01-09,Saudi Arabia,Algeria,1,3,2,0.0,1.0,1522,1587
1976-01-14,Gambia,Guinea-Bissau,3,1,2,1.0,0.0,1470,1507
1976-01-15,Gambia,Mali,0,3,3,0.0,1.0,1465,1583
1976-01-15,Mauritania,Senegal,1,4,3,0.0,1.0,1454,1545
1976-01-16,Guinea,Senegal,2,2,0,0.5,0.5,1613,1547
1976-01-16,Guinea-Bissau,Mali,1,1,0,0.5,0.5,1509,1582
1976-01-17,Guinea,Mauritania,4,0,4,1.0,0.0,1618,1450
1976-01-18,Guinea,Mali,0,1,1,0.0,1.0,1610,1591
1976-01-25,Chad,Gabon,4,0,4,1.0,0.0,1480,1464
1976-01-25,Japan,Bulgaria,1,3,2,0.0,1.0,1593,1733
1976-01-28,Japan,Bulgaria,1,1,0,0.5,0.5,1597,1730
1976-02-01,Japan,Bulgaria,0,3,3,0.0,1.0,1592,1736
1976-02-04,Israel,Denmark,0,1,1,0.0,1.0,1657,1597
1976-02-07,Montenegro,Russia,2,1,1,1.0,0.0,1504,1785
1976-02-08,Congo,Angola,3,2,1,1.0,0.0,1576,1494
1976-02-08,Iraq,Turkey,0,0,0,0.5,0.5,1650,1623
1976-02-08,Kenya,Nigeria,1,1,0,0.5,0.5,1585,1671
1976-02-08,Malawi,Lesotho,4,1,3,1.0,0.0,1560,1463
1976-02-09,El Salvador,Hungary,1,2,1,0.0,1.0,1566,1769
1976-02-14,Zambia,Nigeria,1,3,2,0.0,1.0,1598,1678
1976-02-15,Angola,Congo,1,1,0,0.5,0.5,1496,1575
1976-02-17,Iraq,German DR,1,1,0,0.5,0.5,1654,1791
1976-02-18,Tunisia,Yugoslavia,2,1,1,1.0,0.0,1628,1790
1976-02-20,Nigeria,Tanzania,0,0,0,0.5,0.5,1675,1503
1976-02-20,Saudi Arabia,Morocco,0,2,2,0.0,1.0,1517,1645
1976-02-22,Gabon,Chad,0,1,1,0.0,1.0,1457,1488
1976-02-24,Algeria,Yugoslavia,1,2,1,0.0,1.0,1584,1794
1976-02-25,Paraguay,Argentina,2,3,1,0.0,1.0,1643,1799
1976-02-25,Uruguay,Brazil,1,2,1,0.0,1.0,1704,1948
1976-02-27,Argentina,Brazil,1,2,1,0.0,1.0,1795,1953
1976-02-28,Germany,Malta,8,0,8,1.0,0.0,1916,1473
1976-02-28,Tunisia,Sweden,1,1,0,0.5,0.5,1632,1766
1976-02-29,Egypt,Guinea,1,1,0,0.5,0.5,1708,1613
1976-02-29,Ethiopia,Uganda,2,0,2,1.0,0.0,1531,1574
1976-02-29,New Zealand,Australia,0,1,1,0.0,1.0,1556,1684
1976-03-01,Morocco,Sudan,2,2,0,0.5,0.5,1644,1600
1976-03-01,Nigeria,DR Congo,4,2,2,1.0,0.0,1683,1660
1976-03-02,Algeria,Sweden,0,2,2,0.0,1.0,1580,1771
1976-03-02,Australia,New Zealand,3,1,2,1.0,0.0,1690,1551
1976-03-03,Egypt,Uganda,2,1,1,1.0,0.0,1714,1569
1976-03-03,Ethiopia,Guinea,1,2,1,0.0,1.0,1525,1620
1976-03-03,Israel,Northern Ireland,1,1,0,0.5,0.5,1657,1656
1976-03-04,Morocco,DR Congo,1,0,1,1.0,0.0,1653,1652
1976-03-04,Nigeria,Sudan,1,0,1,1.0,0.0,1690,1594
1976-03-05,Ethiopia,Egypt,1,1,0,0.5,0.5,1529,1711
1976-03-05,Guinea,Uganda,2,1,1,1.0,0.0,1627,1563
1976-03-06,Morocco,Nigeria,3,1,2,1.0,0.0,1662,1682
1976-03-06,Sudan,DR Congo,1,1,0,0.5,0.5,1596,1651
1976-03-07,Sierra Leone,Niger,5,1,4,1.0,0.0,1488,1419
1976-03-09,Egypt,Morocco,1,2,1,0.0,1.0,1702,1672
1976-03-09,Guinea,Nigeria,1,1,0,0.5,0.5,1629,1681
1976-03-10,Czechoslovakia,Russia,2,2,0,0.5,0.5,1778,1785
1976-03-10,Malta,Libya,2,2,0,0.5,0.5,1475,1539
1976-03-10,Uruguay,Paraguay,2,2,0,0.5,0.5,1703,1645
1976-03-11,Egypt,Guinea,2,4,2,0.0,1.0,1693,1639
1976-03-11,Morocco,Nigeria,2,1,1,1.0,0.0,1681,1673
1976-03-13,Burkina Faso,Mauritania,1,1,0,0.5,0.5,1460,1451
1976-03-14,Egypt,Nigeria,2,3,1,0.0,1.0,1685,1682
1976-03-14,Guinea,Morocco,1,1,0,0.5,0.5,1640,1681
1976-03-20,Russia,Argentina,0,1,1,0.0,1.0,1778,1803
1976-03-20,Alderney,Guernsey,0,5,5,0.0,1.0,1312,1639
1976-03-21,Ghana,Togo,4,0,4,1.0,0.0,1676,1529
1976-03-21,Ivory Coast,Senegal,4,1,3,1.0,0.0,1594,1540
1976-03-21,Niger,Sierra Leone,2,1,1,1.0,0.0,1429,1479
1976-03-24,Bulgaria,Russia,0,3,3,0.0,1.0,1729,1786
1976-03-24,Republic of Ireland,Norway,3,0,3,1.0,0.0,1610,1502
1976-03-24,Poland,Argentina,1,2,1,0.0,1.0,1804,1812
1976-03-24,Wales,England,1,2,1,0.0,1.0,1626,1869
1976-03-26,Qatar,Saudi Arabia,1,0,1,1.0,0.0,1437,1507
1976-03-27,Bahrain,United Arab Emirates,3,2,1,1.0,0.0,1463,1449
1976-03-27,France,Czechoslovakia,2,2,0,0.5,0.5,1697,1777
1976-03-27,Hungary,Argentina,2,0,2,1.0,0.0,1778,1804
1976-03-27,Iraq,Oman,4,0,4,1.0,0.0,1659,1466
1976-03-28,Gabon,Ivory Coast,0,3,3,0.0,1.0,1453,1599
1976-03-28,Mauritania,Burkina Faso,0,2,2,0.0,1.0,1444,1468
1976-03-28,Qatar,Kuwait,0,4,4,0.0,1.0,1433,1614
1976-03-29,Bahrain,Iraq,1,4,3,0.0,1.0,1460,1663
1976-03-29,Saudi Arabia,United Arab Emirates,2,0,2,1.0,0.0,1514,1443
1976-03-31,Kuwait,Oman,8,0,8,1.0,0.0,1619,1462
1976-04-01,Algeria,Libya,1,0,1,1.0,0.0,1588,1532
1976-04-01,Iraq,Saudi Arabia,7,1,6,1.0,0.0,1668,1510
1976-04-01,Qatar,United Arab Emirates,3,1,2,1.0,0.0,1442,1435
1976-04-02,Bahrain,Oman,1,0,1,1.0,0.0,1469,1454
1976-04-02,Dominican Republic,Haiti,0,3,3,0.0,1.0,1504,1610
1976-04-03,Kuwait,United Arab Emirates,0,0,0,0.5,0.5,1616,1439
1976-04-03,Qatar,Iraq,0,0,0,0.5,0.5,1447,1664
1976-04-04,Oman,Saudi Arabia,1,3,2,0.0,1.0,1448,1517
1976-04-04,Panama,Costa Rica,3,2,1,1.0,0.0,1476,1691
1976-04-06,Bahrain,Kuwait,2,5,3,0.0,1.0,1465,1621
1976-04-06,Iraq,United Arab Emirates,4,0,4,1.0,0.0,1668,1436
1976-04-07,Italy,Portugal,3,1,2,1.0,0.0,1847,1721
1976-04-07,Paraguay,Brazil,1,1,0,0.5,0.5,1651,1948
1976-04-07,Qatar,Oman,4,1,3,1.0,0.0,1456,1440
1976-04-07,Scotland,Switzerland,1,0,1,1.0,0.0,1748,1607
1976-04-08,Argentina,Uruguay,4,1,3,1.0,0.0,1810,1698
1976-04-08,Bahrain,Saudi Arabia,2,1,1,1.0,0.0,1475,1508
1976-04-08,Iraq,Kuwait,2,2,0,0.5,0.5,1667,1623
1976-04-10,Oman,United Arab Emirates,1,1,0,0.5,0.5,1440,1437
1976-04-10,Qatar,Bahrain,3,0,3,1.0,0.0,1465,1467
1976-04-11,Kuwait,Saudi Arabia,3,1,2,1.0,0.0,1629,1503
1976-04-15,Iraq,Kuwait,2,4,2,0.0,1.0,1659,1638
1976-04-16,Libya,Algeria,0,0,0,0.5,0.5,1534,1587
1976-04-17,Haiti,Dominican Republic,3,0,3,1.0,0.0,1616,1499
1976-04-17,Yugoslavia,Hungary,0,0,0,0.5,0.5,1794,1779
1976-04-19,Ivory Coast,Gabon,1,3,2,0.0,1.0,1588,1465
1976-04-19,Sierra Leone,Guinea,1,1,0,0.5,0.5,1483,1637
1976-04-21,Congo,Cuba,3,1,2,1.0,0.0,1581,1456
1976-04-21,German DR,Algeria,5,0,5,1.0,0.0,1795,1584
1976-04-24,Czechoslovakia,Russia,2,0,2,1.0,0.0,1786,1778
1976-04-24,France,Poland,2,0,2,1.0,0.0,1708,1794
1976-04-24,Spain,Germany,1,1,0,0.5,0.5,1794,1914
1976-04-24,Yugoslavia,Wales,2,0,2,1.0,0.0,1799,1622
1976-04-25,Netherlands,Belgium,5,0,5,1.0,0.0,1795,1755
1976-04-25,Sierra Leone,Liberia,1,0,1,1.0,0.0,1491,1450
1976-04-28,Argentina,Paraguay,2,2,0,0.5,0.5,1807,1655
1976-04-28,Austria,Sweden,1,0,1,1.0,0.0,1725,1762
1976-04-28,Brazil,Uruguay,2,1,1,1.0,0.0,1952,1695
1976-04-30,Switzerland,Hungary,0,1,1,0.0,1.0,1603,1784
1976-05-02,Algeria,Guinea,1,2,1,0.0,1.0,1578,1644
1976-05-02,Gabon,São Tomé and Príncipe,6,1,5,1.0,0.0,1474,1492
1976-05-02,Guadeloupe,Martinique,0,1,1,0.0,1.0,1519,1581
1976-05-02,Panama,El Salvador,1,1,0,0.5,0.5,1479,1564
1976-05-05,Bulgaria,North Korea,3,0,3,1.0,0.0,1736,1637
1976-05-06,China PR,Malaysia,2,0,2,1.0,0.0,1687,1630
1976-05-06,Greece,Poland,1,0,1,1.0,0.0,1587,1782
1976-05-06,Scotland,Wales,3,1,2,1.0,0.0,1754,1617
1976-05-08,Scotland,Northern Ireland,3,0,3,1.0,0.0,1760,1651
1976-05-08,Wales,England,0,1,1,0.0,1.0,1614,1873
1976-05-09,Zambia,Malawi,4,0,4,1.0,0.0,1606,1553
1976-05-09,Jersey,Guernsey,3,1,2,1.0,0.0,1688,1632
1976-05-11,England,Northern Ireland,4,0,4,1.0,0.0,1877,1648
1976-05-11,Martinique,Guadeloupe,3,2,1,1.0,0.0,1588,1513
1976-05-11,Sweden,Denmark,1,2,1,0.0,1.0,1751,1609
1976-05-11,Switzerland,Poland,2,1,1,1.0,0.0,1615,1771
1976-05-12,Bulgaria,Romania,1,0,1,1.0,0.0,1744,1707
1976-05-14,Wales,Northern Ireland,1,0,1,1.0,0.0,1623,1640
1976-05-15,Scotland,England,2,1,1,1.0,0.0,1771,1867
1976-05-19,Brazil,Argentina,2,0,2,1.0,0.0,1957,1803
1976-05-19,Finland,Switzerland,1,0,1,1.0,0.0,1453,1604
1976-05-19,Norway,Iceland,0,1,1,0.0,1.0,1493,1467
1976-05-19,Paraguay,Uruguay,1,0,1,1.0,0.0,1664,1687
1976-05-22,Belgium,Netherlands,1,2,1,0.0,1.0,1748,1803
1976-05-22,Germany,Spain,2,0,2,1.0,0.0,1920,1789
1976-05-22,Hungary,France,1,0,1,1.0,0.0,1791,1702
1976-05-22,Russia,Czechoslovakia,2,2,0,0.5,0.5,1779,1786
1976-05-22,Wales,Yugoslavia,1,1,0,0.5,0.5,1627,1796
1976-05-23,Brazil,England,1,0,1,1.0,0.0,1963,1862
1976-05-23,Cyprus,Denmark,1,5,4,0.0,1.0,1408,1613
1976-05-26,Hungary,Russia,1,1,0,0.5,0.5,1791,1780
1976-05-26,Poland,Republic of Ireland,0,2,2,0.0,1.0,1760,1622
1976-05-28,England,Italy,3,2,1,1.0,0.0,1870,1840
1976-05-30,Malawi,Zambia,0,1,1,0.0,1.0,1547,1613
1976-05-31,Brazil,Italy,4,1,3,1.0,0.0,1969,1835
1976-06-01,Finland,Sweden,0,2,2,0.0,1.0,1451,1754
1976-06-03,Kuwait,Malaysia,2,0,2,1.0,0.0,1646,1623
1976-06-04,Iran,Iraq,2,0,2,1.0,0.0,1668,1652
1976-06-04,Mexico,Brazil,0,3,3,0.0,1.0,1747,1973
1976-06-05,China PR,Malaysia,1,1,0,0.5,0.5,1686,1625
1976-06-05,Italy,Romania,4,2,2,1.0,0.0,1841,1702
1976-06-06,Iraq,Yemen DPR,1,0,1,1.0,0.0,1657,1488
1976-06-06,Catalonia,Russia,1,1,0,0.5,0.5,1507,1775
1976-06-07,China PR,Kuwait,0,1,1,0.0,1.0,1678,1655
1976-06-08,Myanmar,Malaysia,3,1,2,1.0,0.0,1692,1619
1976-06-08,Iran,Yemen DPR,8,0,8,1.0,0.0,1673,1484
1976-06-09,Brazil,Paraguay,3,1,2,1.0,0.0,1976,1662
1976-06-09,Uruguay,Argentina,0,3,3,0.0,1.0,1682,1809
1976-06-10,Indonesia,Malaysia,1,2,1,0.0,1.0,1582,1627
1976-06-11,Iran,China PR,2,0,2,1.0,0.0,1682,1670
1976-06-11,Iraq,Kuwait,2,3,1,0.0,1.0,1649,1664
1976-06-12,Hungary,Austria,2,0,2,1.0,0.0,1798,1719
1976-06-12,Indonesia,Myanmar,1,1,0,0.5,0.5,1585,1690
1976-06-13,China PR,Iraq,1,0,1,1.0,0.0,1678,1642
1976-06-13,Finland,England,1,4,3,0.0,1.0,1450,1872
1976-06-13,Iran,Kuwait,1,0,1,1.0,0.0,1690,1657
1976-06-16,Czechoslovakia,Netherlands,3,1,2,1.0,0.0,1795,1795
1976-06-16,Faroe Islands,Iceland,1,6,5,0.0,1.0,1458,1475
1976-06-16,Sweden,Norway,2,0,2,1.0,0.0,1757,1491
1976-06-17,Yugoslavia,Germany,2,4,2,0.0,1.0,1791,1926
1976-06-19,Yugoslavia,Netherlands,2,3,1,0.0,1.0,1784,1803
1976-06-20,Czechoslovakia,Germany,2,2,0,0.5,0.5,1798,1924
1976-06-23,Austria,Russia,1,2,1,0.0,1.0,1713,1782
1976-06-24,Norway,Denmark,0,0,0,0.5,0.5,1494,1611
1976-06-29,Réunion,Kenya,1,3,2,0.0,1.0,1418,1590
1976-06-30,Guatemala,Costa Rica,1,0,1,1.0,0.0,1602,1681
1976-07-01,Gabon,DR Congo,1,1,0,0.5,0.5,1478,1648
1976-07-01,Seychelles,Réunion,1,4,3,0.0,1.0,1492,1428
1976-07-02,Iran,Romania,2,2,0,0.5,0.5,1691,1702
1976-07-02,Réunion,Mauritius,0,2,2,0.0,1.0,1422,1509
1976-07-03,Rwanda,DR Congo,1,6,5,0.0,1.0,1496,1653
1976-07-03,Seychelles,Kenya,1,4,3,0.0,1.0,1487,1596
1976-07-04,Guyana,Suriname,2,0,2,1.0,0.0,1457,1627
1976-07-05,Cameroon,DR Congo,2,1,1,1.0,0.0,1576,1644
1976-07-06,Malawi,Kenya,1,0,1,1.0,0.0,1557,1587
1976-07-07,Burundi,DR Congo,0,1,1,0.0,1.0,1470,1649
1976-07-07,Guatemala,El Salvador,1,0,1,1.0,0.0,1610,1557
1976-07-08,Malawi,Sierra Leone,4,2,2,1.0,0.0,1564,1485
1976-07-11,Costa Rica,Panama,3,0,3,1.0,0.0,1685,1476
1976-07-14,Finland,Iceland,1,0,1,1.0,0.0,1459,1467
1976-07-19,Afghanistan,Pakistan,1,0,1,1.0,0.0,1442,1460
1976-07-21,India,Pakistan,1,1,0,0.5,0.5,1566,1463
1976-07-24,Afghanistan,India,1,1,0,0.5,0.5,1445,1564
1976-07-30,Curaçao,Haiti,1,2,1,0.0,1.0,1544,1623
1976-08-07,Malaysia,South Korea,2,1,1,1.0,0.0,1638,1748
1976-08-08,Myanmar,Indonesia,5,1,4,1.0,0.0,1696,1580
1976-08-08,India,Japan,1,5,4,0.0,1.0,1557,1600
1976-08-08,São Tomé and Príncipe,Congo,2,3,1,0.0,1.0,1487,1587
1976-08-09,Malaysia,Thailand,0,0,0,0.5,0.5,1636,1551
1976-08-10,Malaysia,India,5,1,4,1.0,0.0,1643,1551
1976-08-10,India,South Korea,0,8,8,0.0,1.0,1548,1752
1976-08-10,Indonesia,Japan,0,6,6,0.0,1.0,1573,1608
1976-08-11,Australia,Hong Kong,0,1,1,0.0,1.0,1679,1550
1976-08-11,Myanmar,Thailand,1,0,1,1.0,0.0,1701,1547
1976-08-11,El Salvador,Panama,4,1,3,1.0,0.0,1564,1470
1976-08-11,Sweden,Finland,6,0,6,1.0,0.0,1760,1457
1976-08-12,Indonesia,South Korea,0,2,2,0.0,1.0,1569,1757
1976-08-13,Myanmar,Japan,2,2,0,0.5,0.5,1699,1611
1976-08-14,Malaysia,Indonesia,7,1,6,1.0,0.0,1650,1563
1976-08-14,Haiti,Curaçao,7,0,7,1.0,0.0,1630,1538
1976-08-14,India,Thailand,2,6,4,0.0,1.0,1540,1556
1976-08-14,Indonesia,India,1,3,2,0.0,1.0,1555,1549
1976-08-15,Barbados,Trinidad and Tobago,2,1,1,1.0,0.0,1473,1611
1976-08-15,Myanmar,South Korea,2,2,0,0.5,0.5,1701,1756
1976-08-15,Jamaica,Cuba,1,3,2,0.0,1.0,1494,1466
1976-08-16,Japan,Thailand,2,2,0,0.5,0.5,1610,1558
1976-08-17,Malaysia,Myanmar,3,1,2,1.0,0.0,1660,1692
1976-08-17,Switzerland,Bulgaria,2,2,0,0.5,0.5,1608,1741
1976-08-18,Australia,Hong Kong,2,0,2,1.0,0.0,1685,1545
1976-08-18,Indonesia,Thailand,0,1,1,0.0,1.0,1548,1566
1976-08-18,Japan,South Korea,0,0,0,0.5,0.5,1614,1753
1976-08-19,Myanmar,India,2,2,0,0.5,0.5,1689,1553
1976-08-20,South Korea,Thailand,2,1,1,1.0,0.0,1758,1562
1976-08-20,Malaysia,Japan,2,2,0,0.5,0.5,1659,1616
1976-08-21,Iceland,Luxembourg,3,1,2,1.0,0.0,1474,1373
1976-08-22,Malaysia,Japan,2,0,2,1.0,0.0,1667,1609
1976-08-25,Denmark,Norway,3,0,3,1.0,0.0,1617,1489
1976-08-25,Finland,Turkey,2,1,1,1.0,0.0,1469,1612
1976-08-29,Cuba,Jamaica,2,0,2,1.0,0.0,1475,1486
1976-08-29,Suriname,Guyana,3,0,3,1.0,0.0,1632,1453
1976-08-31,Trinidad and Tobago,Barbados,1,0,1,1.0,0.0,1616,1469
1976-09-01,Denmark,France,1,1,0,0.5,0.5,1619,1701
1976-09-04,Burkina Faso,Ivory Coast,1,1,0,0.5,0.5,1471,1586
1976-09-04,Malawi,Uganda,1,1,0,0.5,0.5,1564,1564
1976-09-05,Iceland,Belgium,0,1,1,0.0,1.0,1472,1751
1976-09-05,Saudi Arabia,Iraq,0,0,0,0.5,0.5,1507,1639
1976-09-06,Malawi,Uganda,1,2,1,0.0,1.0,1556,1572
1976-09-08,England,Republic of Ireland,1,1,0,0.5,0.5,1868,1627
1976-09-08,Iceland,Netherlands,0,1,1,0.0,1.0,1470,1806
1976-09-08,Libya,Algeria,0,1,1,0.0,1.0,1528,1585
1976-09-08,Norway,Switzerland,1,0,1,1.0,0.0,1500,1598
1976-09-08,Scotland,Finland,6,0,6,1.0,0.0,1774,1467
1976-09-08,Sweden,Hungary,1,1,0,0.5,0.5,1761,1798
1976-09-09,Ivory Coast,Ghana,3,1,2,1.0,0.0,1597,1666
1976-09-10,Libya,Algeria,1,0,1,1.0,0.0,1538,1576
1976-09-11,South Korea,Malaysia,4,4,0,0.5,0.5,1756,1670
1976-09-12,Myanmar,New Zealand,0,2,2,0.0,1.0,1678,1563
1976-09-12,Saudi Arabia,Morocco,0,2,2,0.0,1.0,1503,1686
1976-09-13,South Korea,India,4,0,4,1.0,0.0,1760,1550
1976-09-13,Malawi,Botswana,7,1,6,1.0,0.0,1563,1485
1976-09-13,Malaysia,Singapore,4,1,3,1.0,0.0,1674,1445
1976-09-14,Barbados,Trinidad and Tobago,1,3,2,0.0,1.0,1465,1621
1976-09-15,India,Singapore,1,2,1,0.0,1.0,1540,1456
1976-09-16,Myanmar,Thailand,2,0,2,1.0,0.0,1684,1557
1976-09-17,South Korea,Singapore,7,0,7,1.0,0.0,1763,1454
1976-09-17,Malawi,Botswana,3,0,3,1.0,0.0,1570,1479
1976-09-17,Panama,Guatemala,2,4,2,0.0,1.0,1466,1615
1976-09-18,New Zealand,Thailand,3,1,2,1.0,0.0,1571,1550
1976-09-19,India,Malaysia,0,4,4,0.0,1.0,1535,1680
1976-09-22,Austria,Switzerland,3,1,2,1.0,0.0,1719,1593
1976-09-22,Bulgaria,Turkey,2,2,0,0.5,0.5,1739,1615
1976-09-22,Denmark,Italy,0,1,1,0.0,1.0,1616,1845
1976-09-22,Finland,Luxembourg,7,1,6,1.0,0.0,1473,1368
1976-09-22,German DR,Hungary,1,1,0,0.5,0.5,1796,1798
1976-09-22,Greece,Israel,0,1,1,0.0,1.0,1581,1664
1976-09-22,Norway,Sweden,3,2,1,1.0,0.0,1514,1748
1976-09-22,Romania,Czechoslovakia,1,1,0,0.5,0.5,1705,1796
1976-09-23,South Korea,New Zealand,2,0,2,1.0,0.0,1767,1568
1976-09-24,Canada,United States,1,1,0,0.5,0.5,1481,1446
1976-09-25,Italy,Yugoslavia,3,0,3,1.0,0.0,1852,1778
1976-09-26,Guatemala,Panama,7,0,7,1.0,0.0,1620,1462
1976-09-26,Ivory Coast,Burkina Faso,2,0,2,1.0,0.0,1603,1466
1976-09-30,Botswana,Zambia,2,3,1,0.0,1.0,1474,1619
1976-09-30,Saudi Arabia,Tunisia,0,1,1,0.0,1.0,1498,1638
1976-10-02,New Caledonia,New Zealand,2,1,1,1.0,0.0,1617,1561
1976-10-03,United States,Mexico,0,0,0,0.5,0.5,1452,1742
1976-10-06,Chile,Uruguay,0,0,0,0.5,0.5,1669,1682
1976-10-06,Czechoslovakia,Romania,3,2,1,1.0,0.0,1802,1700
1976-10-06,Wales,Germany,0,2,2,0.0,1.0,1625,1927
1976-10-09,Bulgaria,France,2,2,0,0.5,0.5,1739,1702
1976-10-09,Greece,Hungary,1,1,0,0.5,0.5,1586,1794
1976-10-09,Switzerland,Sweden,1,2,1,0.0,1.0,1589,1753
1976-10-09,Uganda,Burundi,2,0,2,1.0,0.0,1578,1465
1976-10-10,Albania,Algeria,3,0,3,1.0,0.0,1495,1566
1976-10-10,Canada,Mexico,1,0,1,1.0,0.0,1495,1729
1976-10-10,Ethiopia,Mauritius,3,0,3,1.0,0.0,1537,1502
1976-10-10,Ghana,Guinea,2,1,1,1.0,0.0,1674,1637
1976-10-10,Spain,Yugoslavia,1,0,1,1.0,0.0,1797,1771
1976-10-11,Uganda,Burundi,1,0,1,1.0,0.0,1584,1460
1976-10-12,Pakistan,Afghanistan,1,0,1,1.0,0.0,1471,1438
1976-10-12,Peru,Uruguay,0,0,0,0.5,0.5,1669,1682
1976-10-13,Argentina,Chile,2,0,2,1.0,0.0,1814,1665
1976-10-13,Austria,Hungary,2,4,2,0.0,1.0,1713,1801
1976-10-13,Czechoslovakia,Scotland,2,0,2,1.0,0.0,1810,1767
1976-10-13,England,Finland,2,1,1,1.0,0.0,1870,1472
1976-10-13,Netherlands,Northern Ireland,2,2,0,0.5,0.5,1803,1644
1976-10-13,Turkey,Republic of Ireland,3,3,0,0.5,0.5,1616,1627
1976-10-15,Colombia,Uruguay,1,2,1,0.0,1.0,1523,1687
1976-10-15,Mexico,United States,3,0,3,1.0,0.0,1732,1450
1976-10-16,Luxembourg,Italy,1,4,3,0.0,1.0,1368,1853
1976-10-16,Portugal,Poland,0,2,2,0.0,1.0,1714,1768
1976-10-16,Sierra Leone,Nigeria,0,0,0,0.5,0.5,1490,1678
1976-10-17,Congo,Cameroon,2,2,0,0.5,0.5,1587,1577
1976-10-17,Togo,Senegal,1,0,1,1.0,0.0,1538,1532
1976-10-20,Ecuador,Uruguay,2,2,0,0.5,0.5,1449,1683
1976-10-20,Indonesia,Australia,1,1,0,0.5,0.5,1552,1682
1976-10-20,Iraq,Libya,1,0,1,1.0,0.0,1645,1533
1976-10-20,United States,Canada,2,0,2,1.0,0.0,1460,1486
1976-10-22,Iraq,Libya,3,1,2,1.0,0.0,1651,1528
1976-10-22,Singapore,Australia,0,1,1,0.0,1.0,1451,1686
1976-10-24,Hong Kong,Australia,0,2,2,0.0,1.0,1541,1691
1976-10-24,Malawi,Mauritius,1,1,0,0.5,0.5,1569,1504
1976-10-24,Uganda,Ethiopia,4,1,3,1.0,0.0,1591,1531
1976-10-27,Bulgaria,German DR,0,4,4,0.0,1.0,1733,1803
1976-10-27,Denmark,Cyprus,5,0,5,1.0,0.0,1620,1405
1976-10-27,Mexico,Canada,0,0,0,0.5,0.5,1728,1491
1976-10-28,Peru,Argentina,1,3,2,0.0,1.0,1665,1819
1976-10-29,Egypt,Ethiopia,3,0,3,1.0,0.0,1690,1527
1976-10-30,Nigeria,Sierra Leone,6,2,4,1.0,0.0,1683,1486
1976-10-31,Cameroon,Congo,1,2,1,0.0,1.0,1570,1595
1976-10-31,Guinea,Ghana,2,1,1,1.0,0.0,1646,1666
1976-10-31,Poland,Cyprus,5,0,5,1.0,0.0,1770,1404
1976-10-31,Senegal,Togo,1,1,0,0.5,0.5,1533,1538
1976-10-31,Turkey,Malta,4,0,4,1.0,0.0,1621,1471
1976-11-01,Algeria,Libya,2,0,2,1.0,0.0,1574,1521
1976-11-03,Israel,Australia,1,1,0,0.5,0.5,1665,1691
1976-11-04,Tunisia,Libya,3,0,3,1.0,0.0,1644,1516
1976-11-05,Zanzibar,Zambia,0,3,3,0.0,1.0,1332,1622
1976-11-06,Somalia,Uganda,0,2,2,0.0,1.0,1446,1596
1976-11-06,Tanzania,Kenya,1,1,0,0.5,0.5,1505,1586
1976-11-07,Tanzania,Malawi,1,1,0,0.5,0.5,1507,1568
1976-11-08,Somalia,Zambia,2,4,2,0.0,1.0,1442,1627
1976-11-08,Zanzibar,Uganda,0,1,1,0.0,1.0,1330,1599
1976-11-09,Kenya,Malawi,2,2,0,0.5,0.5,1586,1569
1976-11-10,Argentina,Peru,1,0,1,1.0,0.0,1824,1661
1976-11-10,Belgium,Northern Ireland,2,0,2,1.0,0.0,1757,1639
1976-11-10,Greece,Austria,0,3,3,0.0,1.0,1581,1719
1976-11-10,Haiti,United States,0,0,0,0.5,0.5,1627,1464
1976-11-10,Zanzibar,Somalia,1,0,1,1.0,0.0,1341,1432
1976-11-11,Uganda,Zambia,2,3,1,0.0,1.0,1592,1635
1976-11-12,Haiti,United States,0,0,0,0.5,0.5,1624,1468
1976-11-12,Kenya,Zambia,0,2,2,0.0,1.0,1580,1642
1976-11-12,Malawi,Uganda,1,2,1,0.0,1.0,1562,1600
1976-11-12,Saudi Arabia,Syria,2,0,2,1.0,0.0,1508,1535
1976-11-14,Ethiopia,Egypt,1,2,1,0.0,1.0,1523,1695
1976-11-14,Haiti,United States,0,0,0,0.5,0.5,1621,1472
1976-11-14,Suriname,Trinidad and Tobago,1,1,0,0.5,0.5,1632,1622
1976-11-14,Uganda,Zambia,2,0,2,1.0,0.0,1609,1634
1976-11-16,Tanzania,Zambia,2,3,1,0.0,1.0,1502,1640
1976-11-16,Zanzibar,Somalia,1,1,0,0.5,0.5,1344,1430
1976-11-17,France,Republic of Ireland,2,0,2,1.0,0.0,1709,1621
1976-11-17,German DR,Turkey,1,1,0,0.5,0.5,1800,1625
1976-11-17,Germany,Czechoslovakia,2,0,2,1.0,0.0,1933,1805
1976-11-17,Italy,England,2,0,2,1.0,0.0,1862,1862
1976-11-17,Portugal,Denmark,1,0,1,1.0,0.0,1720,1615
1976-11-17,Scotland,Wales,1,0,1,1.0,0.0,1772,1621
1976-11-24,Mali,Burkina Faso,2,1,1,1.0,0.0,1597,1461
1976-11-24,Malta,Tunisia,1,1,0,0.5,0.5,1475,1641
1976-11-24,Uruguay,Peru,0,0,0,0.5,0.5,1683,1662
1976-11-26,Syria,Saudi Arabia,2,1,1,1.0,0.0,1543,1501
1976-11-28,Argentina,Russia,0,0,0,0.5,0.5,1824,1783
1976-11-28,Cuba,Haiti,1,1,0,0.5,0.5,1479,1618
1976-11-28,Romania,Bulgaria,3,2,1,1.0,0.0,1709,1725
1976-11-28,Trinidad and Tobago,Suriname,2,2,0,0.5,0.5,1623,1632
1976-12-01,Brazil,Russia,2,0,2,1.0,0.0,1980,1780
1976-12-01,El Salvador,Costa Rica,1,1,0,0.5,0.5,1567,1683
1976-12-04,Japan,South Korea,1,2,1,0.0,1.0,1605,1772
1976-12-05,Costa Rica,Guatemala,0,0,0,0.5,0.5,1682,1622
1976-12-05,Cyprus,Portugal,1,2,1,0.0,1.0,1402,1723
1976-12-05,Malta,Austria,0,1,1,0.0,1.0,1472,1723
1976-12-08,Guatemala,El Salvador,3,1,2,1.0,0.0,1629,1561
1976-12-11,Haiti,Cuba,1,1,0,0.5,0.5,1615,1483
1976-12-12,Guatemala,Costa Rica,1,1,0,0.5,0.5,1631,1681
1976-12-12,Morocco,Tunisia,1,1,0,0.5,0.5,1685,1643
1976-12-15,Costa Rica,El Salvador,1,1,0,0.5,0.5,1679,1564
1976-12-15,Israel,Austria,1,3,2,0.0,1.0,1659,1730
1976-12-15,Thailand,South Korea,2,1,1,1.0,0.0,1563,1760
1976-12-17,South Korea,Singapore,4,0,4,1.0,0.0,1763,1449
1976-12-18,Bangladesh,Malaysia,0,6,6,0.0,1.0,1465,1684
1976-12-18,Suriname,Trinidad and Tobago,3,2,1,1.0,0.0,1640,1616
1976-12-19,El Salvador,Guatemala,2,0,2,1.0,0.0,1574,1622
1976-12-19,Thailand,Singapore,6,0,6,1.0,0.0,1569,1444
1976-12-22,Canada,United States,3,0,3,1.0,0.0,1499,1465
1976-12-22,South Korea,Malaysia,1,1,0,0.5,0.5,1762,1686
1976-12-22,Portugal,Italy,2,1,1,1.0,0.0,1735,1851
1976-12-23,Panama,Cuba,0,5,5,0.0,1.0,1455,1491
1976-12-25,Thailand,Malaysia,1,1,0,0.5,0.5,1572,1684
1976-12-29,Cuba,Haiti,0,2,2,0.0,1.0,1486,1621
1977-01-04,Uruguay,Ecuador,1,1,0,0.5,0.5,1679,1454
1977-01-05,Northern Cyprus,Turkey,0,1,1,0.0,1.0,1495,1631
1977-01-07,Saudi Arabia,Iran,0,3,3,0.0,1.0,1497,1696
1977-01-09,Paraguay,Ecuador,2,0,2,1.0,0.0,1666,1451
1977-01-09,Tunisia,Morocco,1,1,0,0.5,0.5,1644,1685
1977-01-11,Algeria,Bulgaria,1,1,0,0.5,0.5,1578,1722
1977-01-12,Paraguay,Uruguay,1,1,0,0.5,0.5,1667,1679
1977-01-16,Colombia,Ecuador,0,1,1,0.0,1.0,1514,1461
1977-01-16,Guinea,Ghana,2,0,2,1.0,0.0,1655,1658
1977-01-20,Venezuela,Ecuador,1,0,1,1.0,0.0,1463,1453
1977-01-23,Brazil,Bulgaria,1,0,1,1.0,0.0,1983,1720
1977-01-23,Congo,Gabon,2,2,0,0.5,0.5,1593,1481
1977-01-23,Uruguay,Paraguay,2,1,1,1.0,0.0,1687,1660
1977-01-25,Uganda,Iraq,1,1,0,0.5,0.5,1610,1651
1977-01-26,Cameroon,Congo,2,2,0,0.5,0.5,1571,1593
1977-01-26,Chile,Paraguay,4,0,4,1.0,0.0,1673,1653
1977-01-26,Ecuador,Colombia,4,1,3,1.0,0.0,1463,1505
1977-01-26,Israel,Greece,1,1,0,0.5,0.5,1658,1583
1977-01-26,Italy,Belgium,2,1,1,1.0,0.0,1857,1752
1977-01-28,Syria,Iran,0,1,1,0.0,1.0,1539,1701
1977-01-28,Mauritius,Malawi,3,2,1,1.0,0.0,1514,1553
1977-01-30,Colombia,Yugoslavia,0,1,1,0.0,1.0,1503,1774
1977-01-30,Cyprus,Bulgaria,1,2,1,0.0,1.0,1400,1723
1977-01-30,Gambia,Denmark,1,4,3,0.0,1.0,1461,1620
1977-01-30,Uruguay,Chile,3,0,3,1.0,0.0,1695,1666
1977-02-01,Mexico,Yugoslavia,5,1,4,1.0,0.0,1738,1765
1977-02-01,Tanzania,Mozambique,2,1,1,1.0,0.0,1511,1507
1977-02-02,France,Romania,2,0,2,1.0,0.0,1717,1701
1977-02-02,Paraguay,Chile,2,0,2,1.0,0.0,1662,1658
1977-02-02,Senegal,Denmark,2,3,1,0.0,1.0,1527,1627
1977-02-05,Gabon,Morocco,0,1,1,0.0,1.0,1478,1689
1977-02-06,Bolivia,Paraguay,0,1,1,0.0,1.0,1514,1667
1977-02-06,Kenya,Egypt,0,0,0,0.5,0.5,1583,1693
1977-02-06,Tunisia,Algeria,2,0,2,1.0,0.0,1651,1572
1977-02-08,Mexico,Yugoslavia,0,1,1,0.0,1.0,1731,1773
1977-02-09,Bolivia,Paraguay,2,2,0,0.5,0.5,1518,1664
1977-02-09,England,Netherlands,0,2,2,0.0,1.0,1853,1813
1977-02-09,Republic of Ireland,Spain,0,1,1,0.0,1.0,1617,1802
1977-02-09,Peru,Hungary,3,2,1,1.0,0.0,1674,1790
1977-02-09,Thailand,Israel,3,3,0,0.5,0.5,1574,1657
1977-02-09,Venezuela,Uruguay,1,1,0,0.5,0.5,1468,1691
1977-02-12,Australia,Israel,1,1,0,0.5,0.5,1691,1658
1977-02-13,Ecuador,Paraguay,2,1,1,1.0,0.0,1476,1652
1977-02-13,Ivory Coast,Congo,3,2,1,1.0,0.0,1611,1586
1977-02-13,Togo,Guinea,0,2,2,0.0,1.0,1533,1661
1977-02-13,Uganda,Zambia,1,0,1,1.0,0.0,1619,1632
1977-02-14,Nigeria,Benin,7,0,7,1.0,0.0,1688,1514
1977-02-14,Singapore,South Korea,0,4,4,0.0,1.0,1442,1765
1977-02-16,Australia,Israel,1,1,0,0.5,0.5,1691,1659
1977-02-16,Turkey,Bulgaria,2,0,2,1.0,0.0,1642,1713
1977-02-17,Bahrain,South Korea,1,4,3,0.0,1.0,1465,1768
1977-02-17,Algeria,Kenya,4,1,3,1.0,0.0,1581,1575
1977-02-17,Mauritius,Ethiopia,2,3,1,0.0,1.0,1507,1531
1977-02-17,Sierra Leone,Nigeria,1,1,0,0.5,0.5,1491,1684
1977-02-19,Bahrain,South Korea,1,1,0,0.5,0.5,1471,1763
1977-02-20,Colombia,Brazil,0,0,0,0.5,0.5,1511,1976
1977-02-20,Ecuador,Peru,1,1,0,0.5,0.5,1481,1670
1977-02-20,Panama,Paraguay,0,4,4,0.0,1.0,1452,1656
1977-02-22,Mexico,Hungary,1,1,0,0.5,0.5,1733,1789
1977-02-23,France,Germany,1,0,1,1.0,0.0,1730,1921
1977-02-24,Colombia,Paraguay,0,1,1,0.0,1.0,1507,1661
1977-02-27,Argentina,Hungary,5,1,4,1.0,0.0,1832,1782
1977-02-27,Bolivia,Uruguay,1,0,1,1.0,0.0,1530,1680
1977-02-27,Botswana,China PR,0,2,2,0.0,1.0,1471,1682
1977-02-27,Congo,Ivory Coast,1,3,2,0.0,1.0,1579,1619
1977-02-27,Ecuador,Chile,0,1,1,0.0,1.0,1477,1663
1977-02-27,Egypt,Kenya,1,0,1,1.0,0.0,1699,1570
1977-02-27,Guinea,Togo,2,1,1,1.0,0.0,1667,1528
1977-02-27,Israel,South Korea,0,0,0,0.5,0.5,1662,1761
1977-02-27,Singapore,Thailand,2,0,2,1.0,0.0,1453,1564
1977-02-27,Zambia,Uganda,4,2,2,1.0,0.0,1640,1612
1977-02-28,Algeria,Tunisia,1,1,0,0.5,0.5,1583,1650
1977-02-28,Hong Kong,Indonesia,4,1,3,1.0,0.0,1550,1544
1977-03-01,Malaysia,Thailand,6,4,2,1.0,0.0,1690,1559
1977-03-02,Singapore,Hong Kong,2,2,0,0.5,0.5,1456,1548
1977-03-03,Indonesia,Malaysia,0,0,0,0.5,0.5,1548,1687
1977-03-05,New Zealand,New Caledonia,3,0,3,1.0,0.0,1571,1608
1977-03-05,Senegal,Guinea,1,0,1,1.0,0.0,1539,1656
1977-03-05,Thailand,Hong Kong,1,2,1,0.0,1.0,1551,1557
1977-03-05,Tunisia,Malta,0,1,1,0.0,1.0,1639,1484
1977-03-06,Chile,Peru,1,1,0,0.5,0.5,1664,1670
1977-03-06,Israel,Japan,2,0,2,1.0,0.0,1669,1599
1977-03-06,Paraguay,Colombia,1,1,0,0.5,0.5,1658,1511
1977-03-06,Singapore,Malaysia,1,0,1,1.0,0.0,1469,1675
1977-03-06,Venezuela,Bolivia,1,3,2,0.0,1.0,1462,1537
1977-03-07,Guadeloupe,Martinique,1,3,2,0.0,1.0,1507,1595
1977-03-07,Thailand,Indonesia,3,2,1,1.0,0.0,1559,1541
1977-03-08,Malaysia,Hong Kong,1,1,0,0.5,0.5,1673,1560
1977-03-08,New Zealand,New Caledonia,4,0,4,1.0,0.0,1580,1600
1977-03-08,Qatar,Tunisia,1,0,1,1.0,0.0,1477,1628
1977-03-09,Austria,Greece,2,0,2,1.0,0.0,1735,1579
1977-03-09,Brazil,Colombia,6,0,6,1.0,0.0,1978,1510
1977-03-09,Singapore,Indonesia,0,4,4,0.0,1.0,1463,1548
1977-03-10,Israel,Japan,2,0,2,1.0,0.0,1676,1593
1977-03-11,Bahrain,Kuwait,0,2,2,0.0,1.0,1467,1662
1977-03-12,Peru,Ecuador,4,0,4,1.0,0.0,1674,1474
1977-03-12,Singapore,Hong Kong,0,1,1,0.0,1.0,1458,1566
1977-03-13,Kenya,Algeria,2,1,1,1.0,0.0,1579,1575
1977-03-13,Cameroon,Congo,2,0,2,1.0,0.0,1580,1571
1977-03-13,Guinea,Libya,3,0,3,1.0,0.0,1661,1512
1977-03-13,Senegal,Togo,2,1,1,1.0,0.0,1547,1521
1977-03-13,Egypt,Tunisia,2,2,0,0.5,0.5,1698,1630
1977-03-13,Ethiopia,Mauritius,1,0,1,1.0,0.0,1539,1500
1977-03-13,Nigeria,Sierra Leone,2,0,2,1.0,0.0,1688,1488
1977-03-13,Australia,Taiwan,3,0,3,1.0,0.0,1696,1528
1977-03-13,Bolivia,Venezuela,2,0,2,1.0,0.0,1544,1456
1977-03-13,Paraguay,Brazil,0,1,1,0.0,1.0,1656,1981
1977-03-13,Qatar,Bahrain,2,0,2,1.0,0.0,1485,1460
1977-03-15,Iran,Hungary,0,2,2,0.0,1.0,1695,1789
1977-03-15,Qatar,Kuwait,0,2,2,0.0,1.0,1481,1667
1977-03-16,Taiwan,Australia,1,2,1,0.0,1.0,1524,1701
1977-03-17,Bahrain,Kuwait,1,2,1,0.0,1.0,1457,1671
1977-03-17,Uruguay,Venezuela,2,0,2,1.0,0.0,1684,1453
1977-03-19,Fiji,Australia,1,0,1,1.0,0.0,1444,1688
1977-03-19,Qatar,Bahrain,0,3,3,0.0,1.0,1473,1466
1977-03-20,Brazil,Paraguay,1,1,0,0.5,0.5,1976,1662
1977-03-20,Burkina Faso,Ivory Coast,0,1,1,0.0,1.0,1457,1624
1977-03-20,Chile,Ecuador,3,0,3,1.0,0.0,1669,1470
1977-03-20,South Korea,Israel,3,1,2,1.0,0.0,1768,1670
1977-03-20,New Zealand,Taiwan,6,0,6,1.0,0.0,1587,1518
1977-03-20,Tunisia,Russia,0,3,3,0.0,1.0,1626,1785
1977-03-21,Qatar,Kuwait,1,4,3,0.0,1.0,1470,1675
1977-03-22,Argentina,Iran,1,1,0,0.5,0.5,1829,1699
1977-03-23,New Zealand,Taiwan,6,0,6,1.0,0.0,1594,1512
1977-03-23,Czechoslovakia,Greece,4,0,4,1.0,0.0,1809,1576
1977-03-23,Romania,Turkey,4,0,4,1.0,0.0,1708,1636
1977-03-23,Syria,Morocco,0,2,2,0.0,1.0,1535,1694
1977-03-23,Yugoslavia,Russia,2,4,2,0.0,1.0,1766,1793
1977-03-25,Libya,Guinea,0,2,2,0.0,1.0,1508,1666
1977-03-26,Togo,Senegal,0,1,1,0.0,1.0,1514,1555
1977-03-26,Belgium,Netherlands,0,2,2,0.0,1.0,1746,1820
1977-03-26,Japan,South Korea,0,0,0,0.5,0.5,1597,1765
1977-03-26,Peru,Chile,2,0,2,1.0,0.0,1682,1662
1977-03-26,Zambia,Malawi,8,1,7,1.0,0.0,1647,1547
1977-03-26,Alderney,Jersey,0,3,3,0.0,1.0,1311,1690
1977-03-27,Australia,New Zealand,3,1,2,1.0,0.0,1694,1589
1977-03-27,Ivory Coast,Burkina Faso,4,1,3,1.0,0.0,1629,1453
1977-03-27,Spain,Hungary,1,1,0,0.5,0.5,1802,1790
1977-03-27,Uruguay,Bolivia,2,2,0,0.5,0.5,1681,1548
1977-03-30,England,Luxembourg,5,0,5,1.0,0.0,1854,1368
1977-03-30,Republic of Ireland,France,1,0,1,1.0,0.0,1628,1720
1977-03-30,New Zealand,Australia,1,1,0,0.5,0.5,1592,1692
1977-03-30,Portugal,Switzerland,1,0,1,1.0,0.0,1740,1585
1977-03-30,Wales,Czechoslovakia,3,0,3,1.0,0.0,1633,1798
1977-04-02,Malta,German DR,0,1,1,0.0,1.0,1482,1803
1977-04-03,South Korea,Japan,1,0,1,1.0,0.0,1770,1593
1977-04-03,Morocco,Gabon,5,1,4,1.0,0.0,1698,1475
1977-04-06,Turkey,Finland,1,2,1,0.0,1.0,1625,1484
1977-04-08,Guinea-Bissau,Mali,1,3,2,0.0,1.0,1503,1604
1977-04-09,South Africa,Zimbabwe,7,0,7,1.0,0.0,1592,1488
1977-04-13,Bulgaria,Denmark,3,1,2,1.0,0.0,1720,1621
1977-04-13,Hungary,Poland,2,1,1,1.0,0.0,1798,1763
1977-04-14,Martinique,Guadeloupe,1,0,1,1.0,0.0,1602,1501
1977-04-16,Romania,Spain,1,0,1,1.0,0.0,1719,1792
1977-04-17,Austria,Turkey,1,0,1,1.0,0.0,1741,1620
1977-04-20,Hungary,Czechoslovakia,2,0,2,1.0,0.0,1806,1790
1977-04-22,Iran,Saudi Arabia,2,0,2,1.0,0.0,1703,1494
1977-04-23,Switzerland,France,0,4,4,0.0,1.0,1580,1726
1977-04-24,Republic of Ireland,Poland,0,0,0,0.5,0.5,1631,1761
1977-04-24,Russia,Greece,2,0,2,1.0,0.0,1797,1573
1977-04-27,Tunisia,Egypt,3,2,1,1.0,0.0,1636,1689
1977-04-27,Germany,Northern Ireland,5,0,5,1.0,0.0,1924,1637
1977-04-27,Romania,German DR,1,1,0,0.5,0.5,1721,1802
1977-04-27,Scotland,Sweden,3,1,2,1.0,0.0,1780,1746
1977-04-30,Austria,Malta,9,0,9,1.0,0.0,1744,1480
1977-04-30,Hungary,Russia,2,1,1,1.0,0.0,1814,1790
1977-04-30,Yugoslavia,Germany,1,2,1,0.0,1.0,1762,1929
1977-05-01,Algeria,Senegal,2,0,2,1.0,0.0,1583,1548
1977-05-01,Denmark,Poland,1,2,1,0.0,1.0,1617,1766
1977-05-07,Hong Kong,Macau,2,0,2,1.0,0.0,1573,1491
1977-05-08,Yugoslavia,Romania,0,2,2,0.0,1.0,1754,1730
1977-05-09,Guernsey,Jersey,1,5,4,0.0,1.0,1626,1697
1977-05-10,Greece,Russia,1,0,1,1.0,0.0,1586,1778
1977-05-15,Cyprus,Poland,1,3,2,0.0,1.0,1399,1768
1977-05-17,Mexico,Peru,1,1,0,0.5,0.5,1732,1684
1977-05-18,Russia,Hungary,2,0,2,1.0,0.0,1787,1806
1977-05-24,Mexico,Peru,2,1,1,1.0,0.0,1739,1678
1977-05-24,Switzerland,Czechoslovakia,1,0,1,1.0,0.0,1593,1778
1977-05-26,Haiti,Peru,1,2,1,0.0,1.0,1615,1685
1977-05-26,Luxembourg,Finland,0,1,1,0.0,1.0,1363,1490
1977-05-26,Sweden,Norway,1,0,1,1.0,0.0,1750,1511
1977-05-28,Hungary,Greece,3,0,3,1.0,0.0,1810,1583
1977-05-28,Northern Ireland,England,1,2,1,0.0,1.0,1634,1858
1977-05-28,Senegal,Morocco,3,2,1,1.0,0.0,1560,1687
1977-05-28,Wales,Scotland,0,0,0,0.5,0.5,1637,1777
1977-05-29,Argentina,Poland,3,1,2,1.0,0.0,1836,1762
1977-05-29,Haiti,Peru,2,2,0,0.5,0.5,1617,1684
1977-05-29,Togo,Ghana,0,2,2,0.0,1.0,1510,1663
1977-05-30,Mozambique,Cuba,0,2,2,0.0,1.0,1499,1495
1977-05-31,England,Wales,0,1,1,0.0,1.0,1846,1650
1977-06-01,Bulgaria,Republic of Ireland,2,1,1,1.0,0.0,1726,1626
1977-06-01,Czechoslovakia,Austria,0,0,0,0.5,0.5,1778,1745
1977-06-01,Norway,Denmark,0,2,2,0.0,1.0,1506,1623
1977-06-01,Scotland,Northern Ireland,3,0,3,1.0,0.0,1782,1630
1977-06-03,Libya,Cuba,1,0,1,1.0,0.0,1516,1488
1977-06-03,Northern Ireland,Wales,1,1,0,0.5,0.5,1631,1650
1977-06-04,England,Scotland,1,2,1,0.0,1.0,1837,1792
1977-06-05,Congo,Cameroon,4,0,4,1.0,0.0,1580,1572
1977-06-05,Argentina,Germany,1,3,2,0.0,1.0,1831,1935
1977-06-05,Guinea,Tunisia,1,0,1,1.0,0.0,1674,1629
1977-06-05,Mauritania,Senegal,1,2,1,0.0,1.0,1439,1566
1977-06-06,Honduras,Panama,1,0,1,1.0,0.0,1567,1447
1977-06-08,Brazil,England,0,0,0,0.5,0.5,1973,1841
1977-06-08,Finland,Italy,0,3,3,0.0,1.0,1489,1859
1977-06-08,Sweden,Switzerland,2,1,1,1.0,0.0,1755,1589
1977-06-08,Uruguay,Germany,0,2,2,0.0,1.0,1678,1939
1977-06-09,Algeria,Zambia,2,0,2,1.0,0.0,1593,1638
1977-06-10,Ethiopia,Cuba,0,0,0,0.5,0.5,1538,1490
1977-06-10,Peru,Poland,1,3,2,0.0,1.0,1678,1769
1977-06-11,Iceland,Northern Ireland,1,0,1,1.0,0.0,1482,1620
1977-06-12,Senegal,Nigeria,3,1,2,1.0,0.0,1577,1678
1977-06-12,Ethiopia,Uganda,0,0,0,0.5,0.5,1540,1611
1977-06-12,Argentina,England,1,1,0,0.5,0.5,1832,1841
1977-06-12,Bolivia,Poland,1,2,1,0.0,1.0,1545,1773
1977-06-12,Brazil,Germany,1,1,0,0.5,0.5,1973,1940
1977-06-12,Ghana,Togo,2,0,2,1.0,0.0,1668,1506
1977-06-12,Zambia,Cuba,2,0,2,1.0,0.0,1643,1486
1977-06-14,Mexico,Germany,2,2,0,0.5,0.5,1744,1936
1977-06-15,Chile,Scotland,2,4,2,0.0,1.0,1657,1798
1977-06-15,Denmark,Sweden,2,1,1,1.0,0.0,1634,1745
1977-06-15,South Korea,Japan,2,1,1,1.0,0.0,1775,1589
1977-06-15,Uruguay,England,0,0,0,0.5,0.5,1682,1838
1977-06-16,Zambia,Cuba,0,1,1,0.0,1.0,1632,1498
1977-06-18,Argentina,Scotland,1,1,0,0.5,0.5,1832,1799
1977-06-19,Brazil,Poland,3,1,2,1.0,0.0,1977,1770
1977-06-19,Hong Kong,Iran,0,2,2,0.0,1.0,1568,1709
1977-06-19,Tunisia,Guinea,3,1,2,1.0,0.0,1639,1665
1977-06-22,Finland,Denmark,1,2,1,0.0,1.0,1485,1639
1977-06-23,Brazil,Scotland,2,0,2,1.0,0.0,1982,1795
1977-06-26,Zambia,Algeria,2,0,2,1.0,0.0,1640,1586
1977-06-26,Uganda,Ethiopia,2,1,1,1.0,0.0,1618,1534
1977-06-26,Nigeria,Senegal,3,0,3,1.0,0.0,1684,1572
1977-06-26,Argentina,France,0,0,0,0.5,0.5,1830,1729
1977-06-26,Brazil,Yugoslavia,0,0,0,0.5,0.5,1978,1759
1977-06-26,Hong Kong,South Korea,0,1,1,0.0,1.0,1565,1779
1977-06-30,Brazil,France,2,2,0,0.5,0.5,1974,1734
1977-06-30,Iceland,Norway,2,1,1,1.0,0.0,1491,1498
1977-07-03,Argentina,Yugoslavia,1,0,1,1.0,0.0,1837,1753
1977-07-03,South Korea,Iran,0,0,0,0.5,0.5,1778,1711
1977-07-03,Zimbabwe,South Africa,1,1,0,0.5,0.5,1491,1590
1977-07-06,Malawi,Tanzania,0,0,0,0.5,0.5,1547,1512
1977-07-08,Malawi,Tanzania,1,0,1,1.0,0.0,1555,1505
1977-07-10,Australia,Hong Kong,3,0,3,1.0,0.0,1698,1560
1977-07-10,Nigeria,Ivory Coast,4,0,4,1.0,0.0,1691,1623
1977-07-10,Peru,Brazil,0,1,1,0.0,1.0,1676,1977
1977-07-12,Argentina,German DR,2,0,2,1.0,0.0,1845,1795
1977-07-14,Brazil,Bolivia,8,0,8,1.0,0.0,1979,1544
1977-07-15,Egypt,Zambia,2,0,2,1.0,0.0,1696,1634
1977-07-16,Malaysia,Myanmar,1,0,1,1.0,0.0,1682,1676
1977-07-17,Congo,Gabon,3,2,1,1.0,0.0,1586,1470
1977-07-17,China PR,Hong Kong,2,1,1,1.0,0.0,1688,1555
1977-07-17,South Korea,Libya,4,0,4,1.0,0.0,1781,1514
1977-07-17,Peru,Bolivia,5,0,5,1.0,0.0,1682,1539
1977-07-18,Malaysia,Thailand,3,0,3,1.0,0.0,1688,1554
1977-07-19,China PR,DR Congo,3,2,1,1.0,0.0,1696,1642
1977-07-19,Iraq,Libya,0,0,0,0.5,0.5,1648,1518
1977-07-20,Iceland,Sweden,0,1,1,0.0,1.0,1488,1749
1977-07-20,South Korea,Thailand,4,1,3,1.0,0.0,1785,1551
1977-07-21,Myanmar,Iraq,0,3,3,0.0,1.0,1668,1657
1977-07-21,Malaysia,Libya,1,1,0,0.5,0.5,1685,1522
1977-07-23,Libya,Thailand,2,2,0,0.5,0.5,1523,1551
1977-07-23,Malaysia,Iraq,0,0,0,0.5,0.5,1685,1658
1977-07-24,Afghanistan,India,0,3,3,0.0,1.0,1433,1541
1977-07-24,Myanmar,South Korea,0,4,4,0.0,1.0,1663,1791
1977-07-24,Hong Kong,Iran,1,0,1,1.0,0.0,1567,1700
1977-07-25,Ivory Coast,Nigeria,2,2,0,0.5,0.5,1625,1690
1977-07-25,China PR,Morocco,3,2,1,1.0,0.0,1704,1680
1977-07-25,Iraq,Thailand,5,0,5,1.0,0.0,1664,1546
1977-07-26,Malaysia,South Korea,1,1,0,0.5,0.5,1688,1789
1977-07-27,Myanmar,Libya,3,1,2,1.0,0.0,1668,1519
1977-07-27,China PR,Hong Kong,1,2,1,0.0,1.0,1693,1579
1977-07-27,Iran,Morocco,1,1,0,0.5,0.5,1700,1681
1977-07-28,German DR,Russia,2,1,1,1.0,0.0,1803,1780
1977-07-28,Iraq,South Korea,1,1,0,0.5,0.5,1667,1787
1977-07-29,Myanmar,Thailand,1,1,0,0.5,0.5,1666,1549
1977-07-29,Iran,DR Congo,1,3,2,0.0,1.0,1691,1652
1977-07-31,Gabon,Congo,3,3,0,0.5,0.5,1473,1584
1977-07-31,Iraq,South Korea,0,1,1,0.0,1.0,1662,1793
1977-07-31,Zambia,Egypt,0,0,0,0.5,0.5,1636,1695
1977-08-05,Iran,Romania,0,0,0,0.5,0.5,1692,1730
1977-08-14,Australia,Iran,0,1,1,0.0,1.0,1690,1701
1977-08-14,Czechoslovakia,Romania,1,3,2,0.0,1.0,1769,1740
1977-08-17,Sweden,German DR,0,1,1,0.0,1.0,1743,1810
1977-08-18,Norway,Finland,1,1,0,0.5,0.5,1498,1486
1977-08-24,Argentina,Paraguay,2,1,1,1.0,0.0,1850,1658
1977-08-24,Austria,Poland,2,1,1,1.0,0.0,1754,1762
1977-08-27,Australia,South Korea,2,1,1,1.0,0.0,1701,1783
1977-08-31,Netherlands,Iceland,4,1,3,1.0,0.0,1823,1486
1977-08-31,Paraguay,Argentina,2,0,2,1.0,0.0,1671,1838
1977-09-01,India,Thailand,0,4,4,0.0,1.0,1534,1557
1977-09-03,Belgium,Iceland,4,0,4,1.0,0.0,1749,1484
1977-09-03,South Korea,Thailand,5,1,4,1.0,0.0,1787,1554
1977-09-04,Nigeria,Ghana,2,1,1,1.0,0.0,1698,1661
1977-09-05,South Korea,India,3,0,3,1.0,0.0,1791,1531
1977-09-06,Tunisia,Malta,2,1,1,1.0,0.0,1644,1476
1977-09-06,Wales,Kuwait,0,0,0,0.5,0.5,1651,1675
1977-09-07,Czechoslovakia,Turkey,1,0,1,1.0,0.0,1774,1616
1977-09-07,England,Switzerland,0,0,0,0.5,0.5,1834,1594
1977-09-07,Finland,Germany,0,1,1,0.0,1.0,1485,1938
1977-09-07,German DR,Scotland,1,0,1,1.0,0.0,1818,1788
1977-09-07,Norway,Sweden,2,1,1,1.0,0.0,1511,1731
1977-09-07,Russia,Poland,4,1,3,1.0,0.0,1788,1755
1977-09-08,Bahrain,Malaysia,1,3,2,0.0,1.0,1463,1692
1977-09-11,Trinidad and Tobago,Canada,1,1,0,0.5,0.5,1614,1502
1977-09-13,South Korea,Malaysia,3,0,3,1.0,0.0,1797,1687
1977-09-14,China PR,Thailand,5,2,3,1.0,0.0,1698,1550
1977-09-15,El Salvador,United States,1,2,1,0.0,1.0,1564,1476
1977-09-15,Malaysia,Thailand,1,1,0,0.5,0.5,1684,1554
1977-09-18,Guatemala,United States,3,1,2,1.0,0.0,1627,1472
1977-09-18,Réunion,Mauritius,0,2,2,0.0,1.0,1416,1507
1977-09-18,Suriname,Trinidad and Tobago,2,1,1,1.0,0.0,1648,1607
1977-09-20,Kuwait,Wales,0,0,0,0.5,0.5,1675,1652
1977-09-21,Bulgaria,Turkey,3,1,2,1.0,0.0,1732,1611
1977-09-21,Mauritius,Seychelles,2,1,1,1.0,0.0,1515,1480
1977-09-21,Northern Ireland,Iceland,2,0,2,1.0,0.0,1626,1479
1977-09-21,Poland,Denmark,4,1,3,1.0,0.0,1761,1634
1977-09-21,Romania,Greece,6,1,5,1.0,0.0,1745,1579
1977-09-21,Scotland,Czechoslovakia,3,1,2,1.0,0.0,1796,1767
1977-09-21,Switzerland,Spain,1,2,1,0.0,1.0,1591,1796
1977-09-22,Guyana,Trinidad and Tobago,2,1,1,1.0,0.0,1465,1596
1977-09-24,Austria,German DR,1,1,0,0.5,0.5,1756,1817
1977-09-24,Guyana,Trinidad and Tobago,2,2,0,0.5,0.5,1468,1594
1977-09-24,Libya,Malta,1,0,1,1.0,0.0,1527,1469
1977-09-25,Guatemala,United States,2,0,2,1.0,0.0,1632,1468
1977-09-25,Réunion,Seychelles,1,0,1,1.0,0.0,1426,1471
1977-09-25,Tunisia,Nigeria,0,0,0,0.5,0.5,1646,1697
1977-09-26,Guyana,Trinidad and Tobago,0,2,2,0.0,1.0,1463,1600
1977-09-27,Mexico,United States,3,0,3,1.0,0.0,1747,1466
1977-09-28,Libya,Cyprus,1,0,1,1.0,0.0,1533,1394
1977-09-30,Botswana,Malawi,0,2,2,0.0,1.0,1465,1562
1977-09-30,United States,El Salvador,0,0,0,0.5,0.5,1469,1562
1977-10-01,Botswana,Malawi,1,5,4,0.0,1.0,1460,1568
1977-10-02,Tunisia,Guinea,3,0,3,1.0,0.0,1655,1657
1977-10-02,Hong Kong,Kuwait,1,3,2,0.0,1.0,1574,1681
1977-10-03,Zambia,India,3,1,2,1.0,0.0,1642,1526
1977-10-05,Hungary,Yugoslavia,4,3,1,1.0,0.0,1817,1747
1977-10-05,Netherlands,Russia,0,0,0,0.5,0.5,1823,1789
1977-10-05,Sweden,Denmark,1,0,1,1.0,0.0,1737,1629
1977-10-05,Switzerland,Finland,2,0,2,1.0,0.0,1597,1480
1977-10-06,United States,China PR,1,1,0,0.5,0.5,1474,1694
1977-10-08,Canada,El Salvador,1,2,1,0.0,1.0,1496,1569
1977-10-08,France,Russia,0,0,0,0.5,0.5,1736,1788
1977-10-08,Germany,Italy,2,1,1,1.0,0.0,1945,1853
1977-10-08,Guatemala,Suriname,3,2,1,1.0,0.0,1641,1640
1977-10-08,Nigeria,Egypt,4,0,4,1.0,0.0,1705,1688
1977-10-09,Denmark,Portugal,2,4,2,0.0,1.0,1624,1746
1977-10-09,South Korea,Kuwait,1,0,1,1.0,0.0,1803,1676
1977-10-09,Mexico,Haiti,4,1,3,1.0,0.0,1753,1612
1977-10-09,Zambia,India,3,1,2,1.0,0.0,1648,1521
1977-10-10,United States,China PR,1,0,1,1.0,0.0,1487,1682
1977-10-12,Canada,Suriname,2,1,1,1.0,0.0,1508,1629
1977-10-12,German DR,Austria,1,1,0,0.5,0.5,1816,1758
1977-10-12,Guatemala,Haiti,1,2,1,0.0,1.0,1633,1621
1977-10-12,Hungary,Sweden,3,0,3,1.0,0.0,1824,1731
1977-10-12,Republic of Ireland,Bulgaria,0,0,0,0.5,0.5,1629,1730
1977-10-12,Luxembourg,England,0,2,2,0.0,1.0,1363,1835
1977-10-12,Mexico,El Salvador,3,1,2,1.0,0.0,1758,1565
1977-10-12,Northern Ireland,Netherlands,0,1,1,0.0,1.0,1623,1827
1977-10-12,Wales,Scotland,0,2,2,0.0,1.0,1648,1801
1977-10-15,Italy,Finland,6,1,5,1.0,0.0,1855,1479
1977-10-15,Mexico,Suriname,8,1,7,1.0,0.0,1764,1624
1977-10-16,Guinea,Tunisia,3,2,1,1.0,0.0,1665,1648
1977-10-16,Australia,Kuwait,1,2,1,0.0,1.0,1693,1685
1977-10-16,Canada,Guatemala,2,1,1,1.0,0.0,1519,1623
1977-10-16,El Salvador,Haiti,0,1,1,0.0,1.0,1559,1628
1977-10-16,United States,China PR,2,1,1,1.0,0.0,1500,1670
1977-10-19,Mexico,Guatemala,2,1,1,1.0,0.0,1769,1619
1977-10-20,Canada,Haiti,1,1,0,0.5,0.5,1522,1626
1977-10-20,El Salvador,Suriname,3,2,1,1.0,0.0,1569,1615
1977-10-21,Egypt,Nigeria,3,1,2,1.0,0.0,1697,1697
1977-10-22,Guyana,Barbados,2,0,2,1.0,0.0,1472,1457
1977-10-22,Guyana,Barbados,0,0,0,0.5,0.5,1472,1458
1977-10-22,Mexico,Canada,3,1,2,1.0,0.0,1773,1519
1977-10-23,El Salvador,Guatemala,2,2,0,0.5,0.5,1571,1618
1977-10-23,Haiti,Suriname,1,0,1,1.0,0.0,1634,1608
1977-10-23,Jamaica,China PR,0,1,1,0.0,1.0,1482,1675
1977-10-23,South Korea,Australia,0,0,0,0.5,0.5,1801,1696
1977-10-26,Bulgaria,Greece,0,0,0,0.5,0.5,1727,1583
1977-10-26,Guyana,Barbados,0,0,0,0.5,0.5,1472,1459
1977-10-26,Netherlands,Belgium,1,0,1,1.0,0.0,1834,1743
1977-10-26,Spain,Romania,2,0,2,1.0,0.0,1803,1739
1977-10-28,Iran,Kuwait,1,0,1,1.0,0.0,1709,1678
1977-10-28,Thailand,Singapore,2,0,2,1.0,0.0,1560,1453
1977-10-29,German DR,Malta,9,0,9,1.0,0.0,1818,1468
1977-10-29,Hungary,Bolivia,6,0,6,1.0,0.0,1827,1537
1977-10-29,Poland,Portugal,1,1,0,0.5,0.5,1761,1747
1977-10-30,Hong Kong,Australia,2,5,3,0.0,1.0,1569,1702
1977-10-30,Switzerland,Norway,1,0,1,1.0,0.0,1604,1505
1977-10-30,Turkey,Austria,0,1,1,0.0,1.0,1607,1763
1977-10-31,Jamaica,China PR,0,3,3,0.0,1.0,1479,1679
1977-10-31,Thailand,India,1,1,0,0.5,0.5,1560,1522
1977-11-01,Malaysia,Singapore,4,3,1,1.0,0.0,1688,1450
1977-11-04,India,Singapore,2,1,1,1.0,0.0,1529,1444
1977-11-05,Kuwait,South Korea,2,2,0,0.5,0.5,1681,1799
1977-11-06,Thailand,Malaysia,1,2,1,0.0,1.0,1555,1694
1977-11-09,Czechoslovakia,Hungary,1,1,0,0.5,0.5,1769,1826
1977-11-10,India,Malaysia,0,3,3,0.0,1.0,1525,1699
1977-11-11,Iran,South Korea,2,2,0,0.5,0.5,1712,1797
1977-11-11,Malawi,Lesotho,3,0,3,1.0,0.0,1574,1458
1977-11-12,Kuwait,Hong Kong,4,0,4,1.0,0.0,1687,1564
1977-11-12,Nigeria,Tunisia,0,1,1,0.0,1.0,1688,1658
1977-11-12,Poland,Sweden,2,1,1,1.0,0.0,1769,1724
1977-11-13,Malawi,Lesotho,6,1,5,1.0,0.0,1580,1453
1977-11-13,Romania,Yugoslavia,4,6,2,0.0,1.0,1732,1755
1977-11-13,Singapore,Australia,0,2,2,0.0,1.0,1442,1705
1977-11-16,Czechoslovakia,Wales,1,0,1,1.0,0.0,1775,1643
1977-11-16,England,Italy,2,0,2,1.0,0.0,1844,1847
1977-11-16,France,Bulgaria,3,1,2,1.0,0.0,1744,1720
1977-11-16,Germany,Switzerland,4,1,3,1.0,0.0,1947,1603
1977-11-16,Greece,Yugoslavia,0,0,0,0.5,0.5,1587,1752
1977-11-16,Northern Ireland,Belgium,3,0,3,1.0,0.0,1634,1733
1977-11-16,Portugal,Cyprus,4,0,4,1.0,0.0,1749,1393
1977-11-16,Turkey,German DR,1,2,1,0.0,1.0,1604,1822
1977-11-18,Iran,Hong Kong,3,0,3,1.0,0.0,1717,1560
1977-11-19,Kuwait,Australia,1,0,1,1.0,0.0,1696,1697
1977-11-19,Malaysia,Indonesia,1,2,1,0.0,1.0,1688,1560
1977-11-20,Philippines,Brunei,4,1,3,1.0,0.0,1367,1469
1977-11-20,Thailand,Singapore,2,0,2,1.0,0.0,1561,1437
1977-11-21,Malaysia,Philippines,5,0,5,1.0,0.0,1691,1365
1977-11-21,Myanmar,Singapore,5,1,4,1.0,0.0,1670,1434
1977-11-22,Indonesia,Brunei,4,0,4,1.0,0.0,1566,1464
1977-11-22,Thailand,Myanmar,0,3,3,0.0,1.0,1556,1676
1977-11-23,Philippines,Indonesia,1,1,0,0.5,0.5,1370,1562
1977-11-23,Malaysia,Brunei,7,0,7,1.0,0.0,1695,1461
1977-11-25,Egypt,Tunisia,3,2,1,1.0,0.0,1705,1651
1977-11-25,Iran,Australia,1,0,1,1.0,0.0,1725,1690
1977-11-25,Malaysia,Myanmar,9,1,8,1.0,0.0,1703,1669
1977-11-25,Indonesia,Thailand,0,2,2,0.0,1.0,1554,1565
1977-11-26,Uganda,Zanzibar,1,0,1,1.0,0.0,1621,1342
1977-11-26,Myanmar,Indonesia,2,0,2,1.0,0.0,1675,1549
1977-11-26,Malaysia,Thailand,2,0,2,1.0,0.0,1708,1561
1977-11-27,Iraq,Morocco,3,0,3,1.0,0.0,1671,1673
1977-11-27,Malta,Turkey,0,3,3,0.0,1.0,1463,1610
1977-11-27,Tanzania,Zambia,2,4,2,0.0,1.0,1501,1653
1977-11-28,Kenya,Uganda,1,3,2,0.0,1.0,1572,1629
1977-11-29,Malawi,Zambia,1,0,1,1.0,0.0,1590,1644
1977-11-30,Bolivia,Hungary,2,3,1,0.0,1.0,1535,1829
1977-11-30,Somalia,Zanzibar,1,0,1,1.0,0.0,1437,1336
1977-11-30,Yugoslavia,Spain,0,1,1,0.0,1.0,1746,1810
1977-12-01,Malawi,Tanzania,0,0,0,0.5,0.5,1588,1504
1977-12-02,Kenya,Zanzibar,3,0,3,1.0,0.0,1576,1333
1977-12-03,Italy,Luxembourg,3,0,3,1.0,0.0,1848,1363
1977-12-03,Kuwait,Iran,1,2,1,0.0,1.0,1689,1733
1977-12-03,Morocco,Iraq,0,0,0,0.5,0.5,1673,1672
1977-12-04,South Korea,Hong Kong,5,2,3,1.0,0.0,1801,1557
1977-12-05,Kenya,Zambia,2,4,2,0.0,1.0,1570,1651
1977-12-06,Malawi,Uganda,0,1,1,0.0,1.0,1581,1637
1977-12-08,Kenya,Malawi,1,2,1,0.0,1.0,1563,1589
1977-12-09,Uganda,Zambia,0,0,0,0.5,0.5,1638,1651
1977-12-11,Tunisia,Egypt,4,1,3,1.0,0.0,1661,1696
1977-12-12,Kenya,Malawi,1,1,0,0.5,0.5,1564,1589
1977-12-14,Germany,Wales,1,1,0,0.5,0.5,1942,1649
1977-12-17,Puerto Rico,Martinique,0,2,2,0.0,1.0,1375,1606
1977-12-21,Belgium,Italy,0,1,1,0.0,1.0,1728,1854
1977-12-25,Ghana,Sierra Leone,4,0,4,1.0,0.0,1666,1484
1978-01-11,Cyprus,Greece,0,2,2,0.0,1.0,1390,1591
1978-01-17,Ghana,Gambia,7,1,6,1.0,0.0,1670,1458
1978-01-18,Libya,Morocco,0,1,1,0.0,1.0,1529,1678
1978-01-25,Spain,Italy,2,1,1,1.0,0.0,1820,1845
1978-01-26,Sudan,Kenya,3,0,3,1.0,0.0,1604,1557
1978-01-28,Zambia,Zanzibar,6,1,5,1.0,0.0,1654,1331
1978-01-29,Zambia,Zanzibar,5,0,5,1.0,0.0,1657,1329
1978-01-30,Sudan,Congo,2,1,1,1.0,0.0,1612,1577
1978-02-05,Gabon,Nigeria,0,1,1,0.0,1.0,1470,1692
1978-02-05,Zambia,Eswatini,11,2,9,1.0,0.0,1662,1490
1978-02-08,Israel,Denmark,2,0,2,1.0,0.0,1677,1618
1978-02-08,Italy,France,2,2,0,0.5,0.5,1843,1747
1978-02-12,Benin,Burkina Faso,0,2,2,0.0,1.0,1505,1463
1978-02-15,El Salvador,Mexico,1,5,4,0.0,1.0,1568,1777
1978-02-15,Greece,Austria,1,1,0,0.5,0.5,1595,1760
1978-02-19,Gabon,Burkina Faso,2,2,0,0.5,0.5,1470,1464
1978-02-19,Ghana,Ivory Coast,3,1,2,1.0,0.0,1677,1619
1978-02-21,Iraq,Algeria,3,0,3,1.0,0.0,1679,1580
1978-02-22,Germany,England,2,1,1,1.0,0.0,1948,1839
1978-02-22,Israel,Netherlands,1,2,1,0.0,1.0,1673,1839
1978-02-22,Scotland,Bulgaria,2,1,1,1.0,0.0,1808,1714
1978-02-23,Iraq,Algeria,1,0,1,1.0,0.0,1685,1575
1978-02-26,Burkina Faso,Benin,3,0,3,1.0,0.0,1473,1497
1978-02-26,Morocco,Russia,2,3,1,0.0,1.0,1673,1794
1978-02-26,Syria,Algeria,0,1,1,0.0,1.0,1528,1583
1978-02-27,Iraq,North Korea,1,0,1,1.0,0.0,1692,1631
1978-02-28,Martinique,Antigua and Barbuda,5,0,5,1.0,0.0,1612,1485
1978-03-02,Basque Country,Russia,0,0,0,0.5,0.5,1600,1790
1978-03-05,Ghana,Zambia,2,1,1,1.0,0.0,1685,1655
1978-03-05,Nigeria,Burkina Faso,4,2,2,1.0,0.0,1696,1470
1978-03-06,Congo,Uganda,1,3,2,0.0,1.0,1571,1645
1978-03-06,Morocco,Tunisia,1,1,0,0.5,0.5,1673,1662
1978-03-08,Burkina Faso,Zambia,0,2,2,0.0,1.0,1466,1660
1978-03-08,France,Portugal,2,0,2,1.0,0.0,1756,1741
1978-03-08,German DR,Switzerland,3,1,2,1.0,0.0,1826,1600
1978-03-08,Germany,Russia,1,0,1,1.0,0.0,1953,1786
1978-03-08,Ghana,Nigeria,1,1,0,0.5,0.5,1686,1696
1978-03-09,Congo,Morocco,0,1,1,0.0,1.0,1566,1679
1978-03-09,Tunisia,Uganda,3,1,2,1.0,0.0,1670,1638
1978-03-10,Ghana,Burkina Faso,3,0,3,1.0,0.0,1690,1463
1978-03-10,Nigeria,Zambia,0,0,0,0.5,0.5,1696,1661
1978-03-11,Congo,Tunisia,0,0,0,0.5,0.5,1569,1668
1978-03-11,Morocco,Uganda,0,3,3,0.0,1.0,1671,1647
1978-03-12,Lesotho,Kenya,0,1,1,0.0,1.0,1448,1563
1978-03-12,Libya,Algeria,1,0,1,1.0,0.0,1539,1574
1978-03-14,Ghana,Tunisia,1,0,1,1.0,0.0,1698,1661
1978-03-14,Nigeria,Uganda,1,2,1,0.0,1.0,1687,1657
1978-03-16,Ghana,Uganda,2,0,2,1.0,0.0,1706,1650
1978-03-19,Argentina,Peru,2,1,1,1.0,0.0,1843,1678
1978-03-22,Belgium,Austria,1,0,1,1.0,0.0,1737,1752
1978-03-22,Greece,Czechoslovakia,0,1,1,0.0,1.0,1591,1780
1978-03-22,Luxembourg,Poland,1,3,2,0.0,1.0,1362,1771
1978-03-22,Turkey,Romania,1,1,0,0.5,0.5,1613,1730
1978-03-23,Peru,Argentina,1,3,2,0.0,1.0,1674,1848
1978-03-26,Martinique,Guadeloupe,1,2,1,0.0,1.0,1602,1512
1978-03-29,Argentina,Bulgaria,3,1,2,1.0,0.0,1854,1709
1978-03-29,Spain,Norway,3,0,3,1.0,0.0,1823,1503
1978-03-30,Venezuela,China PR,0,1,1,0.0,1.0,1450,1683
1978-04-01,France,Brazil,1,0,1,1.0,0.0,1769,1967
1978-04-01,Peru,Bulgaria,1,1,0,0.5,0.5,1675,1709
1978-04-01,Guernsey,Alderney,12,0,12,1.0,0.0,1629,1309
1978-04-04,German DR,Sweden,0,1,1,0.0,1.0,1816,1735
1978-04-04,Switzerland,Austria,0,1,1,0.0,1.0,1596,1757
1978-04-05,Argentina,Romania,2,0,2,1.0,0.0,1860,1725
1978-04-05,Germany,Brazil,0,1,1,0.0,1.0,1946,1975
1978-04-05,Iran,Yugoslavia,0,0,0,0.5,0.5,1734,1746
1978-04-05,Republic of Ireland,Turkey,4,2,2,1.0,0.0,1637,1606
1978-04-05,Poland,Greece,5,2,3,1.0,0.0,1776,1587
1978-04-05,Russia,Finland,10,2,8,1.0,0.0,1789,1477
1978-04-05,Tunisia,Netherlands,0,4,4,0.0,1.0,1657,1844
1978-04-11,Mexico,Peru,0,1,1,0.0,1.0,1767,1686
1978-04-12,Poland,Republic of Ireland,3,0,3,1.0,0.0,1781,1633
1978-04-15,Hungary,Czechoslovakia,2,1,1,1.0,0.0,1836,1774
1978-04-16,Martinique,Puerto Rico,3,1,2,1.0,0.0,1606,1372
1978-04-18,Iran,Wales,0,1,1,0.0,1.0,1725,1659
1978-04-19,England,Brazil,1,1,0,0.5,0.5,1842,1973
1978-04-19,German DR,Belgium,0,0,0,0.5,0.5,1815,1739
1978-04-19,Sweden,Germany,3,1,2,1.0,0.0,1748,1934
1978-04-20,Puerto Rico,Martinique,4,1,3,1.0,0.0,1385,1594
1978-04-22,Peru,China PR,2,1,1,1.0,0.0,1694,1676
1978-04-23,Czechoslovakia,Bulgaria,0,0,0,0.5,0.5,1773,1711
1978-04-25,Uruguay,Argentina,2,0,2,1.0,0.0,1694,1849
1978-04-26,Iran,Bulgaria,1,1,0,0.5,0.5,1725,1712
1978-04-26,Malaysia,Singapore,0,1,1,0.0,1.0,1695,1448
1978-04-26,Poland,Bulgaria,1,0,1,1.0,0.0,1788,1706
1978-04-26,Spain,Mexico,2,0,2,1.0,0.0,1830,1761
1978-04-30,Kenya,Lesotho,1,0,1,1.0,0.0,1569,1443
1978-05-01,Barbados,Guyana,1,0,1,1.0,0.0,1468,1464
1978-05-01,Brazil,Peru,3,0,3,1.0,0.0,1976,1692
1978-05-03,Argentina,Uruguay,3,0,3,1.0,0.0,1854,1690
1978-05-03,Barbados,Guyana,3,0,3,1.0,0.0,1476,1457
1978-05-03,Finland,Mexico,0,1,1,0.0,1.0,1475,1764
1978-05-03,Romania,Bulgaria,2,0,2,1.0,0.0,1733,1699
1978-05-03,Thailand,Singapore,2,2,0,0.5,0.5,1559,1451
1978-05-09,Trinidad and Tobago,Guyana,3,0,3,1.0,0.0,1605,1453
1978-05-09,Jersey,Guernsey,0,2,2,0.0,1.0,1688,1639
1978-05-11,France,Iran,2,1,1,1.0,0.0,1776,1719
1978-05-11,Trinidad and Tobago,Guyana,5,1,4,1.0,0.0,1610,1449
1978-05-13,Réunion,Seychelles,4,1,3,1.0,0.0,1436,1462
1978-05-13,Scotland,Northern Ireland,1,1,0,0.5,0.5,1805,1638
1978-05-13,Wales,England,1,3,2,0.0,1.0,1655,1847
1978-05-14,Libya,Malta,1,0,1,1.0,0.0,1546,1457
1978-05-14,Romania,Russia,0,1,1,0.0,1.0,1727,1796
1978-05-15,Mauritius,Seychelles,2,0,2,1.0,0.0,1522,1456
1978-05-16,England,Northern Ireland,1,0,1,1.0,0.0,1851,1635
1978-05-17,Brazil,Czechoslovakia,2,0,2,1.0,0.0,1980,1770
1978-05-17,Scotland,Wales,1,1,0,0.5,0.5,1802,1659
1978-05-18,Italy,Yugoslavia,0,0,0,0.5,0.5,1841,1749
1978-05-18,Réunion,Mauritius,5,3,2,1.0,0.0,1446,1513
1978-05-19,France,Tunisia,2,0,2,1.0,0.0,1782,1652
1978-05-19,Iran,Ghana,3,0,3,1.0,0.0,1727,1699
1978-05-19,Wales,Northern Ireland,1,0,1,1.0,0.0,1667,1628
1978-05-20,Austria,Netherlands,0,1,1,0.0,1.0,1751,1851
1978-05-20,Scotland,England,0,1,1,0.0,1.0,1796,1858
1978-05-21,Norway,Republic of Ireland,0,0,0,0.5,0.5,1506,1631
1978-05-21,Sweden,Czechoslovakia,0,0,0,0.5,0.5,1749,1770
1978-05-23,Japan,Thailand,3,0,3,1.0,0.0,1597,1552
1978-05-24,Denmark,Republic of Ireland,3,3,0,0.5,0.5,1619,1631
1978-05-24,England,Hungary,4,1,3,1.0,0.0,1866,1829
1978-05-24,Finland,Greece,3,0,3,1.0,0.0,1486,1577
1978-05-24,Uruguay,Spain,0,0,0,0.5,0.5,1694,1827
1978-05-31,Bulgaria,Romania,1,1,0,0.5,0.5,1700,1727
1978-05-31,Norway,Denmark,1,2,1,0.0,1.0,1501,1625
1978-06-01,Germany,Poland,0,0,0,0.5,0.5,1931,1792
1978-06-02,Argentina,Hungary,2,1,1,1.0,0.0,1862,1822
1978-06-02,France,Italy,1,2,1,0.0,1.0,1776,1848
1978-06-02,Mexico,Tunisia,1,3,2,0.0,1.0,1754,1663
1978-06-03,Austria,Spain,2,1,1,1.0,0.0,1761,1818
1978-06-03,Brazil,Sweden,1,1,0,0.5,0.5,1976,1754
1978-06-03,Iran,Netherlands,0,3,3,0.0,1.0,1722,1857
1978-06-03,Peru,Scotland,3,1,2,1.0,0.0,1703,1786
1978-06-06,Argentina,France,2,1,1,1.0,0.0,1869,1770
1978-06-06,Germany,Mexico,6,0,6,1.0,0.0,1936,1750
1978-06-06,Hungary,Italy,1,3,2,0.0,1.0,1815,1856
1978-06-06,Poland,Tunisia,1,0,1,1.0,0.0,1798,1658
1978-06-07,Austria,Sweden,1,0,1,1.0,0.0,1769,1747
1978-06-07,Brazil,Spain,0,0,0,0.5,0.5,1973,1822
1978-06-07,Iran,Scotland,1,1,0,0.5,0.5,1724,1785
1978-06-07,Netherlands,Peru,0,0,0,0.5,0.5,1854,1707
1978-06-10,Argentina,Italy,0,1,1,0.0,1.0,1861,1865
1978-06-10,France,Hungary,3,1,2,1.0,0.0,1780,1806
1978-06-10,Germany,Tunisia,0,0,0,0.5,0.5,1931,1664
1978-06-10,Mexico,Poland,1,3,2,0.0,1.0,1744,1805
1978-06-11,Australia,Greece,1,2,1,0.0,1.0,1680,1588
1978-06-11,Austria,Brazil,0,1,1,0.0,1.0,1766,1977
1978-06-11,Iran,Peru,1,4,3,0.0,1.0,1716,1716
1978-06-11,Macau,Hong Kong,0,4,4,0.0,1.0,1485,1564
1978-06-11,Netherlands,Scotland,2,3,1,0.0,1.0,1845,1795
1978-06-11,Spain,Sweden,1,0,1,1.0,0.0,1829,1741
1978-06-13,Indonesia,Malaysia,3,0,3,1.0,0.0,1561,1684
1978-06-14,Argentina,Poland,2,0,2,1.0,0.0,1868,1799
1978-06-14,Australia,Greece,0,1,1,0.0,1.0,1670,1599
1978-06-14,Austria,Netherlands,1,5,4,0.0,1.0,1760,1852
1978-06-14,Brazil,Peru,3,0,3,1.0,0.0,1980,1714
1978-06-14,Germany,Italy,0,0,0,0.5,0.5,1930,1867
1978-06-15,Indonesia,Thailand,1,0,1,1.0,0.0,1569,1545
1978-06-16,Malaysia,Singapore,1,1,0,0.5,0.5,1680,1456
1978-06-17,Singapore,Thailand,1,3,2,0.0,1.0,1451,1551
1978-06-18,Argentina,Brazil,0,0,0,0.5,0.5,1871,1978
1978-06-18,Austria,Italy,0,1,1,0.0,1.0,1755,1873
1978-06-18,Germany,Netherlands,2,2,0,0.5,0.5,1929,1854
1978-06-18,Malawi,Zambia,1,2,1,0.0,1.0,1583,1668
1978-06-18,Peru,Poland,0,1,1,0.0,1.0,1708,1806
1978-06-21,Argentina,Peru,6,0,6,1.0,0.0,1876,1704
1978-06-21,Austria,Germany,3,2,1,1.0,0.0,1767,1918
1978-06-21,Brazil,Poland,3,1,2,1.0,0.0,1983,1802
1978-06-21,Indonesia,Singapore,2,2,0,0.5,0.5,1567,1454
1978-06-21,Italy,Netherlands,1,2,1,0.0,1.0,1865,1863
1978-06-21,Malaysia,Thailand,1,1,0,0.5,0.5,1678,1554
1978-06-23,Indonesia,South Korea,1,3,2,0.0,1.0,1564,1805
1978-06-23,Malaysia,Thailand,3,3,0,0.5,0.5,1676,1557
1978-06-24,Brazil,Italy,2,1,1,1.0,0.0,1989,1860
1978-06-25,Argentina,Netherlands,3,1,2,1.0,0.0,1884,1856
1978-06-25,Barbados,Curaçao,0,0,0,0.5,0.5,1478,1537
1978-06-25,Zambia,Malawi,0,0,0,0.5,0.5,1667,1585
1978-06-28,Iceland,Denmark,0,0,0,0.5,0.5,1483,1622
1978-06-28,Sweden,Finland,2,1,1,1.0,0.0,1744,1484
1978-07-02,Algeria,Iraq,1,1,0,0.5,0.5,1577,1690
1978-07-02,Guadeloupe,Jamaica,1,0,1,1.0,0.0,1520,1472
1978-07-04,Algeria,Iraq,0,0,0,0.5,0.5,1580,1688
1978-07-06,Malawi,Sierra Leone,5,0,5,1.0,0.0,1591,1479
1978-07-09,Guyana,Suriname,0,2,2,0.0,1.0,1445,1613
1978-07-09,Malawi,Sierra Leone,4,2,2,1.0,0.0,1597,1474
1978-07-12,Malaysia,South Korea,1,3,2,0.0,1.0,1671,1811
1978-07-13,Indonesia,Syria,1,0,1,1.0,0.0,1572,1521
1978-07-13,Iraq,Japan,0,0,0,0.5,0.5,1686,1600
1978-07-13,Algeria,Egypt,1,1,0,0.5,0.5,1583,1694
1978-07-14,Malaysia,Singapore,6,0,6,1.0,0.0,1675,1451
1978-07-14,South Korea,Thailand,3,0,3,1.0,0.0,1815,1554
1978-07-14,Libya,Malawi,2,1,1,1.0,0.0,1556,1588
1978-07-14,Nigeria,Mali,3,1,2,1.0,0.0,1694,1598
1978-07-14,Ghana,Cameroon,2,1,1,1.0,0.0,1705,1567
1978-07-15,Indonesia,Japan,2,1,1,1.0,0.0,1581,1592
1978-07-15,Iraq,Syria,2,1,1,1.0,0.0,1691,1517
1978-07-16,Malaysia,Thailand,2,0,2,1.0,0.0,1681,1549
1978-07-16,South Korea,Singapore,2,0,2,1.0,0.0,1817,1450
1978-07-16,Malaysia,Indonesia,1,0,1,1.0,0.0,1687,1576
1978-07-17,Indonesia,Iraq,0,4,4,0.0,1.0,1571,1697
1978-07-17,Japan,Syria,3,2,1,1.0,0.0,1599,1511
1978-07-17,Nigeria,Cameroon,0,0,0,0.5,0.5,1692,1570
1978-07-17,Ghana,Mali,1,1,0,0.5,0.5,1703,1601
1978-07-18,Malaysia,Iraq,1,2,1,0.0,1.0,1680,1705
1978-07-18,Singapore,Thailand,1,2,1,0.0,1.0,1445,1555
1978-07-18,Algeria,Libya,2,1,1,1.0,0.0,1591,1549
1978-07-18,Egypt,Malawi,4,1,3,1.0,0.0,1700,1583
1978-07-19,Japan,South Korea,0,4,4,0.0,1.0,1596,1821
1978-07-20,Iraq,Singapore,3,0,3,1.0,0.0,1708,1443
1978-07-20,Syria,Thailand,1,3,2,0.0,1.0,1505,1562
1978-07-21,Malaysia,Japan,4,1,3,1.0,0.0,1687,1590
1978-07-21,Nigeria,Ghana,0,0,0,0.5,0.5,1693,1703
1978-07-21,Cameroon,Mali,1,1,0,0.5,0.5,1571,1601
1978-07-22,Indonesia,Thailand,0,3,3,0.0,1.0,1563,1571
1978-07-22,Iraq,South Korea,0,2,2,0.0,1.0,1703,1827
1978-07-22,Algeria,Malawi,3,0,3,1.0,0.0,1599,1576
1978-07-22,Egypt,Libya,1,0,1,1.0,0.0,1705,1545
1978-07-23,Japan,Singapore,1,2,1,0.0,1.0,1579,1455
1978-07-23,Malaysia,Syria,5,2,3,1.0,0.0,1692,1501
1978-07-24,Iraq,Thailand,1,0,1,1.0,0.0,1709,1566
1978-07-25,Indonesia,South Korea,0,2,2,0.0,1.0,1561,1830
1978-07-25,Singapore,Syria,4,1,3,1.0,0.0,1465,1492
1978-07-25,Algeria,Ghana,2,0,2,1.0,0.0,1610,1693
1978-07-25,Nigeria,Malawi,3,2,1,1.0,0.0,1699,1571
1978-07-26,Japan,Thailand,4,0,4,1.0,0.0,1587,1559
1978-07-27,Indonesia,Singapore,0,0,0,0.5,0.5,1559,1468
1978-07-27,South Korea,Syria,2,0,2,1.0,0.0,1833,1490
1978-07-28,Ghana,Malawi,1,0,1,1.0,0.0,1699,1566
1978-07-28,Algeria,Nigeria,1,0,1,1.0,0.0,1621,1689
1978-07-29,Curaçao,Barbados,1,0,1,1.0,0.0,1544,1472
1978-07-29,Iraq,South Korea,0,2,2,0.0,1.0,1704,1839
1978-07-30,Grenada,Trinidad and Tobago,1,1,0,0.5,0.5,1578,1610
1978-07-30,Jamaica,Guadeloupe,1,2,1,0.0,1.0,1466,1527
1978-07-30,Suriname,Guyana,2,1,1,1.0,0.0,1618,1441
1978-08-07,Vanuatu,Tahiti,2,4,2,0.0,1.0,1450,1582
1978-08-09,Finland,Norway,1,1,0,0.5,0.5,1485,1501
1978-08-13,New Caledonia,Tahiti,2,0,2,1.0,0.0,1608,1575
1978-08-16,Denmark,Sweden,2,1,1,1.0,0.0,1633,1734
1978-08-16,São Tomé and Príncipe,Angola,3,3,0,0.5,0.5,1488,1496
1978-08-20,New Caledonia,Tahiti,3,4,1,0.0,1.0,1600,1584
1978-08-20,Puerto Rico,Haiti,1,1,0,0.5,0.5,1390,1630
1978-08-20,Trinidad and Tobago,French Guiana,2,4,2,0.0,1.0,1599,1460
1978-08-26,Haiti,Puerto Rico,1,0,1,1.0,0.0,1634,1387
1978-08-30,Finland,Poland,0,1,1,0.0,1.0,1483,1805
1978-08-30,German DR,Bulgaria,2,2,0,0.5,0.5,1813,1703
1978-08-30,Norway,Austria,0,2,2,0.0,1.0,1499,1770
1978-09-01,France,Sweden,2,2,0,0.5,0.5,1779,1736
1978-09-02,French Guiana,Trinidad and Tobago,1,4,3,0.0,1.0,1456,1604
1978-09-03,China PR,Congo,1,0,1,1.0,0.0,1682,1564
1978-09-03,Iceland,United States,0,0,0,0.5,0.5,1484,1500
1978-09-06,German DR,Czechoslovakia,2,1,1,1.0,0.0,1821,1763
1978-09-06,Iceland,Poland,0,2,2,0.0,1.0,1482,1808
1978-09-06,Iran,Russia,0,1,1,0.0,1.0,1710,1803
1978-09-06,Eswatini,Zambia,1,6,5,0.0,1.0,1486,1672
1978-09-06,Switzerland,United States,2,0,2,1.0,0.0,1602,1495
1978-09-07,Eswatini,Zambia,2,5,3,0.0,1.0,1482,1677
1978-09-09,Bahrain,Malaysia,1,2,1,0.0,1.0,1460,1696
1978-09-09,French Guiana,Martinique,4,2,2,1.0,0.0,1468,1583
1978-09-10,Indonesia,Thailand,0,2,2,0.0,1.0,1551,1567
1978-09-10,Lebanon,Mexico,1,7,6,0.0,1.0,1473,1747
1978-09-11,South Korea,Malaysia,2,2,0,0.5,0.5,1836,1700
1978-09-13,South Korea,Bahrain,3,1,2,1.0,0.0,1838,1459
1978-09-16,Haiti,Martinique,0,0,0,0.5,0.5,1633,1585
1978-09-17,Seychelles,Réunion,1,0,1,1.0,0.0,1464,1439
1978-09-20,Austria,Scotland,3,2,1,1.0,0.0,1779,1787
1978-09-20,Belgium,Norway,1,1,0,0.5,0.5,1735,1504
1978-09-20,Denmark,England,3,4,1,0.0,1.0,1630,1870
1978-09-20,Finland,Hungary,2,1,1,1.0,0.0,1497,1793
1978-09-20,Republic of Ireland,Northern Ireland,0,0,0,0.5,0.5,1631,1629
1978-09-20,Italy,Bulgaria,1,0,1,1.0,0.0,1865,1699
1978-09-20,Libya,Yemen DPR,2,0,2,1.0,0.0,1552,1478
1978-09-20,Netherlands,Iceland,3,0,3,1.0,0.0,1858,1481
1978-09-20,Portugal,United States,1,0,1,1.0,0.0,1745,1492
1978-09-20,Russia,Greece,2,0,2,1.0,0.0,1807,1596
1978-09-23,Italy,Turkey,1,0,1,1.0,0.0,1868,1604
1978-09-23,Réunion,Mauritius,0,2,2,0.0,1.0,1433,1520
1978-09-30,Botswana,Mozambique,1,4,3,0.0,1.0,1453,1507
1978-09-30,Curaçao,Suriname,0,2,2,0.0,1.0,1538,1625
1978-10-01,Botswana,Mozambique,0,2,2,0.0,1.0,1447,1514
1978-10-01,Martinique,Haiti,0,0,0,0.5,0.5,1587,1632
1978-10-01,Singapore,New Zealand,0,2,2,0.0,1.0,1463,1598
1978-10-04,German DR,Iceland,3,1,2,1.0,0.0,1823,1480
1978-10-04,Sweden,Czechoslovakia,1,3,2,0.0,1.0,1729,1771
1978-10-04,Yugoslavia,Spain,1,2,1,0.0,1.0,1743,1836
1978-10-05,Turkey,Russia,0,2,2,0.0,1.0,1601,1811
1978-10-07,Luxembourg,France,1,3,2,0.0,1.0,1361,1781
1978-10-11,Czechoslovakia,Germany,3,4,1,0.0,1.0,1767,1923
1978-10-11,Denmark,Bulgaria,2,2,0,0.5,0.5,1632,1698
1978-10-11,Greece,Finland,8,1,7,1.0,0.0,1602,1492
1978-10-11,Hungary,Russia,2,0,2,1.0,0.0,1802,1803
1978-10-11,Portugal,Belgium,1,1,0,0.5,0.5,1745,1736
1978-10-11,Romania,Poland,1,0,1,1.0,0.0,1737,1799
1978-10-11,Switzerland,Netherlands,1,3,2,0.0,1.0,1600,1861
1978-10-13,Suriname,Curaçao,3,0,3,1.0,0.0,1632,1532
1978-10-15,Tanzania,Kenya,1,0,1,1.0,0.0,1514,1560
1978-10-20,Kenya,Tanzania,0,0,0,0.5,0.5,1559,1516
1978-10-22,Haiti,Suriname,0,3,3,0.0,1.0,1624,1640
1978-10-22,Malawi,Algeria,1,1,0,0.5,0.5,1568,1620
1978-10-23,Trinidad and Tobago,Antigua and Barbuda,3,1,2,1.0,0.0,1610,1480
1978-10-24,Malawi,Algeria,2,1,1,1.0,0.0,1578,1611
1978-10-25,Republic of Ireland,England,1,1,0,0.5,0.5,1636,1866
1978-10-25,Northern Ireland,Denmark,2,1,1,1.0,0.0,1638,1624
1978-10-25,Romania,Yugoslavia,3,2,1,1.0,0.0,1746,1735
1978-10-25,Scotland,Norway,3,2,1,1.0,0.0,1790,1502
1978-10-25,Trinidad and Tobago,Suriname,0,1,1,0.0,1.0,1603,1648
1978-10-25,Wales,Malta,7,0,7,1.0,0.0,1671,1454
1978-10-26,Antigua and Barbuda,Haiti,0,1,1,0.0,1.0,1476,1629
1978-10-28,Antigua and Barbuda,Suriname,0,4,4,0.0,1.0,1472,1653
1978-10-28,Zambia,Algeria,0,3,3,0.0,1.0,1668,1621
1978-10-28,Greece,Hungary,4,1,3,1.0,0.0,1615,1790
1978-10-29,Trinidad and Tobago,Haiti,2,2,0,0.5,0.5,1604,1629
1978-11-01,Malawi,Kenya,1,0,1,1.0,0.0,1586,1552
1978-11-03,Malawi,Somalia,3,1,2,1.0,0.0,1591,1433
1978-11-05,Malawi,Uganda,0,2,2,0.0,1.0,1585,1657
1978-11-07,Uganda,Zambia,1,2,1,0.0,1.0,1650,1676
1978-11-08,Czechoslovakia,Italy,3,0,3,1.0,0.0,1778,1858
1978-11-08,France,Spain,1,0,1,1.0,0.0,1791,1827
1978-11-09,Kenya,Uganda,0,1,1,0.0,1.0,1547,1656
1978-11-09,Somalia,Zambia,0,4,4,0.0,1.0,1430,1680
1978-11-11,Burkina Faso,Mali,3,1,2,1.0,0.0,1475,1590
1978-11-11,Kenya,Somalia,1,0,1,1.0,0.0,1553,1425
1978-11-11,Malawi,Zambia,2,1,1,1.0,0.0,1596,1670
1978-11-13,Kenya,Zambia,0,9,9,0.0,1.0,1548,1676
1978-11-13,Somalia,Uganda,2,2,0,0.5,0.5,1430,1652
1978-11-15,Austria,Portugal,1,2,1,0.0,1.0,1771,1754
1978-11-15,Germany,Hungary,0,0,0,0.5,0.5,1921,1793
1978-11-15,Israel,Belgium,1,0,1,1.0,0.0,1683,1727
1978-11-15,Netherlands,German DR,3,0,3,1.0,0.0,1869,1816
1978-11-15,Poland,Switzerland,2,0,2,1.0,0.0,1803,1597
1978-11-15,Spain,Romania,1,0,1,1.0,0.0,1834,1740
1978-11-15,Yugoslavia,Greece,4,1,3,1.0,0.0,1741,1610
1978-11-17,Algeria,Congo,3,0,3,1.0,0.0,1628,1558
1978-11-17,Malawi,Kenya,2,0,2,1.0,0.0,1603,1542
1978-11-17,Uganda,Zambia,0,4,4,0.0,1.0,1645,1684
1978-11-19,Japan,Russia,1,4,3,0.0,1.0,1584,1807
1978-11-19,Kenya,Uganda,2,0,2,1.0,0.0,1553,1635
1978-11-19,Malawi,Zambia,3,2,1,1.0,0.0,1613,1675
1978-11-23,Japan,Russia,1,4,3,0.0,1.0,1581,1811
1978-11-25,Grenada,Barbados,2,0,2,1.0,0.0,1584,1467
1978-11-26,Grenada,Barbados,0,0,0,0.5,0.5,1582,1470
1978-11-26,Japan,Russia,0,3,3,0.0,1.0,1578,1815
1978-11-29,Bulgaria,Northern Ireland,0,2,2,0.0,1.0,1689,1648
1978-11-29,England,Czechoslovakia,1,0,1,1.0,0.0,1873,1772
1978-11-29,Portugal,Scotland,1,0,1,1.0,0.0,1763,1782
1978-11-29,Wales,Turkey,1,0,1,1.0,0.0,1678,1595
1978-12-03,Madagascar,Malawi,2,1,1,1.0,0.0,1551,1604
1978-12-03,Mauritius,Lesotho,0,1,1,0.0,1.0,1511,1453
1978-12-10,India,Malaysia,0,1,1,0.0,1.0,1521,1705
1978-12-10,Iraq,Qatar,2,1,1,1.0,0.0,1708,1467
1978-12-10,China PR,Saudi Arabia,1,0,1,1.0,0.0,1687,1490
1978-12-11,Bahrain,South Korea,1,5,4,0.0,1.0,1458,1840
1978-12-11,Japan,Kuwait,0,2,2,0.0,1.0,1573,1695
1978-12-11,Thailand,Myanmar,2,1,1,1.0,0.0,1578,1665
1978-12-12,Antigua and Barbuda,Martinique,0,2,2,0.0,1.0,1467,1593
1978-12-12,Bangladesh,Malaysia,0,1,1,0.0,1.0,1462,1709
1978-12-12,Qatar,Saudi Arabia,2,2,0,0.5,0.5,1468,1490
1978-12-12,China PR,Iraq,0,2,2,0.0,1.0,1680,1716
1978-12-13,Greece,Romania,2,1,1,1.0,0.0,1621,1730
1978-12-13,Spain,Cyprus,5,0,5,1.0,0.0,1836,1389
1978-12-13,Bahrain,Japan,0,4,4,0.0,1.0,1453,1579
1978-12-13,South Korea,Kuwait,2,0,2,1.0,0.0,1845,1691
1978-12-13,Myanmar,North Korea,0,3,3,0.0,1.0,1657,1640
1978-12-14,Bangladesh,India,0,3,3,0.0,1.0,1456,1528
1978-12-14,China PR,Qatar,3,0,3,1.0,0.0,1684,1465
1978-12-14,Iraq,Saudi Arabia,1,1,0,0.5,0.5,1712,1495
1978-12-15,Japan,South Korea,1,3,2,0.0,1.0,1577,1848
1978-12-15,Bahrain,Kuwait,0,3,3,0.0,1.0,1450,1695
1978-12-15,Thailand,North Korea,0,3,3,0.0,1.0,1572,1647
1978-12-17,Lesotho,Mauritius,1,2,1,0.0,1.0,1447,1518
1978-12-17,Malawi,Madagascar,5,1,4,1.0,0.0,1611,1545
1978-12-17,India,Kuwait,1,6,5,0.0,1.0,1524,1700
1978-12-17,Iraq,North Korea,0,1,1,0.0,1.0,1703,1657
1978-12-17,China PR,South Korea,0,1,1,0.0,1.0,1680,1853
1978-12-17,Thailand,Malaysia,2,1,1,1.0,0.0,1584,1698
1978-12-18,Iraq,Kuwait,3,0,3,1.0,0.0,1711,1693
1978-12-18,India,North Korea,1,3,2,0.0,1.0,1519,1663
1978-12-18,Thailand,China PR,1,4,3,0.0,1.0,1579,1686
1978-12-18,Malaysia,South Korea,0,1,1,0.0,1.0,1694,1858
1978-12-19,Israel,Romania,1,1,0,0.5,0.5,1685,1729
1978-12-19,Syria,Tunisia,2,1,1,1.0,0.0,1502,1653
1978-12-19,India,Iraq,0,3,3,0.0,1.0,1516,1715
1978-12-19,North Korea,Kuwait,2,2,0,0.5,0.5,1664,1693
1978-12-19,China PR,Malaysia,7,1,6,1.0,0.0,1695,1686
1978-12-19,Thailand,South Korea,1,3,2,0.0,1.0,1577,1861
1978-12-20,Germany,Netherlands,3,1,2,1.0,0.0,1928,1863
1978-12-20,Iraq,China PR,0,1,1,0.0,1.0,1707,1704
1978-12-20,North Korea,South Korea,0,0,0,0.5,0.5,1669,1857
1978-12-21,Italy,Spain,1,0,1,1.0,0.0,1866,1829
1978-12-25,South Korea,Macau,4,1,3,1.0,0.0,1859,1484
1978-12-25,Philippines,China PR,0,3,3,0.0,1.0,1368,1707
1978-12-27,China PR,Macau,2,1,1,1.0,0.0,1711,1481
1978-12-27,Philippines,South Korea,0,5,5,0.0,1.0,1368,1860
1978-12-29,South Korea,China PR,1,0,1,1.0,0.0,1865,1707
1979-01-07,Guinea-Bissau,Cape Verde,3,0,3,1.0,0.0,1511,1485
1979-01-08,Gambia,Mauritania,3,1,2,1.0,0.0,1466,1432
1979-01-08,Guinea,Mali,0,1,1,0.0,1.0,1656,1600
1979-01-09,Cape Verde,Senegal,0,1,1,0.0,1.0,1479,1579
1979-01-10,Gambia,Mali,0,1,1,0.0,1.0,1461,1606
1979-01-10,Guinea,Mauritania,4,1,3,1.0,0.0,1660,1429
1979-01-10,Rwanda,Gabon,2,2,0,0.5,0.5,1496,1471
1979-01-11,Guinea-Bissau,Senegal,0,2,2,0.0,1.0,1505,1586
1979-01-12,Gambia,Guinea,1,1,0,0.5,0.5,1466,1656
1979-01-12,Mali,Mauritania,4,2,2,1.0,0.0,1611,1425
1979-01-13,Guinea,Senegal,1,3,2,0.0,1.0,1647,1596
1979-01-13,Guinea-Bissau,Mali,1,1,0,0.5,0.5,1508,1609
1979-01-14,Guinea-Bissau,Guinea,2,2,0,0.5,0.5,1512,1644
1979-01-14,Mali,Senegal,0,1,1,0.0,1.0,1601,1605
1979-01-16,Cyprus,Bulgaria,0,1,1,0.0,1.0,1387,1692
1979-01-27,Ivory Coast,Togo,0,1,1,0.0,1.0,1609,1517
1979-01-28,Liberia,Guinea,2,1,1,1.0,0.0,1463,1632
1979-01-29,Gambia,Ivory Coast,2,1,1,1.0,0.0,1478,1598
1979-01-30,Guinea,Senegal,1,1,0,0.5,0.5,1632,1606
1979-01-30,Israel,Austria,0,1,1,0.0,1.0,1679,1778
1979-01-31,Gambia,Togo,2,2,0,0.5,0.5,1479,1517
1979-02-01,Liberia,Senegal,1,1,0,0.5,0.5,1467,1603
1979-02-03,Senegal,Togo,0,1,1,0.0,1.0,1594,1527
1979-02-04,Liberia,Gambia,1,0,1,1.0,0.0,1476,1471
1979-02-05,Iraq,Finland,1,0,1,1.0,0.0,1711,1489
1979-02-07,England,Northern Ireland,4,0,4,1.0,0.0,1877,1645
1979-02-07,Iraq,Finland,2,0,2,1.0,0.0,1715,1486
1979-02-07,Libya,Greece,2,2,0,0.5,0.5,1554,1620
1979-02-09,Bahrain,Finland,0,1,1,0.0,1.0,1443,1494
1979-02-09,Iraq,German DR,1,1,0,0.5,0.5,1718,1814
1979-02-11,Iraq,German DR,2,1,1,1.0,0.0,1729,1804
1979-02-14,Israel,Greece,4,1,3,1.0,0.0,1686,1614
1979-02-16,Libya,Poland,1,0,1,1.0,0.0,1567,1791
1979-02-18,Tunisia,Poland,0,2,2,0.0,1.0,1649,1796
1979-02-18,Mauritania,Morocco,2,2,0,0.5,0.5,1430,1667
1979-02-24,Italy,Netherlands,3,0,3,1.0,0.0,1874,1856
1979-02-25,France,Luxembourg,3,0,3,1.0,0.0,1793,1360
1979-02-25,Malta,Germany,0,0,0,0.5,0.5,1462,1921
1979-02-28,Bulgaria,German DR,1,0,1,1.0,0.0,1703,1794
1979-02-28,Turkey,Algeria,0,1,1,0.0,1.0,1588,1636
1979-03-03,Barbados,Trinidad and Tobago,2,2,0,0.5,0.5,1473,1602
1979-03-04,Japan,South Korea,2,1,1,1.0,0.0,1591,1852
1979-03-05,Bangladesh,Afghanistan,3,2,1,1.0,0.0,1464,1426
1979-03-07,Bangladesh,Qatar,1,3,2,0.0,1.0,1457,1473
1979-03-10,Senegal,Mali,2,1,1,1.0,0.0,1603,1593
1979-03-14,Czechoslovakia,Spain,1,0,1,1.0,0.0,1782,1820
1979-03-16,Martinique,Trinidad and Tobago,0,0,0,0.5,0.5,1594,1602
1979-03-18,Turkey,Malta,2,1,1,1.0,0.0,1594,1457
1979-03-21,Romania,Greece,3,0,3,1.0,0.0,1735,1609
1979-03-23,Iraq,Bahrain,4,0,4,1.0,0.0,1732,1441
1979-03-24,Kuwait,Qatar,3,1,2,1.0,0.0,1697,1470
1979-03-24,Saudi Arabia,United Arab Emirates,2,1,1,1.0,0.0,1502,1431
1979-03-25,Mali,Senegal,2,1,1,1.0,0.0,1602,1595
1979-03-27,Iraq,Qatar,2,0,2,1.0,0.0,1735,1468
1979-03-27,Bahrain,United Arab Emirates,3,0,3,1.0,0.0,1449,1424
1979-03-27,Jersey,Alderney,8,0,8,1.0,0.0,1690,1308
1979-03-28,Belgium,Austria,1,1,0,0.5,0.5,1729,1777
1979-03-28,Hungary,German DR,3,0,3,1.0,0.0,1802,1786
1979-03-28,Netherlands,Switzerland,3,0,3,1.0,0.0,1859,1595
1979-03-28,Russia,Bulgaria,3,1,2,1.0,0.0,1821,1698
1979-03-28,Saudi Arabia,Oman,4,0,4,1.0,0.0,1509,1434
1979-03-29,Qatar,United Arab Emirates,1,0,1,1.0,0.0,1475,1418
1979-03-30,Bahrain,Oman,3,1,2,1.0,0.0,1457,1427
1979-03-30,Iraq,Kuwait,3,1,2,1.0,0.0,1743,1690
1979-04-01,Cyprus,Yugoslavia,0,3,3,0.0,1.0,1386,1743
1979-04-01,Oman,Qatar,0,1,1,0.0,1.0,1421,1482
1979-04-01,Turkey,Germany,0,0,0,0.5,0.5,1600,1916
1979-04-01,Kuwait,United Arab Emirates,7,0,7,1.0,0.0,1693,1416
1979-04-02,Saudi Arabia,Bahrain,1,1,0,0.5,0.5,1508,1459
1979-04-03,Barbados,Martinique,1,2,1,0.0,1.0,1468,1600
1979-04-03,Kuwait,Oman,2,0,2,1.0,0.0,1696,1419
1979-04-04,Czechoslovakia,France,2,0,2,1.0,0.0,1791,1785
1979-04-04,Poland,Hungary,1,1,0,0.5,0.5,1797,1802
1979-04-04,Romania,Spain,2,2,0,0.5,0.5,1737,1819
1979-04-04,Saudi Arabia,Qatar,7,0,7,1.0,0.0,1516,1475
1979-04-04,Iraq,United Arab Emirates,5,0,5,1.0,0.0,1746,1414
1979-04-06,Iraq,Oman,7,0,7,1.0,0.0,1749,1417
1979-04-06,Kuwait,Saudi Arabia,0,0,0,0.5,0.5,1693,1520
1979-04-07,Bahrain,Qatar,1,1,0,0.5,0.5,1460,1475
1979-04-08,Gabon,Ivory Coast,2,1,1,1.0,0.0,1482,1588
1979-04-08,Iraq,Saudi Arabia,2,0,2,1.0,0.0,1753,1517
1979-04-08,Morocco,Mauritania,4,1,3,1.0,0.0,1671,1427
1979-04-09,Bahrain,Kuwait,0,2,2,0.0,1.0,1457,1697
1979-04-09,Oman,United Arab Emirates,0,4,4,0.0,1.0,1409,1423
1979-04-15,Benin,Ivory Coast,1,0,1,1.0,0.0,1508,1578
1979-04-15,Congo,DR Congo,4,2,2,1.0,0.0,1569,1642
1979-04-15,Guadeloupe,Martinique,0,1,1,0.0,1.0,1521,1607
1979-04-15,Malawi,Zambia,0,2,2,0.0,1.0,1605,1682
1979-04-15,Guinea,Cameroon,3,0,3,1.0,0.0,1639,1565
1979-04-15,Libya,Ethiopia,2,1,1,1.0,0.0,1575,1527
1979-04-16,Togo,Gambia,2,0,2,1.0,0.0,1534,1465
1979-04-16,Mauritius,Tanzania,3,2,1,1.0,0.0,1526,1509
1979-04-18,German DR,Poland,2,1,1,1.0,0.0,1795,1789
1979-04-19,Russia,Sweden,2,0,2,1.0,0.0,1827,1724
1979-04-25,Argentina,Bulgaria,2,1,1,1.0,0.0,1889,1694
1979-04-25,São Tomé and Príncipe,Angola,1,2,1,0.0,1.0,1481,1504
1979-04-29,DR Congo,Congo,4,1,3,1.0,0.0,1649,1563
1979-04-29,Gambia,Togo,1,0,1,1.0,0.0,1475,1525
1979-04-29,Tanzania,Mauritius,4,0,4,1.0,0.0,1518,1518
1979-04-29,Ivory Coast,Benin,4,1,3,1.0,0.0,1585,1502
1979-04-29,Ethiopia,Libya,1,1,0,0.5,0.5,1529,1574
1979-04-29,Cameroon,Guinea,3,0,3,1.0,0.0,1575,1630
1979-04-29,Madagascar,Kenya,4,0,4,1.0,0.0,1554,1545
1979-04-29,Zambia,Malawi,2,0,2,1.0,0.0,1689,1599
1979-05-01,Luxembourg,Czechoslovakia,0,3,3,0.0,1.0,1359,1793
1979-05-02,Austria,Belgium,0,0,0,0.5,0.5,1776,1731
1979-05-02,Hungary,Greece,0,0,0,0.5,0.5,1798,1614
1979-05-02,Republic of Ireland,Denmark,2,0,2,1.0,0.0,1644,1617
1979-05-02,North Korea,Hong Kong,3,0,3,1.0,0.0,1675,1559
1979-05-02,Northern Ireland,Bulgaria,2,0,2,1.0,0.0,1655,1685
1979-05-02,Poland,Netherlands,2,0,2,1.0,0.0,1799,1850
1979-05-02,United States,France,0,6,6,0.0,1.0,1490,1788
1979-05-02,Wales,Germany,0,2,2,0.0,1.0,1675,1920
1979-05-05,Russia,Czechoslovakia,3,0,3,1.0,0.0,1835,1786
1979-05-05,Saint Vincent and the Grenadines,Martinique,2,2,0,0.5,0.5,1570,1607
1979-05-05,Switzerland,German DR,0,2,2,0.0,1.0,1592,1799
1979-05-07,North Korea,Indonesia,3,1,2,1.0,0.0,1681,1546
1979-05-09,Denmark,Sweden,2,2,0,0.5,0.5,1620,1722
1979-05-09,Malaysia,North Korea,1,1,0,0.5,0.5,1686,1682
1979-05-09,Norway,Portugal,0,1,1,0.0,1.0,1500,1766
1979-05-09,Guernsey,Jersey,5,0,5,1.0,0.0,1649,1681
1979-05-11,Malaysia,Hong Kong,0,0,0,0.5,0.5,1684,1562
1979-05-12,Thailand,North Korea,0,1,1,0.0,1.0,1572,1688
1979-05-13,Cyprus,Romania,1,1,0,0.5,0.5,1393,1731
1979-05-14,North Korea,Malaysia,1,0,1,1.0,0.0,1696,1677
1979-05-17,Brazil,Paraguay,6,0,6,1.0,0.0,1992,1669
1979-05-19,Bulgaria,Republic of Ireland,1,0,1,1.0,0.0,1693,1637
1979-05-19,Mozambique,Zimbabwe,0,6,6,0.0,1.0,1506,1500
1979-05-19,Northern Ireland,England,0,2,2,0.0,1.0,1652,1881
1979-05-19,Russia,Hungary,2,2,0,0.5,0.5,1835,1799
1979-05-19,Wales,Scotland,3,0,3,1.0,0.0,1686,1772
1979-05-22,Argentina,Netherlands,0,0,0,0.5,0.5,1889,1851
1979-05-22,Republic of Ireland,Germany,1,3,2,0.0,1.0,1635,1923
1979-05-22,Scotland,Northern Ireland,1,0,1,1.0,0.0,1778,1647
1979-05-22,Switzerland,Iceland,2,0,2,1.0,0.0,1598,1475
1979-05-23,England,Wales,0,0,0,0.5,0.5,1877,1691
1979-05-24,Martinique,Trinidad and Tobago,3,1,2,1.0,0.0,1615,1595
1979-05-26,England,Scotland,3,1,2,1.0,0.0,1883,1773
1979-05-26,Iceland,Germany,1,3,2,0.0,1.0,1474,1925
1979-05-26,Italy,Argentina,2,2,0,0.5,0.5,1875,1889
1979-05-26,Northern Ireland,Wales,1,1,0,0.5,0.5,1649,1690
1979-05-29,Republic of Ireland,Argentina,0,0,0,0.5,0.5,1640,1885
1979-05-31,Brazil,Uruguay,5,1,4,1.0,0.0,1995,1692
1979-05-31,Japan,Indonesia,4,0,4,1.0,0.0,1598,1540
1979-06-01,German DR,Romania,1,0,1,1.0,0.0,1806,1725
1979-06-02,Malta,Wales,0,2,2,0.0,1.0,1454,1694
1979-06-02,Scotland,Argentina,1,3,2,0.0,1.0,1768,1891
1979-06-03,Benin,Togo,0,1,1,0.0,1.0,1495,1533
1979-06-03,Jamaica,Saint Kitts and Nevis,2,1,1,1.0,0.0,1475,1472
1979-06-06,Bulgaria,England,0,3,3,0.0,1.0,1689,1888
1979-06-06,Denmark,Northern Ireland,4,0,4,1.0,0.0,1629,1641
1979-06-07,Norway,Scotland,0,4,4,0.0,1.0,1498,1771
1979-06-07,Sweden,Luxembourg,3,0,3,1.0,0.0,1724,1358
1979-06-09,Iceland,Switzerland,1,2,1,0.0,1.0,1469,1604
1979-06-09,Martinique,Saint Vincent and the Grenadines,0,1,1,0.0,1.0,1606,1580
1979-06-10,Sweden,England,0,0,0,0.5,0.5,1728,1885
1979-06-13,Austria,England,4,3,1,1.0,0.0,1787,1875
1979-06-13,Chile,Ecuador,0,0,0,0.5,0.5,1654,1474
1979-06-13,New Zealand,Australia,1,0,1,1.0,0.0,1608,1661
1979-06-13,Yugoslavia,Italy,4,1,3,1.0,0.0,1754,1865
1979-06-16,South Korea,Japan,4,1,3,1.0,0.0,1856,1595
1979-06-17,Saint Kitts and Nevis,Jamaica,1,2,1,0.0,1.0,1465,1483
1979-06-21,Ecuador,Chile,2,1,1,1.0,0.0,1486,1643
1979-06-24,Ghana,Liberia,0,0,0,0.5,0.5,1695,1481
1979-06-24,Malawi,Lesotho,1,0,1,1.0,0.0,1604,1443
1979-06-24,Zambia,DR Congo,4,1,3,1.0,0.0,1697,1642
1979-06-24,Algeria,Libya,3,1,2,1.0,0.0,1643,1568
1979-06-24,Morocco,Togo,7,0,7,1.0,0.0,1676,1529
1979-06-26,Malawi,Lesotho,1,2,1,0.0,1.0,1593,1455
1979-06-27,Denmark,Russia,1,2,1,0.0,1.0,1626,1839
1979-06-28,Sweden,Norway,2,0,2,1.0,0.0,1732,1495
1979-06-29,Malaysia,Japan,1,1,0,0.5,0.5,1676,1597
1979-06-29,Fiji,New Zealand,0,6,6,0.0,1.0,1440,1613
1979-06-29,Japan,Thailand,2,0,2,1.0,0.0,1605,1565
1979-06-29,Malaysia,Myanmar,4,1,3,1.0,0.0,1684,1650
1979-06-29,Sudan,Ivory Coast,2,0,2,1.0,0.0,1620,1578
1979-06-30,Kenya,Egypt,3,1,2,1.0,0.0,1557,1694
1979-06-30,DR Congo,Zambia,1,2,1,0.0,1.0,1636,1704
1979-06-30,Indonesia,Singapore,0,0,0,0.5,0.5,1539,1465
1979-07-01,Malaysia,Thailand,4,2,2,1.0,0.0,1690,1560
1979-07-01,Myanmar,Japan,0,1,1,0.0,1.0,1641,1615
1979-07-01,Fiji,New Zealand,0,3,3,0.0,1.0,1436,1618
1979-07-03,Myanmar,Thailand,2,0,2,1.0,0.0,1648,1554
1979-07-04,Malaysia,Indonesia,1,1,0,0.5,0.5,1687,1543
1979-07-04,Finland,Russia,1,1,0,0.5,0.5,1501,1833
1979-07-05,Singapore,Thailand,1,1,0,0.5,0.5,1468,1552
1979-07-06,Ivory Coast,Sudan,4,0,4,1.0,0.0,1587,1612
1979-07-06,Togo,Morocco,2,1,1,1.0,0.0,1541,1665
1979-07-06,Malawi,Kenya,1,0,1,1.0,0.0,1601,1550
1979-07-08,Libya,Algeria,1,0,1,1.0,0.0,1578,1634
1979-07-08,DR Congo,Togo,4,1,3,1.0,0.0,1642,1536
1979-07-08,Indonesia,Thailand,2,1,1,1.0,0.0,1552,1544
1979-07-08,Malawi,Kenya,0,0,0,0.5,0.5,1600,1552
1979-07-09,Malaysia,Singapore,3,0,3,1.0,0.0,1691,1465
1979-07-10,Bolivia,Paraguay,3,1,2,1.0,0.0,1546,1659
1979-07-11,Myanmar,Singapore,4,1,3,1.0,0.0,1653,1461
1979-07-11,Chile,Uruguay,1,0,1,1.0,0.0,1653,1683
1979-07-11,Indonesia,Japan,0,0,0,0.5,0.5,1554,1614
1979-07-11,Peru,Ecuador,2,1,1,1.0,0.0,1708,1483
1979-07-12,Bolivia,Paraguay,1,1,0,0.5,0.5,1549,1657
1979-07-13,Myanmar,Indonesia,4,0,4,1.0,0.0,1659,1549
1979-07-13,Japan,Singapore,3,1,2,1.0,0.0,1619,1457
1979-07-13,Egypt,Kenya,3,0,3,1.0,0.0,1699,1548
1979-07-15,Kenya,DR Congo,2,2,0,0.5,0.5,1551,1640
1979-07-15,Malawi,Tanzania,2,0,2,1.0,0.0,1607,1512
1979-07-17,Malawi,Tanzania,2,0,2,1.0,0.0,1613,1507
1979-07-18,Bolivia,Argentina,2,1,1,1.0,0.0,1564,1877
1979-07-18,Peru,Colombia,0,1,1,0.0,1.0,1696,1523
1979-07-18,Uruguay,Chile,2,1,1,1.0,0.0,1691,1646
1979-07-19,Malawi,Tanzania,0,1,1,0.0,1.0,1603,1518
1979-07-20,Kyrgyzstan,Lithuania,0,0,0,0.5,0.5,1492,1459
1979-07-21,Belarus,Armenia,3,0,3,1.0,0.0,1511,1493
1979-07-22,Georgia,Lithuania,5,0,5,1.0,0.0,1508,1452
1979-07-22,Grenada,Trinidad and Tobago,0,1,1,0.0,1.0,1575,1603
1979-07-23,Belarus,Latvia,2,1,1,1.0,0.0,1519,1496
1979-07-24,Azerbaijan,Lithuania,0,1,1,0.0,1.0,1491,1462
1979-07-25,Belarus,Russia,2,3,1,0.0,1.0,1517,1836
1979-07-25,Benin,DR Congo,0,1,1,0.0,1.0,1491,1645
1979-07-25,Colombia,Peru,1,2,1,0.0,1.0,1519,1701
1979-07-26,Bolivia,Brazil,2,1,1,1.0,0.0,1579,1981
1979-07-26,Liberia,Ghana,3,1,2,1.0,0.0,1494,1683
1979-07-28,Benin,DR Congo,0,3,3,0.0,1.0,1487,1650
1979-07-28,Lithuania,Ukraine,0,2,2,0.0,1.0,1456,1516
1979-07-28,Russia,Belarus,0,0,0,0.5,0.5,1831,1523
1979-07-29,Madagascar,Tanzania,2,4,2,0.0,1.0,1546,1527
1979-07-30,Belarus,Ukraine,0,0,0,0.5,0.5,1523,1517
1979-07-30,Russia,Lithuania,2,0,2,1.0,0.0,1833,1455
1979-08-01,Belarus,Lithuania,0,2,2,0.0,1.0,1514,1465
1979-08-01,Madagascar,Tanzania,1,0,1,1.0,0.0,1554,1520
1979-08-01,Paraguay,Bolivia,2,0,2,1.0,0.0,1664,1573
1979-08-01,Venezuela,Colombia,0,0,0,0.5,0.5,1452,1518
1979-08-02,Brazil,Argentina,2,1,1,1.0,0.0,1987,1872
1979-08-04,Belarus,Kazakhstan,0,1,1,0.0,1.0,1506,1509
1979-08-04,Trinidad and Tobago,Grenada,2,1,1,1.0,0.0,1611,1568
1979-08-05,DR Congo,Guinea,3,2,1,1.0,0.0,1658,1623
1979-08-05,Russia,Lithuania,2,1,1,1.0,0.0,1835,1464
1979-08-08,Argentina,Bolivia,3,0,3,1.0,0.0,1875,1571
1979-08-08,Ecuador,Peru,2,1,1,1.0,0.0,1496,1689
1979-08-08,Venezuela,Chile,1,1,0,0.5,0.5,1457,1642
1979-08-11,Tanzania,Zambia,1,0,1,1.0,0.0,1532,1693
1979-08-15,Colombia,Chile,1,0,1,1.0,0.0,1529,1632
1979-08-15,Norway,Sweden,2,0,2,1.0,0.0,1508,1720
1979-08-16,Brazil,Bolivia,2,0,2,1.0,0.0,1989,1570
1979-08-19,Guinea,DR Congo,3,1,2,1.0,0.0,1632,1650
1979-08-19,Poland,Libya,5,0,5,1.0,0.0,1803,1575
1979-08-22,Colombia,Venezuela,4,0,4,1.0,0.0,1536,1451
1979-08-23,Argentina,Brazil,2,2,0,0.5,0.5,1878,1987
1979-08-23,North Korea,Japan,0,0,0,0.5,0.5,1695,1621
1979-08-25,Lesotho,Malawi,0,3,3,0.0,1.0,1451,1608
1979-08-26,Zambia,Tanzania,1,1,0,0.5,0.5,1690,1536
1979-08-26,Réunion,Seychelles,3,0,3,1.0,0.0,1442,1456
1979-08-26,Mauritius,Comoros,3,0,3,1.0,0.0,1526,1493
1979-08-27,Seychelles,Maldives,9,0,9,1.0,0.0,1466,1491
1979-08-28,Tunisia,Malta,4,0,4,1.0,0.0,1653,1451
1979-08-28,Réunion,Maldives,9,0,9,1.0,0.0,1452,1482
1979-08-28,Comoros,Mauritius,1,3,2,0.0,1.0,1486,1534
1979-08-29,Austria,Norway,4,0,4,1.0,0.0,1790,1506
1979-08-29,Chile,Venezuela,7,0,7,1.0,0.0,1637,1447
1979-08-29,Ecuador,Paraguay,1,2,1,0.0,1.0,1492,1669
1979-08-29,Finland,Denmark,0,0,0,0.5,0.5,1504,1624
1979-08-29,Guam,Vanuatu,0,4,4,0.0,1.0,1475,1459
1979-08-29,Poland,Romania,3,0,3,1.0,0.0,1810,1719
1979-08-29,Solomon Islands,Wallis Islands and Futuna,6,0,6,1.0,0.0,1481,1476
1979-08-29,Tahiti,Tonga,8,0,8,1.0,0.0,1591,1494
1979-08-29,Fiji,Papua New Guinea,0,0,0,0.5,0.5,1437,1471
1979-08-29,Comoros,Maldives,2,1,1,1.0,0.0,1494,1475
1979-08-30,Fiji,Kiribati,24,0,24,1.0,0.0,1447,1491
1979-08-30,Guam,New Caledonia,1,10,9,0.0,1.0,1470,1606
1979-08-30,Peru,Uruguay,2,0,2,1.0,0.0,1698,1683
1979-08-30,Tahiti,Tuvalu,18,0,18,1.0,0.0,1597,1495
1979-08-31,Kiribati,Papua New Guinea,0,13,13,0.0,1.0,1483,1480
1979-08-31,Solomon Islands,Samoa,12,0,12,1.0,0.0,1490,1492
1979-08-31,New Caledonia,Vanuatu,3,0,3,1.0,0.0,1611,1455
1979-08-31,Seychelles,Mauritius,1,1,0,0.5,0.5,1468,1533
1979-08-31,Réunion,Comoros,6,1,5,1.0,0.0,1461,1486
1979-09-01,Tonga,Tuvalu,3,5,2,0.0,1.0,1487,1503
1979-09-01,Wallis Islands and Futuna,Samoa,3,1,2,1.0,0.0,1485,1484
1979-09-01,Réunion,Seychelles,2,1,1,1.0,0.0,1470,1460
1979-09-03,Fiji,Wallis Islands and Futuna,5,0,5,1.0,0.0,1456,1477
1979-09-03,Libya,Palestine,0,0,0,0.5,0.5,1573,1479
1979-09-03,New Caledonia,Tuvalu,11,0,11,1.0,0.0,1617,1498
1979-09-03,Papua New Guinea,Solomon Islands,2,3,1,0.0,1.0,1473,1498
1979-09-03,Tahiti,Vanuatu,1,0,1,1.0,0.0,1602,1451
1979-09-04,New Caledonia,Tahiti,2,3,1,0.0,1.0,1609,1611
1979-09-04,Fiji,Solomon Islands,2,0,2,1.0,0.0,1465,1490
1979-09-05,Chile,Colombia,2,0,2,1.0,0.0,1643,1531
1979-09-05,Ecuador,Uruguay,2,1,1,1.0,0.0,1505,1671
1979-09-05,Guam,Samoa,4,2,2,1.0,0.0,1479,1476
1979-09-05,Iceland,Netherlands,0,4,4,0.0,1.0,1468,1853
1979-09-05,Kiribati,Tuvalu,3,3,0,0.5,0.5,1484,1498
1979-09-05,Russia,German DR,1,0,1,1.0,0.0,1843,1799
1979-09-05,Sweden,France,1,3,2,0.0,1.0,1714,1795
1979-09-05,Tonga,Wallis Islands and Futuna,1,0,1,1.0,0.0,1495,1470
1979-09-05,Vanuatu,Papua New Guinea,2,0,2,1.0,0.0,1460,1465
1979-09-06,Guam,Tuvalu,7,2,5,1.0,0.0,1488,1490
1979-09-06,Vanuatu,Tonga,7,1,6,1.0,0.0,1469,1487
1979-09-07,New Caledonia,Solomon Islands,1,3,2,0.0,1.0,1599,1501
1979-09-07,Fiji,Tahiti,0,3,3,0.0,1.0,1461,1616
1979-09-08,South Korea,Sudan,8,0,8,1.0,0.0,1860,1609
1979-09-09,Indonesia,Thailand,0,2,2,0.0,1.0,1541,1553
1979-09-10,Bangladesh,Sudan,1,4,3,0.0,1.0,1453,1614
1979-09-11,Wales,Republic of Ireland,2,1,1,1.0,0.0,1701,1634
1979-09-12,England,Denmark,1,0,1,1.0,0.0,1879,1621
1979-09-12,Germany,Argentina,2,1,1,1.0,0.0,1932,1872
1979-09-12,Greece,Russia,1,0,1,1.0,0.0,1627,1831
1979-09-12,Hungary,Czechoslovakia,2,1,1,1.0,0.0,1807,1779
1979-09-12,Iceland,German DR,0,3,3,0.0,1.0,1466,1802
1979-09-12,South Korea,Sri Lanka,6,0,6,1.0,0.0,1861,1378
1979-09-12,Norway,Belgium,1,2,1,0.0,1.0,1503,1735
1979-09-12,Scotland,Peru,1,1,0,0.5,0.5,1770,1700
1979-09-12,Switzerland,Poland,0,2,2,0.0,1.0,1601,1814
1979-09-13,Paraguay,Ecuador,2,0,2,1.0,0.0,1674,1501
1979-09-14,South Korea,Bahrain,5,1,4,1.0,0.0,1863,1456
1979-09-16,South Korea,Bangladesh,9,0,9,1.0,0.0,1865,1452
1979-09-16,Sri Lanka,Sudan,0,1,1,0.0,1.0,1375,1618
1979-09-16,Uruguay,Ecuador,2,1,1,1.0,0.0,1676,1497
1979-09-16,Yugoslavia,Argentina,4,2,2,1.0,0.0,1765,1862
1979-09-20,Paraguay,Uruguay,0,0,0,0.5,0.5,1675,1676
1979-09-22,Indonesia,Singapore,3,0,3,1.0,0.0,1548,1451
1979-09-22,Thailand,Myanmar,1,0,1,1.0,0.0,1564,1649
1979-09-23,Singapore,Malaysia,0,2,2,0.0,1.0,1448,1695
1979-09-23,Indonesia,Thailand,1,3,2,0.0,1.0,1541,1572
1979-09-25,Malaysia,Myanmar,0,0,0,0.5,0.5,1694,1651
1979-09-25,Singapore,Thailand,2,2,0,0.5,0.5,1451,1570
1979-09-26,Austria,Hungary,3,1,2,1.0,0.0,1799,1799
1979-09-26,Czechoslovakia,Republic of Ireland,4,1,3,1.0,0.0,1784,1630
1979-09-26,Denmark,Finland,1,0,1,1.0,0.0,1627,1499
1979-09-26,Italy,Sweden,1,0,1,1.0,0.0,1870,1710
1979-09-26,Netherlands,Belgium,1,0,1,1.0,0.0,1859,1730
1979-09-26,Poland,German DR,1,1,0,0.5,0.5,1814,1803
1979-09-26,Spain,Portugal,1,1,0,0.5,0.5,1818,1768
1979-09-26,Uruguay,Paraguay,2,2,0,0.5,0.5,1676,1676
1979-09-26,Myanmar,Singapore,1,2,1,0.0,1.0,1639,1464
1979-09-26,Indonesia,Malaysia,0,0,0,0.5,0.5,1545,1691
1979-09-28,Malaysia,Thailand,1,0,1,1.0,0.0,1697,1565
1979-09-28,Indonesia,Myanmar,2,1,1,1.0,0.0,1556,1629
1979-09-29,Haiti,Antigua and Barbuda,1,0,1,1.0,0.0,1634,1463
1979-09-29,Senegal,Nigeria,0,2,2,0.0,1.0,1590,1695
1979-09-29,Sierra Leone,Gambia,2,0,2,1.0,0.0,1483,1467
1979-09-29,Indonesia,Thailand,0,0,0,0.5,0.5,1557,1565
1979-09-30,Indonesia,Malaysia,0,1,1,0.0,1.0,1553,1702
1979-10-03,Bahrain,New Zealand,0,2,2,0.0,1.0,1452,1623
1979-10-07,Bermuda,United States,1,3,2,0.0,1.0,1450,1498
1979-10-08,Bahrain,New Zealand,1,2,1,0.0,1.0,1448,1628
1979-10-10,Czechoslovakia,Sweden,4,1,3,1.0,0.0,1791,1704
1979-10-10,France,United States,3,0,3,1.0,0.0,1798,1496
1979-10-10,Peru,Paraguay,2,3,1,0.0,1.0,1692,1685
1979-10-10,Poland,Iceland,2,0,2,1.0,0.0,1816,1465
1979-10-10,Spain,Yugoslavia,0,1,1,0.0,1.0,1809,1775
1979-10-13,German DR,Switzerland,5,2,3,1.0,0.0,1807,1598
1979-10-14,Benin,Nigeria,1,1,0,0.5,0.5,1492,1691
1979-10-14,Russia,Romania,3,1,2,1.0,0.0,1837,1714
1979-10-15,Antigua and Barbuda,Haiti,1,2,1,0.0,1.0,1459,1639
1979-10-17,Belgium,Portugal,2,0,2,1.0,0.0,1739,1760
1979-10-17,Germany,Wales,5,1,4,1.0,0.0,1936,1698
1979-10-17,Hungary,Finland,3,1,2,1.0,0.0,1802,1497
1979-10-17,Republic of Ireland,Bulgaria,3,0,3,1.0,0.0,1640,1680
1979-10-17,Netherlands,Poland,1,1,0,0.5,0.5,1859,1817
1979-10-17,Northern Ireland,England,1,5,4,0.0,1.0,1638,1883
1979-10-17,Peru,Chile,1,2,1,0.0,1.0,1683,1653
1979-10-17,Scotland,Austria,1,1,0,0.5,0.5,1771,1799
1979-10-21,Benin,Burkina Faso,3,2,1,1.0,0.0,1500,1468
1979-10-21,Ivory Coast,Togo,3,0,3,1.0,0.0,1594,1530
1979-10-21,United Arab Emirates,India,0,0,0,0.5,0.5,1426,1514
1979-10-22,Guadeloupe,Saint Vincent and the Grenadines,1,3,2,0.0,1.0,1515,1587
1979-10-22,Saint Vincent and the Grenadines,Guadeloupe,0,0,0,0.5,0.5,1586,1517
1979-10-23,Luxembourg,Sweden,1,1,0,0.5,0.5,1365,1698
1979-10-23,Togo,Burkina Faso,5,3,2,1.0,0.0,1537,1462
1979-10-24,Chile,Peru,0,0,0,0.5,0.5,1654,1683
1979-10-24,Paraguay,Brazil,2,1,1,1.0,0.0,1699,1974
1979-10-25,Liberia,Nigeria,2,2,0,0.5,0.5,1499,1687
1979-10-26,Hungary,United States,0,2,2,0.0,1.0,1789,1510
1979-10-26,Ivory Coast,Benin,3,1,2,1.0,0.0,1600,1495
1979-10-26,Niger,Togo,2,2,0,0.5,0.5,1432,1535
1979-10-27,Sierra Leone,Nigeria,0,0,0,0.5,0.5,1488,1683
1979-10-28,Benin,Niger,0,1,1,0.0,1.0,1486,1442
1979-10-28,Haiti,Jamaica,3,0,3,1.0,0.0,1644,1479
1979-10-28,Ivory Coast,Togo,0,1,1,0.0,1.0,1591,1545
1979-10-28,Malta,Turkey,1,2,1,0.0,1.0,1447,1605
1979-10-29,Republic of Ireland,United States,3,2,1,1.0,0.0,1646,1505
1979-10-31,Brazil,Paraguay,2,2,0,0.5,0.5,1969,1705
1979-10-31,Bulgaria,Denmark,3,0,3,1.0,0.0,1687,1621
1979-10-31,Russia,Finland,2,2,0,0.5,0.5,1831,1504
1979-10-31,Yugoslavia,Romania,2,1,1,1.0,0.0,1782,1708
1979-11-01,Mexico,Peru,1,0,1,1.0,0.0,1754,1677
1979-11-01,Portugal,Norway,3,1,2,1.0,0.0,1763,1501
1979-11-02,Jamaica,Haiti,0,4,4,0.0,1.0,1475,1649
1979-11-03,Kenya,Tanzania,0,0,0,0.5,0.5,1551,1537
1979-11-03,Sierra Leone,Senegal,1,0,1,1.0,0.0,1499,1580
1979-11-04,Malawi,Zanzibar,4,0,4,1.0,0.0,1611,1327
1979-11-04,Nigeria,Benin,5,0,5,1.0,0.0,1687,1483
1979-11-04,Uganda,Zambia,1,2,1,0.0,1.0,1629,1697
1979-11-06,Tanzania,Zambia,2,2,0,0.5,0.5,1541,1694
1979-11-07,Kenya,Uganda,3,1,2,1.0,0.0,1561,1620
1979-11-07,Malawi,Sudan,4,0,4,1.0,0.0,1620,1610
1979-11-09,Sudan,Zanzibar,1,1,0,0.5,0.5,1605,1333
1979-11-09,Tanzania,Uganda,5,3,2,1.0,0.0,1551,1611
1979-11-10,Kenya,Zambia,3,1,2,1.0,0.0,1572,1684
1979-11-11,Haiti,Trinidad and Tobago,1,0,1,1.0,0.0,1657,1604
1979-11-12,Suriname,Saint Vincent and the Grenadines,2,3,1,0.0,1.0,1644,1596
1979-11-13,Malawi,Tanzania,1,1,0,0.5,0.5,1619,1553
1979-11-14,Haiti,Saint Vincent and the Grenadines,3,1,2,1.0,0.0,1664,1590
1979-11-14,Kenya,Zanzibar,2,0,2,1.0,0.0,1576,1330
1979-11-14,Malawi,Tanzania,4,0,4,1.0,0.0,1626,1547
1979-11-14,Malaysia,Sweden,1,3,2,0.0,1.0,1694,1707
1979-11-14,Spain,Denmark,1,3,2,0.0,1.0,1798,1633
1979-11-14,Yugoslavia,Cyprus,5,0,5,1.0,0.0,1784,1392
1979-11-15,Suriname,Trinidad and Tobago,3,0,3,1.0,0.0,1652,1597
1979-11-16,Tanzania,Zanzibar,2,1,1,1.0,0.0,1551,1327
1979-11-17,France,Czechoslovakia,2,1,1,1.0,0.0,1806,1784
1979-11-17,Italy,Switzerland,2,0,2,1.0,0.0,1873,1596
1979-11-17,Kenya,Malawi,2,3,1,0.0,1.0,1570,1633
1979-11-17,Singapore,Sweden,0,5,5,0.0,1.0,1461,1711
1979-11-18,Romania,Cyprus,2,0,2,1.0,0.0,1711,1390
1979-11-18,Suriname,Haiti,0,1,1,0.0,1.0,1645,1672
1979-11-21,Belgium,Scotland,2,0,2,1.0,0.0,1748,1763
1979-11-21,German DR,Netherlands,2,3,1,0.0,1.0,1801,1866
1979-11-21,Malaysia,Taiwan,0,3,3,0.0,1.0,1683,1524
1979-11-21,Northern Ireland,Republic of Ireland,1,0,1,1.0,0.0,1647,1638
1979-11-21,Portugal,Austria,1,2,1,0.0,1.0,1756,1807
1979-11-21,Russia,Germany,1,3,2,0.0,1.0,1826,1942
1979-11-21,Turkey,Wales,1,0,1,1.0,0.0,1616,1688
1979-11-22,England,Bulgaria,2,0,2,1.0,0.0,1887,1684
1979-11-22,Thailand,Sri Lanka,5,1,4,1.0,0.0,1570,1371
1979-11-24,Czechoslovakia,Luxembourg,4,0,4,1.0,0.0,1786,1364
1979-11-24,Thailand,Indonesia,3,0,3,1.0,0.0,1578,1546
1979-11-25,Angola,Gabon,1,0,1,1.0,0.0,1512,1475
1979-11-26,Bermuda,Finland,0,2,2,0.0,1.0,1444,1511
1979-11-26,Indonesia,Sri Lanka,0,0,0,0.5,0.5,1543,1375
1979-11-27,Angola,Cameroon,0,1,1,0.0,1.0,1506,1582
1979-11-28,Cameroon,Congo,1,3,2,0.0,1.0,1574,1572
1979-11-28,Paraguay,Chile,3,0,3,1.0,0.0,1712,1648
1979-11-29,Angola,Congo,0,1,1,0.0,1.0,1500,1579
1979-11-29,Cameroon,Gabon,3,1,2,1.0,0.0,1580,1470
1979-12-04,El Salvador,Mexico,0,2,2,0.0,1.0,1564,1759
1979-12-05,Chile,Paraguay,1,0,1,1.0,0.0,1658,1703
1979-12-09,Cyprus,Spain,1,3,2,0.0,1.0,1389,1800
1979-12-11,Chile,Paraguay,0,0,0,0.5,0.5,1660,1702
1979-12-18,Mexico,El Salvador,1,1,0,0.5,0.5,1755,1569
1979-12-19,Scotland,Belgium,1,3,2,0.0,1.0,1755,1757
1979-12-22,Germany,Turkey,2,0,2,1.0,0.0,1945,1614
1979-12-23,Basque Country,Bulgaria,4,0,4,1.0,0.0,1610,1675
1979-12-26,Tunisia,Senegal,3,1,2,1.0,0.0,1660,1574
1980-01-06,Sierra Leone,Ghana,2,4,2,0.0,1.0,1495,1688
1980-01-16,Cyprus,Greece,1,1,0,0.5,0.5,1394,1623
1980-01-19,Congo,Ivory Coast,2,0,2,1.0,0.0,1588,1583
1980-01-20,Congo,Ivory Coast,0,2,2,0.0,1.0,1580,1592
1980-01-23,Spain,Netherlands,1,0,1,1.0,0.0,1810,1857
1980-01-26,Nigeria,Liberia,1,0,1,1.0,0.0,1692,1495
1980-01-27,Australia,Czechoslovakia,0,4,4,0.0,1.0,1656,1792
1980-01-27,Cameroon,Ivory Coast,1,1,0,0.5,0.5,1581,1592
1980-01-27,Ghana,Tunisia,4,1,3,1.0,0.0,1696,1653
1980-01-30,Ivory Coast,Tunisia,1,1,0,0.5,0.5,1594,1652
1980-01-30,Saudi Arabia,South Korea,1,3,2,0.0,1.0,1516,1867
1980-02-01,Congo,Gabon,3,0,3,1.0,0.0,1586,1465
1980-02-01,Saudi Arabia,South Korea,0,0,0,0.5,0.5,1523,1861
1980-02-02,Nigeria,Cameroon,0,0,0,0.5,0.5,1690,1584
1980-02-03,Australia,Czechoslovakia,0,5,5,0.0,1.0,1651,1798
1980-02-06,England,Republic of Ireland,2,0,2,1.0,0.0,1891,1635
1980-02-09,Australia,Czechoslovakia,2,2,0,0.5,0.5,1655,1795
1980-02-09,Gambia,Guinea-Bissau,2,0,2,1.0,0.0,1477,1503
1980-02-10,Mali,Senegal,1,0,1,1.0,0.0,1610,1567
1980-02-11,Guinea-Bissau,Guinea,1,2,1,0.0,1.0,1498,1638
1980-02-12,Ivory Coast,Morocco,4,4,0,0.5,0.5,1596,1664
1980-02-12,Mali,Mauritania,0,1,1,0.0,1.0,1599,1439
1980-02-13,Gambia,Guinea,0,0,0,0.5,0.5,1481,1635
1980-02-13,Spain,German DR,0,1,1,0.0,1.0,1802,1810
1980-02-14,Mauritania,Senegal,1,2,1,0.0,1.0,1434,1573
1980-02-16,Gambia,Mauritania,2,2,0,0.5,0.5,1480,1436
1980-02-16,Guinea,Senegal,1,2,1,0.0,1.0,1626,1583
1980-02-16,Italy,Romania,2,1,1,1.0,0.0,1878,1707
1980-02-17,Guinea-Bissau,Mali,2,4,2,0.0,1.0,1493,1605
1980-02-17,Morocco,Poland,1,0,1,1.0,0.0,1676,1806
1980-02-18,Gambia,Senegal,0,1,1,0.0,1.0,1475,1589
1980-02-19,Fiji,New Zealand,1,1,0,0.5,0.5,1465,1625
1980-02-21,Fiji,New Zealand,0,2,2,0.0,1.0,1461,1630
1980-02-24,New Caledonia,Australia,0,8,8,0.0,1.0,1593,1662
1980-02-24,Vanuatu,Papua New Guinea,3,4,1,0.0,1.0,1461,1474
1980-02-25,Fiji,Solomon Islands,3,1,2,1.0,0.0,1470,1493
1980-02-25,Morocco,Senegal,3,2,1,1.0,0.0,1683,1583
1980-02-25,New Zealand,Tahiti,1,3,2,0.0,1.0,1622,1625
1980-02-26,Australia,Papua New Guinea,11,2,9,1.0,0.0,1667,1470
1980-02-26,Mexico,South Korea,0,1,1,0.0,1.0,1750,1867
1980-02-26,New Caledonia,Vanuatu,4,3,1,1.0,0.0,1599,1456
1980-02-27,Belgium,Luxembourg,5,0,5,1.0,0.0,1759,1363
1980-02-27,Fiji,New Zealand,4,0,4,1.0,0.0,1482,1611
1980-02-27,France,Greece,5,1,4,1.0,0.0,1811,1619
1980-02-27,Germany,Malta,8,0,8,1.0,0.0,1946,1447
1980-02-27,Iraq,Poland,1,1,0,0.5,0.5,1755,1805
1980-02-27,Morocco,Tunisia,0,0,0,0.5,0.5,1683,1653
1980-02-27,Solomon Islands,Tahiti,1,12,11,0.0,1.0,1488,1631
1980-02-28,Australia,Vanuatu,1,0,1,1.0,0.0,1671,1453
1980-02-28,New Caledonia,Papua New Guinea,8,0,8,1.0,0.0,1605,1465
1980-02-29,Fiji,Tahiti,3,6,3,0.0,1.0,1478,1636
1980-02-29,Iraq,Poland,1,0,1,1.0,0.0,1765,1796
1980-02-29,New Zealand,Solomon Islands,6,1,5,1.0,0.0,1617,1483
1980-03-01,Australia,Tahiti,4,2,2,1.0,0.0,1679,1629
1980-03-01,New Caledonia,Fiji,2,1,1,1.0,0.0,1611,1473
1980-03-04,Sierra Leone,Guinea,3,2,1,1.0,0.0,1506,1616
1980-03-06,Honduras,Costa Rica,1,1,0,0.5,0.5,1570,1677
1980-03-08,Egypt,Ivory Coast,2,1,1,1.0,0.0,1705,1591
1980-03-08,Kuwait,Bulgaria,1,1,0,0.5,0.5,1697,1676
1980-03-08,Nigeria,Tanzania,3,1,2,1.0,0.0,1695,1547
1980-03-09,Algeria,Ghana,0,0,0,0.5,0.5,1636,1695
1980-03-09,Guinea,Morocco,1,1,0,0.5,0.5,1618,1682
1980-03-12,Egypt,Tanzania,2,1,1,1.0,0.0,1710,1543
1980-03-12,Malaysia,Saudi Arabia,3,0,3,1.0,0.0,1688,1519
1980-03-12,Nigeria,Ivory Coast,0,0,0,0.5,0.5,1693,1594
1980-03-13,Algeria,Morocco,1,0,1,1.0,0.0,1646,1673
1980-03-13,Ghana,Guinea,1,0,1,1.0,0.0,1702,1612
1980-03-15,Italy,Uruguay,1,0,1,1.0,0.0,1882,1673
1980-03-15,Ivory Coast,Tanzania,1,1,0,0.5,0.5,1593,1545
1980-03-15,Nigeria,Egypt,1,0,1,1.0,0.0,1702,1702
1980-03-16,Algeria,Guinea,3,2,1,1.0,0.0,1654,1605
1980-03-16,Ghana,Morocco,0,1,1,0.0,1.0,1694,1682
1980-03-16,Malaysia,China PR,3,1,2,1.0,0.0,1697,1699
1980-03-18,Belgium,Uruguay,2,0,2,1.0,0.0,1766,1667
1980-03-18,Honduras,Mexico,0,1,1,0.0,1.0,1566,1755
1980-03-19,Algeria,Egypt,2,2,0,0.5,0.5,1656,1701
1980-03-19,Nigeria,Morocco,1,0,1,1.0,0.0,1710,1675
1980-03-20,Tahiti,Vanuatu,1,0,1,1.0,0.0,1634,1449
1980-03-21,Egypt,Morocco,0,2,2,0.0,1.0,1693,1684
1980-03-22,Nigeria,Algeria,3,0,3,1.0,0.0,1717,1650
1980-03-22,Yugoslavia,Uruguay,2,1,1,1.0,0.0,1790,1662
1980-03-26,Bulgaria,Russia,1,3,2,0.0,1.0,1672,1831
1980-03-26,Cyprus,Republic of Ireland,2,3,1,0.0,1.0,1391,1639
1980-03-26,France,Netherlands,0,0,0,0.5,0.5,1813,1856
1980-03-26,Hungary,Poland,2,1,1,1.0,0.0,1798,1788
1980-03-26,Israel,Northern Ireland,0,0,0,0.5,0.5,1686,1648
1980-03-26,Luxembourg,Uruguay,0,1,1,0.0,1.0,1361,1665
1980-03-26,Scotland,Portugal,4,1,3,1.0,0.0,1764,1748
1980-03-26,Spain,England,0,2,2,0.0,1.0,1797,1897
1980-03-26,Switzerland,Czechoslovakia,2,0,2,1.0,0.0,1609,1783
1980-03-29,Alderney,Guernsey,0,5,5,0.0,1.0,1307,1651
1980-03-30,Guyana,Grenada,5,2,3,1.0,0.0,1452,1558
1980-03-30,Yugoslavia,Romania,2,0,2,1.0,0.0,1797,1701
1980-04-01,Switzerland,Greece,2,0,2,1.0,0.0,1618,1611
1980-04-02,Belgium,Poland,2,1,1,1.0,0.0,1775,1780
1980-04-02,Germany,Austria,1,0,1,1.0,0.0,1951,1803
1980-04-02,Romania,German DR,2,2,0,0.5,0.5,1704,1808
1980-04-05,Senegal,Tunisia,0,2,2,0.0,1.0,1577,1660
1980-04-06,Ivory Coast,Gabon,4,1,3,1.0,0.0,1599,1460
1980-04-08,Mexico,Honduras,5,0,5,1.0,0.0,1760,1562
1980-04-13,Grenada,Guyana,2,3,1,0.0,1.0,1548,1463
1980-04-15,Guatemala,Mexico,2,4,2,0.0,1.0,1614,1765
1980-04-16,Costa Rica,Honduras,1,1,0,0.5,0.5,1675,1565
1980-04-16,German DR,Greece,2,0,2,1.0,0.0,1812,1608
1980-04-16,Spain,Czechoslovakia,2,2,0,0.5,0.5,1797,1784
1980-04-19,Italy,Poland,2,2,0,0.5,0.5,1880,1783
1980-04-20,Tanzania,Zambia,0,2,2,0.0,1.0,1541,1689
1980-04-20,Zimbabwe,Mozambique,6,0,6,1.0,0.0,1509,1498
1980-04-21,Mozambique,Tanzania,0,2,2,0.0,1.0,1491,1549
1980-04-21,Zimbabwe,Zambia,2,1,1,1.0,0.0,1521,1678
1980-04-26,Yugoslavia,Poland,2,1,1,1.0,0.0,1805,1776
1980-04-27,Malta,Libya,0,3,3,0.0,1.0,1442,1579
1980-04-29,Mexico,Guatemala,2,2,0,0.5,0.5,1762,1618
1980-04-29,Sweden,Russia,1,5,4,0.0,1.0,1706,1837
1980-04-30,Czechoslovakia,Hungary,1,0,1,1.0,0.0,1793,1790
1980-04-30,Republic of Ireland,Switzerland,2,0,2,1.0,0.0,1647,1611
1980-05-01,Senegal,Guinea,1,0,1,1.0,0.0,1586,1597
1980-05-01,Thailand,Luxembourg,0,1,1,0.0,1.0,1566,1374
1980-05-04,Zambia,Malawi,1,1,0,0.5,0.5,1677,1635
1980-05-07,Sweden,Denmark,0,1,1,0.0,1.0,1697,1643
1980-05-08,Libya,Gambia,2,1,1,1.0,0.0,1585,1470
1980-05-09,South Korea,Luxembourg,2,3,1,0.0,1.0,1852,1390
1980-05-09,Martinique,Guadeloupe,1,0,1,1.0,0.0,1612,1512
1980-05-09,Panama,El Salvador,0,0,0,0.5,0.5,1450,1567
1980-05-09,Jersey,Guernsey,1,2,1,0.0,1.0,1673,1660
1980-05-11,Japan,Luxembourg,1,0,1,1.0,0.0,1625,1387
1980-05-13,Myanmar,Luxembourg,2,0,2,1.0,0.0,1633,1384
1980-05-13,England,Argentina,3,1,2,1.0,0.0,1905,1855
1980-05-13,Germany,Poland,3,1,2,1.0,0.0,1956,1772
1980-05-13,Haiti,El Salvador,2,0,2,1.0,0.0,1678,1562
1980-05-14,Greece,Bulgaria,0,0,0,0.5,0.5,1610,1671
1980-05-14,South Korea,Luxembourg,3,0,3,1.0,0.0,1854,1383
1980-05-16,Republic of Ireland,Argentina,0,1,1,0.0,1.0,1644,1859
1980-05-16,Northern Ireland,Scotland,1,0,1,1.0,0.0,1659,1754
1980-05-17,Wales,England,4,1,3,1.0,0.0,1701,1893
1980-05-18,Ethiopia,Zambia,0,0,0,0.5,0.5,1533,1674
1980-05-20,England,Northern Ireland,1,1,0,0.5,0.5,1889,1664
1980-05-20,Guatemala,Costa Rica,0,0,0,0.5,0.5,1620,1674
1980-05-21,Austria,Argentina,1,5,4,0.0,1.0,1797,1866
1980-05-21,Denmark,Spain,2,2,0,0.5,0.5,1647,1794
1980-05-21,Scotland,Wales,1,0,1,1.0,0.0,1761,1695
1980-05-22,Finland,Sweden,0,2,2,0.0,1.0,1507,1702
1980-05-22,Norway,Bulgaria,1,0,1,1.0,0.0,1513,1660
1980-05-23,Russia,France,1,0,1,1.0,0.0,1845,1806
1980-05-23,Wales,Northern Ireland,0,1,1,0.0,1.0,1687,1673
1980-05-24,Scotland,England,0,2,2,0.0,1.0,1756,1895
1980-05-28,Poland,Scotland,1,0,1,1.0,0.0,1780,1749
1980-05-29,Costa Rica,Guatemala,2,1,1,1.0,0.0,1681,1614
1980-05-31,Australia,England,1,2,1,0.0,1.0,1676,1899
1980-05-31,Hungary,Scotland,3,1,2,1.0,0.0,1798,1742
1980-05-31,Sierra Leone,Algeria,2,2,0,0.5,0.5,1510,1647
1980-06-01,Macau,Hong Kong,0,2,2,0.0,1.0,1475,1569
1980-06-01,Zambia,Ethiopia,4,0,4,1.0,0.0,1679,1529
1980-06-02,Iceland,Wales,0,4,4,0.0,1.0,1462,1691
1980-06-04,Denmark,Norway,3,1,2,1.0,0.0,1653,1508
1980-06-04,El Salvador,Haiti,3,0,3,1.0,0.0,1573,1668
1980-06-04,Finland,Bulgaria,0,2,2,0.0,1.0,1503,1665
1980-06-04,Hungary,Austria,1,1,0,0.5,0.5,1798,1798
1980-06-06,Belgium,Romania,2,1,1,1.0,0.0,1782,1698
1980-06-06,Honduras,Haiti,3,1,2,1.0,0.0,1576,1658
1980-06-07,Zambia,Zimbabwe,2,1,1,1.0,0.0,1684,1517
1980-06-08,Brazil,Mexico,2,0,2,1.0,0.0,1973,1759
1980-06-08,Tunisia,Morocco,0,1,1,0.0,1.0,1653,1692
1980-06-08,Zambia,Zimbabwe,1,3,2,0.0,1.0,1673,1529
1980-06-09,Hong Kong,Japan,1,3,2,0.0,1.0,1563,1632
1980-06-10,Honduras,Haiti,1,0,1,1.0,0.0,1586,1649
1980-06-11,China PR,Japan,1,0,1,1.0,0.0,1706,1626
1980-06-11,Czechoslovakia,Germany,0,1,1,0.0,1.0,1789,1961
1980-06-11,Netherlands,Greece,1,0,1,1.0,0.0,1860,1607
1980-06-12,Belgium,England,1,1,0,0.5,0.5,1785,1897
1980-06-12,Guatemala,Haiti,1,2,1,0.0,1.0,1607,1657
1980-06-12,Italy,Spain,0,0,0,0.5,0.5,1879,1796
1980-06-13,Algeria,Sierra Leone,3,1,2,1.0,0.0,1652,1506
1980-06-13,China PR,Hong Kong,7,0,7,1.0,0.0,1711,1559
1980-06-13,Honduras,Panama,0,0,0,0.5,0.5,1584,1453
1980-06-13,Togo,Nigeria,0,1,1,0.0,1.0,1541,1722
1980-06-14,Germany,Netherlands,3,2,1,1.0,0.0,1967,1855
1980-06-14,Greece,Czechoslovakia,1,3,2,0.0,1.0,1603,1794
1980-06-15,Australia,Northern Ireland,1,1,0,0.5,0.5,1676,1674
1980-06-15,Belgium,Spain,2,1,1,1.0,0.0,1794,1788
1980-06-15,Brazil,Russia,1,2,1,0.0,1.0,1963,1856
1980-06-15,Honduras,Panama,2,0,2,1.0,0.0,1590,1448
1980-06-15,Italy,England,1,0,1,1.0,0.0,1888,1889
1980-06-15,Malawi,Zambia,2,0,2,1.0,0.0,1644,1665
1980-06-17,Greece,Germany,0,0,0,0.5,0.5,1610,1961
1980-06-17,Netherlands,Czechoslovakia,1,1,0,0.5,0.5,1854,1796
1980-06-18,Australia,Northern Ireland,1,2,1,0.0,1.0,1668,1683
1980-06-18,Hong Kong,Japan,0,2,2,0.0,1.0,1553,1633
1980-06-18,Italy,Belgium,0,0,0,0.5,0.5,1886,1797
1980-06-18,Spain,England,1,2,1,0.0,1.0,1783,1895
1980-06-18,Sweden,Israel,1,1,0,0.5,0.5,1702,1687
1980-06-19,Madagascar,Tanzania,2,1,1,1.0,0.0,1562,1542
1980-06-21,Italy,Czechoslovakia,1,1,0,0.5,0.5,1884,1799
1980-06-22,Belgium,Germany,1,2,1,0.0,1.0,1793,1966
1980-06-22,Guinea,Lesotho,3,1,2,1.0,0.0,1602,1447
1980-06-22,Madagascar,Tanzania,1,1,0,0.5,0.5,1562,1543
1980-06-22,Poland,Iraq,3,0,3,1.0,0.0,1788,1758
1980-06-22,Senegal,Morocco,0,1,1,0.0,1.0,1581,1698
1980-06-24,Brazil,Chile,2,1,1,1.0,0.0,1966,1658
1980-06-24,Congo,Guinea,1,1,0,0.5,0.5,1587,1602
1980-06-24,Costa Rica,Cuba,3,0,3,1.0,0.0,1686,1494
1980-06-25,DR Congo,Congo,1,2,1,0.0,1.0,1641,1597
1980-06-25,Iceland,Finland,1,1,0,0.5,0.5,1463,1503
1980-06-27,DR Congo,Gabon,1,1,0,0.5,0.5,1638,1464
1980-06-29,Brazil,Poland,1,1,0,0.5,0.5,1963,1792
1980-06-29,Cameroon,Malawi,3,0,3,1.0,0.0,1594,1635
1980-06-29,Tunisia,Nigeria,2,0,2,1.0,0.0,1663,1713
1980-06-29,Zambia,Kenya,5,0,5,1.0,0.0,1671,1565
1980-06-30,Iceland,Faroe Islands,2,1,1,1.0,0.0,1471,1451
1980-07-02,Bolivia,Poland,0,1,1,0.0,1.0,1567,1796
1980-07-02,Faroe Islands,Greenland,6,0,6,1.0,0.0,1461,1491
1980-07-02,Mauritania,Senegal,1,3,2,0.0,1.0,1432,1586
1980-07-02,Panama,Guatemala,0,2,2,0.0,1.0,1444,1612
1980-07-03,Iceland,Greenland,4,1,3,1.0,0.0,1480,1483
1980-07-05,Kenya,Tanzania,3,1,2,1.0,0.0,1573,1536
1980-07-06,Gambia,Libya,0,0,0,0.5,0.5,1473,1583
1980-07-06,Lesotho,Guinea,1,1,0,0.5,0.5,1451,1599
1980-07-06,Malawi,Zimbabwe,0,1,1,0.0,1.0,1625,1540
1980-07-06,Morocco,Senegal,0,0,0,0.5,0.5,1696,1589
1980-07-08,Malawi,Zimbabwe,1,1,0,0.5,0.5,1624,1542
1980-07-09,Colombia,Poland,1,4,3,0.0,1.0,1529,1799
1980-07-10,Fiji,Tahiti,1,1,0,0.5,0.5,1477,1631
1980-07-12,Nigeria,Tunisia,2,0,2,1.0,0.0,1720,1657
1980-07-12,Russia,Denmark,2,0,2,1.0,0.0,1860,1650
1980-07-13,DR Congo,Mozambique,5,2,3,1.0,0.0,1643,1487
1980-07-14,Norway,Iceland,3,1,2,1.0,0.0,1516,1473
1980-07-16,Guatemala,Honduras,1,1,0,0.5,0.5,1612,1591
1980-07-16,Niger,Somalia,0,0,0,0.5,0.5,1442,1431
1980-07-17,Sweden,Iceland,1,1,0,0.5,0.5,1698,1478
1980-07-18,Uruguay,Peru,0,0,0,0.5,0.5,1666,1677
1980-07-19,Tanzania,Kenya,5,0,5,1.0,0.0,1545,1565
1980-07-20,Malawi,Cameroon,1,1,0,0.5,0.5,1624,1595
1980-07-27,Mozambique,DR Congo,1,2,1,0.0,1.0,1483,1648
1980-07-27,Somalia,Niger,1,1,0,0.5,0.5,1432,1442
1980-07-30,Panama,Honduras,0,2,2,0.0,1.0,1440,1596
1980-08-01,Haiti,Trinidad and Tobago,2,0,2,1.0,0.0,1664,1591
1980-08-03,Basque Country,Hungary,1,5,4,0.0,1.0,1606,1803
1980-08-05,United Arab Emirates,Iran,0,2,2,0.0,1.0,1424,1713
1980-08-07,United Arab Emirates,Iran,0,3,3,0.0,1.0,1422,1716
1980-08-10,Mozambique,Lesotho,6,1,5,1.0,0.0,1491,1444
1980-08-10,Panama,Costa Rica,1,1,0,0.5,0.5,1445,1682
1980-08-17,Cuba,Suriname,3,0,3,1.0,0.0,1506,1634
1980-08-17,Guatemala,El Salvador,1,1,0,0.5,0.5,1612,1574
1980-08-17,Trinidad and Tobago,Haiti,1,0,1,1.0,0.0,1601,1655
1980-08-20,Hungary,Sweden,2,0,2,1.0,0.0,1809,1693
1980-08-20,New Zealand,Mexico,4,0,4,1.0,0.0,1629,1748
1980-08-21,Norway,Finland,6,1,5,1.0,0.0,1524,1496
1980-08-21,Uruguay,Chile,0,0,0,0.5,0.5,1666,1659
1980-08-23,Indonesia,Thailand,2,1,1,1.0,0.0,1552,1558
1980-08-23,South Korea,Malaysia,2,0,2,1.0,0.0,1859,1693
1980-08-24,Australia,Mexico,2,2,0,0.5,0.5,1670,1747
1980-08-24,Lesotho,Mozambique,2,1,1,1.0,0.0,1454,1482
1980-08-24,Panama,El Salvador,1,3,2,0.0,1.0,1440,1580
1980-08-25,Bahrain,Malaysia,1,1,0,0.5,0.5,1453,1689
1980-08-25,South Korea,Indonesia,3,0,3,1.0,0.0,1862,1550
1980-08-26,Australia,Mexico,1,1,0,0.5,0.5,1672,1746
1980-08-26,Bolivia,Paraguay,1,1,0,0.5,0.5,1570,1700
1980-08-27,Bahrain,Indonesia,2,3,1,0.0,1.0,1448,1556
1980-08-27,Brazil,Uruguay,1,0,1,1.0,0.0,1966,1664
1980-08-27,Hungary,Russia,1,4,3,0.0,1.0,1803,1867
1980-08-27,South Korea,Thailand,4,0,4,1.0,0.0,1865,1556
1980-08-27,Romania,Yugoslavia,4,1,3,1.0,0.0,1709,1795
1980-08-27,Switzerland,Denmark,1,1,0,0.5,0.5,1612,1650
1980-08-28,Bolivia,Paraguay,1,3,2,0.0,1.0,1565,1706
1980-08-29,South Korea,Bahrain,5,0,5,1.0,0.0,1867,1447
1980-08-29,Malaysia,Thailand,1,4,3,0.0,1.0,1679,1567
1980-08-30,Fiji,Mexico,0,2,2,0.0,1.0,1475,1749
1980-08-30,Zimbabwe,Zambia,1,1,0,0.5,0.5,1545,1669
1980-08-31,Bahrain,Thailand,0,1,1,0.0,1.0,1442,1573
1980-08-31,Indonesia,Malaysia,1,1,0,0.5,0.5,1559,1677
1980-08-31,Zimbabwe,Zambia,1,2,1,0.0,1.0,1540,1675
1980-09-02,South Korea,Indonesia,2,0,2,1.0,0.0,1870,1557
1980-09-02,Tahiti,Mexico,0,1,1,0.0,1.0,1626,1755
1980-09-03,Albania,Finland,2,0,2,1.0,0.0,1504,1488
1980-09-03,Iceland,Russia,1,2,1,0.0,1.0,1477,1869
1980-09-07,Suriname,Cuba,0,0,0,0.5,0.5,1632,1509
1980-09-09,Singapore,South Korea,0,2,2,0.0,1.0,1460,1872
1980-09-10,Bulgaria,Romania,1,2,1,0.0,1.0,1659,1716
1980-09-10,England,Norway,4,0,4,1.0,0.0,1897,1523
1980-09-10,Republic of Ireland,Netherlands,2,1,1,1.0,0.0,1657,1842
1980-09-10,Luxembourg,Yugoslavia,0,5,5,0.0,1.0,1382,1797
1980-09-10,Sweden,Scotland,0,1,1,0.0,1.0,1687,1749
1980-09-10,Switzerland,Germany,2,3,1,0.0,1.0,1611,1968
1980-09-12,Haiti,Curaçao,1,0,1,1.0,0.0,1661,1527
1980-09-14,Madagascar,Mauritius,0,0,0,0.5,0.5,1562,1534
1980-09-15,Canada,New Zealand,4,0,4,1.0,0.0,1530,1619
1980-09-15,Kuwait,United Arab Emirates,1,1,0,0.5,0.5,1692,1428
1980-09-16,North Korea,Bangladesh,3,2,1,1.0,0.0,1699,1449
1980-09-16,Malaysia,South Korea,1,1,0,0.5,0.5,1682,1868
1980-09-17,Canada,New Zealand,3,0,3,1.0,0.0,1541,1609
1980-09-17,Iran,Syria,0,0,0,0.5,0.5,1712,1507
1980-09-17,Qatar,United Arab Emirates,2,1,1,1.0,0.0,1482,1422
1980-09-18,Argentina,Chile,2,2,0,0.5,0.5,1862,1664
1980-09-18,North Korea,China PR,2,1,1,1.0,0.0,1708,1703
1980-09-18,Kuwait,Malaysia,3,1,2,1.0,0.0,1700,1675
1980-09-18,Paraguay,Bolivia,2,1,1,1.0,0.0,1711,1561
1980-09-19,Bangladesh,Syria,0,1,1,0.0,1.0,1443,1514
1980-09-19,Qatar,South Korea,0,2,2,0.0,1.0,1481,1870
1980-09-20,China PR,Iran,2,2,0,0.5,0.5,1704,1712
1980-09-20,United Arab Emirates,Malaysia,0,2,2,0.0,1.0,1419,1679
1980-09-21,Kuwait,South Korea,0,3,3,0.0,1.0,1696,1875
1980-09-22,Bangladesh,Iran,0,7,7,0.0,1.0,1441,1715
1980-09-23,Malaysia,Qatar,1,1,0,0.5,0.5,1675,1486
1980-09-23,Syria,China PR,1,0,1,1.0,0.0,1526,1693
1980-09-24,Bulgaria,Sweden,2,3,1,0.0,1.0,1652,1695
1980-09-24,Finland,Austria,0,2,2,0.0,1.0,1486,1801
1980-09-24,Hungary,Spain,2,2,0,0.5,0.5,1803,1784
1980-09-24,Iran,North Korea,3,2,1,1.0,0.0,1723,1701
1980-09-24,Italy,Portugal,3,1,2,1.0,0.0,1890,1743
1980-09-24,South Korea,United Arab Emirates,4,1,3,1.0,0.0,1877,1418
1980-09-24,Norway,Romania,1,1,0,0.5,0.5,1528,1712
1980-09-24,Poland,Czechoslovakia,1,1,0,0.5,0.5,1799,1799
1980-09-24,Turkey,Iceland,1,3,2,0.0,1.0,1603,1489
1980-09-25,China PR,Bangladesh,6,0,6,1.0,0.0,1697,1438
1980-09-25,Kuwait,Qatar,4,0,4,1.0,0.0,1700,1483
1980-09-25,Paraguay,Brazil,1,2,1,0.0,1.0,1709,1969
1980-09-26,Syria,North Korea,1,2,1,0.0,1.0,1522,1706
1980-09-27,Yugoslavia,Denmark,2,1,1,1.0,0.0,1802,1646
1980-09-28,Guyana,Suriname,0,1,1,0.0,1.0,1459,1637
1980-09-28,South Korea,North Korea,2,1,1,1.0,0.0,1882,1702
1980-09-28,Kuwait,Iran,2,1,1,1.0,0.0,1709,1715
1980-09-28,Mali,Mauritania,2,0,2,1.0,0.0,1610,1428
1980-09-28,Mauritius,Madagascar,1,1,0,0.5,0.5,1535,1562
1980-09-28,Turkey,Northern Cyprus,5,0,5,1.0,0.0,1609,1490
1980-09-29,Iran,North Korea,3,0,3,1.0,0.0,1723,1695
1980-09-30,El Salvador,Guatemala,3,2,1,1.0,0.0,1589,1604
1980-09-30,Kuwait,South Korea,3,0,3,1.0,0.0,1721,1871
1980-09-30,Northern Cyprus,Saudi Arabia,0,2,2,0.0,1.0,1483,1527
1980-10-01,Costa Rica,Honduras,2,3,1,0.0,1.0,1673,1606
1980-10-01,Turkey,Libya,1,2,1,0.0,1.0,1601,1592
1980-10-03,Turkey,Saudi Arabia,3,0,3,1.0,0.0,1608,1521
1980-10-04,Libya,Saudi Arabia,2,0,2,1.0,0.0,1599,1515
1980-10-04,Luxembourg,United States,0,2,2,0.0,1.0,1377,1511
1980-10-05,El Salvador,Panama,4,1,3,1.0,0.0,1594,1436
1980-10-07,Portugal,United States,1,1,0,0.5,0.5,1739,1516
1980-10-08,Austria,Hungary,3,1,2,1.0,0.0,1810,1795
1980-10-08,Czechoslovakia,German DR,0,1,1,0.0,1.0,1792,1820
1980-10-09,Argentina,Bulgaria,2,0,2,1.0,0.0,1866,1649
1980-10-11,Cyprus,France,0,7,7,0.0,1.0,1390,1808
1980-10-11,Luxembourg,Italy,0,2,2,0.0,1.0,1377,1891
1980-10-11,Netherlands,Germany,1,1,0,0.5,0.5,1845,1966
1980-10-12,Argentina,Poland,2,1,1,1.0,0.0,1873,1793
1980-10-12,Cameroon,Zimbabwe,2,0,2,1.0,0.0,1602,1534
1980-10-12,Guatemala,Costa Rica,0,0,0,0.5,0.5,1606,1672
1980-10-12,Mauritania,Mali,2,1,1,1.0,0.0,1440,1599
1980-10-12,Suriname,Guyana,4,0,4,1.0,0.0,1642,1455
1980-10-15,Argentina,Czechoslovakia,1,0,1,1.0,0.0,1880,1786
1980-10-15,Denmark,Greece,0,1,1,0.0,1.0,1638,1619
1980-10-15,German DR,Spain,0,0,0,0.5,0.5,1820,1785
1980-10-15,Republic of Ireland,Belgium,1,1,0,0.5,0.5,1660,1791
1980-10-15,Northern Ireland,Sweden,3,0,3,1.0,0.0,1692,1687
1980-10-15,Romania,England,2,1,1,1.0,0.0,1724,1886
1980-10-15,Russia,Iceland,5,0,5,1.0,0.0,1871,1488
1980-10-15,Scotland,Portugal,0,0,0,0.5,0.5,1749,1740
1980-10-15,Wales,Turkey,4,0,4,1.0,0.0,1698,1602
1980-10-15,South Korea,New Zealand,1,2,1,0.0,1.0,1858,1623
1980-10-16,South Korea,Indonesia,1,0,1,1.0,0.0,1861,1555
1980-10-17,Malaysia,Myanmar,3,2,1,1.0,0.0,1683,1626
1980-10-17,Morocco,Thailand,2,1,1,1.0,0.0,1702,1568
1980-10-18,South Korea,Kuwait,3,0,3,1.0,0.0,1866,1717
1980-10-18,Canada,Mexico,1,1,0,0.5,0.5,1546,1751
1980-10-19,Bulgaria,Albania,2,1,1,1.0,0.0,1654,1500
1980-10-19,Kuwait,New Zealand,1,5,4,0.0,1.0,1707,1634
1980-10-20,Myanmar,Morocco,2,2,0,0.5,0.5,1628,1701
1980-10-20,Malaysia,Thailand,2,2,0,0.5,0.5,1681,1571
1980-10-20,South Korea,Morocco,1,1,0,0.5,0.5,1863,1705
1980-10-21,Indonesia,New Zealand,0,0,0,0.5,0.5,1557,1633
1980-10-22,Myanmar,Thailand,1,2,1,0.0,1.0,1619,1581
1980-10-22,Trinidad and Tobago,Guyana,1,1,0,0.5,0.5,1598,1459
1980-10-22,Malaysia,South Korea,1,1,0,0.5,0.5,1685,1860
1980-10-22,Kuwait,Myanmar,3,1,2,1.0,0.0,1714,1613
1980-10-23,South Korea,Thailand,0,0,0,0.5,0.5,1855,1587
1980-10-24,Myanmar,New Zealand,1,1,0,0.5,0.5,1614,1633
1980-10-24,Kuwait,Thailand,0,1,1,0.0,1.0,1704,1598
1980-10-24,Trinidad and Tobago,Guyana,2,0,2,1.0,0.0,1603,1455
1980-10-25,Kuwait,Indonesia,1,2,1,0.0,1.0,1693,1569
1980-10-25,Liberia,Mali,1,1,0,0.5,0.5,1498,1597
1980-10-25,United States,Canada,0,0,0,0.5,0.5,1517,1546
1980-10-26,Honduras,Guatemala,0,0,0,0.5,0.5,1606,1606
1980-10-26,Indonesia,Thailand,1,1,0,0.5,0.5,1570,1598
1980-10-26,Malawi,Zimbabwe,0,1,1,0.0,1.0,1614,1545
1980-10-26,Morocco,New Zealand,3,0,3,1.0,0.0,1712,1627
1980-10-27,Kuwait,Morocco,0,3,3,0.0,1.0,1686,1720
1980-10-27,Malaysia,Indonesia,1,1,0,0.5,0.5,1683,1573
1980-10-28,France,Republic of Ireland,2,0,2,1.0,0.0,1813,1656
1980-10-28,New Zealand,Thailand,1,1,0,0.5,0.5,1627,1599
1980-10-29,Malaysia,Kuwait,2,1,1,1.0,0.0,1692,1678
1980-10-29,Indonesia,Morocco,0,2,2,0.0,1.0,1569,1725
1980-10-29,Switzerland,Norway,1,2,1,0.0,1.0,1602,1538
1980-10-30,Malaysia,New Zealand,2,0,2,1.0,0.0,1699,1621
1980-10-30,Myanmar,South Korea,1,1,0,0.5,0.5,1619,1851
1980-10-30,Brazil,Paraguay,6,0,6,1.0,0.0,1972,1707
1980-10-31,Myanmar,Indonesia,1,0,1,1.0,0.0,1626,1563
1980-11-01,Canada,United States,2,1,1,1.0,0.0,1554,1510
1980-11-01,Italy,Denmark,2,0,2,1.0,0.0,1895,1635
1980-11-01,Tanzania,Madagascar,0,0,0,0.5,0.5,1546,1562
1980-11-01,Zambia,Angola,0,0,0,0.5,0.5,1672,1504
1980-11-02,Malaysia,Morocco,1,2,1,0.0,1.0,1692,1733
1980-11-02,Zambia,Angola,1,1,0,0.5,0.5,1669,1508
1980-11-05,Costa Rica,Panama,2,0,2,1.0,0.0,1676,1433
1980-11-09,Bolivia,Uruguay,1,3,2,0.0,1.0,1556,1670
1980-11-09,Cuba,Guyana,1,0,1,1.0,0.0,1516,1449
1980-11-09,Guatemala,El Salvador,0,0,0,0.5,0.5,1606,1595
1980-11-09,Honduras,Canada,2,0,2,1.0,0.0,1613,1548
1980-11-09,Liberia,Gambia,0,0,0,0.5,0.5,1498,1474
1980-11-09,Mexico,United States,5,1,4,1.0,0.0,1755,1507
1980-11-09,Senegal,Mauritania,3,0,3,1.0,0.0,1594,1436
1980-11-09,Trinidad and Tobago,Curaçao,0,0,0,0.5,0.5,1602,1529
1980-11-09,Zimbabwe,Malawi,1,1,0,0.5,0.5,1547,1613
1980-11-11,Greece,Australia,3,3,0,0.5,0.5,1621,1671
1980-11-11,Guatemala,Canada,0,1,1,0.0,1.0,1597,1558
1980-11-12,Ethiopia,Mozambique,3,2,1,1.0,0.0,1536,1476
1980-11-12,Israel,Sweden,0,0,0,0.5,0.5,1687,1687
1980-11-12,Peru,Uruguay,1,1,0,0.5,0.5,1677,1671
1980-11-12,Spain,Poland,1,2,1,0.0,1.0,1778,1801
1980-11-14,Sudan,Tanzania,0,1,1,0.0,1.0,1596,1556
1980-11-15,Austria,Albania,5,0,5,1.0,0.0,1813,1498
1980-11-15,Benin,Niger,1,0,1,1.0,0.0,1491,1435
1980-11-15,Italy,Yugoslavia,2,0,2,1.0,0.0,1901,1797
1980-11-16,Brunei,Western Australia,0,2,2,0.0,1.0,1454,1485
1980-11-16,Guatemala,Panama,5,0,5,1.0,0.0,1602,1429
1980-11-16,Honduras,Costa Rica,1,1,0,0.5,0.5,1615,1675
1980-11-16,Madagascar,DR Congo,1,1,0,0.5,0.5,1564,1647
1980-11-16,Malawi,Zanzibar,1,0,1,1.0,0.0,1616,1325
1980-11-16,Mexico,Canada,1,1,0,0.5,0.5,1751,1563
1980-11-16,Morocco,Zambia,2,0,2,1.0,0.0,1740,1663
1980-11-16,Zimbabwe,Cameroon,1,0,1,1.0,0.0,1557,1593
1980-11-16,Angola,Congo,1,1,0,0.5,0.5,1511,1595
1980-11-17,Senegal,Sierra Leone,2,0,2,1.0,0.0,1601,1500
1980-11-17,Somalia,Tanzania,1,1,0,0.5,0.5,1435,1554
1980-11-19,Belgium,Netherlands,1,0,1,1.0,0.0,1801,1836
1980-11-19,Denmark,Luxembourg,4,0,4,1.0,0.0,1638,1375
1980-11-19,England,Switzerland,2,1,1,1.0,0.0,1889,1600
1980-11-19,German DR,Hungary,2,0,2,1.0,0.0,1828,1788
1980-11-19,Germany,France,4,1,3,1.0,0.0,1971,1809
1980-11-19,Republic of Ireland,Cyprus,6,0,6,1.0,0.0,1659,1388
1980-11-19,Kenya,Malawi,0,1,1,0.0,1.0,1559,1623
1980-11-19,Poland,Algeria,5,1,4,1.0,0.0,1806,1648
1980-11-19,Portugal,Northern Ireland,1,0,1,1.0,0.0,1747,1686
1980-11-19,Wales,Czechoslovakia,1,0,1,1.0,0.0,1708,1777
1980-11-20,Brunei,Singapore,0,3,3,0.0,1.0,1447,1468
1980-11-20,Sudan,Somalia,2,0,2,1.0,0.0,1601,1431
1980-11-22,Kenya,Zanzibar,1,2,1,0.0,1.0,1547,1338
1980-11-22,Trinidad and Tobago,Cuba,2,2,0,0.5,0.5,1601,1518
1980-11-23,El Salvador,Honduras,2,1,1,1.0,0.0,1604,1607
1980-11-23,Gambia,Liberia,1,1,0,0.5,0.5,1475,1498
1980-11-23,Guinea,DR Congo,2,1,1,1.0,0.0,1609,1638
1980-11-23,United States,Mexico,2,1,1,1.0,0.0,1520,1739
1980-11-24,Malawi,Tanzania,0,1,1,0.0,1.0,1614,1564
1980-11-25,Singapore,Western Australia,1,1,0,0.5,0.5,1469,1485
1980-11-26,Costa Rica,Guatemala,0,3,3,0.0,1.0,1666,1612
1980-11-28,Sudan,Tanzania,1,0,1,1.0,0.0,1609,1557
1980-11-29,Curaçao,Trinidad and Tobago,0,0,0,0.5,0.5,1531,1600
1980-11-30,Bolivia,Finland,3,0,3,1.0,0.0,1563,1480
1980-11-30,Congo,Angola,0,0,0,0.5,0.5,1594,1513
1980-11-30,Guyana,Cuba,0,3,3,0.0,1.0,1443,1525
1980-11-30,Honduras,El Salvador,2,0,2,1.0,0.0,1615,1597
1980-11-30,Sierra Leone,Senegal,1,2,1,0.0,1.0,1495,1607
1980-11-30,Zambia,Morocco,2,0,2,1.0,0.0,1673,1731
1980-12-02,Israel,Australia,0,1,1,0.0,1.0,1679,1680
1980-12-03,Bulgaria,Germany,1,3,2,0.0,1.0,1652,1974
1980-12-03,Czechoslovakia,Turkey,2,0,2,1.0,0.0,1782,1598
1980-12-04,Argentina,Russia,1,1,0,0.5,0.5,1880,1872
1980-12-04,Bolivia,Finland,2,2,0,0.5,0.5,1562,1482
1980-12-05,Hong Kong,Australia,1,0,1,1.0,0.0,1564,1670
1980-12-06,Albania,Austria,0,1,1,0.0,1.0,1496,1816
1980-12-06,Greece,Italy,0,2,2,0.0,1.0,1619,1904
1980-12-06,Nigeria,Tanzania,1,1,0,0.5,0.5,1717,1561
1980-12-07,Guatemala,Honduras,0,1,1,0.0,1.0,1605,1623
1980-12-07,Indonesia,Australia,1,1,0,0.5,0.5,1566,1668
1980-12-07,Kenya,Zambia,1,1,0,0.5,0.5,1550,1671
1980-12-07,Liberia,Guinea,0,0,0,0.5,0.5,1501,1607
1980-12-07,Mali,Togo,1,2,1,0.0,1.0,1588,1551
1980-12-07,Malta,Poland,0,2,2,0.0,1.0,1441,1808
1980-12-08,Uruguay,Finland,6,0,6,1.0,0.0,1676,1478
1980-12-09,Mali,Togo,4,0,4,1.0,0.0,1596,1544
1980-12-10,Costa Rica,El Salvador,0,0,0,0.5,0.5,1665,1599
1980-12-10,Kenya,Zambia,2,0,2,1.0,0.0,1561,1661
1980-12-11,Uruguay,Bolivia,5,0,5,1.0,0.0,1682,1557
1980-12-12,Algeria,Sudan,2,0,2,1.0,0.0,1656,1602
1980-12-12,Curaçao,Haiti,1,1,0,0.5,0.5,1534,1659
1980-12-12,Kenya,Zambia,2,1,1,1.0,0.0,1572,1651
1980-12-12,Saudi Arabia,Indonesia,8,0,8,1.0,0.0,1525,1557
1980-12-14,Honduras,Panama,5,0,5,1.0,0.0,1627,1426
1980-12-14,Niger,Togo,0,1,1,0.0,1.0,1430,1550
1980-12-14,Saudi Arabia,Indonesia,3,0,3,1.0,0.0,1534,1549
1980-12-16,Argentina,Switzerland,5,0,5,1.0,0.0,1883,1598
1980-12-17,Portugal,Israel,3,0,3,1.0,0.0,1754,1673
1980-12-18,Uruguay,Switzerland,4,0,4,1.0,0.0,1689,1592
1980-12-20,Tanzania,Nigeria,0,2,2,0.0,1.0,1557,1722
1980-12-21,Brazil,Switzerland,2,0,2,1.0,0.0,1974,1591
1980-12-21,DR Congo,Madagascar,3,2,1,1.0,0.0,1645,1558
1980-12-21,Cyprus,Belgium,0,2,2,0.0,1.0,1387,1803
1980-12-21,El Salvador,Guatemala,1,0,1,1.0,0.0,1608,1597
1980-12-21,Guinea,Liberia,1,0,1,1.0,0.0,1613,1496
1980-12-21,Hong Kong,China PR,0,1,1,0.0,1.0,1559,1703
1980-12-22,North Korea,Macau,3,0,3,1.0,0.0,1699,1472
1980-12-22,Singapore,Japan,0,1,1,0.0,1.0,1465,1638
1980-12-24,China PR,Macau,3,0,3,1.0,0.0,1707,1469
1980-12-24,Hong Kong,Singapore,1,1,0,0.5,0.5,1557,1468
1980-12-26,China PR,Japan,1,0,1,1.0,0.0,1714,1632
1980-12-26,Singapore,North Korea,0,1,1,0.0,1.0,1465,1703
1980-12-28,Hong Kong,North Korea,2,2,0,0.5,0.5,1561,1700
1980-12-28,Japan,Macau,3,0,3,1.0,0.0,1637,1465
1980-12-28,Sudan,Algeria,1,1,0,0.5,0.5,1604,1655
1980-12-28,Togo,Niger,1,2,1,0.0,1.0,1540,1441
1980-12-30,North Korea,Japan,1,0,1,1.0,0.0,1707,1631
1980-12-30,Uruguay,Netherlands,2,0,2,1.0,0.0,1701,1825
1980-12-31,Hong Kong,China PR,0,0,0,0.5,0.5,1565,1711
1981-01-01,Argentina,Germany,2,1,1,1.0,0.0,1894,1964
1981-01-03,Uruguay,Italy,2,0,2,1.0,0.0,1714,1892
1981-01-04,Argentina,Brazil,1,1,0,0.5,0.5,1896,1973
1981-01-04,North Korea,China PR,2,4,2,0.0,1.0,1700,1719
1981-01-06,Netherlands,Italy,1,1,0,0.5,0.5,1827,1891
1981-01-07,Brazil,Germany,4,1,3,1.0,0.0,1981,1957
1981-01-10,Uruguay,Brazil,2,1,1,1.0,0.0,1728,1968
1981-01-11,Curaçao,Venezuela,3,1,2,1.0,0.0,1541,1441
1981-01-11,Tunisia,Qatar,4,0,4,1.0,0.0,1662,1479
1981-01-18,Venezuela,Curaçao,1,0,1,1.0,0.0,1452,1531
1981-01-20,Mexico,Bulgaria,1,1,0,0.5,0.5,1738,1654
1981-01-25,Japan,Poland,0,2,2,0.0,1.0,1627,1813
1981-01-27,Ecuador,Bulgaria,1,3,2,0.0,1.0,1493,1659
1981-01-27,Japan,Poland,2,4,2,0.0,1.0,1623,1818
1981-01-28,Greece,Luxembourg,2,0,2,1.0,0.0,1623,1372
1981-01-30,Japan,Poland,1,4,3,0.0,1.0,1620,1822
1981-02-01,Bolivia,Bulgaria,1,3,2,0.0,1.0,1552,1665
1981-02-01,Colombia,Brazil,1,1,0,0.5,0.5,1536,1962
1981-02-01,Japan,Poland,0,3,3,0.0,1.0,1617,1826
1981-02-02,Gambia,Guinea,1,1,0,0.5,0.5,1479,1610
1981-02-02,Mali,Mauritania,2,0,2,1.0,0.0,1601,1432
1981-02-03,Cape Verde,Senegal,0,1,1,0.0,1.0,1474,1613
1981-02-04,Mali,Guinea,1,1,0,0.5,0.5,1602,1610
1981-02-04,Peru,Czechoslovakia,1,3,2,0.0,1.0,1672,1788
1981-02-05,Guinea-Bissau,Senegal,0,1,1,0.0,1.0,1488,1619
1981-02-06,Guinea,Mauritania,2,1,1,1.0,0.0,1615,1428
1981-02-06,Jordan,Iraq,0,2,2,0.0,1.0,1437,1761
1981-02-06,Mali,Gambia,4,1,3,1.0,0.0,1608,1474
1981-02-07,Cape Verde,Guinea-Bissau,3,0,3,1.0,0.0,1483,1480
1981-02-08,Jordan,Iraq,0,2,2,0.0,1.0,1435,1764
1981-02-08,Malaysia,Japan,1,0,1,1.0,0.0,1699,1611
1981-02-08,Venezuela,Brazil,0,1,1,0.0,1.0,1452,1963
1981-02-09,Mali,Cape Verde,2,0,2,1.0,0.0,1614,1478
1981-02-10,Guinea,Senegal,1,0,1,1.0,0.0,1624,1611
1981-02-10,Malaysia,Japan,1,1,0,0.5,0.5,1698,1613
1981-02-11,Guinea-Bissau,Mauritania,4,3,1,1.0,0.0,1487,1422
1981-02-11,Mexico,South Korea,4,0,4,1.0,0.0,1749,1841
1981-02-11,Peru,Bulgaria,1,2,1,0.0,1.0,1664,1674
1981-02-12,Cape Verde,Senegal,1,5,4,0.0,1.0,1473,1617
1981-02-13,Mali,Guinea,0,0,0,0.5,0.5,1615,1624
1981-02-14,Ecuador,Brazil,0,6,6,0.0,1.0,1492,1965
1981-02-14,Oman,Jordan,0,1,1,0.0,1.0,1402,1443
1981-02-15,Bolivia,Venezuela,3,0,3,1.0,0.0,1558,1447
1981-02-15,Morocco,Syria,3,0,3,1.0,0.0,1735,1519
1981-02-16,Oman,Jordan,0,2,2,0.0,1.0,1395,1451
1981-02-17,Singapore,Japan,0,1,1,0.0,1.0,1461,1618
1981-02-18,Belgium,Cyprus,3,2,1,1.0,0.0,1805,1386
1981-02-18,Spain,France,1,0,1,1.0,0.0,1787,1801
1981-02-19,Singapore,Japan,0,0,0,0.5,0.5,1465,1615
1981-02-22,Bolivia,Brazil,1,2,1,0.0,1.0,1557,1967
1981-02-22,Netherlands,Cyprus,3,0,3,1.0,0.0,1829,1385
1981-02-24,Indonesia,Japan,2,0,2,1.0,0.0,1559,1606
1981-02-24,Republic of Ireland,Wales,1,3,2,0.0,1.0,1653,1715
1981-02-25,Israel,Scotland,0,1,1,0.0,1.0,1667,1756
1981-02-27,Bahrain,Jordan,1,0,1,1.0,0.0,1451,1443
1981-02-28,Norway,Sweden,2,4,2,0.0,1.0,1534,1692
1981-03-01,Finland,Sweden,2,1,1,1.0,0.0,1491,1680
1981-03-02,Tahiti,Fiji,1,0,1,1.0,0.0,1631,1471
1981-03-05,Bahrain,Tunisia,0,3,3,0.0,1.0,1448,1666
1981-03-08,Japan,South Korea,0,1,1,0.0,1.0,1603,1845
1981-03-08,Liberia,Togo,2,0,2,1.0,0.0,1506,1531
1981-03-08,Morocco,Iraq,1,1,0,0.5,0.5,1736,1764
1981-03-08,Saudi Arabia,Tunisia,1,2,1,0.0,1.0,1529,1672
1981-03-10,Chile,Colombia,1,0,1,1.0,0.0,1670,1531
1981-03-10,Tahiti,Fiji,2,1,1,1.0,0.0,1636,1467
1981-03-11,Luxembourg,Greece,0,2,2,0.0,1.0,1369,1627
1981-03-11,Saudi Arabia,Jordan,2,1,1,1.0,0.0,1536,1437
1981-03-14,Brazil,Chile,2,1,1,1.0,0.0,1970,1668
1981-03-15,Paraguay,Colombia,0,2,2,0.0,1.0,1696,1543
1981-03-15,Venezuela,Bolivia,1,0,1,1.0,0.0,1458,1547
1981-03-18,Qatar,Iraq,0,1,1,0.0,1.0,1477,1767
1981-03-19,Colombia,Chile,1,2,1,0.0,1.0,1538,1674
1981-03-19,Syria,Bahrain,0,1,1,0.0,1.0,1510,1458
1981-03-21,Saudi Arabia,Iraq,1,0,1,1.0,0.0,1549,1755
1981-03-21,Alderney,Jersey,0,5,5,0.0,1.0,1306,1675
1981-03-22,Brazil,Bolivia,3,1,2,1.0,0.0,1972,1546
1981-03-22,Morocco,Liberia,3,1,2,1.0,0.0,1740,1503
1981-03-22,Qatar,Bahrain,3,0,3,1.0,0.0,1485,1451
1981-03-24,Czechoslovakia,Switzerland,0,1,1,0.0,1.0,1776,1604
1981-03-24,Saudi Arabia,Syria,2,0,2,1.0,0.0,1557,1503
1981-03-25,Belgium,Republic of Ireland,1,0,1,1.0,0.0,1810,1649
1981-03-25,England,Spain,1,2,1,0.0,1.0,1879,1798
1981-03-25,Iraq,Bahrain,2,0,2,1.0,0.0,1758,1449
1981-03-25,Netherlands,France,1,0,1,1.0,0.0,1837,1794
1981-03-25,Romania,Poland,2,0,2,1.0,0.0,1735,1816
1981-03-25,Scotland,Northern Ireland,1,1,0,0.5,0.5,1755,1688
1981-03-25,Senegal,Guinea,0,1,1,0.0,1.0,1610,1632
1981-03-25,Turkey,Wales,0,1,1,0.0,1.0,1593,1721
1981-03-25,Yugoslavia,Bulgaria,2,1,1,1.0,0.0,1803,1669
1981-03-27,Qatar,Syria,2,1,1,1.0,0.0,1494,1495
1981-03-28,Saudi Arabia,Bahrain,1,0,1,1.0,0.0,1563,1444
1981-03-29,Brazil,Venezuela,5,0,5,1.0,0.0,1973,1458
1981-03-30,Iraq,Syria,2,1,1,1.0,0.0,1761,1493
1981-03-31,Saudi Arabia,Qatar,1,0,1,1.0,0.0,1570,1488
1981-04-01,Albania,Germany,0,2,2,0.0,1.0,1495,1959
1981-04-01,Cameroon,Niger,2,0,2,1.0,0.0,1598,1437
1981-04-03,Algeria,Senegal,2,0,2,1.0,0.0,1662,1604
1981-04-04,Kenya,Egypt,3,5,2,0.0,1.0,1567,1699
1981-04-04,Liberia,Morocco,0,5,5,0.0,1.0,1500,1744
1981-04-04,Malta,German DR,1,2,1,0.0,1.0,1440,1830
1981-04-04,Nigeria,Angola,0,0,0,0.5,0.5,1718,1518
1981-04-05,Cameroon,Togo,4,0,4,1.0,0.0,1605,1525
1981-04-05,DR Congo,Mozambique,2,1,1,1.0,0.0,1650,1472
1981-04-05,Singapore,Malaysia,1,1,0,0.5,0.5,1470,1694
1981-04-05,Zambia,Congo,1,1,0,0.5,0.5,1650,1596
1981-04-08,Israel,Romania,2,1,1,1.0,0.0,1677,1726
1981-04-10,Algeria,Mali,5,1,4,1.0,0.0,1669,1609
1981-04-11,Ghana,Congo,1,1,0,0.5,0.5,1692,1599
1981-04-11,Zimbabwe,Zambia,0,1,1,0.0,1.0,1552,1656
1981-04-12,DR Congo,Cameroon,1,0,1,1.0,0.0,1657,1599
1981-04-12,Ethiopia,Kenya,0,0,0,0.5,0.5,1537,1567
1981-04-12,Guinea,Nigeria,1,1,0,0.5,0.5,1634,1717
1981-04-12,Tunisia,Senegal,1,0,1,1.0,0.0,1679,1598
1981-04-14,Togo,Congo,2,1,1,1.0,0.0,1535,1590
1981-04-15,Cyprus,Greece,0,1,1,0.0,1.0,1382,1631
1981-04-15,Denmark,Romania,2,1,1,1.0,0.0,1648,1717
1981-04-15,Portugal,Bulgaria,1,1,0,0.5,0.5,1753,1671
1981-04-15,Spain,Hungary,0,3,3,0.0,1.0,1790,1797
1981-04-15,Turkey,Czechoslovakia,0,3,3,0.0,1.0,1589,1781
1981-04-15,Nigeria,Guinea,1,0,1,1.0,0.0,1724,1628
1981-04-17,Malaysia,Singapore,1,2,1,0.0,1.0,1682,1483
1981-04-18,Botswana,Malawi,2,5,3,0.0,1.0,1443,1619
1981-04-18,Egypt,Kenya,2,0,2,1.0,0.0,1705,1562
1981-04-18,Lesotho,Mozambique,0,2,2,0.0,1.0,1447,1480
1981-04-18,Eswatini,Zambia,1,6,5,0.0,1.0,1478,1661
1981-04-19,Chile,Peru,3,0,3,1.0,0.0,1682,1657
1981-04-19,Ethiopia,Sudan,1,1,0,0.5,0.5,1539,1603
1981-04-19,Italy,German DR,0,0,0,0.5,0.5,1890,1832
1981-04-19,Malawi,Zambia,2,1,1,1.0,0.0,1628,1653
1981-04-19,Mali,Algeria,3,0,3,1.0,0.0,1619,1660
1981-04-19,Mozambique,DR Congo,3,3,0,0.5,0.5,1484,1654
1981-04-19,Togo,Cameroon,2,2,0,0.5,0.5,1537,1598
1981-04-20,Zimbabwe,Malawi,4,0,4,1.0,0.0,1562,1619
1981-04-21,Ethiopia,Sudan,2,0,2,1.0,0.0,1549,1594
1981-04-21,South Korea,Malaysia,2,1,1,1.0,0.0,1850,1678
1981-04-22,Kuwait,Thailand,6,0,6,1.0,0.0,1685,1593
1981-04-24,South Korea,Thailand,5,1,4,1.0,0.0,1853,1591
1981-04-25,Kuwait,Malaysia,4,0,4,1.0,0.0,1693,1671
1981-04-25,New Zealand,Australia,3,3,0,0.5,0.5,1623,1667
1981-04-25,Zambia,Zimbabwe,2,0,2,1.0,0.0,1659,1557
1981-04-26,Cameroon,DR Congo,6,1,5,1.0,0.0,1608,1645
1981-04-26,Congo,Ghana,0,1,1,0.0,1.0,1585,1698
1981-04-26,Ethiopia,Rwanda,1,0,1,1.0,0.0,1556,1490
1981-04-26,Morocco,Egypt,1,0,1,1.0,0.0,1752,1698
1981-04-26,Senegal,Tunisia,0,0,0,0.5,0.5,1600,1678
1981-04-27,Malaysia,Thailand,2,2,0,0.5,0.5,1670,1593
1981-04-28,Scotland,Israel,3,1,2,1.0,0.0,1762,1671
1981-04-28,Switzerland,Hungary,2,2,0,0.5,0.5,1609,1793
1981-04-29,Bulgaria,Norway,1,0,1,1.0,0.0,1676,1530
1981-04-29,Chile,Uruguay,1,2,1,0.0,1.0,1676,1735
1981-04-29,Cyprus,Netherlands,0,1,1,0.0,1.0,1381,1839
1981-04-29,England,Romania,0,0,0,0.5,0.5,1876,1721
1981-04-29,France,Belgium,3,2,1,1.0,0.0,1803,1802
1981-04-29,Germany,Austria,2,0,2,1.0,0.0,1964,1812
1981-04-29,Republic of Ireland,Czechoslovakia,3,1,2,1.0,0.0,1660,1771
1981-04-29,Kuwait,South Korea,2,0,2,1.0,0.0,1705,1842
1981-04-29,Northern Ireland,Portugal,1,0,1,1.0,0.0,1698,1744
1981-04-29,Yugoslavia,Greece,5,1,4,1.0,0.0,1808,1627
1981-05-01,Algeria,Niger,4,0,4,1.0,0.0,1664,1434
1981-05-01,Luxembourg,Denmark,1,2,1,0.0,1.0,1367,1651
1981-05-02,Poland,German DR,1,0,1,1.0,0.0,1825,1824
1981-05-03,Fiji,New Zealand,0,4,4,0.0,1.0,1463,1628
1981-05-04,Guernsey,Jersey,1,4,3,0.0,1.0,1653,1683
1981-05-06,Liberia,Guinea,2,1,1,1.0,0.0,1511,1618
1981-05-07,Taiwan,New Zealand,0,0,0,0.5,0.5,1527,1626
1981-05-08,Egypt,Morocco,0,0,0,0.5,0.5,1700,1751
1981-05-10,Rwanda,Ethiopia,1,0,1,1.0,0.0,1500,1547
1981-05-11,Indonesia,New Zealand,0,2,2,0.0,1.0,1553,1633
1981-05-12,England,Brazil,0,1,1,0.0,1.0,1871,1979
1981-05-13,Bulgaria,Finland,4,0,4,1.0,0.0,1681,1487
1981-05-13,Hungary,Romania,1,0,1,1.0,0.0,1800,1715
1981-05-14,Sweden,Denmark,1,2,1,0.0,1.0,1672,1660
1981-05-15,France,Brazil,1,3,2,0.0,1.0,1799,1984
1981-05-16,Australia,New Zealand,0,2,2,0.0,1.0,1659,1642
1981-05-16,Wales,Scotland,2,0,2,1.0,0.0,1730,1754
1981-05-17,Ecuador,Paraguay,1,0,1,1.0,0.0,1505,1684
1981-05-17,Ethiopia,Yemen DPR,1,1,0,0.5,0.5,1546,1480
1981-05-19,German DR,Cuba,5,0,5,1.0,0.0,1827,1523
1981-05-19,Germany,Brazil,1,2,1,0.0,1.0,1957,1992
1981-05-19,Scotland,Northern Ireland,2,0,2,1.0,0.0,1761,1692
1981-05-20,Australia,Indonesia,2,0,2,1.0,0.0,1665,1548
1981-05-20,England,Wales,0,0,0,0.5,0.5,1868,1734
1981-05-20,Norway,Hungary,1,2,1,0.0,1.0,1528,1803
1981-05-23,England,Scotland,0,1,1,0.0,1.0,1858,1772
1981-05-23,New Zealand,Indonesia,5,0,5,1.0,0.0,1648,1543
1981-05-23,Poland,Republic of Ireland,3,0,3,1.0,0.0,1830,1656
1981-05-24,Ecuador,Chile,0,0,0,0.5,0.5,1509,1673
1981-05-24,Finland,Germany,0,4,4,0.0,1.0,1486,1959
1981-05-27,Czechoslovakia,Iceland,6,1,5,1.0,0.0,1774,1486
1981-05-28,Austria,Bulgaria,2,0,2,1.0,0.0,1818,1676
1981-05-30,New Zealand,Taiwan,2,0,2,1.0,0.0,1654,1522
1981-05-30,Switzerland,England,2,1,1,1.0,0.0,1622,1846
1981-05-30,Wales,Russia,0,0,0,0.5,0.5,1738,1869
1981-05-31,Fiji,Indonesia,0,0,0,0.5,0.5,1465,1542
1981-05-31,Niger,Algeria,1,0,1,1.0,0.0,1447,1652
1981-05-31,Paraguay,Ecuador,3,1,2,1.0,0.0,1689,1505
1981-06-01,Equatorial Guinea,São Tomé and Príncipe,1,1,0,0.5,0.5,1496,1482
1981-06-02,Japan,China PR,0,0,0,0.5,0.5,1606,1717
1981-06-03,Denmark,Italy,3,1,2,1.0,0.0,1673,1878
1981-06-03,Romania,Norway,1,0,1,1.0,0.0,1720,1524
1981-06-03,Sweden,Northern Ireland,1,0,1,1.0,0.0,1681,1684
1981-06-06,Fiji,Taiwan,2,1,1,1.0,0.0,1475,1513
1981-06-06,Hungary,England,1,3,2,0.0,1.0,1796,1854
1981-06-07,Paraguay,Chile,0,1,1,0.0,1.0,1681,1682
1981-06-07,Suriname,French Guiana,3,1,2,1.0,0.0,1647,1464
1981-06-10,Australia,Taiwan,3,2,1,1.0,0.0,1670,1509
1981-06-11,Haiti,El Salvador,0,0,0,0.5,0.5,1658,1610
1981-06-13,Haiti,El Salvador,0,0,0,0.5,0.5,1657,1612
1981-06-14,Chile,Ecuador,2,0,2,1.0,0.0,1687,1501
1981-06-14,Liechtenstein,Malta,1,1,0,0.5,0.5,1499,1442
1981-06-15,Indonesia,Taiwan,1,0,1,1.0,0.0,1550,1502
1981-06-16,Liechtenstein,Thailand,0,2,2,0.0,1.0,1494,1599
1981-06-17,Austria,Finland,5,1,4,1.0,0.0,1821,1484
1981-06-17,South Korea,Malaysia,2,0,2,1.0,0.0,1847,1666
1981-06-17,Norway,Switzerland,1,1,0,0.5,0.5,1527,1620
1981-06-18,Indonesia,Malta,0,1,1,0.0,1.0,1540,1453
1981-06-19,Japan,Malaysia,2,0,2,1.0,0.0,1616,1657
1981-06-19,Malawi,Tanzania,4,1,3,1.0,0.0,1626,1551
1981-06-20,Indonesia,Thailand,1,3,2,0.0,1.0,1534,1606
1981-06-20,Portugal,Spain,2,0,2,1.0,0.0,1754,1781
1981-06-21,Chile,Paraguay,3,0,3,1.0,0.0,1695,1674
1981-06-21,French Guiana,Suriname,3,1,2,1.0,0.0,1476,1636
1981-06-21,Guadeloupe,Dominica,5,0,5,1.0,0.0,1519,1462
1981-06-21,South Korea,Japan,2,0,2,1.0,0.0,1851,1613
1981-06-21,Malawi,Tanzania,3,1,2,1.0,0.0,1633,1545
1981-06-22,Indonesia,Liechtenstein,2,3,1,0.0,1.0,1526,1503
1981-06-22,Malta,Thailand,2,0,2,1.0,0.0,1465,1595
1981-06-23,Malawi,Tanzania,0,0,0,0.5,0.5,1632,1547
1981-06-24,Hong Kong,Macau,3,1,2,1.0,0.0,1571,1460
1981-06-24,Sweden,Portugal,3,0,3,1.0,0.0,1691,1745
1981-06-25,Mozambique,Angola,0,1,1,0.0,1.0,1477,1526
1981-06-26,Zambia,DR Congo,3,1,2,1.0,0.0,1667,1638
1981-06-27,Angola,Zimbabwe,1,1,0,0.5,0.5,1527,1557
1981-06-27,Liberia,Ghana,0,0,0,0.5,0.5,1515,1695
1981-06-28,Guinea,Ethiopia,2,2,0,0.5,0.5,1617,1548
1981-06-28,Venezuela,Spain,0,2,2,0.0,1.0,1456,1784
1981-06-28,Zambia,DR Congo,2,2,0,0.5,0.5,1667,1639
1981-06-28,Taiwan,Indonesia,2,0,2,1.0,0.0,1511,1518
1981-07-02,Colombia,Spain,1,1,0,0.5,0.5,1543,1780
1981-07-02,Finland,Norway,3,1,2,1.0,0.0,1493,1519
1981-07-05,Barbados,Trinidad and Tobago,1,1,0,0.5,0.5,1471,1598
1981-07-05,Chile,Spain,1,1,0,0.5,0.5,1697,1779
1981-07-05,Dominica,Guadeloupe,2,3,1,0.0,1.0,1456,1526
1981-07-05,Saint Vincent and the Grenadines,Martinique,2,1,1,1.0,0.0,1599,1604
1981-07-06,Malawi,Mozambique,3,1,2,1.0,0.0,1637,1473
1981-07-07,Vanuatu,Western Samoa,13,1,12,1.0,0.0,1459,1491
1981-07-07,Solomon Islands,Fiji,1,2,1,0.0,1.0,1475,1484
1981-07-07,Tahiti,New Caledonia,1,0,1,1.0,0.0,1644,1604
1981-07-08,Brazil,Spain,1,0,1,1.0,0.0,1996,1776
1981-07-08,Mozambique,Zimbabwe,2,4,2,0.0,1.0,1467,1564
1981-07-08,Papua New Guinea,Fiji,3,2,1,1.0,0.0,1474,1476
1981-07-08,Vanuatu,New Caledonia,2,2,0,0.5,0.5,1463,1601
1981-07-08,Tahiti,Western Samoa,13,0,13,1.0,0.0,1649,1487
1981-07-09,Solomon Islands,New Caledonia,1,1,0,0.5,0.5,1478,1599
1981-07-09,Papua New Guinea,Western Samoa,4,1,3,1.0,0.0,1483,1479
1981-07-09,Tahiti,Vanuatu,1,1,0,0.5,0.5,1646,1467
1981-07-10,Malawi,Zimbabwe,2,0,2,1.0,0.0,1644,1558
1981-07-10,Vanuatu,Fiji,1,1,0,0.5,0.5,1468,1476
1981-07-10,Solomon Islands,Western Samoa,5,0,5,1.0,0.0,1487,1471
1981-07-10,New Caledonia,Papua New Guinea,5,1,4,1.0,0.0,1605,1478
1981-07-11,Fiji,Western Samoa,4,0,4,1.0,0.0,1484,1464
1981-07-11,Tahiti,Papua New Guinea,5,0,5,1.0,0.0,1651,1474
1981-07-11,Solomon Islands,Vanuatu,2,1,1,1.0,0.0,1495,1461
1981-07-12,Kenya,Mauritius,2,1,1,1.0,0.0,1570,1528
1981-07-12,Réunion,Madagascar,2,3,1,0.0,1.0,1464,1565
1981-07-13,Réunion,Madagascar,0,3,3,0.0,1.0,1459,1571
1981-07-13,Vanuatu,Papua New Guinea,2,3,1,0.0,1.0,1454,1482
1981-07-13,New Caledonia,Fiji,3,0,3,1.0,0.0,1611,1479
1981-07-13,Solomon Islands,Tahiti,1,4,3,0.0,1.0,1491,1656
1981-07-14,Madagascar,Mauritius,0,0,0,0.5,0.5,1571,1529
1981-07-14,Réunion,Kenya,1,3,2,0.0,1.0,1454,1576
1981-07-14,New Caledonia,Western Samoa,8,0,8,1.0,0.0,1616,1460
1981-07-14,Tahiti,Fiji,6,0,6,1.0,0.0,1661,1475
1981-07-14,Solomon Islands,Papua New Guinea,1,2,1,0.0,1.0,1483,1491
1981-07-15,Uruguay,Chile,0,0,0,0.5,0.5,1735,1698
1981-07-15,Papua New Guinea,Vanuatu,1,0,1,1.0,0.0,1499,1447
1981-07-15,Tahiti,New Caledonia,1,0,1,1.0,0.0,1668,1610
1981-07-16,Benin,DR Congo,1,2,1,0.0,1.0,1487,1644
1981-07-17,Trinidad and Tobago,Barbados,1,1,0,0.5,0.5,1596,1474
1981-07-18,Nigeria,Burkina Faso,1,0,1,1.0,0.0,1727,1460
1981-07-19,Benin,Ghana,1,2,1,0.0,1.0,1484,1699
1981-07-19,Kenya,Madagascar,1,0,1,1.0,0.0,1584,1564
1981-07-19,Martinique,Saint Vincent and the Grenadines,1,2,1,0.0,1.0,1596,1608
1981-07-19,Réunion,Mauritius,1,2,1,0.0,1.0,1448,1536
1981-07-19,Suriname,French Guiana,1,0,1,1.0,0.0,1641,1472
1981-07-22,Ghana,DR Congo,2,2,0,0.5,0.5,1698,1646
1981-07-26,Colombia,Peru,1,1,0,0.5,0.5,1546,1655
1981-07-26,El Salvador,Haiti,4,0,4,1.0,0.0,1622,1648
1981-07-26,Fiji,Australia,1,4,3,0.0,1.0,1472,1674
1981-07-29,Congo,DR Congo,2,2,0,0.5,0.5,1587,1645
1981-07-29,Sweden,Finland,1,0,1,1.0,0.0,1695,1490
1981-08-01,Zimbabwe,Nigeria,2,0,2,1.0,0.0,1570,1716
1981-08-02,DR Congo,Ghana,1,2,1,0.0,1.0,1639,1705
1981-08-02,Guadeloupe,Saint Vincent and the Grenadines,3,0,3,1.0,0.0,1536,1599
1981-08-02,Suriname,Trinidad and Tobago,1,1,0,0.5,0.5,1640,1598
1981-08-03,Kenya,Nigeria,1,3,2,0.0,1.0,1579,1722
1981-08-05,Peru,Chile,1,2,1,0.0,1.0,1648,1706
1981-08-06,Uganda,Burundi,2,2,0,0.5,0.5,1608,1464
1981-08-09,Uruguay,Colombia,3,2,1,1.0,0.0,1740,1542
1981-08-10,Indonesia,Fiji,3,3,0,0.5,0.5,1517,1474
1981-08-12,Finland,Denmark,1,2,1,0.0,1.0,1486,1678
1981-08-12,Norway,Nigeria,2,2,0,0.5,0.5,1524,1718
1981-08-12,Sweden,Bulgaria,1,0,1,1.0,0.0,1703,1669
1981-08-14,Australia,Fiji,10,0,10,1.0,0.0,1678,1471
1981-08-14,Indonesia,Philippines,3,0,3,1.0,0.0,1522,1364
1981-08-14,Trinidad and Tobago,Suriname,3,2,1,1.0,0.0,1607,1632
1981-08-16,Cameroon,Madagascar,5,1,4,1.0,0.0,1615,1558
1981-08-16,Morocco,Zambia,2,1,1,1.0,0.0,1758,1661
1981-08-16,New Zealand,Fiji,13,0,13,1.0,0.0,1659,1467
1981-08-16,Peru,Colombia,2,0,2,1.0,0.0,1654,1537
1981-08-16,Saint Vincent and the Grenadines,Guadeloupe,3,1,2,1.0,0.0,1606,1530
1981-08-20,Indonesia,South Korea,0,1,1,0.0,1.0,1520,1854
1981-08-22,Iceland,Nigeria,3,0,3,1.0,0.0,1499,1706
1981-08-22,Iraq,Ghana,4,0,4,1.0,0.0,1768,1699
1981-08-23,Uruguay,Peru,1,2,1,0.0,1.0,1731,1664
1981-08-24,Iraq,Ghana,2,2,0,0.5,0.5,1767,1701
1981-08-26,Chile,Brazil,0,0,0,0.5,0.5,1712,1991
1981-08-26,Denmark,Iceland,3,0,3,1.0,0.0,1683,1495
1981-08-30,Algeria,Burkina Faso,7,0,7,1.0,0.0,1656,1457
1981-08-30,Indonesia,Australia,1,0,1,1.0,0.0,1532,1667
1981-08-30,Madagascar,Cameroon,2,1,1,1.0,0.0,1568,1606
1981-08-30,Malaysia,Japan,0,2,2,0.0,1.0,1648,1623
1981-08-30,Zambia,Morocco,2,0,2,1.0,0.0,1672,1748
1981-09-01,India,New Zealand,0,0,0,0.5,0.5,1518,1656
1981-09-01,Singapore,Thailand,1,3,2,0.0,1.0,1478,1601
1981-09-01,Switzerland,Netherlands,2,1,1,1.0,0.0,1633,1827
1981-09-02,Finland,Albania,2,1,1,1.0,0.0,1495,1487
1981-09-02,Indonesia,United Arab Emirates,5,2,3,1.0,0.0,1538,1413
1981-09-02,Poland,Germany,0,2,2,0.0,1.0,1825,1965
1981-09-03,India,Japan,2,3,1,0.0,1.0,1513,1629
1981-09-04,South Korea,Singapore,2,0,2,1.0,0.0,1856,1477
1981-09-04,Malawi,Zimbabwe,1,2,1,0.0,1.0,1635,1580
1981-09-04,Malaysia,New Zealand,0,1,1,0.0,1.0,1641,1664
1981-09-04,Eswatini,Lesotho,1,1,0,0.5,0.5,1478,1448
1981-09-05,India,United Arab Emirates,2,0,2,1.0,0.0,1519,1408
1981-09-05,Lesotho,Malawi,1,4,3,0.0,1.0,1444,1640
1981-09-05,Eswatini,Zimbabwe,0,2,2,0.0,1.0,1473,1586
1981-09-06,Lesotho,Zimbabwe,2,5,3,0.0,1.0,1440,1591
1981-09-06,Niger,Burkina Faso,2,1,1,1.0,0.0,1456,1449
1981-09-06,Peru,Uruguay,0,0,0,0.5,0.5,1666,1730
1981-09-06,Eswatini,Malawi,0,0,0,0.5,0.5,1477,1637
1981-09-07,Indonesia,New Zealand,0,0,0,0.5,0.5,1541,1662
1981-09-08,Japan,United Arab Emirates,3,2,1,1.0,0.0,1633,1405
1981-09-09,Belgium,France,2,0,2,1.0,0.0,1810,1792
1981-09-09,Czechoslovakia,Wales,2,0,2,1.0,0.0,1782,1731
1981-09-09,Denmark,Yugoslavia,1,2,1,0.0,1.0,1678,1814
1981-09-09,Iceland,Turkey,2,0,2,1.0,0.0,1506,1579
1981-09-09,Malaysia,Indonesia,2,0,2,1.0,0.0,1647,1536
1981-09-09,Netherlands,Republic of Ireland,2,2,0,0.5,0.5,1824,1660
1981-09-09,Norway,England,2,1,1,1.0,0.0,1538,1841
1981-09-09,Romania,Bulgaria,1,2,1,0.0,1.0,1711,1679
1981-09-09,Scotland,Sweden,2,0,2,1.0,0.0,1779,1697
1981-09-10,Iraq,Thailand,7,1,6,1.0,0.0,1772,1597
1981-09-10,New Zealand,United Arab Emirates,0,1,1,0.0,1.0,1649,1419
1981-09-11,India,Indonesia,1,0,1,1.0,0.0,1528,1528
1981-09-12,Japan,New Zealand,0,1,1,0.0,1.0,1626,1657
1981-09-12,Malaysia,United Arab Emirates,0,1,1,0.0,1.0,1635,1432
1981-09-13,Colombia,Uruguay,1,1,0,0.5,0.5,1542,1726
1981-09-13,Iraq,South Korea,1,1,0,0.5,0.5,1774,1855
1981-09-13,Saint Vincent and the Grenadines,Suriname,2,1,1,1.0,0.0,1615,1624
1981-09-14,Indonesia,Japan,0,2,2,0.0,1.0,1523,1632
1981-09-15,Malaysia,India,2,2,0,0.5,0.5,1633,1531
1981-09-16,Iraq,Singapore,4,0,4,1.0,0.0,1777,1475
1981-09-16,South Korea,Thailand,1,1,0,0.5,0.5,1850,1603
1981-09-18,Iraq,Japan,2,0,2,1.0,0.0,1782,1628
1981-09-20,Burkina Faso,Algeria,1,1,0,0.5,0.5,1454,1652
1981-09-20,Venezuela,Cuba,1,0,1,1.0,0.0,1466,1514
1981-09-23,Austria,Spain,0,0,0,0.5,0.5,1820,1778
1981-09-23,Denmark,Norway,2,1,1,1.0,0.0,1683,1534
1981-09-23,Germany,Finland,7,1,6,1.0,0.0,1967,1494
1981-09-23,Greece,Sweden,2,1,1,1.0,0.0,1637,1688
1981-09-23,Iceland,Czechoslovakia,1,1,0,0.5,0.5,1512,1777
1981-09-23,Italy,Bulgaria,3,2,1,1.0,0.0,1882,1676
1981-09-23,Portugal,Poland,2,0,2,1.0,0.0,1755,1816
1981-09-23,Romania,Hungary,0,0,0,0.5,0.5,1713,1795
1981-09-23,Russia,Turkey,4,0,4,1.0,0.0,1872,1577
1981-09-24,China PR,New Zealand,0,0,0,0.5,0.5,1716,1659
1981-09-26,Uganda,Nigeria,1,0,1,1.0,0.0,1619,1696
1981-09-27,Morocco,Tunisia,2,2,0,0.5,0.5,1747,1680
1981-09-27,Suriname,Saint Vincent and the Grenadines,3,3,0,0.5,0.5,1624,1616
1981-09-30,Botswana,Zimbabwe,0,1,1,0.0,1.0,1439,1596
1981-09-30,Trinidad and Tobago,Grenada,3,1,2,1.0,0.0,1614,1542
1981-10-02,Trinidad and Tobago,Grenada,5,1,4,1.0,0.0,1621,1536
1981-10-03,New Zealand,China PR,1,0,1,1.0,0.0,1669,1707
1981-10-03,Nigeria,Liberia,3,0,3,1.0,0.0,1701,1511
1981-10-04,Ethiopia,Guinea,1,1,0,0.5,0.5,1550,1616
1981-10-07,Turkey,Russia,0,3,3,0.0,1.0,1575,1875
1981-10-10,German DR,Poland,2,3,1,0.0,1.0,1819,1825
1981-10-10,New Zealand,Kuwait,1,2,1,0.0,1.0,1662,1713
1981-10-10,Nigeria,Algeria,0,2,2,0.0,1.0,1692,1662
1981-10-10,Romania,Switzerland,1,2,1,0.0,1.0,1704,1643
1981-10-12,Trinidad and Tobago,Canada,2,4,2,0.0,1.0,1612,1573
1981-10-14,Albania,Bulgaria,0,2,2,0.0,1.0,1483,1681
1981-10-14,Austria,Germany,1,3,2,0.0,1.0,1816,1972
1981-10-14,Greece,Denmark,2,3,1,0.0,1.0,1631,1690
1981-10-14,Hungary,Switzerland,3,0,3,1.0,0.0,1800,1639
1981-10-14,Republic of Ireland,France,3,2,1,1.0,0.0,1671,1782
1981-10-14,Netherlands,Belgium,3,0,3,1.0,0.0,1832,1803
1981-10-14,Northern Ireland,Scotland,0,0,0,0.5,0.5,1687,1777
1981-10-14,Portugal,Sweden,1,2,1,0.0,1.0,1746,1698
1981-10-14,Spain,Luxembourg,3,0,3,1.0,0.0,1780,1366
1981-10-14,Wales,Iceland,2,2,0,0.5,0.5,1727,1517
1981-10-17,Saudi Arabia,South Korea,2,0,2,1.0,0.0,1584,1837
1981-10-17,Yugoslavia,Italy,1,1,0,0.5,0.5,1816,1881
1981-10-18,China PR,Kuwait,3,0,3,1.0,0.0,1716,1705
1981-10-19,Puerto Rico,Guadeloupe,1,1,0,0.5,0.5,1391,1527
1981-10-19,Saint Vincent and the Grenadines,Trinidad and Tobago,0,2,2,0.0,1.0,1608,1621
1981-10-21,Guadeloupe,Trinidad and Tobago,0,2,2,0.0,1.0,1522,1627
1981-10-21,Puerto Rico,Saint Vincent and the Grenadines,0,2,2,0.0,1.0,1388,1612
1981-10-24,Guadeloupe,Saint Vincent and the Grenadines,1,3,2,0.0,1.0,1517,1618
1981-10-24,Tunisia,Malta,0,1,1,0.0,1.0,1668,1478
1981-10-26,United Arab Emirates,India,2,0,2,1.0,0.0,1443,1521
1981-10-28,Argentina,Poland,1,2,1,0.0,1.0,1887,1835
1981-10-28,Brazil,Bulgaria,3,0,3,1.0,0.0,1994,1679
1981-10-28,Israel,Portugal,4,1,3,1.0,0.0,1681,1737
1981-10-28,Russia,Czechoslovakia,2,0,2,1.0,0.0,1881,1772
1981-10-28,Saudi Arabia,Sweden,1,2,1,0.0,1.0,1579,1704
1981-10-28,United Arab Emirates,India,3,1,2,1.0,0.0,1453,1512
1981-10-30,Algeria,Nigeria,2,1,1,1.0,0.0,1671,1684
1981-10-31,Burundi,Tanzania,1,2,1,0.0,1.0,1458,1554
1981-10-31,Hungary,Norway,4,1,3,1.0,0.0,1803,1532
1981-11-01,Mexico,Cuba,4,0,4,1.0,0.0,1753,1511
1981-11-01,Senegal,Morocco,2,0,2,1.0,0.0,1612,1736
1981-11-02,Burundi,Tanzania,0,1,1,0.0,1.0,1453,1560
1981-11-02,Canada,El Salvador,1,0,1,1.0,0.0,1583,1613
1981-11-03,Honduras,Haiti,4,0,4,1.0,0.0,1636,1640
1981-11-04,Saudi Arabia,Kuwait,0,1,1,0.0,1.0,1574,1711
1981-11-04,Trinidad and Tobago,Barbados,2,1,1,1.0,0.0,1632,1470
1981-11-06,Canada,Haiti,1,1,0,0.5,0.5,1585,1639
1981-11-06,Mexico,El Salvador,0,1,1,0.0,1.0,1742,1625
1981-11-06,Trinidad and Tobago,Barbados,0,0,0,0.5,0.5,1629,1474
1981-11-08,Honduras,Cuba,2,0,2,1.0,0.0,1642,1506
1981-11-08,Tunisia,Cameroon,1,1,0,0.5,0.5,1667,1608
1981-11-09,Thailand,Singapore,2,1,1,1.0,0.0,1609,1470
1981-11-11,Argentina,Czechoslovakia,1,1,0,0.5,0.5,1885,1775
1981-11-11,Bulgaria,Austria,0,0,0,0.5,0.5,1683,1813
1981-11-11,Cuba,El Salvador,0,0,0,0.5,0.5,1509,1623
1981-11-11,German DR,Malta,5,1,4,1.0,0.0,1821,1477
1981-11-11,Haiti,Mexico,1,1,0,0.5,0.5,1642,1740
1981-11-11,Malaysia,Singapore,0,1,1,0.0,1.0,1622,1482
1981-11-11,Switzerland,Romania,0,0,0,0.5,0.5,1641,1703
1981-11-11,Thailand,Pakistan,1,0,1,1.0,0.0,1614,1467
1981-11-12,Honduras,Canada,2,1,1,1.0,0.0,1649,1579
1981-11-12,Saudi Arabia,China PR,2,4,2,0.0,1.0,1570,1721
1981-11-13,Malaysia,Pakistan,2,3,1,0.0,1.0,1611,1479
1981-11-14,Italy,Greece,1,1,0,0.5,0.5,1877,1636
1981-11-14,Kenya,Malawi,1,0,1,1.0,0.0,1589,1628
1981-11-15,Haiti,Cuba,0,2,2,0.0,1.0,1632,1520
1981-11-15,Mexico,Canada,1,1,0,0.5,0.5,1737,1583
1981-11-15,Morocco,Cameroon,0,2,2,0.0,1.0,1726,1619
1981-11-15,Poland,Malta,6,0,6,1.0,0.0,1837,1476
1981-11-15,Sudan,Uganda,2,2,0,0.5,0.5,1595,1619
1981-11-15,Tanzania,Zanzibar,3,1,2,1.0,0.0,1564,1335
1981-11-15,Thailand,Malaysia,2,0,2,1.0,0.0,1622,1604
1981-11-16,Honduras,El Salvador,0,0,0,0.5,0.5,1649,1624
1981-11-17,Kenya,Zanzibar,2,1,1,1.0,0.0,1593,1332
1981-11-17,Pakistan,Singapore,1,0,1,1.0,0.0,1488,1474
1981-11-17,Sudan,Zimbabwe,0,0,0,0.5,0.5,1596,1596
1981-11-17,Tanzania,Malawi,2,2,0,0.5,0.5,1566,1627
1981-11-17,Uganda,Zambia,3,1,2,1.0,0.0,1629,1663
1981-11-18,England,Hungary,1,0,1,1.0,0.0,1849,1796
1981-11-18,France,Netherlands,2,0,2,1.0,0.0,1792,1823
1981-11-18,Germany,Albania,8,0,8,1.0,0.0,1973,1483
1981-11-18,Northern Ireland,Israel,1,0,1,1.0,0.0,1695,1674
1981-11-18,Poland,Spain,2,3,1,0.0,1.0,1828,1790
1981-11-18,Portugal,Scotland,2,1,1,1.0,0.0,1746,1769
1981-11-18,Russia,Wales,3,0,3,1.0,0.0,1886,1723
1981-11-19,China PR,Saudi Arabia,2,0,2,1.0,0.0,1726,1566
1981-11-19,El Salvador,Haiti,1,0,1,1.0,0.0,1633,1624
1981-11-19,Zambia,Zimbabwe,1,1,0,0.5,0.5,1662,1598
1981-11-20,Malawi,Zanzibar,4,1,3,1.0,0.0,1630,1330
1981-11-20,Tanzania,Kenya,1,0,1,1.0,0.0,1575,1585
1981-11-21,Cuba,Canada,2,2,0,0.5,0.5,1522,1582
1981-11-21,Sudan,Zambia,0,2,2,0.0,1.0,1590,1669
1981-11-21,Yugoslavia,Luxembourg,5,0,5,1.0,0.0,1818,1365
1981-11-22,Germany,Bulgaria,4,0,4,1.0,0.0,1976,1681
1981-11-22,Honduras,Mexico,0,0,0,0.5,0.5,1651,1736
1981-11-24,Kenya,Uganda,3,1,2,1.0,0.0,1595,1620
1981-11-24,Tanzania,Zambia,2,1,1,1.0,0.0,1586,1659
1981-11-27,Uganda,Zambia,0,1,1,0.0,1.0,1613,1667
1981-11-28,New Zealand,Saudi Arabia,2,2,0,0.5,0.5,1660,1569
1981-11-28,Tanzania,Kenya,0,1,1,0.0,1.0,1579,1603
1981-11-29,Cameroon,Morocco,2,1,1,1.0,0.0,1630,1716
1981-11-29,Czechoslovakia,Russia,1,1,0,0.5,0.5,1778,1884
1981-11-29,Greece,Yugoslavia,1,2,1,0.0,1.0,1632,1823
1981-11-30,Kuwait,China PR,1,0,1,1.0,0.0,1720,1718
1981-12-05,France,Cyprus,4,0,4,1.0,0.0,1794,1380
1981-12-05,Italy,Luxembourg,1,0,1,1.0,0.0,1878,1365
1981-12-06,Malaysia,Myanmar,1,0,1,1.0,0.0,1613,1618
1981-12-07,Kuwait,Saudi Arabia,2,0,2,1.0,0.0,1725,1565
1981-12-07,Indonesia,Singapore,1,0,1,1.0,0.0,1530,1468
1981-12-08,Malaysia,Thailand,2,2,0,0.5,0.5,1614,1622
1981-12-09,Philippines,Singapore,0,4,4,0.0,1.0,1359,1474
1981-12-11,Thailand,Myanmar,3,3,0,0.5,0.5,1622,1619
1981-12-11,Philippines,Indonesia,0,2,2,0.0,1.0,1355,1535
1981-12-13,Malaysia,Singapore,1,1,0,0.5,0.5,1611,1478
1981-12-13,Thailand,Indonesia,2,1,1,1.0,0.0,1629,1529
1981-12-14,Kuwait,New Zealand,2,2,0,0.5,0.5,1724,1662
1981-12-14,Indonesia,Singapore,2,0,2,1.0,0.0,1536,1472
1981-12-15,Thailand,Malaysia,2,1,1,1.0,0.0,1637,1604
1981-12-16,Bulgaria,Portugal,5,2,3,1.0,0.0,1691,1737
1981-12-16,Spain,Belgium,2,0,2,1.0,0.0,1799,1795
1981-12-19,Saudi Arabia,New Zealand,0,5,5,0.0,1.0,1560,1668
1981-12-29,United Arab Emirates,Tunisia,1,4,3,0.0,1.0,1450,1671
1982-01-10,China PR,New Zealand,1,2,1,0.0,1.0,1709,1678
1982-01-17,Cameroon,Congo,2,1,1,1.0,0.0,1638,1580
1982-01-17,Ethiopia,Tanzania,0,2,2,0.0,1.0,1543,1587
1982-01-17,Singapore,Bahrain,2,0,2,1.0,0.0,1480,1437
1982-01-19,Ethiopia,Tanzania,0,0,0,0.5,0.5,1545,1586
1982-01-20,Greece,Portugal,1,2,1,0.0,1.0,1627,1743
1982-01-24,Benin,Mali,2,3,1,0.0,1.0,1479,1625
1982-01-24,Burkina Faso,Senegal,0,0,0,0.5,0.5,1458,1609
1982-01-26,Brazil,German DR,3,1,2,1.0,0.0,1999,1817
1982-01-31,Senegal,Benin,1,0,1,1.0,0.0,1615,1474
1982-02-05,Libya,Guinea,3,0,3,1.0,0.0,1608,1608
1982-02-06,Mali,Niger,2,2,0,0.5,0.5,1622,1460
1982-02-07,Tunisia,Algeria,0,1,1,0.0,1.0,1663,1679
1982-02-10,Greece,German DR,0,1,1,0.0,1.0,1623,1822
1982-02-11,Cape Verde,Gambia,2,0,2,1.0,0.0,1482,1466
1982-02-11,Guinea,Senegal,1,1,0,0.5,0.5,1609,1615
1982-02-11,Guinea-Bissau,Sierra Leone,1,2,1,0.0,1.0,1480,1503
1982-02-11,Mali,Mauritania,4,0,4,1.0,0.0,1626,1419
1982-02-11,New Zealand,Hungary,1,2,1,0.0,1.0,1673,1802
1982-02-13,Benin,Ghana,0,4,4,0.0,1.0,1471,1705
1982-02-13,Cape Verde,Mali,1,0,1,1.0,0.0,1494,1615
1982-02-13,Gambia,Mauritania,3,1,2,1.0,0.0,1473,1413
1982-02-13,Guinea,Sierra Leone,1,0,1,1.0,0.0,1615,1498
1982-02-13,Guinea-Bissau,Senegal,0,1,1,0.0,1.0,1475,1621
1982-02-13,Liberia,Togo,0,1,1,0.0,1.0,1504,1545
1982-02-14,Ethiopia,Uganda,1,2,1,0.0,1.0,1539,1620
1982-02-14,New Zealand,Hungary,1,2,1,0.0,1.0,1668,1808
1982-02-15,Benin,Niger,2,0,2,1.0,0.0,1479,1453
1982-02-15,Cape Verde,Mauritania,1,2,1,0.0,1.0,1485,1423
1982-02-15,Gambia,Mali,1,1,0,0.5,0.5,1477,1612
1982-02-15,Ghana,Ivory Coast,5,5,0,0.5,0.5,1703,1602
1982-02-15,Guinea-Bissau,Guinea,0,0,0,0.5,0.5,1479,1612
1982-02-15,Liberia,Burkina Faso,1,2,1,0.0,1.0,1495,1468
1982-02-15,Senegal,Sierra Leone,2,0,2,1.0,0.0,1627,1493
1982-02-16,Bangladesh,Nepal,1,1,0,0.5,0.5,1440,1495
1982-02-16,India,China PR,1,1,0,0.5,0.5,1517,1705
1982-02-17,Benin,Ivory Coast,3,3,0,0.5,0.5,1482,1600
1982-02-17,Cape Verde,Guinea,0,1,1,0.0,1.0,1480,1618
1982-02-17,Germany,Portugal,3,1,2,1.0,0.0,1980,1740
1982-02-17,Ghana,Niger,2,2,0,0.5,0.5,1699,1458
1982-02-17,Mali,Senegal,0,1,1,0.0,1.0,1605,1635
1982-02-17,Nepal,Oman,0,1,1,0.0,1.0,1485,1406
1982-02-17,Togo,Burkina Faso,2,1,1,1.0,0.0,1552,1462
1982-02-18,Ethiopia,Uganda,1,0,1,1.0,0.0,1549,1611
1982-02-18,India,South Korea,2,2,0,0.5,0.5,1523,1832
1982-02-18,Zambia,Botswana,2,0,2,1.0,0.0,1671,1436
1982-02-19,Bangladesh,Oman,1,3,2,0.0,1.0,1432,1415
1982-02-19,Cape Verde,Mali,1,2,1,0.0,1.0,1475,1611
1982-02-19,Ghana,Burkina Faso,1,0,1,1.0,0.0,1703,1459
1982-02-19,Guinea,Senegal,3,0,3,1.0,0.0,1627,1627
1982-02-19,Ivory Coast,Niger,1,1,0,0.5,0.5,1597,1462
1982-02-19,Libya,Qatar,2,1,1,1.0,0.0,1614,1483
1982-02-20,Finland,Sweden,2,2,0,0.5,0.5,1499,1700
1982-02-20,South Korea,Uruguay,2,2,0,0.5,0.5,1830,1729
1982-02-21,Finland,Sweden,2,1,1,1.0,0.0,1512,1688
1982-02-21,Ivory Coast,Togo,1,1,0,0.5,0.5,1596,1554
1982-02-22,China PR,Uruguay,0,0,0,0.5,0.5,1706,1729
1982-02-22,Ivory Coast,Burkina Faso,1,1,0,0.5,0.5,1593,1463
1982-02-23,England,Northern Ireland,4,0,4,1.0,0.0,1854,1691
1982-02-23,France,Italy,2,0,2,1.0,0.0,1804,1869
1982-02-23,Ghana,Togo,2,1,1,1.0,0.0,1708,1550
1982-02-24,Spain,Scotland,3,0,3,1.0,0.0,1807,1762
1982-02-25,India,Uruguay,1,3,2,0.0,1.0,1520,1733
1982-03-01,China PR,South Korea,1,1,0,0.5,0.5,1709,1828
1982-03-01,United Arab Emirates,Honduras,0,1,1,0.0,1.0,1447,1655
1982-03-02,Iraq,German DR,0,0,0,0.5,0.5,1783,1822
1982-03-03,Brazil,Czechoslovakia,1,1,0,0.5,0.5,1995,1783
1982-03-03,United Arab Emirates,Honduras,0,0,0,0.5,0.5,1452,1651
1982-03-04,China PR,Uruguay,0,2,2,0.0,1.0,1702,1741
1982-03-05,Cameroon,Tunisia,1,1,0,0.5,0.5,1639,1663
1982-03-05,Libya,Ghana,2,2,0,0.5,0.5,1617,1706
1982-03-06,Iran,North Korea,2,0,2,1.0,0.0,1731,1693
1982-03-07,Algeria,Zambia,1,0,1,1.0,0.0,1687,1664
1982-03-07,Ethiopia,Nigeria,0,3,3,0.0,1.0,1544,1690
1982-03-07,Iraq,South Korea,3,0,3,1.0,0.0,1793,1819
1982-03-09,Argentina,Czechoslovakia,0,0,0,0.5,0.5,1883,1786
1982-03-09,Cameroon,Ghana,0,0,0,0.5,0.5,1641,1705
1982-03-09,Libya,Tunisia,2,0,2,1.0,0.0,1627,1654
1982-03-09,Liechtenstein,Switzerland,0,1,1,0.0,1.0,1499,1646
1982-03-10,Algeria,Nigeria,2,1,1,1.0,0.0,1696,1682
1982-03-10,Ethiopia,Zambia,0,1,1,0.0,1.0,1539,1670
1982-03-10,Greece,Russia,0,2,2,0.0,1.0,1621,1887
1982-03-10,Iraq,South Korea,1,1,0,0.5,0.5,1794,1819
1982-03-10,United Arab Emirates,Singapore,3,0,3,1.0,0.0,1461,1472
1982-03-12,Ghana,Tunisia,1,0,1,1.0,0.0,1712,1648
1982-03-12,Libya,Cameroon,0,0,0,0.5,0.5,1628,1641
1982-03-12,United Arab Emirates,Singapore,5,3,2,1.0,0.0,1470,1464
1982-03-13,Algeria,Ethiopia,0,0,0,0.5,0.5,1693,1543
1982-03-13,Nigeria,Zambia,0,3,3,0.0,1.0,1674,1679
1982-03-14,Kuwait,Iceland,0,0,0,0.5,0.5,1720,1522
1982-03-16,Algeria,Ghana,2,3,1,0.0,1.0,1686,1720
1982-03-16,Libya,Zambia,2,1,1,1.0,0.0,1638,1670
1982-03-18,Algeria,Zambia,0,2,2,0.0,1.0,1678,1679
1982-03-19,Libya,Ghana,1,1,0,0.5,0.5,1640,1719
1982-03-19,United Arab Emirates,Qatar,1,0,1,1.0,0.0,1479,1475
1982-03-20,Bahrain,Kuwait,0,2,2,0.0,1.0,1435,1723
1982-03-21,Brazil,Germany,1,0,1,1.0,0.0,2003,1973
1982-03-21,South Korea,Japan,3,0,3,1.0,0.0,1823,1625
1982-03-21,Trinidad and Tobago,United States,1,2,1,0.0,1.0,1619,1531
1982-03-21,United Arab Emirates,Saudi Arabia,1,0,1,1.0,0.0,1489,1551
1982-03-22,Oman,Qatar,0,3,3,0.0,1.0,1409,1482
1982-03-23,Chile,Peru,2,1,1,1.0,0.0,1719,1660
1982-03-23,Scotland,Netherlands,2,1,1,1.0,0.0,1772,1814
1982-03-24,Argentina,Germany,1,1,0,0.5,0.5,1886,1971
1982-03-24,Belgium,Romania,4,1,3,1.0,0.0,1801,1698
1982-03-24,Czechoslovakia,Greece,2,1,1,1.0,0.0,1791,1617
1982-03-24,France,Northern Ireland,4,0,4,1.0,0.0,1810,1686
1982-03-24,Hungary,Austria,2,3,1,0.0,1.0,1801,1821
1982-03-24,Spain,Wales,1,1,0,0.5,0.5,1806,1725
1982-03-24,Switzerland,Portugal,2,1,1,1.0,0.0,1657,1730
1982-03-24,United Arab Emirates,Kuwait,0,2,2,0.0,1.0,1486,1727
1982-03-24,Guernsey,Alderney,5,1,4,1.0,0.0,1655,1305
1982-03-25,Bahrain,Oman,4,1,3,1.0,0.0,1443,1402
1982-03-26,Saudi Arabia,Kuwait,0,1,1,0.0,1.0,1547,1732
1982-03-27,United Arab Emirates,Bahrain,2,3,1,0.0,1.0,1478,1452
1982-03-29,Kuwait,Oman,2,0,2,1.0,0.0,1735,1400
1982-03-29,Saudi Arabia,Qatar,1,0,1,1.0,0.0,1554,1476
1982-03-30,Peru,Chile,1,0,1,1.0,0.0,1670,1710
1982-03-31,Bahrain,Qatar,1,0,1,1.0,0.0,1461,1468
1982-03-31,Saudi Arabia,Oman,3,0,3,1.0,0.0,1559,1396
1982-04-01,Nepal,Bhutan,3,1,2,1.0,0.0,1494,1492
1982-04-02,Bahrain,Saudi Arabia,2,2,0,0.5,0.5,1464,1557
1982-04-02,United Arab Emirates,Oman,3,1,2,1.0,0.0,1485,1390
1982-04-04,Kuwait,Qatar,1,2,1,0.0,1.0,1722,1482
1982-04-07,India,Thailand,1,1,0,0.5,0.5,1523,1635
1982-04-14,Argentina,Russia,1,1,0,0.5,0.5,1887,1887
1982-04-14,Bulgaria,Romania,1,2,1,0.0,1.0,1684,1706
1982-04-14,German DR,Italy,1,0,1,1.0,0.0,1832,1860
1982-04-14,Germany,Czechoslovakia,2,1,1,1.0,0.0,1976,1787
1982-04-14,Netherlands,Greece,1,0,1,1.0,0.0,1818,1614
1982-04-18,El Salvador,Honduras,3,2,1,1.0,0.0,1642,1643
1982-04-18,Hungary,Peru,1,2,1,0.0,1.0,1791,1681
1982-04-19,Nepal,Thailand,1,0,1,1.0,0.0,1506,1624
1982-04-22,Honduras,El Salvador,1,1,0,0.5,0.5,1643,1643
1982-04-25,Algeria,Peru,1,1,0,0.5,0.5,1679,1681
1982-04-27,Wales,England,0,1,1,0.0,1.0,1720,1860
1982-04-28,Algeria,Republic of Ireland,2,0,2,1.0,0.0,1687,1664
1982-04-28,Austria,Czechoslovakia,2,1,1,1.0,0.0,1829,1780
1982-04-28,Belgium,Bulgaria,2,1,1,1.0,0.0,1807,1679
1982-04-28,France,Peru,0,1,1,0.0,1.0,1800,1692
1982-04-28,Northern Ireland,Scotland,1,1,0,0.5,0.5,1688,1771
1982-04-28,Norway,Finland,1,1,0,0.5,0.5,1532,1513
1982-04-28,Spain,Switzerland,2,0,2,1.0,0.0,1811,1653
1982-05-01,Cameroon,Senegal,2,1,1,1.0,0.0,1649,1620
1982-05-01,Romania,Cyprus,3,1,2,1.0,0.0,1709,1378
1982-05-01,Thailand,Singapore,1,1,0,0.5,0.5,1621,1468
1982-05-02,Cameroon,Guinea,1,1,0,0.5,0.5,1649,1628
1982-05-04,Ghana,Senegal,0,0,0,0.5,0.5,1717,1623
1982-05-05,Argentina,Bulgaria,2,1,1,1.0,0.0,1891,1676
1982-05-05,Brazil,Portugal,3,1,2,1.0,0.0,2006,1728
1982-05-05,Cameroon,Ghana,0,0,0,0.5,0.5,1651,1716
1982-05-05,Denmark,Sweden,1,1,0,0.5,0.5,1690,1689
1982-05-05,Guinea,Senegal,1,1,0,0.5,0.5,1628,1624
1982-05-05,South Korea,Malaysia,5,0,5,1.0,0.0,1827,1601
1982-05-05,Nepal,Singapore,0,2,2,0.0,1.0,1498,1477
1982-05-05,Russia,German DR,1,0,1,1.0,0.0,1894,1826
1982-05-06,Philippines,Singapore,0,1,1,0.0,1.0,1350,1483
1982-05-07,Ghana,Guinea,0,0,0,0.5,0.5,1715,1630
1982-05-08,Trinidad and Tobago,Bermuda,2,2,0,0.5,0.5,1616,1448
1982-05-09,Macau,Hong Kong,1,0,1,1.0,0.0,1471,1561
1982-05-09,Thailand,South Korea,0,3,3,0.0,1.0,1618,1831
1982-05-09,Jersey,Guernsey,2,1,1,1.0,0.0,1691,1648
1982-05-12,Argentina,Romania,1,0,1,1.0,0.0,1896,1705
1982-05-12,Morocco,Senegal,2,1,1,1.0,0.0,1722,1619
1982-05-12,Norway,Germany,2,4,2,0.0,1.0,1531,1978
1982-05-12,Trinidad and Tobago,Bermuda,4,2,2,1.0,0.0,1621,1444
1982-05-13,Thailand,Singapore,1,0,1,1.0,0.0,1624,1478
1982-05-15,Barbados,Bermuda,2,1,1,1.0,0.0,1482,1437
1982-05-15,Thailand,Singapore,2,2,0,0.5,0.5,1621,1482
1982-05-17,Barbados,Bermuda,0,0,0,0.5,0.5,1481,1439
1982-05-17,Thailand,South Korea,0,0,0,0.5,0.5,1626,1827
1982-05-17,Peru,Romania,2,0,2,1.0,0.0,1701,1697
1982-05-19,Austria,Denmark,1,0,1,1.0,0.0,1834,1686
1982-05-19,Brazil,Switzerland,1,1,0,0.5,0.5,2000,1660
1982-05-19,Sweden,German DR,2,2,0,0.5,0.5,1693,1823
1982-05-21,Chile,Republic of Ireland,1,0,1,1.0,0.0,1717,1658
1982-05-24,Scotland,Wales,1,0,1,1.0,0.0,1778,1714
1982-05-25,England,Netherlands,2,0,2,1.0,0.0,1868,1811
1982-05-27,Brazil,Republic of Ireland,7,0,7,1.0,0.0,2002,1657
1982-05-27,Denmark,Belgium,1,0,1,1.0,0.0,1697,1797
1982-05-27,Wales,Northern Ireland,3,0,3,1.0,0.0,1722,1681
1982-05-28,Switzerland,Italy,1,1,0,0.5,0.5,1665,1856
1982-05-29,Scotland,England,0,1,1,0.0,1.0,1773,1874
1982-05-30,Trinidad and Tobago,Republic of Ireland,2,1,1,1.0,0.0,1630,1649
1982-06-02,France,Wales,0,1,1,0.0,1.0,1791,1732
1982-06-02,Iceland,England,1,1,0,0.5,0.5,1529,1868
1982-06-02,Japan,Singapore,2,0,2,1.0,0.0,1630,1478
1982-06-03,Finland,England,1,4,3,0.0,1.0,1512,1870
1982-06-03,Sweden,Russia,1,1,0,0.5,0.5,1698,1890
1982-06-05,Malta,Iceland,2,1,1,1.0,0.0,1486,1520
1982-06-06,Liechtenstein,China PR,2,0,2,1.0,0.0,1512,1690
1982-06-06,Zimbabwe,Uganda,2,1,1,1.0,0.0,1607,1603
1982-06-09,South Korea,India,1,0,1,1.0,0.0,1830,1521
1982-06-10,Malaysia,Thailand,1,1,0,0.5,0.5,1602,1626
1982-06-11,South Korea,Bahrain,3,0,3,1.0,0.0,1832,1463
1982-06-13,Argentina,Belgium,0,1,1,0.0,1.0,1886,1808
1982-06-13,Bahrain,India,0,0,0,0.5,0.5,1465,1520
1982-06-13,Zimbabwe,Uganda,1,1,0,0.5,0.5,1607,1604
1982-06-14,Brazil,Russia,2,1,1,1.0,0.0,2008,1885
1982-06-14,Italy,Poland,0,0,0,0.5,0.5,1856,1829
1982-06-15,Hungary,El Salvador,10,1,9,1.0,0.0,1796,1639
1982-06-15,Norway,Denmark,2,1,1,1.0,0.0,1543,1686
1982-06-15,Peru,Cameroon,0,0,0,0.5,0.5,1700,1653
1982-06-15,Scotland,New Zealand,5,2,3,1.0,0.0,1779,1663
1982-06-16,England,France,3,1,2,1.0,0.0,1877,1785
1982-06-16,Germany,Algeria,1,2,1,0.0,1.0,1965,1701
1982-06-16,Spain,Honduras,1,1,0,0.5,0.5,1808,1647
1982-06-17,Chile,Austria,0,1,1,0.0,1.0,1712,1840
1982-06-17,Czechoslovakia,Kuwait,1,1,0,0.5,0.5,1779,1724
1982-06-17,Yugoslavia,Northern Ireland,0,0,0,0.5,0.5,1820,1685
1982-06-18,Argentina,Hungary,4,1,3,1.0,0.0,1892,1791
1982-06-18,Brazil,Scotland,4,1,3,1.0,0.0,2012,1776
1982-06-18,Italy,Peru,1,1,0,0.5,0.5,1853,1704
1982-06-19,Belgium,El Salvador,1,0,1,1.0,0.0,1813,1635
1982-06-19,Poland,Cameroon,0,0,0,0.5,0.5,1826,1657
1982-06-19,Russia,New Zealand,3,0,3,1.0,0.0,1889,1660
1982-06-20,England,Czechoslovakia,2,0,2,1.0,0.0,1883,1774
1982-06-20,Germany,Chile,4,1,3,1.0,0.0,1969,1709
1982-06-20,Spain,Yugoslavia,2,1,1,1.0,0.0,1817,1812
1982-06-21,Algeria,Austria,0,2,2,0.0,1.0,1697,1845
1982-06-21,France,Kuwait,4,1,3,1.0,0.0,1792,1718
1982-06-21,Honduras,Northern Ireland,1,1,0,0.5,0.5,1648,1685
1982-06-22,Belgium,Hungary,1,1,0,0.5,0.5,1813,1792
1982-06-22,Poland,Peru,5,1,4,1.0,0.0,1832,1699
1982-06-22,Russia,Scotland,2,2,0,0.5,0.5,1887,1779
1982-06-22,Tunisia,China PR,1,0,1,1.0,0.0,1657,1682
1982-06-23,Argentina,El Salvador,2,0,2,1.0,0.0,1895,1633
1982-06-23,Brazil,New Zealand,4,0,4,1.0,0.0,2014,1659
1982-06-23,Italy,Cameroon,1,1,0,0.5,0.5,1849,1662
1982-06-24,Algeria,Chile,3,2,1,1.0,0.0,1706,1701
1982-06-24,France,Czechoslovakia,1,1,0,0.5,0.5,1792,1775
1982-06-24,Honduras,Yugoslavia,0,1,1,0.0,1.0,1644,1817
1982-06-25,England,Kuwait,1,0,1,1.0,0.0,1888,1714
1982-06-25,Germany,Austria,1,0,1,1.0,0.0,1975,1840
1982-06-25,Spain,Northern Ireland,0,1,1,0.0,1.0,1807,1696
1982-06-26,Tunisia,China PR,1,2,1,0.0,1.0,1650,1690
1982-06-27,Mozambique,Zimbabwe,1,1,0,0.5,0.5,1471,1604
1982-06-27,Trinidad and Tobago,Suriname,2,3,1,0.0,1.0,1622,1633
1982-06-28,Austria,France,0,1,1,0.0,1.0,1831,1802
1982-06-28,Poland,Belgium,3,0,3,1.0,0.0,1840,1806
1982-06-29,Germany,England,0,0,0,0.5,0.5,1974,1890
1982-06-29,Italy,Argentina,2,1,1,1.0,0.0,1859,1886
1982-07-01,Austria,Northern Ireland,2,2,0,0.5,0.5,1829,1699
1982-07-01,Belgium,Russia,0,1,1,0.0,1.0,1800,1894
1982-07-02,Argentina,Brazil,1,3,2,0.0,1.0,1881,2020
1982-07-02,Spain,Germany,1,2,1,0.0,1.0,1803,1979
1982-07-04,France,Northern Ireland,4,1,3,1.0,0.0,1808,1694
1982-07-04,Poland,Russia,0,0,0,0.5,0.5,1842,1893
1982-07-05,Italy,Brazil,3,2,1,1.0,0.0,1871,2009
1982-07-05,Spain,England,0,0,0,0.5,0.5,1805,1889
1982-07-06,Malawi,Tanzania,0,1,1,0.0,1.0,1621,1596
1982-07-08,Germany,France,3,3,0,0.5,0.5,1976,1812
1982-07-08,Malawi,Tanzania,2,0,2,1.0,0.0,1629,1589
1982-07-08,Poland,Italy,0,2,2,0.0,1.0,1835,1879
1982-07-10,Poland,France,3,2,1,1.0,0.0,1843,1805
1982-07-11,Finland,Iceland,3,2,1,1.0,0.0,1521,1512
1982-07-11,Italy,Germany,3,1,2,1.0,0.0,1890,1966
1982-07-21,China PR,Hong Kong,2,0,2,1.0,0.0,1696,1556
1982-07-23,China PR,Morocco,3,3,0,0.5,0.5,1697,1722
1982-07-25,Hong Kong,Morocco,0,0,0,0.5,0.5,1560,1719
1982-07-25,Zimbabwe,Réunion,2,3,1,0.0,1.0,1593,1460
1982-08-01,Faroe Islands,Iceland,1,4,3,0.0,1.0,1455,1519
1982-08-02,Faroe Islands,Iceland,0,4,4,0.0,1.0,1449,1526
1982-08-05,Malaysia,Indonesia,0,2,2,0.0,1.0,1593,1546
1982-08-06,India,Thailand,0,0,0,0.5,0.5,1523,1624
1982-08-06,South Korea,Senegal,0,2,2,0.0,1.0,1820,1632
1982-08-07,Singapore,Ghana,0,3,3,0.0,1.0,1475,1719
1982-08-07,Malaysia,United Arab Emirates,1,0,1,1.0,0.0,1599,1480
1982-08-08,South Korea,Indonesia,4,0,4,1.0,0.0,1823,1544
1982-08-09,Ghana,India,1,0,1,1.0,0.0,1723,1520
1982-08-09,Malaysia,Pakistan,4,1,3,1.0,0.0,1605,1483
1982-08-09,Senegal,United Arab Emirates,3,1,2,1.0,0.0,1637,1476
1982-08-10,Malaysia,South Korea,1,2,1,0.0,1.0,1602,1827
1982-08-11,Denmark,Finland,3,2,1,1.0,0.0,1691,1517
1982-08-11,Indonesia,Senegal,2,2,0,0.5,0.5,1547,1635
1982-08-11,Norway,Sweden,1,0,1,1.0,0.0,1555,1687
1982-08-11,Thailand,Ghana,1,4,3,0.0,1.0,1619,1729
1982-08-12,Singapore,India,3,0,3,1.0,0.0,1485,1511
1982-08-12,South Korea,United Arab Emirates,3,2,1,1.0,0.0,1829,1475
1982-08-13,Malaysia,Senegal,1,0,1,1.0,0.0,1611,1627
1982-08-14,Singapore,Thailand,2,0,2,1.0,0.0,1496,1609
1982-08-14,Indonesia,United Arab Emirates,1,2,1,0.0,1.0,1538,1485
1982-08-20,Ghana,Senegal,2,2,0,0.5,0.5,1727,1630
1982-08-29,Mauritius,Zimbabwe,2,0,2,1.0,0.0,1546,1584
1982-08-30,Burundi,Rwanda,1,0,1,1.0,0.0,1463,1491
1982-08-31,France,Poland,0,4,4,0.0,1.0,1798,1851
1982-09-01,Iceland,Netherlands,1,1,0,0.5,0.5,1532,1806
1982-09-01,Réunion,Zimbabwe,0,1,1,0.0,1.0,1455,1590
1982-09-01,Romania,Denmark,1,0,1,1.0,0.0,1705,1684
1982-09-05,Réunion,Mauritius,1,1,0,0.5,0.5,1458,1544
1982-09-07,Switzerland,Bulgaria,3,2,1,1.0,0.0,1674,1668
1982-09-08,Finland,Poland,2,3,1,0.0,1.0,1515,1854
1982-09-08,Iceland,German DR,0,1,1,0.0,1.0,1530,1826
1982-09-08,Romania,Sweden,2,0,2,1.0,0.0,1713,1680
1982-09-12,Malawi,Zimbabwe,2,0,2,1.0,0.0,1637,1583
1982-09-12,Tanzania,Uganda,1,1,0,0.5,0.5,1590,1604
1982-09-19,Somalia,Rwanda,0,1,1,0.0,1.0,1425,1498
1982-09-22,Austria,Albania,5,0,5,1.0,0.0,1831,1482
1982-09-22,Bulgaria,German DR,2,2,0,0.5,0.5,1672,1823
1982-09-22,Denmark,England,2,2,0,0.5,0.5,1689,1885
1982-09-22,Finland,Portugal,0,2,2,0.0,1.0,1512,1732
1982-09-22,Germany,Belgium,0,0,0,0.5,0.5,1963,1804
1982-09-22,Hungary,Turkey,5,0,5,1.0,0.0,1796,1572
1982-09-22,Netherlands,Republic of Ireland,2,1,1,1.0,0.0,1811,1645
1982-09-22,Wales,Norway,1,0,1,1.0,0.0,1737,1551
1982-09-26,Uganda,Tanzania,3,2,1,1.0,0.0,1612,1583
1982-10-01,Egypt,Zambia,3,5,2,0.0,1.0,1692,1688
1982-10-03,Burkina Faso,Niger,1,1,0,0.5,0.5,1463,1463
1982-10-03,Egypt,Zambia,0,0,0,0.5,0.5,1692,1689
1982-10-03,Saudi Arabia,Morocco,2,1,1,1.0,0.0,1569,1708
1982-10-03,Zimbabwe,Malawi,0,2,2,0.0,1.0,1577,1644
1982-10-05,Singapore,Malaysia,0,1,1,0.0,1.0,1491,1617
1982-10-06,Belgium,Switzerland,3,0,3,1.0,0.0,1810,1669
1982-10-06,Czechoslovakia,Sweden,2,2,0,0.5,0.5,1773,1683
1982-10-06,France,Hungary,1,0,1,1.0,0.0,1806,1789
1982-10-07,Singapore,Brunei,7,0,7,1.0,0.0,1498,1441
1982-10-09,Luxembourg,Greece,0,2,2,0.0,1.0,1362,1618
1982-10-10,Brunei,Malaysia,0,4,4,0.0,1.0,1437,1622
1982-10-10,Portugal,Poland,2,1,1,1.0,0.0,1743,1844
1982-10-11,Australia,Indonesia,2,0,2,1.0,0.0,1673,1533
1982-10-12,Saudi Arabia,Cameroon,0,0,0,0.5,0.5,1572,1660
1982-10-13,Austria,Northern Ireland,2,0,2,1.0,0.0,1836,1690
1982-10-13,England,Germany,1,2,1,0.0,1.0,1879,1970
1982-10-13,Republic of Ireland,Iceland,2,0,2,1.0,0.0,1651,1525
1982-10-13,Norway,Yugoslavia,3,1,2,1.0,0.0,1565,1804
1982-10-13,Russia,Finland,2,0,2,1.0,0.0,1895,1511
1982-10-13,Scotland,German DR,2,0,2,1.0,0.0,1789,1814
1982-10-13,Gabon,Angola,2,2,0,0.5,0.5,1466,1526
1982-10-14,Australia,Malaysia,5,0,5,1.0,0.0,1680,1616
1982-10-14,Bulgaria,Malta,7,0,7,1.0,0.0,1677,1482
1982-10-17,Indonesia,Malaysia,0,0,0,0.5,0.5,1535,1615
1982-10-27,Bulgaria,Norway,2,2,0,0.5,0.5,1675,1568
1982-10-27,Cyprus,Greece,1,1,0,0.5,0.5,1383,1614
1982-10-27,Denmark,Czechoslovakia,1,3,2,0.0,1.0,1683,1780
1982-10-27,Italy,Switzerland,0,1,1,0.0,1.0,1878,1682
1982-10-27,Senegal,Togo,1,2,1,0.0,1.0,1621,1560
1982-10-27,Spain,Iceland,1,0,1,1.0,0.0,1808,1523
1982-10-27,Turkey,Albania,1,0,1,1.0,0.0,1578,1477
1982-11-07,Liberia,Sierra Leone,1,0,1,1.0,0.0,1503,1486
1982-11-07,Togo,Benin,2,2,0,0.5,0.5,1559,1484
1982-11-10,Luxembourg,Denmark,1,2,1,0.0,1.0,1360,1686
1982-11-10,Netherlands,France,1,2,1,0.0,1.0,1803,1815
1982-11-10,Singapore,Malaysia,3,1,2,1.0,0.0,1509,1605
1982-11-11,Angola,Ghana,1,2,1,0.0,1.0,1523,1731
1982-11-13,Cyprus,Sweden,0,1,1,0.0,1.0,1381,1686
1982-11-13,Italy,Czechoslovakia,2,2,0,0.5,0.5,1876,1783
1982-11-13,Kuwait,Norway,1,0,1,1.0,0.0,1719,1564
1982-11-13,Uganda,Malawi,2,1,1,1.0,0.0,1621,1636
1982-11-14,Kenya,Sudan,2,0,2,1.0,0.0,1611,1583
1982-11-14,Angola,Gabon,4,0,4,1.0,0.0,1530,1460
1982-11-14,Mali,Gambia,3,1,2,1.0,0.0,1617,1472
1982-11-14,Niger,Senegal,0,0,0,0.5,0.5,1467,1618
1982-11-14,Tanzania,Zimbabwe,0,3,3,0.0,1.0,1575,1586
1982-11-14,Togo,Sierra Leone,3,0,3,1.0,0.0,1566,1480
1982-11-16,Malawi,Zimbabwe,1,1,0,0.5,0.5,1635,1588
1982-11-17,Austria,Turkey,4,0,4,1.0,0.0,1839,1576
1982-11-17,Bulgaria,Yugoslavia,0,1,1,0.0,1.0,1670,1810
1982-11-17,German DR,Romania,4,1,3,1.0,0.0,1820,1708
1982-11-17,Greece,England,0,3,3,0.0,1.0,1612,1882
1982-11-17,Republic of Ireland,Spain,3,3,0,0.5,0.5,1655,1805
1982-11-17,Northern Ireland,Germany,1,0,1,1.0,0.0,1704,1957
1982-11-17,Switzerland,Scotland,2,0,2,1.0,0.0,1693,1779
1982-11-17,Uganda,Tanzania,1,0,1,1.0,0.0,1628,1569
1982-11-18,Sudan,Zanzibar,0,1,1,0.0,1.0,1571,1343
1982-11-19,Malawi,Tanzania,2,0,2,1.0,0.0,1642,1563
1982-11-20,Uganda,Zimbabwe,1,1,0,0.5,0.5,1628,1589
1982-11-20,North Korea,Syria,1,1,0,0.5,0.5,1689,1498
1982-11-20,Saudi Arabia,Thailand,1,0,1,1.0,0.0,1581,1601
1982-11-20,China PR,Malaysia,1,0,1,1.0,0.0,1703,1600
1982-11-20,India,Bangladesh,2,0,2,1.0,0.0,1518,1426
1982-11-21,Kenya,Zanzibar,2,2,0,0.5,0.5,1606,1349
1982-11-21,Kuwait,Nepal,3,1,2,1.0,0.0,1723,1495
1982-11-21,Iraq,Myanmar,4,0,4,1.0,0.0,1799,1615
1982-11-21,Japan,Iran,1,0,1,1.0,0.0,1641,1721
1982-11-21,South Korea,South Yemen,3,0,3,1.0,0.0,1832,1498
1982-11-22,North Korea,Thailand,3,0,3,1.0,0.0,1696,1595
1982-11-22,Saudi Arabia,Syria,1,1,0,0.5,0.5,1580,1500
1982-11-22,India,Malaysia,1,0,1,1.0,0.0,1528,1591
1982-11-22,China PR,Bangladesh,1,0,1,1.0,0.0,1706,1424
1982-11-23,Kuwait,Myanmar,4,0,4,1.0,0.0,1729,1610
1982-11-23,Iraq,Nepal,3,0,3,1.0,0.0,1802,1493
1982-11-23,South Korea,Iran,0,1,1,0.0,1.0,1822,1732
1982-11-23,Japan,South Yemen,3,1,2,1.0,0.0,1646,1494
1982-11-24,Kenya,Zimbabwe,2,1,1,1.0,0.0,1614,1582
1982-11-24,Uganda,Zanzibar,3,0,3,1.0,0.0,1631,1347
1982-11-24,North Korea,Saudi Arabia,2,2,0,0.5,0.5,1694,1583
1982-11-24,Thailand,Syria,3,1,2,1.0,0.0,1601,1495
1982-11-24,India,China PR,2,2,0,0.5,0.5,1532,1703
1982-11-24,Malaysia,Bangladesh,1,2,1,0.0,1.0,1580,1436
1982-11-25,Iraq,Kuwait,1,2,1,0.0,1.0,1793,1739
1982-11-25,Myanmar,Nepal,3,0,3,1.0,0.0,1616,1488
1982-11-25,South Korea,Japan,1,2,1,0.0,1.0,1811,1658
1982-11-25,Iran,South Yemen,2,0,2,1.0,0.0,1736,1491
1982-11-26,Zanzibar,Zimbabwe,0,3,3,0.0,1.0,1344,1586
1982-11-27,Uganda,Kenya,1,1,0,0.5,0.5,1631,1615
1982-11-27,North Korea,China PR,1,0,1,1.0,0.0,1703,1695
1982-11-27,India,Saudi Arabia,0,1,1,0.0,1.0,1526,1590
1982-11-28,Gambia,Mali,1,0,1,1.0,0.0,1484,1606
1982-11-28,Senegal,Niger,1,0,1,1.0,0.0,1623,1463
1982-11-28,Sierra Leone,Togo,0,1,1,0.0,1.0,1474,1573
1982-11-28,Japan,Iraq,0,1,1,0.0,1.0,1653,1799
1982-11-28,Kuwait,Iran,1,0,1,1.0,0.0,1747,1729
1982-11-30,North Korea,Kuwait,2,3,1,0.0,1.0,1697,1754
1982-12-01,Greece,Switzerland,1,3,2,0.0,1.0,1606,1700
1982-12-01,Saudi Arabia,Iraq,0,1,1,0.0,1.0,1587,1803
1982-12-02,North Korea,Saudi Arabia,0,2,2,0.0,1.0,1687,1598
1982-12-03,Kuwait,Iraq,0,1,1,0.0,1.0,1748,1810
1982-12-04,Italy,Romania,0,0,0,0.5,0.5,1873,1712
1982-12-08,Tunisia,Angola,3,1,2,1.0,0.0,1656,1525
1982-12-15,Albania,Northern Ireland,0,0,0,0.5,0.5,1482,1700
1982-12-15,Belgium,Scotland,3,2,1,1.0,0.0,1818,1772
1982-12-15,England,Luxembourg,9,0,9,1.0,0.0,1883,1360
1982-12-15,Yugoslavia,Wales,4,4,0,0.5,0.5,1809,1739
1982-12-19,Malta,Netherlands,0,6,6,0.0,1.0,1480,1806
1982-12-19,Tunisia,Algeria,0,1,1,0.0,1.0,1650,1713
1982-12-22,Greece,Cyprus,1,0,1,1.0,0.0,1610,1378
1982-12-26,Bermuda,Trinidad and Tobago,2,2,0,0.5,0.5,1443,1619
1982-12-26,Malta,Bulgaria,0,0,0,0.5,0.5,1484,1667
1982-12-28,Malta,Bulgaria,1,7,6,0.0,1.0,1480,1672
1982-12-30,Bermuda,Trinidad and Tobago,2,2,0,0.5,0.5,1447,1616
1983-01-09,Ivory Coast,Mali,0,1,1,0.0,1.0,1586,1614
1983-01-17,Benin,Mauritania,1,1,0,0.5,0.5,1483,1425
1983-01-21,Egypt,Hungary,1,0,1,1.0,0.0,1703,1779
1983-01-23,Egypt,Hungary,0,2,2,0.0,1.0,1697,1786
1983-01-23,Niger,Senegal,2,0,2,1.0,0.0,1475,1612
1983-01-29,Turkey,Romania,1,1,0,0.5,0.5,1579,1710
1983-02-01,Malta,Tunisia,1,2,1,0.0,1.0,1476,1655
1983-02-01,Senegal,Guinea,1,0,1,1.0,0.0,1621,1622
1983-02-02,Greece,Romania,1,3,2,0.0,1.0,1605,1716
1983-02-04,Mauritania,Benin,2,0,2,1.0,0.0,1435,1474
1983-02-06,Senegal,Niger,2,0,2,1.0,0.0,1626,1471
1983-02-06,Sierra Leone,Gambia,0,1,1,0.0,1.0,1467,1492
1983-02-06,Tunisia,German DR,1,0,1,1.0,0.0,1667,1809
1983-02-10,Tunisia,German DR,0,2,2,0.0,1.0,1663,1814
1983-02-12,Cyprus,Italy,1,1,0,0.5,0.5,1386,1866
1983-02-12,Syria,Japan,2,2,0,0.5,0.5,1499,1650
1983-02-13,Guinea,Mali,1,1,0,0.5,0.5,1622,1615
1983-02-16,Portugal,France,0,3,3,0.0,1.0,1737,1822
1983-02-16,Spain,Netherlands,1,0,1,1.0,0.0,1814,1798
1983-02-18,Nigeria,Egypt,0,0,0,0.5,0.5,1675,1697
1983-02-20,Gambia,Sierra Leone,0,1,1,0.0,1.0,1484,1476
1983-02-20,Guadeloupe,Dominica,1,0,1,1.0,0.0,1524,1450
1983-02-20,Nigeria,Egypt,1,1,0,0.5,0.5,1676,1697
1983-02-20,Saint Vincent and the Grenadines,Martinique,1,3,2,0.0,1.0,1610,1605
1983-02-22,New Zealand,Australia,2,1,1,1.0,0.0,1668,1672
1983-02-23,Cameroon,Egypt,2,0,2,1.0,0.0,1669,1689
1983-02-23,England,Wales,2,1,1,1.0,0.0,1888,1735
1983-02-23,German DR,Greece,2,1,1,1.0,0.0,1818,1602
1983-02-23,Ivory Coast,Guinea,3,2,1,1.0,0.0,1595,1614
1983-02-23,Portugal,Germany,1,0,1,1.0,0.0,1750,1945
1983-02-26,Cameroon,Egypt,1,1,0,0.5,0.5,1670,1689
1983-02-27,Australia,New Zealand,0,2,2,0.0,1.0,1664,1677
1983-02-27,Mali,Guinea,1,1,0,0.5,0.5,1615,1615
1983-03-02,Gabon,Nigeria,0,0,0,0.5,0.5,1465,1672
1983-03-05,Barbados,Suriname,1,0,1,1.0,0.0,1493,1622
1983-03-06,Dominica,Guadeloupe,1,2,1,0.0,1.0,1444,1531
1983-03-06,Japan,South Korea,1,1,0,0.5,0.5,1654,1808
1983-03-08,Barbados,Suriname,0,0,0,0.5,0.5,1496,1620
1983-03-09,Romania,Turkey,3,1,2,1.0,0.0,1721,1575
1983-03-09,Senegal,Morocco,1,0,1,1.0,0.0,1636,1699
1983-03-10,Senegal,Morocco,0,0,0,0.5,0.5,1638,1698
1983-03-15,Costa Rica,Mexico,0,1,1,0.0,1.0,1659,1743
1983-03-16,German DR,Finland,3,1,2,1.0,0.0,1821,1509
1983-03-17,Gabon,Congo,2,3,1,0.0,1.0,1460,1586
1983-03-20,Benin,Congo,0,2,2,0.0,1.0,1469,1592
1983-03-20,Ethiopia,Kenya,2,2,0,0.5,0.5,1545,1614
1983-03-22,Ethiopia,Kenya,0,0,0,0.5,0.5,1547,1613
1983-03-22,Mexico,Costa Rica,1,0,1,1.0,0.0,1750,1653
1983-03-23,France,Russia,1,1,0,0.5,0.5,1824,1894
1983-03-23,Poland,Bulgaria,3,1,2,1.0,0.0,1849,1668
1983-03-23,Tunisia,Morocco,1,0,1,1.0,0.0,1672,1690
1983-03-24,Togo,Congo,0,2,2,0.0,1.0,1566,1600
1983-03-27,Cyprus,Czechoslovakia,1,1,0,0.5,0.5,1393,1777
1983-03-27,Ethiopia,Djibouti,8,1,7,1.0,0.0,1553,1442
1983-03-27,Luxembourg,Hungary,2,6,4,0.0,1.0,1359,1788
1983-03-29,Ethiopia,Djibouti,4,2,2,1.0,0.0,1559,1437
1983-03-30,Albania,Germany,1,2,1,0.0,1.0,1481,1947
1983-03-30,Benin,Togo,0,2,2,0.0,1.0,1464,1572
1983-03-30,England,Greece,0,0,0,0.5,0.5,1883,1608
1983-03-30,German DR,Belgium,1,2,1,0.0,1.0,1813,1827
1983-03-30,Malta,Republic of Ireland,0,1,1,0.0,1.0,1472,1660
1983-03-30,Northern Ireland,Turkey,2,1,1,1.0,0.0,1706,1570
1983-03-30,Romania,Yugoslavia,0,2,2,0.0,1.0,1715,1816
1983-03-30,Scotland,Switzerland,2,2,0,0.5,0.5,1771,1702
1983-04-01,Ethiopia,Uganda,0,1,1,0.0,1.0,1553,1638
1983-04-02,Guadeloupe,Antigua and Barbuda,2,3,1,0.0,1.0,1522,1469
1983-04-03,Congo,Angola,1,0,1,1.0,0.0,1607,1519
1983-04-03,Ethiopia,Uganda,2,1,1,1.0,0.0,1563,1629
1983-04-03,Mozambique,Cameroon,3,0,3,1.0,0.0,1484,1658
1983-04-05,Guatemala,Mexico,0,2,2,0.0,1.0,1593,1755
1983-04-08,Algeria,Benin,6,2,4,1.0,0.0,1717,1461
1983-04-08,Haiti,United States,0,2,2,0.0,1.0,1614,1542
1983-04-08,Libya,Senegal,2,1,1,1.0,0.0,1648,1631
1983-04-09,Nigeria,Angola,2,0,2,1.0,0.0,1677,1515
1983-04-09,Jersey,Alderney,6,1,5,1.0,0.0,1693,1304
1983-04-10,Congo,Egypt,2,0,2,1.0,0.0,1617,1680
1983-04-10,Ethiopia,Mauritius,1,0,1,1.0,0.0,1571,1537
1983-04-10,Guinea,Togo,0,1,1,0.0,1.0,1607,1581
1983-04-10,Madagascar,Uganda,1,0,1,1.0,0.0,1578,1620
1983-04-10,Morocco,Mali,4,0,4,1.0,0.0,1697,1609
1983-04-10,Sudan,Zambia,2,1,1,1.0,0.0,1582,1679
1983-04-10,Tunisia,Rwanda,5,0,5,1.0,0.0,1677,1494
1983-04-13,German DR,Bulgaria,3,0,3,1.0,0.0,1818,1664
1983-04-13,Portugal,Hungary,0,0,0,0.5,0.5,1751,1788
1983-04-13,Switzerland,Russia,0,1,1,0.0,1.0,1699,1898
1983-04-16,Czechoslovakia,Cyprus,6,0,6,1.0,0.0,1779,1392
1983-04-16,Romania,Italy,1,0,1,1.0,0.0,1727,1855
1983-04-17,Guinea-Bissau,Togo,2,0,2,1.0,0.0,1490,1571
1983-04-17,Hungary,Luxembourg,6,2,4,1.0,0.0,1790,1358
1983-04-17,Mali,Ivory Coast,1,2,1,0.0,1.0,1601,1604
1983-04-17,Poland,Finland,1,1,0,0.5,0.5,1843,1516
1983-04-17,Sierra Leone,Jordan,2,1,1,1.0,0.0,1484,1430
1983-04-22,Egypt,Congo,2,0,2,1.0,0.0,1687,1611
1983-04-23,France,Yugoslavia,4,0,4,1.0,0.0,1832,1809
1983-04-23,Turkey,Germany,0,3,3,0.0,1.0,1569,1949
1983-04-24,Angola,Nigeria,1,0,1,1.0,0.0,1527,1666
1983-04-24,Barbados,Guyana,1,1,0,0.5,0.5,1495,1445
1983-04-24,Cameroon,Mozambique,4,0,4,1.0,0.0,1663,1480
1983-04-24,Mali,Morocco,2,0,2,1.0,0.0,1612,1687
1983-04-24,Mauritius,Ethiopia,1,0,1,1.0,0.0,1546,1563
1983-04-24,Rwanda,Tunisia,0,1,1,0.0,1.0,1490,1682
1983-04-24,Senegal,Libya,1,0,1,1.0,0.0,1640,1640
1983-04-24,Togo,Guinea,2,0,2,1.0,0.0,1580,1599
1983-04-24,Uganda,Madagascar,1,2,1,0.0,1.0,1612,1587
1983-04-24,Zambia,Sudan,0,0,0,0.5,0.5,1677,1585
1983-04-26,Benin,Algeria,6,2,4,1.0,0.0,1475,1704
1983-04-27,Austria,Germany,0,0,0,0.5,0.5,1842,1947
1983-04-27,Belgium,German DR,2,1,1,1.0,0.0,1835,1811
1983-04-27,Denmark,Greece,1,0,1,1.0,0.0,1693,1602
1983-04-27,England,Hungary,2,0,2,1.0,0.0,1889,1785
1983-04-27,Netherlands,Sweden,0,3,3,0.0,1.0,1788,1697
1983-04-27,Northern Ireland,Albania,1,0,1,1.0,0.0,1710,1478
1983-04-27,Russia,Portugal,5,0,5,1.0,0.0,1903,1747
1983-04-27,Spain,Republic of Ireland,2,0,2,1.0,0.0,1819,1656
1983-04-27,Wales,Bulgaria,1,0,1,1.0,0.0,1742,1658
1983-04-28,Brazil,Chile,3,2,1,1.0,0.0,2012,1699
1983-04-28,Ghana,Libya,1,0,1,1.0,0.0,1737,1635
1983-04-28,Iraq,Egypt,2,1,1,1.0,0.0,1816,1682
1983-04-29,Ethiopia,Nigeria,0,1,1,0.0,1.0,1558,1672
1983-05-01,Ethiopia,Libya,1,0,1,1.0,0.0,1568,1626
1983-05-01,Ghana,Nigeria,1,0,1,1.0,0.0,1744,1666
1983-05-01,Guinea,Guinea-Bissau,3,0,3,1.0,0.0,1605,1485
1983-05-02,Guernsey,Jersey,2,1,1,1.0,0.0,1658,1684
1983-05-03,Ethiopia,Libya,0,1,1,0.0,1.0,1562,1633
1983-05-03,Guatemala,Honduras,0,2,2,0.0,1.0,1587,1651
1983-05-06,Indonesia,Taiwan,0,2,2,0.0,1.0,1527,1520
1983-05-08,Antigua and Barbuda,Guadeloupe,3,3,0,0.5,0.5,1471,1521
1983-05-08,Guyana,Barbados,2,0,2,1.0,0.0,1455,1486
1983-05-08,Togo,Guinea-Bissau,3,0,3,1.0,0.0,1586,1480
1983-05-11,Albania,Turkey,1,1,0,0.5,0.5,1481,1567
1983-05-12,Chile,Argentina,2,2,0,0.5,0.5,1703,1878
1983-05-14,Switzerland,German DR,0,0,0,0.5,0.5,1702,1809
1983-05-15,Hungary,Greece,2,3,1,0.0,1.0,1774,1614
1983-05-15,Malta,Spain,2,3,1,0.0,1.0,1471,1821
1983-05-15,Romania,Czechoslovakia,0,1,1,0.0,1.0,1721,1786
1983-05-15,Sweden,Cyprus,5,0,5,1.0,0.0,1700,1390
1983-05-17,Austria,Russia,2,2,0,0.5,0.5,1844,1902
1983-05-22,Poland,Russia,1,1,0,0.5,0.5,1845,1901
1983-05-23,Kenya,Madagascar,1,2,1,0.0,1.0,1605,1596
1983-05-24,Scotland,Northern Ireland,0,0,0,0.5,0.5,1770,1712
1983-05-25,Martinique,Saint Kitts and Nevis,7,0,7,1.0,0.0,1610,1461
1983-05-28,Northern Ireland,England,0,0,0,0.5,0.5,1716,1886
1983-05-28,Wales,Scotland,0,2,2,0.0,1.0,1735,1778
1983-05-28,Singapore,Malaysia,2,1,1,1.0,0.0,1519,1571
1983-05-29,Egypt,Cameroon,4,0,4,1.0,0.0,1690,1656
1983-05-29,Guyana,Antigua and Barbuda,0,0,0,0.5,0.5,1456,1471
1983-05-29,Iceland,Spain,0,1,1,0.0,1.0,1521,1824
1983-05-29,Sweden,Italy,2,0,2,1.0,0.0,1712,1844
1983-05-29,Thailand,Indonesia,5,0,5,1.0,0.0,1608,1521
1983-05-29,Myanmar,Brunei,1,2,1,0.0,1.0,1605,1449
1983-05-30,Philippines,Malaysia,0,0,0,0.5,0.5,1355,1567
1983-05-31,Belgium,France,1,1,0,0.5,0.5,1835,1833
1983-05-31,Northern Ireland,Wales,0,1,1,0.0,1.0,1709,1743
1983-05-31,Indonesia,Myanmar,2,1,1,1.0,0.0,1531,1596
1983-05-31,Thailand,Brunei,2,1,1,1.0,0.0,1613,1445
1983-06-01,Denmark,Hungary,3,1,2,1.0,0.0,1703,1765
1983-06-01,England,Scotland,2,0,2,1.0,0.0,1892,1773
1983-06-01,Finland,Russia,0,1,1,0.0,1.0,1515,1903
1983-06-01,Yugoslavia,Romania,1,0,1,1.0,0.0,1816,1715
1983-06-01,Singapore,Philippines,5,0,5,1.0,0.0,1524,1351
1983-06-02,Paraguay,Uruguay,0,0,0,0.5,0.5,1676,1740
1983-06-02,Myanmar,Thailand,1,0,1,1.0,0.0,1605,1605
1983-06-02,Indonesia,Brunei,1,1,0,0.5,0.5,1530,1447
1983-06-04,Nigeria,Thailand,0,0,0,0.5,0.5,1665,1607
1983-06-04,Singapore,Brunei,4,0,4,1.0,0.0,1531,1441
1983-06-04,Thailand,Malaysia,1,1,0,0.5,0.5,1607,1568
1983-06-05,Antigua and Barbuda,Guyana,4,0,4,1.0,0.0,1479,1449
1983-06-05,Iceland,Malta,1,0,1,1.0,0.0,1528,1465
1983-06-05,Saint Kitts and Nevis,Martinique,0,5,5,0.0,1.0,1457,1615
1983-06-05,Malaysia,Brunei,5,0,5,1.0,0.0,1574,1436
1983-06-06,South Korea,Thailand,4,0,4,1.0,0.0,1812,1604
1983-06-06,Singapore,Thailand,1,2,1,0.0,1.0,1525,1611
1983-06-07,Germany,Yugoslavia,4,2,2,1.0,0.0,1953,1811
1983-06-07,Ghana,New Zealand,0,2,2,0.0,1.0,1735,1687
1983-06-07,Japan,Syria,1,0,1,1.0,0.0,1659,1495
1983-06-08,Albania,Austria,1,2,1,0.0,1.0,1480,1846
1983-06-08,Indonesia,Thailand,0,3,3,0.0,1.0,1524,1618
1983-06-08,South Korea,Nigeria,1,0,1,1.0,0.0,1817,1661
1983-06-08,Portugal,Brazil,0,4,4,0.0,1.0,1745,2015
1983-06-09,New Zealand,Sudan,1,1,0,0.5,0.5,1685,1588
1983-06-09,Sweden,Romania,0,1,1,0.0,1.0,1705,1723
1983-06-09,Uruguay,Paraguay,3,0,3,1.0,0.0,1747,1670
1983-06-10,Indonesia,Nigeria,1,2,1,0.0,1.0,1520,1666
1983-06-12,Australia,England,0,0,0,0.5,0.5,1669,1888
1983-06-12,Canada,Scotland,0,2,2,0.0,1.0,1579,1777
1983-06-12,South Korea,Indonesia,3,0,3,1.0,0.0,1820,1518
1983-06-12,Wales,Brazil,1,1,0,0.5,0.5,1749,2010
1983-06-13,Ghana,Sudan,3,1,2,1.0,0.0,1740,1584
1983-06-15,Australia,England,0,1,1,0.0,1.0,1666,1892
1983-06-15,South Korea,Ghana,1,0,1,1.0,0.0,1827,1734
1983-06-16,Canada,Scotland,0,3,3,0.0,1.0,1576,1781
1983-06-16,Malawi,Mozambique,2,0,2,1.0,0.0,1647,1476
1983-06-17,Switzerland,Brazil,1,2,1,0.0,1.0,1700,2013
1983-06-18,Malawi,Mozambique,0,0,0,0.5,0.5,1644,1480
1983-06-19,Australia,England,1,1,0,0.5,0.5,1671,1888
1983-06-19,Réunion,Seychelles,2,1,1,1.0,0.0,1467,1452
1983-06-22,Sweden,Brazil,3,3,0,0.5,0.5,1711,2008
1983-06-23,Argentina,Chile,1,0,1,1.0,0.0,1883,1699
1983-06-23,Réunion,Seychelles,0,0,0,0.5,0.5,1467,1453
1983-06-26,Niger,Mauritania,1,0,1,1.0,0.0,1479,1428
1983-06-29,Greenland,Faroe Islands,0,0,0,0.5,0.5,1483,1450
1983-07-01,Hong Kong,Macau,1,0,1,1.0,0.0,1566,1466
1983-07-03,Ethiopia,Togo,2,1,1,1.0,0.0,1571,1578
1983-07-03,Gambia,Mali,1,1,0,0.5,0.5,1487,1610
1983-07-03,Greenland,Faroe Islands,2,3,1,0.0,1.0,1475,1459
1983-07-03,Seychelles,Mauritius,1,2,1,0.0,1.0,1448,1552
1983-07-06,Malawi,Zimbabwe,0,0,0,0.5,0.5,1643,1588
1983-07-08,Malawi,Zimbabwe,1,0,1,1.0,0.0,1650,1582
1983-07-08,Qatar,Sudan,3,1,2,1.0,0.0,1493,1574
1983-07-10,Madagascar,Mauritius,1,1,0,0.5,0.5,1595,1554
1983-07-10,Qatar,Sudan,2,0,2,1.0,0.0,1503,1565
1983-07-13,Réunion,Madagascar,0,3,3,0.0,1.0,1462,1601
1983-07-14,Colombia,Chile,2,2,0,0.5,0.5,1546,1696
1983-07-14,Mauritania,Niger,0,0,0,0.5,0.5,1430,1478
1983-07-14,Paraguay,Argentina,1,0,1,1.0,0.0,1683,1871
1983-07-16,Réunion,Mauritius,1,1,0,0.5,0.5,1465,1552
1983-07-18,Hong Kong,Thailand,1,1,0,0.5,0.5,1568,1617
1983-07-18,Uruguay,Peru,1,1,0,0.5,0.5,1746,1701
1983-07-19,Bolivia,Chile,1,2,1,0.0,1.0,1542,1701
1983-07-20,China PR,Thailand,2,1,1,1.0,0.0,1702,1611
1983-07-20,Guinea-Bissau,Senegal,1,1,0,0.5,0.5,1484,1637
1983-07-20,Mauritania,Cape Verde,2,0,2,1.0,0.0,1440,1466
1983-07-21,Argentina,Paraguay,0,0,0,0.5,0.5,1868,1687
1983-07-21,Gambia,Guinea,4,1,3,1.0,0.0,1498,1595
1983-07-21,Peru,Chile,0,1,1,0.0,1.0,1693,1709
1983-07-22,Cape Verde,Mali,1,0,1,1.0,0.0,1478,1599
1983-07-22,Guinea-Bissau,Guinea,2,1,1,1.0,0.0,1495,1585
1983-07-23,Antigua and Barbuda,Martinique,0,2,2,0.0,1.0,1474,1621
1983-07-23,French Guiana,Trinidad and Tobago,0,1,1,0.0,1.0,1468,1621
1983-07-23,Gambia,Senegal,1,2,1,0.0,1.0,1494,1642
1983-07-24,Guinea,Senegal,1,1,0,0.5,0.5,1587,1641
1983-07-24,Mauritania,Mali,0,2,2,0.0,1.0,1436,1604
1983-07-24,Paraguay,Chile,1,0,1,1.0,0.0,1696,1701
1983-07-25,French Guiana,Antigua and Barbuda,1,0,1,1.0,0.0,1477,1466
1983-07-25,Gambia,Guinea-Bissau,2,2,0,0.5,0.5,1495,1495
1983-07-25,Martinique,Trinidad and Tobago,3,1,2,1.0,0.0,1629,1613
1983-07-26,Ecuador,Colombia,0,0,0,0.5,0.5,1503,1545
1983-07-26,El Salvador,Guatemala,0,0,0,0.5,0.5,1632,1589
1983-07-26,German DR,Russia,1,3,2,0.0,1.0,1804,1909
1983-07-27,Antigua and Barbuda,Trinidad and Tobago,1,2,1,0.0,1.0,1462,1618
1983-07-27,French Guiana,Martinique,0,0,0,0.5,0.5,1481,1626
1983-07-27,Mali,Senegal,1,2,1,0.0,1.0,1597,1649
1983-07-27,Mauritania,Guinea-Bissau,1,2,1,0.0,1.0,1430,1502
1983-07-27,Panama,Cuba,0,0,0,0.5,0.5,1429,1520
1983-07-28,Chile,Brazil,0,0,0,0.5,0.5,1707,2003
1983-07-28,Mauritania,Mali,0,2,2,0.0,1.0,1426,1602
1983-07-29,Colombia,Ecuador,0,0,0,0.5,0.5,1545,1504
1983-07-29,Guatemala,South Korea,1,1,0,0.5,0.5,1594,1823
1983-07-29,Guinea-Bissau,Senegal,0,3,3,0.0,1.0,1498,1654
1983-07-31,Panama,Cuba,1,0,1,1.0,0.0,1440,1510
1983-08-02,Congo,Cameroon,2,2,0,0.5,0.5,1613,1655
1983-08-02,Costa Rica,Cuba,3,0,3,1.0,0.0,1658,1506
1983-08-03,Bolivia,Paraguay,2,1,1,1.0,0.0,1554,1685
1983-08-03,Chile,Peru,2,0,2,1.0,0.0,1715,1686
1983-08-03,Guatemala,South Korea,2,1,1,1.0,0.0,1607,1811
1983-08-04,Costa Rica,Cuba,2,0,2,1.0,0.0,1663,1502
1983-08-05,Bolivia,Paraguay,1,3,2,0.0,1.0,1549,1691
1983-08-07,Algeria,Bulgaria,2,3,1,0.0,1.0,1695,1668
1983-08-07,Vanuatu,Tahiti,1,5,4,0.0,1.0,1444,1672
1983-08-08,Iceland,Faroe Islands,6,0,6,1.0,0.0,1535,1453
1983-08-09,Costa Rica,South Korea,1,1,0,0.5,0.5,1667,1808
1983-08-10,Ecuador,Argentina,2,2,0,0.5,0.5,1511,1862
1983-08-10,Norway,Romania,0,0,0,0.5,0.5,1568,1720
1983-08-11,Peru,Uruguay,1,1,0,0.5,0.5,1688,1745
1983-08-11,Vanuatu,Tahiti,1,6,5,0.0,1.0,1441,1676
1983-08-12,Mauritania,Togo,0,4,4,0.0,1.0,1422,1583
1983-08-13,Senegal,Algeria,1,1,0,0.5,0.5,1655,1695
1983-08-14,Bolivia,Colombia,0,1,1,0.0,1.0,1541,1554
1983-08-14,Cameroon,Sudan,5,0,5,1.0,0.0,1661,1560
1983-08-14,Egypt,Tunisia,1,0,1,1.0,0.0,1698,1675
1983-08-14,Madagascar,Malawi,0,1,1,0.0,1.0,1595,1657
1983-08-14,Nigeria,Morocco,0,0,0,0.5,0.5,1667,1687
1983-08-14,Vanuatu,Tahiti,1,1,0,0.5,0.5,1446,1672
1983-08-16,Fiji,New Zealand,2,0,2,1.0,0.0,1480,1673
1983-08-17,Chile,Paraguay,3,2,1,1.0,0.0,1723,1684
1983-08-17,Ecuador,Brazil,0,1,1,0.0,1.0,1511,2004
1983-08-17,Iceland,Sweden,0,4,4,0.0,1.0,1531,1716
1983-08-17,Peru,Colombia,1,0,1,1.0,0.0,1694,1549
1983-08-18,Fiji,New Zealand,0,1,1,0.0,1.0,1477,1677
1983-08-20,Greece,Libya,3,2,1,1.0,0.0,1623,1625
1983-08-20,Niue,Tahiti,0,14,14,0.0,1.0,1496,1677
1983-08-20,Tonga,Wallis Islands and Futuna,0,3,3,0.0,1.0,1479,1479
1983-08-20,Samoa,American Samoa,3,1,2,1.0,0.0,1485,1492
1983-08-21,Bolivia,Peru,1,1,0,0.5,0.5,1545,1691
1983-08-22,American Samoa,Wallis Islands and Futuna,3,0,3,1.0,0.0,1500,1472
1983-08-22,Niue,Papua New Guinea,0,19,19,0.0,1.0,1489,1507
1983-08-22,Samoa,Tonga,3,3,0,0.5,0.5,1485,1480
1983-08-22,Fiji,Solomon Islands,10,0,10,1.0,0.0,1486,1475
1983-08-24,American Samoa,Tonga,2,3,1,0.0,1.0,1492,1489
1983-08-24,Argentina,Brazil,1,0,1,1.0,0.0,1874,1993
1983-08-24,Chile,Bolivia,4,2,2,1.0,0.0,1728,1541
1983-08-24,Romania,German DR,1,0,1,1.0,0.0,1730,1795
1983-08-24,Samoa,Wallis Islands and Futuna,1,2,1,0.0,1.0,1477,1481
1983-08-24,Turkey,Libya,0,0,0,0.5,0.5,1569,1624
1983-08-24,Papua New Guinea,Tahiti,1,2,1,0.0,1.0,1503,1682
1983-08-25,Algeria,Ivory Coast,3,0,3,1.0,0.0,1701,1599
1983-08-25,Uruguay,Paraguay,0,0,0,0.5,0.5,1744,1686
1983-08-26,Fiji,Vanuatu,6,0,6,1.0,0.0,1494,1439
1983-08-28,Algeria,Senegal,2,0,2,1.0,0.0,1708,1649
1983-08-28,Colombia,Peru,2,2,0,0.5,0.5,1553,1688
1983-08-28,Malawi,Madagascar,1,1,0,0.5,0.5,1656,1597
1983-08-28,Morocco,Nigeria,0,0,0,0.5,0.5,1687,1668
1983-08-28,Sudan,Cameroon,2,0,2,1.0,0.0,1571,1651
1983-08-28,Togo,Ethiopia,3,0,3,1.0,0.0,1591,1564
1983-08-28,Tunisia,Egypt,0,0,0,0.5,0.5,1676,1698
1983-08-29,Libya,Zimbabwe,3,1,2,1.0,0.0,1632,1575
1983-08-31,Colombia,Bolivia,2,2,0,0.5,0.5,1553,1542
1983-08-31,Greece,Bulgaria,2,3,1,0.0,1.0,1617,1675
1983-09-01,Brazil,Ecuador,5,0,5,1.0,0.0,1994,1511
1983-09-01,Uruguay,Chile,2,1,1,1.0,0.0,1752,1721
1983-09-03,Malaysia,Singapore,0,0,0,0.5,0.5,1573,1527
1983-09-04,Peru,Bolivia,2,1,1,1.0,0.0,1693,1538
1983-09-04,Uruguay,Venezuela,3,0,3,1.0,0.0,1755,1464
1983-09-07,Argentina,Ecuador,2,2,0,0.5,0.5,1868,1518
1983-09-07,Denmark,France,3,1,2,1.0,0.0,1714,1823
1983-09-07,Finland,Sweden,0,3,3,0.0,1.0,1512,1720
1983-09-07,Hungary,Germany,1,1,0,0.5,0.5,1769,1950
1983-09-07,Netherlands,Iceland,3,0,3,1.0,0.0,1791,1529
1983-09-07,Norway,Bulgaria,1,2,1,0.0,1.0,1563,1681
1983-09-07,Poland,Romania,2,2,0,0.5,0.5,1843,1733
1983-09-07,Switzerland,Czechoslovakia,0,0,0,0.5,0.5,1702,1785
1983-09-08,Chile,Venezuela,5,0,5,1.0,0.0,1724,1462
1983-09-10,Singapore,Malaysia,0,1,1,0.0,1.0,1521,1580
1983-09-11,Chile,Uruguay,2,0,2,1.0,0.0,1733,1747
1983-09-11,New Caledonia,Vanuatu,6,2,4,1.0,0.0,1615,1435
1983-09-11,New Caledonia,Solomon Islands,1,0,1,1.0,0.0,1620,1471
1983-09-13,Fiji,New Caledonia,5,1,4,1.0,0.0,1505,1610
1983-09-14,Brazil,Argentina,0,0,0,0.5,0.5,1992,1871
1983-09-14,Fiji,New Caledonia,3,2,1,1.0,0.0,1516,1600
1983-09-14,Fiji,Papua New Guinea,2,0,2,1.0,0.0,1524,1496
1983-09-14,New Caledonia,Wallis Islands and Futuna,4,0,4,1.0,0.0,1606,1476
1983-09-14,Papua New Guinea,Tahiti,1,6,5,0.0,1.0,1492,1687
1983-09-14,Samoa,Tahiti,0,2,2,0.0,1.0,1474,1691
1983-09-15,Fiji,Tahiti,0,1,1,0.0,1.0,1520,1696
1983-09-15,New Caledonia,Papua New Guinea,2,1,1,1.0,0.0,1612,1487
1983-09-18,Venezuela,Uruguay,1,2,1,0.0,1.0,1460,1750
1983-09-19,Ghana,Thailand,2,1,1,1.0,0.0,1740,1606
1983-09-19,Malaysia,Nepal,7,0,7,1.0,0.0,1586,1483
1983-09-21,Belgium,Netherlands,1,1,0,0.5,0.5,1834,1793
1983-09-21,England,Denmark,0,1,1,0.0,1.0,1877,1726
1983-09-21,Iceland,Republic of Ireland,0,3,3,0.0,1.0,1524,1662
1983-09-21,Northern Ireland,Austria,3,1,2,1.0,0.0,1721,1835
1983-09-21,Norway,Wales,0,0,0,0.5,0.5,1567,1746
1983-09-21,Portugal,Finland,5,0,5,1.0,0.0,1749,1509
1983-09-21,Scotland,Uruguay,2,0,2,1.0,0.0,1789,1743
1983-09-21,Sweden,Czechoslovakia,1,0,1,1.0,0.0,1730,1776
1983-09-21,Venezuela,Chile,0,0,0,0.5,0.5,1466,1728
1983-09-22,Bangladesh,Nepal,1,0,1,1.0,0.0,1446,1474
1983-09-25,Ivory Coast,Liberia,0,0,0,0.5,0.5,1597,1506
1983-09-26,Israel,Uruguay,2,2,0,0.5,0.5,1676,1742
1983-09-27,Ghana,Togo,1,1,0,0.5,0.5,1737,1595
1983-09-28,Ghana,Liberia,1,0,1,1.0,0.0,1741,1503
1983-09-28,Ivory Coast,Togo,3,0,3,1.0,0.0,1605,1588
1983-09-28,Malaysia,Bangladesh,1,0,1,1.0,0.0,1591,1442
1983-09-30,Ivory Coast,Ghana,0,2,2,0.0,1.0,1600,1747
1983-09-30,Liberia,Togo,0,4,4,0.0,1.0,1497,1595
1983-10-02,Ghana,Togo,3,1,2,1.0,0.0,1752,1591
1983-10-02,Ivory Coast,Liberia,2,1,1,1.0,0.0,1606,1492
1983-10-05,France,Spain,1,1,0,0.5,0.5,1824,1824
1983-10-05,Germany,Austria,3,0,3,1.0,0.0,1956,1830
1983-10-05,Italy,Greece,3,0,3,1.0,0.0,1848,1614
1983-10-05,Peru,Paraguay,0,2,2,0.0,1.0,1685,1695
1983-10-07,Paraguay,Peru,4,1,3,1.0,0.0,1703,1678
1983-10-08,Sierra Leone,Mali,1,0,1,1.0,0.0,1495,1592
1983-10-09,Libya,Malta,4,0,4,1.0,0.0,1637,1461
1983-10-09,Russia,Poland,2,0,2,1.0,0.0,1916,1837
1983-10-12,Denmark,Luxembourg,6,0,6,1.0,0.0,1728,1357
1983-10-12,German DR,Switzerland,3,0,3,1.0,0.0,1801,1697
1983-10-12,Hungary,England,0,3,3,0.0,1.0,1764,1883
1983-10-12,Republic of Ireland,Netherlands,2,3,1,0.0,1.0,1657,1799
1983-10-12,Scotland,Belgium,1,1,0,0.5,0.5,1791,1833
1983-10-12,Turkey,Northern Ireland,1,0,1,1.0,0.0,1581,1710
1983-10-12,Wales,Romania,5,0,5,1.0,0.0,1754,1726
1983-10-12,Yugoslavia,Norway,2,1,1,1.0,0.0,1815,1564
1983-10-13,Paraguay,Brazil,1,1,0,0.5,0.5,1709,1987
1983-10-13,Peru,Uruguay,0,1,1,0.0,1.0,1672,1749
1983-10-15,Italy,Sweden,0,3,3,0.0,1.0,1838,1741
1983-10-20,Brazil,Paraguay,0,0,0,0.5,0.5,1982,1715
1983-10-20,Uruguay,Peru,1,1,0,0.5,0.5,1748,1674
1983-10-22,Tanzania,Malawi,1,1,0,0.5,0.5,1566,1654
1983-10-24,Tanzania,Malawi,0,0,0,0.5,0.5,1568,1653
1983-10-25,El Salvador,Mexico,0,5,5,0.0,1.0,1627,1761
1983-10-26,Czechoslovakia,Bulgaria,1,2,1,0.0,1.0,1766,1692
1983-10-26,Germany,Turkey,5,1,4,1.0,0.0,1958,1580
1983-10-26,Hungary,Denmark,1,0,1,1.0,0.0,1772,1721
1983-10-26,Switzerland,Yugoslavia,2,0,2,1.0,0.0,1708,1805
1983-10-26,Zanzibar,Malawi,0,1,1,0.0,1.0,1342,1656
1983-10-27,Uruguay,Brazil,2,0,2,1.0,0.0,1761,1970
1983-10-28,Poland,Portugal,0,1,1,0.0,1.0,1828,1759
1983-10-29,Tanzania,Malawi,1,0,1,1.0,0.0,1578,1647
1983-11-04,Brazil,Uruguay,1,1,0,0.5,0.5,1966,1766
1983-11-08,Israel,Romania,1,1,0,0.5,0.5,1678,1725
1983-11-09,Switzerland,Belgium,3,1,2,1.0,0.0,1719,1823
1983-11-12,Cyprus,Romania,0,1,1,0.0,1.0,1388,1728
1983-11-12,Kenya,Uganda,2,1,1,1.0,0.0,1614,1604
1983-11-12,Yugoslavia,France,0,0,0,0.5,0.5,1806,1824
1983-11-13,Ethiopia,Tanzania,1,1,0,0.5,0.5,1565,1578
1983-11-13,Malawi,Zimbabwe,0,1,1,0.0,1.0,1638,1585
1983-11-13,Niger,Mali,1,1,0,0.5,0.5,1481,1590
1983-11-13,Portugal,Russia,1,0,1,1.0,0.0,1771,1905
1983-11-14,Niger,Mali,1,1,0,0.5,0.5,1484,1588
1983-11-14,Somalia,Zanzibar,1,1,0,0.5,0.5,1424,1344
1983-11-14,Sudan,Uganda,1,2,1,0.0,1.0,1564,1612
1983-11-15,Kenya,Ethiopia,2,0,2,1.0,0.0,1621,1559
1983-11-15,Nigeria,Senegal,1,0,1,1.0,0.0,1676,1642
1983-11-16,Bulgaria,Wales,1,0,1,1.0,0.0,1702,1745
1983-11-16,Czechoslovakia,Italy,2,0,2,1.0,0.0,1776,1829
1983-11-16,German DR,Scotland,2,1,1,1.0,0.0,1809,1784
1983-11-16,Germany,Northern Ireland,0,1,1,0.0,1.0,1946,1723
1983-11-16,Greece,Denmark,0,2,2,0.0,1.0,1609,1727
1983-11-16,Republic of Ireland,Malta,8,0,8,1.0,0.0,1661,1458
1983-11-16,Luxembourg,England,0,4,4,0.0,1.0,1357,1884
1983-11-16,Netherlands,Spain,2,1,1,1.0,0.0,1808,1816
1983-11-16,Sudan,Tanzania,1,0,1,1.0,0.0,1573,1570
1983-11-16,Trinidad and Tobago,Sweden,0,5,5,0.0,1.0,1613,1747
1983-11-16,Turkey,Austria,3,1,2,1.0,0.0,1593,1818
1983-11-16,Zanzibar,Zimbabwe,1,2,1,0.0,1.0,1341,1589
1983-11-17,Ethiopia,Uganda,1,2,1,0.0,1.0,1553,1619
1983-11-17,Malawi,Somalia,2,1,1,1.0,0.0,1642,1421
1983-11-18,Kenya,Tanzania,0,0,0,0.5,0.5,1620,1572
1983-11-19,Barbados,Sweden,0,4,4,0.0,1.0,1484,1750
1983-11-19,Ethiopia,Sudan,0,2,2,0.0,1.0,1546,1581
1983-11-19,Senegal,Nigeria,0,1,1,0.0,1.0,1635,1684
1983-11-19,Somalia,Zimbabwe,1,2,1,0.0,1.0,1417,1594
1983-11-20,Germany,Albania,2,1,1,1.0,0.0,1948,1479
1983-11-20,Malawi,Zanzibar,3,1,2,1.0,0.0,1645,1339
1983-11-20,Sri Lanka,Singapore,0,4,4,0.0,1.0,1371,1526
1983-11-20,Tanzania,Uganda,1,1,0,0.5,0.5,1574,1618
1983-11-21,Kenya,Sudan,1,0,1,1.0,0.0,1628,1574
1983-11-22,Mexico,Sweden,2,0,2,1.0,0.0,1769,1743
1983-11-23,Kenya,Malawi,2,0,2,1.0,0.0,1637,1637
1983-11-23,Uganda,Zimbabwe,0,1,1,0.0,1.0,1610,1603
1983-11-25,Malawi,Uganda,1,2,1,0.0,1.0,1629,1619
1983-11-26,Kenya,Zimbabwe,1,0,1,1.0,0.0,1645,1596
1983-11-29,Martinique,Mexico,4,4,0,0.5,0.5,1630,1766
1983-11-30,Algeria,Switzerland,1,2,1,0.0,1.0,1701,1727
1983-11-30,Czechoslovakia,Romania,1,1,0,0.5,0.5,1775,1730
1983-12-02,Ivory Coast,Switzerland,1,0,1,1.0,0.0,1617,1717
1983-12-03,Greece,Hungary,2,2,0,0.5,0.5,1613,1769
1983-12-04,Australia,China PR,1,2,1,0.0,1.0,1664,1710
1983-12-04,Zimbabwe,Switzerland,3,2,1,1.0,0.0,1607,1707
1983-12-06,Kenya,Switzerland,0,0,0,0.5,0.5,1647,1706
1983-12-06,Mexico,Canada,5,0,5,1.0,0.0,1771,1572
1983-12-08,Belize,Canada,0,2,2,0.0,1.0,1494,1579
1983-12-08,Kenya,Ethiopia,2,2,0,0.5,0.5,1645,1549
1983-12-10,Kenya,Ethiopia,1,0,1,1.0,0.0,1651,1544
1983-12-11,Honduras,Canada,3,1,2,1.0,0.0,1658,1573
1983-12-11,Singapore,Brunei,4,0,4,1.0,0.0,1532,1431
1983-12-12,Kenya,Ethiopia,2,1,1,1.0,0.0,1657,1539
1983-12-13,Northern Ireland,Scotland,2,0,2,1.0,0.0,1733,1775
1983-12-14,Greece,Luxembourg,1,0,1,1.0,0.0,1616,1355
1983-12-14,Honduras,Canada,1,0,1,1.0,0.0,1665,1567
1983-12-14,Singapore,China PR,1,0,1,1.0,0.0,1544,1699
1983-12-14,Wales,Yugoslavia,1,1,0,0.5,0.5,1747,1805
1983-12-15,Ivory Coast,Mali,1,1,0,0.5,0.5,1617,1589
1983-12-16,Nigeria,Togo,2,5,3,0.0,1.0,1674,1602
1983-12-17,Netherlands,Malta,5,0,5,1.0,0.0,1810,1457
1983-12-17,Singapore,Australia,2,4,2,0.0,1.0,1539,1670
1983-12-18,Ivory Coast,Togo,2,1,1,1.0,0.0,1625,1595
1983-12-18,Mali,Nigeria,0,0,0,0.5,0.5,1591,1673
1983-12-20,Ivory Coast,Togo,1,0,1,1.0,0.0,1633,1588
1983-12-21,Spain,Malta,12,1,11,1.0,0.0,1818,1456
1983-12-21,Yugoslavia,Bulgaria,3,2,1,1.0,0.0,1811,1697
1983-12-22,Italy,Cyprus,3,1,2,1.0,0.0,1831,1387
1984-01-02,Gambia,Senegal,2,2,0,0.5,0.5,1499,1632
1984-01-02,Mauritania,Sierra Leone,0,1,1,0.0,1.0,1416,1502
1984-01-04,Gambia,Sierra Leone,1,0,1,1.0,0.0,1508,1494
1984-01-04,Mauritania,Senegal,0,2,2,0.0,1.0,1413,1636
1984-01-08,Ivory Coast,Sierra Leone,1,0,1,1.0,0.0,1638,1490
1984-01-11,India,Poland,1,2,1,0.0,1.0,1524,1831
1984-01-14,India,Argentina,0,1,1,0.0,1.0,1523,1873
1984-01-15,China PR,Poland,0,1,1,0.0,1.0,1694,1837
1984-01-15,Ivory Coast,Morocco,3,3,0,0.5,0.5,1640,1686
1984-01-17,Argentina,Poland,1,1,0,0.5,0.5,1873,1838
1984-01-17,Gambia,Guinea,1,0,1,1.0,0.0,1518,1578
1984-01-18,Senegal,Guinea,1,0,1,1.0,0.0,1643,1572
1984-01-18,Spain,Hungary,0,1,1,0.0,1.0,1809,1779
1984-01-20,Argentina,China PR,0,1,1,0.0,1.0,1862,1706
1984-01-20,Egypt,Turkey,1,0,1,1.0,0.0,1704,1588
1984-01-22,Egypt,Turkey,0,1,1,0.0,1.0,1694,1599
1984-01-22,Ivory Coast,Guinea,3,0,3,1.0,0.0,1647,1566
1984-01-25,India,China PR,0,3,3,0.0,1.0,1519,1711
1984-01-27,China PR,Poland,0,1,1,0.0,1.0,1706,1844
1984-01-29,Gambia,Ghana,0,1,1,0.0,1.0,1515,1756
1984-01-29,Ivory Coast,Mali,4,1,3,1.0,0.0,1654,1585
1984-01-29,Liberia,Senegal,0,0,0,0.5,0.5,1496,1640
1984-01-31,Guinea,Ghana,1,2,1,0.0,1.0,1562,1761
1984-01-31,Ivory Coast,Senegal,1,0,1,1.0,0.0,1662,1633
1984-01-31,Liberia,Mali,2,2,0,0.5,0.5,1499,1583
1984-02-02,Ivory Coast,Liberia,4,1,3,1.0,0.0,1667,1495
1984-02-02,Mali,Senegal,1,1,0,0.5,0.5,1585,1632
1984-02-04,Italy,Mexico,5,0,5,1.0,0.0,1838,1765
1984-02-05,Ivory Coast,Senegal,4,3,1,1.0,0.0,1675,1625
1984-02-05,Liberia,Mali,0,1,1,0.0,1.0,1490,1591
1984-02-05,Morocco,Bulgaria,1,1,0,0.5,0.5,1687,1697
1984-02-07,Algeria,Romania,1,1,0,0.5,0.5,1702,1730
1984-02-08,Congo,Ivory Coast,2,3,1,0.0,1.0,1607,1682
1984-02-08,Gambia,Guinea,2,2,0,0.5,0.5,1517,1561
1984-02-08,Sierra Leone,Cape Verde,2,0,2,1.0,0.0,1498,1471
1984-02-09,Guinea-Bissau,Senegal,2,3,1,0.0,1.0,1493,1631
1984-02-09,Mali,Mauritania,1,0,1,1.0,0.0,1596,1409
1984-02-10,Cape Verde,Guinea,1,1,0,0.5,0.5,1474,1559
1984-02-10,Sierra Leone,Gambia,1,0,1,1.0,0.0,1507,1509
1984-02-11,Guinea-Bissau,Mauritania,2,1,1,1.0,0.0,1500,1403
1984-02-11,Mali,Senegal,1,0,1,1.0,0.0,1605,1623
1984-02-12,Cape Verde,Gambia,0,2,2,0.0,1.0,1467,1517
1984-02-12,Malawi,Zambia,1,0,1,1.0,0.0,1639,1668
1984-02-12,Sierra Leone,Guinea,0,0,0,0.5,0.5,1509,1558
1984-02-13,Guinea-Bissau,Mali,1,0,1,1.0,0.0,1511,1595
1984-02-13,Mauritania,Senegal,0,6,6,0.0,1.0,1400,1627
1984-02-15,Bulgaria,Germany,2,3,1,0.0,1.0,1694,1952
1984-02-15,Gambia,Senegal,0,1,1,0.0,1.0,1512,1633
1984-02-15,Greece,German DR,1,3,2,0.0,1.0,1613,1813
1984-02-15,Malawi,Zambia,0,0,0,0.5,0.5,1640,1668
1984-02-15,Togo,Ghana,2,1,1,1.0,0.0,1600,1750
1984-02-16,Sierra Leone,Mali,0,0,0,0.5,0.5,1511,1594
1984-02-18,Gambia,Mali,0,2,2,0.0,1.0,1506,1601
1984-02-19,Gabon,Togo,1,1,0,0.5,0.5,1464,1597
1984-02-19,Sierra Leone,Senegal,0,0,0,0.5,0.5,1514,1631
1984-02-21,Saudi Arabia,Algeria,4,2,2,1.0,0.0,1609,1692
1984-02-26,Peru,Honduras,1,3,2,0.0,1.0,1666,1674
1984-02-27,Egypt,Iraq,1,2,1,0.0,1.0,1689,1822
1984-02-28,Scotland,Wales,2,1,1,1.0,0.0,1783,1740
1984-02-29,Belgium,Germany,0,1,1,0.0,1.0,1818,1958
1984-02-29,Egypt,Iraq,0,0,0,0.5,0.5,1692,1820
1984-02-29,France,England,2,0,2,1.0,0.0,1834,1875
1984-02-29,Luxembourg,Spain,0,1,1,0.0,1.0,1354,1811
1984-03-03,Turkey,Italy,1,2,1,0.0,1.0,1596,1842
1984-03-04,Cameroon,Egypt,0,1,1,0.0,1.0,1644,1700
1984-03-04,Ivory Coast,Togo,3,0,3,1.0,0.0,1689,1591
1984-03-05,Algeria,Malawi,3,0,3,1.0,0.0,1699,1634
1984-03-05,Ghana,Nigeria,1,2,1,0.0,1.0,1741,1683
1984-03-06,Brunei,Japan,1,7,6,0.0,1.0,1428,1663
1984-03-07,Cameroon,Togo,4,1,3,1.0,0.0,1651,1585
1984-03-07,Ivory Coast,Egypt,1,2,1,0.0,1.0,1682,1708
1984-03-07,Romania,Greece,2,0,2,1.0,0.0,1736,1608
1984-03-08,Algeria,Ghana,2,0,2,1.0,0.0,1708,1733
1984-03-08,Malawi,Nigeria,2,2,0,0.5,0.5,1636,1682
1984-03-09,Kuwait,Finland,1,0,1,1.0,0.0,1752,1506
1984-03-09,Oman,Bahrain,0,1,1,0.0,1.0,1384,1472
1984-03-10,Egypt,Togo,0,0,0,0.5,0.5,1706,1588
1984-03-10,Ivory Coast,Cameroon,0,2,2,0.0,1.0,1674,1660
1984-03-10,Kuwait,United Arab Emirates,0,2,2,0.0,1.0,1739,1499
1984-03-10,Saudi Arabia,Qatar,1,2,1,0.0,1.0,1599,1514
1984-03-11,Algeria,Nigeria,0,0,0,0.5,0.5,1708,1683
1984-03-11,Ghana,Malawi,1,0,1,1.0,0.0,1739,1631
1984-03-11,Luxembourg,Turkey,1,3,2,0.0,1.0,1351,1600
1984-03-11,Oman,Iraq,1,2,1,0.0,1.0,1383,1822
1984-03-12,Bahrain,Kuwait,0,1,1,0.0,1.0,1470,1742
1984-03-13,Panama,Cuba,1,1,0,0.5,0.5,1442,1501
1984-03-13,Qatar,United Arab Emirates,0,1,1,0.0,1.0,1506,1508
1984-03-14,Algeria,Cameroon,0,0,0,0.5,0.5,1707,1662
1984-03-14,Egypt,Nigeria,2,2,0,0.5,0.5,1706,1684
1984-03-14,Netherlands,Denmark,6,0,6,1.0,0.0,1817,1721
1984-03-15,Iraq,United Arab Emirates,0,0,0,0.5,0.5,1817,1514
1984-03-15,Oman,Saudi Arabia,1,3,2,0.0,1.0,1380,1603
1984-03-16,Kuwait,Qatar,1,2,1,0.0,1.0,1730,1519
1984-03-17,Algeria,Egypt,3,1,2,1.0,0.0,1715,1699
1984-03-17,Iraq,Saudi Arabia,4,0,4,1.0,0.0,1821,1600
1984-03-18,Bahrain,United Arab Emirates,1,1,0,0.5,0.5,1472,1513
1984-03-18,Cameroon,Nigeria,3,1,2,1.0,0.0,1671,1676
1984-03-18,Oman,Qatar,0,2,2,0.0,1.0,1376,1524
1984-03-18,Panama,Cuba,0,1,1,0.0,1.0,1436,1508
1984-03-20,Bahrain,Iraq,0,1,1,0.0,1.0,1471,1823
1984-03-20,Saudi Arabia,Kuwait,1,1,0,0.5,0.5,1603,1728
1984-03-21,Oman,United Arab Emirates,1,1,0,0.5,0.5,1380,1510
1984-03-22,Bahrain,Qatar,1,1,0,0.5,0.5,1473,1523
1984-03-22,Iraq,Kuwait,3,1,2,1.0,0.0,1829,1723
1984-03-23,Djibouti,Ethiopia,0,2,2,0.0,1.0,1432,1545
1984-03-23,Saudi Arabia,United Arab Emirates,2,0,2,1.0,0.0,1609,1505
1984-03-24,Panama,Costa Rica,1,1,0,0.5,0.5,1441,1663
1984-03-25,Iraq,Qatar,1,2,1,0.0,1.0,1816,1537
1984-03-25,Oman,Kuwait,0,0,0,0.5,0.5,1387,1717
1984-03-26,Bahrain,Saudi Arabia,0,2,2,0.0,1.0,1468,1615
1984-03-27,Switzerland,Poland,1,1,0,0.5,0.5,1710,1841
1984-03-28,France,Austria,1,0,1,1.0,0.0,1842,1811
1984-03-28,German DR,Czechoslovakia,2,1,1,1.0,0.0,1821,1768
1984-03-28,Germany,Russia,2,1,1,1.0,0.0,1965,1899
1984-03-28,Haiti,Canada,0,1,1,0.0,1.0,1605,1577
1984-03-28,Iraq,Qatar,1,1,0,0.5,0.5,1811,1543
1984-03-31,New Zealand,Malaysia,2,0,2,1.0,0.0,1684,1585
1984-03-31,Yugoslavia,Hungary,2,1,1,1.0,0.0,1819,1772
1984-03-31,Alderney,Guernsey,0,6,6,0.0,1.0,1303,1660
1984-04-02,Kuwait,Bulgaria,1,1,0,0.5,0.5,1717,1695
1984-04-03,New Zealand,Malaysia,6,1,5,1.0,0.0,1690,1580
1984-04-04,England,Northern Ireland,1,0,1,1.0,0.0,1880,1729
1984-04-04,Israel,Republic of Ireland,3,0,3,1.0,0.0,1686,1654
1984-04-04,Turkey,Hungary,0,6,6,0.0,1.0,1596,1777
1984-04-07,Italy,Czechoslovakia,1,1,0,0.5,0.5,1841,1770
1984-04-08,New Zealand,Malaysia,0,0,0,0.5,0.5,1688,1583
1984-04-11,Greece,Cyprus,1,1,0,0.5,0.5,1604,1392
1984-04-11,Romania,Israel,0,0,0,0.5,0.5,1735,1688
1984-04-11,Spain,Denmark,2,1,1,1.0,0.0,1817,1716
1984-04-12,Kenya,China PR,1,0,1,1.0,0.0,1667,1697
1984-04-17,Poland,Belgium,0,1,1,0.0,1.0,1833,1827
1984-04-18,Austria,Greece,0,0,0,0.5,0.5,1807,1609
1984-04-18,France,Germany,1,0,1,1.0,0.0,1853,1955
1984-04-27,Panama,Nicaragua,2,0,2,1.0,0.0,1448,1351
1984-04-29,Jamaica,Haiti,0,1,1,0.0,1.0,1470,1611
1984-05-01,Luxembourg,Norway,0,2,2,0.0,1.0,1348,1568
1984-05-02,Cyprus,Austria,1,2,1,0.0,1.0,1391,1809
1984-05-02,Switzerland,Sweden,0,0,0,0.5,0.5,1711,1743
1984-05-02,Wales,England,1,0,1,1.0,0.0,1752,1869
1984-05-09,Jersey,Guernsey,6,2,4,1.0,0.0,1692,1653
1984-05-15,Finland,Russia,1,3,2,0.0,1.0,1505,1901
1984-05-16,Czechoslovakia,Denmark,1,0,1,1.0,0.0,1777,1710
1984-05-19,Réunion,Tanzania,1,1,0,0.5,0.5,1468,1572
1984-05-22,Germany,Italy,1,0,1,1.0,0.0,1961,1836
1984-05-22,Wales,Northern Ireland,1,1,0,0.5,0.5,1752,1730
1984-05-23,Hungary,Norway,0,0,0,0.5,0.5,1773,1573
1984-05-23,Republic of Ireland,Poland,0,0,0,0.5,0.5,1658,1830
1984-05-23,Sweden,Malta,4,0,4,1.0,0.0,1746,1454
1984-05-26,Canada,Italy,0,2,2,0.0,1.0,1575,1839
1984-05-26,Scotland,England,1,1,0,0.5,0.5,1785,1868
1984-05-26,Switzerland,Spain,0,4,4,0.0,1.0,1706,1823
1984-05-27,Finland,Northern Ireland,1,0,1,1.0,0.0,1518,1718
1984-05-29,El Salvador,Panama,2,1,1,1.0,0.0,1632,1444
1984-05-30,United States,Italy,0,0,0,0.5,0.5,1548,1834
1984-05-31,Hungary,Spain,1,1,0,0.5,0.5,1775,1822
1984-05-31,Japan,China PR,1,0,1,1.0,0.0,1672,1689
1984-06-01,France,Scotland,2,0,2,1.0,0.0,1860,1779
1984-06-02,England,Russia,0,2,2,0.0,1.0,1861,1909
1984-06-02,Portugal,Yugoslavia,2,3,1,0.0,1.0,1765,1826
1984-06-03,China PR,Republic of Ireland,0,1,1,0.0,1.0,1681,1667
1984-06-03,Ethiopia,Djibouti,2,0,2,1.0,0.0,1551,1427
1984-06-03,South Korea,Guatemala,2,0,2,1.0,0.0,1812,1604
1984-06-06,Belgium,Hungary,2,2,0,0.5,0.5,1826,1777
1984-06-06,Norway,Wales,1,0,1,1.0,0.0,1585,1741
1984-06-06,Sweden,Denmark,0,1,1,0.0,1.0,1738,1719
1984-06-07,Djibouti,Zimbabwe,1,3,2,0.0,1.0,1423,1612
1984-06-07,Liechtenstein,Austria,0,6,6,0.0,1.0,1510,1812
1984-06-07,Spain,Yugoslavia,0,1,1,0.0,1.0,1815,1834
1984-06-08,Denmark,Bulgaria,1,1,0,0.5,0.5,1719,1696
1984-06-09,Luxembourg,Portugal,1,2,1,0.0,1.0,1347,1767
1984-06-09,Trinidad and Tobago,India,1,2,1,0.0,1.0,1603,1530
1984-06-10,Brazil,England,0,2,2,0.0,1.0,1956,1872
1984-06-10,Israel,Wales,0,0,0,0.5,0.5,1690,1740
1984-06-10,Zambia,Zimbabwe,1,1,0,0.5,0.5,1667,1614
1984-06-11,Ethiopia,Zimbabwe,2,0,2,1.0,0.0,1561,1605
1984-06-11,Trinidad and Tobago,India,3,0,3,1.0,0.0,1610,1524
1984-06-12,France,Denmark,1,0,1,1.0,0.0,1865,1715
1984-06-13,Belgium,Yugoslavia,2,0,2,1.0,0.0,1835,1826
1984-06-13,Uruguay,England,2,0,2,1.0,0.0,1777,1862
1984-06-14,Germany,Portugal,0,0,0,0.5,0.5,1957,1772
1984-06-14,Romania,Spain,1,1,0,0.5,0.5,1737,1814
1984-06-15,Panama,Honduras,0,3,3,0.0,1.0,1441,1678
1984-06-15,Suriname,India,6,2,4,1.0,0.0,1626,1519
1984-06-16,Denmark,Yugoslavia,5,0,5,1.0,0.0,1726,1816
1984-06-16,France,Belgium,5,0,5,1.0,0.0,1873,1828
1984-06-17,Brazil,Argentina,0,0,0,0.5,0.5,1954,1865
1984-06-17,Chile,England,0,0,0,0.5,0.5,1731,1860
1984-06-17,Germany,Romania,2,1,1,1.0,0.0,1961,1734
1984-06-17,Macau,Hong Kong,0,3,3,0.0,1.0,1461,1574
1984-06-17,Portugal,Spain,1,1,0,0.5,0.5,1773,1814
1984-06-17,Suriname,India,4,1,3,1.0,0.0,1632,1514
1984-06-18,Guyana,India,3,0,3,1.0,0.0,1459,1505
1984-06-19,Denmark,Belgium,3,2,1,1.0,0.0,1737,1818
1984-06-19,France,Yugoslavia,3,2,1,1.0,0.0,1880,1810
1984-06-20,Germany,Spain,0,1,1,0.0,1.0,1950,1826
1984-06-20,Iceland,Norway,0,1,1,0.0,1.0,1518,1592
1984-06-20,Portugal,Romania,1,0,1,1.0,0.0,1781,1727
1984-06-21,Brazil,Uruguay,1,0,1,1.0,0.0,1959,1773
1984-06-21,China PR,India,2,0,2,1.0,0.0,1686,1501
1984-06-22,Trinidad and Tobago,India,3,0,3,1.0,0.0,1616,1496
1984-06-23,France,Portugal,3,2,1,1.0,0.0,1886,1776
1984-06-23,Morocco,Senegal,2,1,1,1.0,0.0,1694,1625
1984-06-24,Denmark,Spain,1,1,0,0.5,0.5,1740,1824
1984-06-24,Honduras,Panama,1,0,1,1.0,0.0,1682,1438
1984-06-27,El Salvador,Guatemala,3,1,2,1.0,0.0,1640,1597
1984-06-27,France,Spain,2,0,2,1.0,0.0,1893,1818
1984-06-30,Kenya,Cameroon,1,3,2,0.0,1.0,1660,1679
1984-06-30,Sierra Leone,Morocco,0,1,1,0.0,1.0,1510,1699
1984-07-01,Angola,Senegal,1,0,1,1.0,0.0,1538,1615
1984-07-01,Eswatini,Lesotho,3,1,2,1.0,0.0,1485,1433
1984-07-01,Zimbabwe,Zambia,2,1,1,1.0,0.0,1615,1658
1984-07-03,Egypt,Cameroon,2,1,1,1.0,0.0,1707,1672
1984-07-06,Malawi,Kenya,2,1,1,1.0,0.0,1640,1652
1984-07-08,Malawi,Kenya,1,1,0,0.5,0.5,1641,1652
1984-07-10,Malawi,Kenya,2,1,1,1.0,0.0,1650,1644
1984-07-15,Mauritius,Malawi,0,1,1,0.0,1.0,1547,1656
1984-07-15,Morocco,Sierra Leone,4,0,4,1.0,0.0,1704,1506
1984-07-15,Senegal,Angola,1,0,1,1.0,0.0,1622,1532
1984-07-15,Zambia,Congo,2,1,1,1.0,0.0,1665,1601
1984-07-18,Uruguay,Argentina,1,0,1,1.0,0.0,1784,1855
1984-07-20,Norway,Yugoslavia,1,1,0,0.5,0.5,1597,1806
1984-07-21,Guyana,Trinidad and Tobago,0,2,2,0.0,1.0,1455,1621
1984-07-22,Zimbabwe,Uganda,1,0,1,1.0,0.0,1624,1611
1984-07-25,Mauritania,Gambia,0,0,0,0.5,0.5,1403,1504
1984-07-26,Gambia,Guinea,1,1,0,0.5,0.5,1506,1557
1984-07-26,Colombia,Peru,1,1,0,0.5,0.5,1556,1664
1984-07-27,Mauritania,Guinea,1,1,0,0.5,0.5,1407,1554
1984-07-28,Benin,Congo,2,0,2,1.0,0.0,1486,1591
1984-07-28,Malawi,Mauritius,4,0,4,1.0,0.0,1662,1542
1984-07-28,Trinidad and Tobago,Guyana,3,1,2,1.0,0.0,1626,1451
1984-07-29,El Salvador,Puerto Rico,5,0,5,1.0,0.0,1644,1385
1984-07-29,Gambia,Guinea,0,1,1,0.0,1.0,1500,1561
1984-07-29,Romania,China PR,4,2,2,1.0,0.0,1735,1679
1984-07-29,Zambia,Uganda,3,0,3,1.0,0.0,1672,1605
1984-07-30,Ghana,Niger,1,0,1,1.0,0.0,1742,1482
1984-07-30,Mauritania,Gambia,1,1,0,0.5,0.5,1410,1498
1984-07-31,Mauritania,Guinea,0,2,2,0.0,1.0,1406,1566
1984-07-31,Romania,China PR,1,0,1,1.0,0.0,1742,1673
1984-08-01,Burkina Faso,Benin,3,1,2,1.0,0.0,1472,1478
1984-08-01,Faroe Islands,Iceland,0,0,0,0.5,0.5,1455,1517
1984-08-02,Argentina,Uruguay,0,0,0,0.5,0.5,1854,1786
1984-08-02,Mauritania,Guinea,0,0,0,0.5,0.5,1410,1563
1984-08-03,Burkina Faso,Ghana,0,2,2,0.0,1.0,1470,1745
1984-08-03,Greenland,Iceland,0,1,1,0.0,1.0,1468,1525
1984-08-04,Haiti,Antigua and Barbuda,4,0,4,1.0,0.0,1616,1458
1984-08-04,Tanzania,Uganda,0,1,1,0.0,1.0,1565,1613
1984-08-05,Faroe Islands,Greenland,1,0,1,1.0,0.0,1464,1460
1984-08-05,Puerto Rico,El Salvador,0,3,3,0.0,1.0,1383,1647
1984-08-06,Indonesia,Thailand,2,1,1,1.0,0.0,1528,1597
1984-08-07,Faroe Islands,Greenland,4,2,2,1.0,0.0,1472,1453
1984-08-07,Haiti,Antigua and Barbuda,1,2,1,0.0,1.0,1605,1470
1984-08-07,Iran,Bangladesh,5,0,5,1.0,0.0,1732,1440
1984-08-07,Syria,Philippines,2,0,2,1.0,0.0,1500,1347
1984-08-08,Republic of Ireland,Mexico,0,0,0,0.5,0.5,1670,1763
1984-08-09,Indonesia,Bangladesh,2,1,1,1.0,0.0,1535,1434
1984-08-09,Iran,Syria,3,1,2,1.0,0.0,1736,1497
1984-08-09,Peru,Colombia,0,0,0,0.5,0.5,1662,1559
1984-08-09,Thailand,Philippines,3,0,3,1.0,0.0,1601,1344
1984-08-11,German DR,Mexico,1,1,0,0.5,0.5,1820,1765
1984-08-11,Indonesia,Philippines,1,0,1,1.0,0.0,1539,1341
1984-08-11,Iran,Thailand,5,0,5,1.0,0.0,1742,1596
1984-08-11,Syria,Bangladesh,2,1,1,1.0,0.0,1504,1428
1984-08-12,Malaysia,Singapore,1,0,1,1.0,0.0,1590,1533
1984-08-13,Bangladesh,Philippines,3,2,1,1.0,0.0,1435,1335
1984-08-13,Indonesia,Iran,0,1,1,0.0,1.0,1536,1746
1984-08-13,Syria,Thailand,2,3,1,0.0,1.0,1499,1602
1984-08-15,Indonesia,Syria,1,2,1,0.0,1.0,1528,1508
1984-08-15,Iran,Philippines,7,1,6,1.0,0.0,1748,1334
1984-08-15,Suriname,Guyana,1,0,1,1.0,0.0,1637,1447
1984-08-15,Thailand,Bangladesh,2,1,1,1.0,0.0,1607,1431
1984-08-16,Finland,Mexico,0,3,3,0.0,1.0,1515,1769
1984-08-18,Iran,Syria,1,0,1,1.0,0.0,1752,1505
1984-08-18,Singapore,Malaysia,1,1,0,0.5,0.5,1535,1589
1984-08-18,Uganda,Tanzania,1,3,2,0.0,1.0,1604,1575
1984-08-19,Russia,Mexico,3,0,3,1.0,0.0,1914,1765
1984-08-22,Hungary,Switzerland,3,0,3,1.0,0.0,1784,1700
1984-08-22,Sweden,Mexico,1,1,0,0.5,0.5,1739,1765
1984-08-24,Colombia,Argentina,1,0,1,1.0,0.0,1573,1841
1984-08-25,Hungary,Mexico,0,2,2,0.0,1.0,1776,1774
1984-08-25,Liberia,Papua New Guinea,1,2,1,0.0,1.0,1482,1496
1984-08-25,Uganda,Zambia,1,0,1,1.0,0.0,1614,1663
1984-08-26,Malaysia,Indonesia,2,2,0,0.5,0.5,1588,1530
1984-08-28,Egypt,Zimbabwe,1,0,1,1.0,0.0,1714,1618
1984-08-29,German DR,Romania,2,1,1,1.0,0.0,1827,1736
1984-08-29,Guyana,Suriname,1,1,0,0.5,0.5,1451,1634
1984-08-29,Malaysia,Liberia,3,1,2,1.0,0.0,1594,1477
1984-08-29,Norway,Poland,1,1,0,0.5,0.5,1602,1826
1984-09-01,Cyprus,Greece,0,2,2,0.0,1.0,1388,1613
1984-09-01,Indonesia,Papua New Guinea,0,1,1,0.0,1.0,1522,1505
1984-09-01,Switzerland,Argentina,0,2,2,0.0,1.0,1696,1846
1984-09-04,Indonesia,Liberia,1,2,1,0.0,1.0,1513,1487
1984-09-04,Malaysia,Papua New Guinea,5,1,4,1.0,0.0,1600,1500
1984-09-04,Singapore,Qatar,0,1,1,0.0,1.0,1528,1551
1984-09-05,Belgium,Argentina,0,2,2,0.0,1.0,1811,1854
1984-09-05,Greece,Czechoslovakia,0,1,1,0.0,1.0,1609,1782
1984-09-06,Israel,Malta,2,1,1,1.0,0.0,1694,1451
1984-09-10,Jordan,Hong Kong,1,1,0,0.5,0.5,1434,1571
1984-09-10,Qatar,Afghanistan,8,0,8,1.0,0.0,1557,1421
1984-09-12,China PR,Afghanistan,6,0,6,1.0,0.0,1677,1418
1984-09-12,Denmark,Austria,3,1,2,1.0,0.0,1750,1803
1984-09-12,England,German DR,1,0,1,1.0,0.0,1868,1820
1984-09-12,Finland,Poland,0,2,2,0.0,1.0,1513,1829
1984-09-12,German DR,Greece,1,0,1,1.0,0.0,1824,1606
1984-09-12,Germany,Argentina,1,3,2,0.0,1.0,1940,1865
1984-09-12,Iceland,Wales,1,0,1,1.0,0.0,1538,1728
1984-09-12,Republic of Ireland,Russia,1,0,1,1.0,0.0,1683,1902
1984-09-12,Northern Ireland,Romania,3,2,1,1.0,0.0,1727,1728
1984-09-12,Norway,Switzerland,0,1,1,0.0,1.0,1597,1702
1984-09-12,Qatar,Hong Kong,1,0,1,1.0,0.0,1566,1563
1984-09-12,Scotland,Yugoslavia,6,1,5,1.0,0.0,1788,1798
1984-09-12,Sweden,Portugal,0,1,1,0.0,1.0,1732,1784
1984-09-15,China PR,Jordan,6,0,6,1.0,0.0,1681,1431
1984-09-15,Hong Kong,Afghanistan,0,0,0,0.5,0.5,1560,1422
1984-09-16,Mauritius,Mozambique,0,0,0,0.5,0.5,1541,1482
1984-09-17,China PR,Hong Kong,2,0,2,1.0,0.0,1687,1555
1984-09-17,Qatar,Jordan,2,0,2,1.0,0.0,1572,1426
1984-09-18,Mexico,Argentina,1,1,0,0.5,0.5,1777,1863
1984-09-18,Nepal,Maldives,4,0,4,1.0,0.0,1483,1467
1984-09-18,Bangladesh,Bhutan,2,0,2,1.0,0.0,1441,1483
1984-09-19,Uruguay,Peru,2,0,2,1.0,0.0,1792,1657
1984-09-19,Bangladesh,Maldives,5,0,5,1.0,0.0,1450,1459
1984-09-20,China PR,Qatar,1,0,1,1.0,0.0,1693,1567
1984-09-20,Jordan,Afghanistan,6,1,5,1.0,0.0,1434,1415
1984-09-20,Nepal,Bhutan,5,0,5,1.0,0.0,1491,1475
1984-09-21,Maldives,Bhutan,1,0,1,1.0,0.0,1468,1467
1984-09-21,Nepal,Bangladesh,0,5,5,0.0,1.0,1483,1459
1984-09-23,Ghana,Gambia,3,1,2,1.0,0.0,1749,1495
1984-09-23,Niger,Ivory Coast,1,3,2,0.0,1.0,1479,1678
1984-09-23,Nepal,Bangladesh,4,2,2,1.0,0.0,1491,1452
1984-09-25,Saudi Arabia,Iceland,1,2,1,0.0,1.0,1606,1548
1984-09-26,Denmark,Norway,1,0,1,1.0,0.0,1755,1593
1984-09-26,Hungary,Austria,3,1,2,1.0,0.0,1785,1795
1984-09-26,Italy,Sweden,1,0,1,1.0,0.0,1840,1727
1984-09-26,Poland,Turkey,2,0,2,1.0,0.0,1833,1593
1984-09-26,Tunisia,Nigeria,5,0,5,1.0,0.0,1684,1668
1984-09-29,Curaçao,United States,0,0,0,0.5,0.5,1532,1548
1984-09-29,Yugoslavia,Bulgaria,0,0,0,0.5,0.5,1796,1699
1984-09-30,Botswana,Angola,1,3,2,0.0,1.0,1431,1538
1984-09-30,South Korea,Japan,1,2,1,0.0,1.0,1801,1684
1984-09-30,Mozambique,Mauritius,3,0,3,1.0,0.0,1492,1532
1984-09-30,Zimbabwe,Egypt,1,1,0,0.5,0.5,1621,1712
1984-10-03,Honduras,Guatemala,1,0,1,1.0,0.0,1689,1591
1984-10-03,Peru,Uruguay,1,3,2,0.0,1.0,1652,1798
1984-10-04,South Korea,Cameroon,5,0,5,1.0,0.0,1807,1667
1984-10-06,United States,Curaçao,4,0,4,1.0,0.0,1556,1525
1984-10-08,Saudi Arabia,Thailand,2,1,1,1.0,0.0,1615,1599
1984-10-09,Greece,Israel,2,2,0,0.5,0.5,1608,1693
1984-10-09,Mexico,Colombia,1,0,1,1.0,0.0,1781,1570
1984-10-09,United States,El Salvador,3,1,2,1.0,0.0,1567,1637
1984-10-10,German DR,Algeria,5,2,3,1.0,0.0,1830,1710
1984-10-10,South Korea,Yemen,6,0,6,1.0,0.0,1809,1414
1984-10-10,Norway,Russia,1,1,0,0.5,0.5,1599,1897
1984-10-10,Saudi Arabia,Thailand,1,3,2,0.0,1.0,1607,1608
1984-10-11,El Salvador,Mexico,0,1,1,0.0,1.0,1633,1786
1984-10-11,Ivory Coast,Liberia,3,0,3,1.0,0.0,1682,1484
1984-10-11,Malaysia,Pakistan,5,0,5,1.0,0.0,1606,1478
1984-10-11,United States,Colombia,1,0,1,1.0,0.0,1576,1562
1984-10-12,India,Yemen,4,0,4,1.0,0.0,1503,1408
1984-10-13,Kenya,Ethiopia,2,1,1,1.0,0.0,1651,1555
1984-10-13,South Korea,Pakistan,6,0,6,1.0,0.0,1812,1476
1984-10-13,Luxembourg,France,0,4,4,0.0,1.0,1347,1894
1984-10-13,Tanzania,Sudan,1,1,0,0.5,0.5,1575,1575
1984-10-14,Guatemala,United States,4,0,4,1.0,0.0,1599,1569
1984-10-14,India,Malaysia,2,1,1,1.0,0.0,1514,1596
1984-10-14,Portugal,Czechoslovakia,2,1,1,1.0,0.0,1792,1775
1984-10-14,Zimbabwe,Eswatini,3,0,3,1.0,0.0,1627,1480
1984-10-15,Congo,Benin,0,2,2,0.0,1.0,1581,1489
1984-10-15,Pakistan,Yemen,4,1,3,1.0,0.0,1483,1402
1984-10-16,Algeria,Canada,1,0,1,1.0,0.0,1716,1570
1984-10-16,South Korea,Malaysia,0,0,0,0.5,0.5,1808,1601
1984-10-16,Northern Ireland,Israel,3,0,3,1.0,0.0,1735,1686
1984-10-16,Turkey,Bulgaria,0,0,0,0.5,0.5,1596,1697
1984-10-17,Belgium,Albania,3,1,2,1.0,0.0,1814,1477
1984-10-17,England,Finland,5,0,5,1.0,0.0,1870,1512
1984-10-17,Germany,Sweden,2,0,2,1.0,0.0,1944,1724
1984-10-17,India,Pakistan,2,0,2,1.0,0.0,1522,1476
1984-10-17,Mexico,United States,2,1,1,1.0,0.0,1790,1566
1984-10-17,Netherlands,Hungary,1,2,1,0.0,1.0,1809,1794
1984-10-17,Norway,Republic of Ireland,1,0,1,1.0,0.0,1609,1674
1984-10-17,Poland,Greece,3,1,2,1.0,0.0,1837,1605
1984-10-17,Scotland,Iceland,3,0,3,1.0,0.0,1792,1545
1984-10-17,Spain,Wales,3,0,3,1.0,0.0,1824,1723
1984-10-17,Switzerland,Denmark,1,0,1,1.0,0.0,1712,1746
1984-10-18,Fiji,New Zealand,1,2,1,0.0,1.0,1516,1693
1984-10-18,Malaysia,Yemen,4,1,3,1.0,0.0,1605,1399
1984-10-19,India,South Korea,0,1,1,0.0,1.0,1520,1811
1984-10-19,Saudi Arabia,Nepal,7,0,7,1.0,0.0,1613,1486
1984-10-20,Fiji,New Zealand,1,1,0,0.5,0.5,1520,1690
1984-10-20,German DR,Yugoslavia,2,3,1,0.0,1.0,1822,1805
1984-10-20,Nigeria,Liberia,3,0,3,1.0,0.0,1673,1480
1984-10-20,Oman,Sri Lanka,1,1,0,0.5,0.5,1387,1372
1984-10-21,Ivory Coast,Gambia,4,0,4,1.0,0.0,1687,1491
1984-10-21,Tunisia,Canada,2,0,2,1.0,0.0,1690,1565
1984-10-22,Saudi Arabia,United Arab Emirates,1,0,1,1.0,0.0,1619,1500
1984-10-22,Sri Lanka,Nepal,4,0,4,1.0,0.0,1383,1476
1984-10-24,Morocco,Canada,3,2,1,1.0,0.0,1709,1561
1984-10-24,Saudi Arabia,Sri Lanka,5,0,5,1.0,0.0,1623,1380
1984-10-24,United Arab Emirates,Oman,8,0,8,1.0,0.0,1506,1382
1984-10-25,Argentina,Mexico,1,1,0,0.5,0.5,1862,1792
1984-10-26,Saudi Arabia,Oman,6,0,6,1.0,0.0,1627,1379
1984-10-26,United Arab Emirates,Nepal,11,0,11,1.0,0.0,1514,1469
1984-10-27,Sudan,Tanzania,0,0,0,0.5,0.5,1575,1575
1984-10-28,Benin,Tunisia,0,2,2,0.0,1.0,1486,1694
1984-10-28,Chile,Mexico,1,0,1,1.0,0.0,1741,1783
1984-10-28,Ethiopia,Kenya,3,3,0,0.5,0.5,1558,1649
1984-10-28,Oman,Nepal,8,0,8,1.0,0.0,1390,1459
1984-10-28,United Arab Emirates,Sri Lanka,5,1,4,1.0,0.0,1520,1375
1984-10-31,Czechoslovakia,Malta,4,0,4,1.0,0.0,1778,1449
1984-10-31,Poland,Albania,2,2,0,0.5,0.5,1831,1484
1984-10-31,Turkey,Finland,1,2,1,0.0,1.0,1587,1522
1984-10-31,Uruguay,Mexico,1,1,0,0.5,0.5,1798,1784
1984-11-02,Egypt,Canada,1,0,1,1.0,0.0,1717,1557
1984-11-03,China PR,Australia,3,2,1,1.0,0.0,1701,1663
1984-11-03,Switzerland,Italy,1,1,0,0.5,0.5,1715,1838
1984-11-04,Gambia,Ivory Coast,3,2,1,1.0,0.0,1504,1675
1984-11-04,Liberia,Nigeria,0,1,1,0.0,1.0,1477,1677
1984-11-04,Eswatini,Zimbabwe,1,5,4,0.0,1.0,1476,1632
1984-11-09,Guyana,Suriname,1,1,0,0.5,0.5,1455,1631
1984-11-09,Somalia,Kenya,1,0,1,1.0,0.0,1430,1637
1984-11-11,Angola,Congo,1,0,1,1.0,0.0,1547,1573
1984-11-11,Burkina Faso,Mali,1,0,1,1.0,0.0,1481,1591
1984-11-11,DR Congo,Gabon,2,0,2,1.0,0.0,1644,1460
1984-11-11,Guyana,Suriname,1,1,0,0.5,0.5,1459,1628
1984-11-11,Liberia,Mauritania,3,1,2,1.0,0.0,1484,1404
1984-11-11,Trinidad and Tobago,Mexico,0,2,2,0.0,1.0,1622,1789
1984-11-13,Tunisia,Benin,4,0,4,1.0,0.0,1698,1483
1984-11-14,Austria,Netherlands,1,0,1,1.0,0.0,1804,1801
1984-11-14,Denmark,Republic of Ireland,3,0,3,1.0,0.0,1753,1668
1984-11-14,Northern Ireland,Finland,2,1,1,1.0,0.0,1739,1519
1984-11-14,Portugal,Sweden,1,3,2,0.0,1.0,1783,1734
1984-11-14,Scotland,Spain,3,1,2,1.0,0.0,1801,1816
1984-11-14,Turkey,England,0,8,8,0.0,1.0,1585,1873
1984-11-14,Wales,Iceland,2,1,1,1.0,0.0,1728,1541
1984-11-17,Burkina Faso,Togo,1,1,0,0.5,0.5,1484,1586
1984-11-17,Cyprus,Hungary,1,2,1,0.0,1.0,1387,1796
1984-11-17,Luxembourg,German DR,0,5,5,0.0,1.0,1347,1823
1984-11-17,Malawi,Zimbabwe,3,0,3,1.0,0.0,1670,1625
1984-11-18,Gambia,Sierra Leone,3,2,1,1.0,0.0,1513,1498
1984-11-18,Ghana,Ivory Coast,2,0,2,1.0,0.0,1756,1669
1984-11-18,Mali,Benin,1,0,1,1.0,0.0,1597,1478
1984-11-19,Malawi,Zimbabwe,1,0,1,1.0,0.0,1677,1619
1984-11-20,Burkina Faso,Ivory Coast,2,2,0,0.5,0.5,1488,1666
1984-11-20,Saudi Arabia,Finland,2,1,1,1.0,0.0,1633,1514
1984-11-21,France,Bulgaria,1,0,1,1.0,0.0,1898,1694
1984-11-21,Ghana,Togo,2,2,0,0.5,0.5,1753,1590
1984-11-21,Israel,Romania,1,1,0,0.5,0.5,1687,1728
1984-11-22,Burkina Faso,Benin,2,1,1,1.0,0.0,1496,1471
1984-11-22,Qatar,Finland,2,2,0,0.5,0.5,1566,1516
1984-11-23,Ivory Coast,Togo,1,1,0,0.5,0.5,1665,1592
1984-11-23,Kenya,Somalia,1,0,1,1.0,0.0,1641,1427
1984-11-23,Mauritania,Liberia,3,0,3,1.0,0.0,1414,1475
1984-11-24,Benin,Ivory Coast,1,2,1,0.0,1.0,1468,1669
1984-11-24,Burkina Faso,Ghana,1,1,0,0.5,0.5,1502,1748
1984-11-24,Qatar,Finland,1,1,0,0.5,0.5,1565,1518
1984-11-25,Benin,Togo,0,2,2,0.0,1.0,1463,1598
1984-11-25,Gabon,DR Congo,1,1,0,0.5,0.5,1464,1641
1984-11-25,United Arab Emirates,Syria,2,1,1,1.0,0.0,1528,1498
1984-11-27,Benin,Ghana,1,3,2,0.0,1.0,1461,1751
1984-11-28,Burkina Faso,Ivory Coast,0,2,2,0.0,1.0,1498,1674
1984-11-28,Ghana,Togo,1,1,0,0.5,0.5,1748,1602
1984-11-30,United States,Ecuador,0,0,0,0.5,0.5,1565,1520
1984-12-01,Iran,United Arab Emirates,3,0,3,1.0,0.0,1756,1525
1984-12-01,Qatar,Syria,1,1,0,0.5,0.5,1564,1500
1984-12-01,Uganda,Tanzania,1,1,0,0.5,0.5,1614,1576
1984-12-02,Benin,Mali,2,2,0,0.5,0.5,1464,1595
1984-12-02,Dominica,Grenada,0,4,4,0.0,1.0,1439,1542
1984-12-02,Kenya,Malawi,1,2,1,0.0,1.0,1634,1685
1984-12-02,Saudi Arabia,South Korea,1,1,0,0.5,0.5,1637,1808
1984-12-02,Sierra Leone,Gambia,2,0,2,1.0,0.0,1507,1505
1984-12-02,Singapore,India,2,0,2,1.0,0.0,1536,1513
1984-12-02,Saint Lucia,Saint Vincent and the Grenadines,2,0,2,1.0,0.0,1480,1599
1984-12-02,United States,Ecuador,2,2,0,0.5,0.5,1564,1522
1984-12-02,Zambia,Zimbabwe,2,0,2,1.0,0.0,1670,1613
1984-12-03,China PR,Iran,0,2,2,0.0,1.0,1695,1763
1984-12-03,Kuwait,Qatar,1,0,1,1.0,0.0,1722,1560
1984-12-03,Somalia,Zanzibar,2,1,1,1.0,0.0,1434,1333
1984-12-04,El Salvador,Guatemala,2,1,1,1.0,0.0,1641,1592
1984-12-04,Mexico,Ecuador,3,2,1,1.0,0.0,1792,1520
1984-12-04,Syria,Saudi Arabia,0,1,1,0.0,1.0,1496,1642
1984-12-04,Uganda,Zimbabwe,4,1,3,1.0,0.0,1622,1606
1984-12-04,United Arab Emirates,India,2,0,2,1.0,0.0,1533,1506
1984-12-05,Bulgaria,Luxembourg,4,0,4,1.0,0.0,1696,1346
1984-12-05,Greece,Romania,2,1,1,1.0,0.0,1616,1718
1984-12-05,South Korea,Kuwait,0,0,0,0.5,0.5,1807,1724
1984-12-05,Malawi,Somalia,1,0,1,1.0,0.0,1689,1431
1984-12-05,Singapore,China PR,0,2,2,0.0,1.0,1532,1700
1984-12-05,Tanzania,Zambia,1,2,1,0.0,1.0,1571,1676
1984-12-06,Kenya,Zanzibar,1,0,1,1.0,0.0,1637,1331
1984-12-07,Honduras,Ecuador,0,0,0,0.5,0.5,1686,1524
1984-12-07,Iran,India,0,0,0,0.5,0.5,1758,1512
1984-12-07,Syria,South Korea,1,0,1,1.0,0.0,1510,1794
1984-12-07,Uganda,Zambia,1,1,0,0.5,0.5,1624,1675
1984-12-08,France,German DR,2,0,2,1.0,0.0,1905,1817
1984-12-08,Italy,Poland,2,0,2,1.0,0.0,1846,1824
1984-12-08,Kenya,Somalia,1,1,0,0.5,0.5,1633,1436
1984-12-08,Qatar,Saudi Arabia,1,1,0,0.5,0.5,1562,1641
1984-12-08,Singapore,United Arab Emirates,0,1,1,0.0,1.0,1525,1541
1984-12-08,Tanzania,Zimbabwe,2,2,0,0.5,0.5,1572,1606
1984-12-09,Congo,Equatorial Guinea,5,0,5,1.0,0.0,1580,1490
1984-12-09,Guatemala,Ecuador,1,0,1,1.0,0.0,1599,1518
1984-12-09,India,China PR,0,3,3,0.0,1.0,1508,1705
1984-12-09,Ivory Coast,Guinea,2,2,0,0.5,0.5,1672,1566
1984-12-09,Kuwait,Syria,3,1,2,1.0,0.0,1728,1507
1984-12-09,Malawi,Zanzibar,1,0,1,1.0,0.0,1691,1330
1984-12-10,Chad,Cameroon,0,2,2,0.0,1.0,1484,1672
1984-12-10,South Korea,Qatar,0,1,1,0.0,1.0,1782,1575
1984-12-10,Singapore,Iran,1,1,0,0.5,0.5,1530,1754
1984-12-11,China PR,United Arab Emirates,5,0,5,1.0,0.0,1710,1537
1984-12-11,Saudi Arabia,Kuwait,1,0,1,1.0,0.0,1651,1719
1984-12-12,Chad,Gabon,3,3,0,0.5,0.5,1484,1465
1984-12-12,Congo,Central African Republic,2,1,1,1.0,0.0,1586,1467
1984-12-12,El Salvador,Ecuador,0,0,0,0.5,0.5,1639,1521
1984-12-12,Kenya,Zambia,0,2,2,0.0,1.0,1626,1683
1984-12-12,Uganda,Malawi,0,2,2,0.0,1.0,1618,1698
1984-12-13,Saudi Arabia,Iran,1,1,0,0.5,0.5,1654,1752
1984-12-14,Cameroon,Gabon,0,0,0,0.5,0.5,1668,1470
1984-12-14,Central African Republic,Equatorial Guinea,1,1,0,0.5,0.5,1468,1490
1984-12-14,Kuwait,China PR,0,1,1,0.0,1.0,1711,1719
1984-12-15,Malawi,Zambia,0,0,0,0.5,0.5,1698,1684
1984-12-15,Uganda,Kenya,3,1,2,1.0,0.0,1627,1618
1984-12-16,Chad,Equatorial Guinea,1,1,0,0.5,0.5,1485,1490
1984-12-16,Guatemala,Honduras,1,0,1,1.0,0.0,1609,1677
1984-12-16,Iran,Kuwait,1,1,0,0.5,0.5,1752,1712
1984-12-16,Malta,Germany,2,3,1,0.0,1.0,1449,1945
1984-12-16,Saudi Arabia,China PR,2,0,2,1.0,0.0,1664,1710
1984-12-17,Central African Republic,Cameroon,1,7,6,0.0,1.0,1465,1672
1984-12-17,Congo,Gabon,3,0,3,1.0,0.0,1592,1465
1984-12-17,Cyprus,Luxembourg,1,0,1,1.0,0.0,1395,1339
1984-12-17,Egypt,Norway,0,1,1,0.0,1.0,1707,1620
1984-12-19,Central African Republic,Gabon,2,2,0,0.5,0.5,1465,1465
1984-12-19,Greece,Belgium,0,0,0,0.5,0.5,1621,1810
1984-12-19,Israel,Luxembourg,2,0,2,1.0,0.0,1689,1338
1984-12-20,Congo,Cameroon,2,2,0,0.5,0.5,1594,1671
1984-12-20,Egypt,Norway,0,1,1,0.0,1.0,1698,1630
1984-12-22,Albania,Belgium,2,0,2,1.0,0.0,1498,1797
1984-12-22,Turkey,Luxembourg,1,0,1,1.0,0.0,1589,1335
1984-12-23,Cyprus,Netherlands,0,1,1,0.0,1.0,1394,1803
1984-12-23,Guatemala,El Salvador,2,0,2,1.0,0.0,1618,1631
1984-12-28,Algeria,Ghana,1,2,1,0.0,1.0,1709,1756
1984-12-28,Ivory Coast,Tunisia,3,1,2,1.0,0.0,1681,1690
1984-12-30,Algeria,Tunisia,3,1,2,1.0,0.0,1717,1683
1984-12-30,Ivory Coast,Ghana,2,0,2,1.0,0.0,1691,1747
1985-01-01,Ghana,Tunisia,0,2,2,0.0,1.0,1738,1693
1985-01-01,Ivory Coast,Algeria,1,1,0,0.5,0.5,1692,1717
1985-01-02,Libya,Morocco,0,0,0,0.5,0.5,1639,1708
1985-01-09,Israel,Greece,0,2,2,0.0,1.0,1680,1631
1985-01-13,Barbados,Saint Lucia,4,1,3,1.0,0.0,1492,1473
1985-01-19,Singapore,North Korea,1,1,0,0.5,0.5,1534,1684
1985-01-20,Guyana,Cuba,2,1,1,1.0,0.0,1469,1499
1985-01-20,Iran,Yugoslavia,1,3,2,0.0,1.0,1746,1812
1985-01-21,China PR,Russia,2,3,1,0.0,1.0,1706,1902
1985-01-23,Spain,Finland,3,1,2,1.0,0.0,1819,1516
1985-01-25,Russia,Yugoslavia,1,2,1,0.0,1.0,1892,1823
1985-01-27,Guyana,Cuba,1,1,0,0.5,0.5,1470,1499
1985-01-27,Honduras,Denmark,1,0,1,1.0,0.0,1687,1744
1985-01-28,Iran,Russia,0,2,2,0.0,1.0,1742,1897
1985-01-29,China PR,Yugoslavia,1,1,0,0.5,0.5,1709,1821
1985-01-29,Germany,Hungary,0,1,1,0.0,1.0,1934,1808
1985-01-29,Uruguay,German DR,3,0,3,1.0,0.0,1807,1809
1985-01-30,Portugal,Romania,2,3,1,0.0,1.0,1774,1728
1985-01-31,India,Morocco,0,1,1,0.0,1.0,1505,1712
1985-01-31,Ivory Coast,Egypt,0,1,1,0.0,1.0,1685,1706
1985-02-01,Colombia,Switzerland,2,2,0,0.5,0.5,1566,1712
1985-02-02,Morocco,Russia,0,1,1,0.0,1.0,1708,1902
1985-02-02,Zimbabwe,Zambia,1,1,0,0.5,0.5,1608,1683
1985-02-03,Bolivia,German DR,2,1,1,1.0,0.0,1552,1796
1985-02-03,Cameroon,Egypt,1,0,1,1.0,0.0,1680,1698
1985-02-03,Uruguay,Paraguay,1,0,1,1.0,0.0,1813,1710
1985-02-03,Zimbabwe,Zambia,2,3,1,0.0,1.0,1602,1690
1985-02-04,Yugoslavia,Russia,1,2,1,0.0,1.0,1815,1909
1985-02-05,Bulgaria,Switzerland,1,0,1,1.0,0.0,1705,1704
1985-02-05,Iran,North Korea,1,0,1,1.0,0.0,1749,1678
1985-02-05,Republic of Ireland,Italy,1,2,1,0.0,1.0,1664,1851
1985-02-05,Mexico,Poland,5,0,5,1.0,0.0,1801,1816
1985-02-06,Bolivia,Uruguay,0,1,1,0.0,1.0,1550,1816
1985-02-06,Bulgaria,Poland,2,2,0,0.5,0.5,1708,1814
1985-02-06,Cameroon,Egypt,0,0,0,0.5,0.5,1681,1698
1985-02-06,Chile,Paraguay,1,0,1,1.0,0.0,1749,1703
1985-02-06,Costa Rica,El Salvador,2,1,1,1.0,0.0,1671,1624
1985-02-06,Ecuador,German DR,2,3,1,0.0,1.0,1519,1799
1985-02-06,Mexico,Switzerland,1,2,1,0.0,1.0,1791,1715
1985-02-08,Chile,Finland,2,0,2,1.0,0.0,1753,1513
1985-02-08,United States,Switzerland,1,1,0,0.5,0.5,1568,1712
1985-02-10,Colombia,Poland,1,2,1,0.0,1.0,1563,1818
1985-02-10,Ecuador,German DR,3,2,1,1.0,0.0,1533,1786
1985-02-10,Guinea,Tunisia,1,0,1,1.0,0.0,1577,1683
1985-02-10,Malta,Portugal,1,3,2,0.0,1.0,1447,1777
1985-02-10,Paraguay,Uruguay,1,3,2,0.0,1.0,1698,1822
1985-02-11,Gambia,Cape Verde,1,2,1,0.0,1.0,1497,1476
1985-02-11,Guinea-Bissau,Sierra Leone,0,0,0,0.5,0.5,1511,1508
1985-02-12,Guinea,Senegal,0,2,2,0.0,1.0,1571,1629
1985-02-12,Mali,Mauritania,3,0,3,1.0,0.0,1600,1410
1985-02-13,Cape Verde,Sierra Leone,2,2,0,0.5,0.5,1477,1508
1985-02-13,El Salvador,Costa Rica,1,0,1,1.0,0.0,1634,1662
1985-02-13,Gambia,Guinea-Bissau,1,0,1,1.0,0.0,1506,1503
1985-02-14,Colombia,Poland,1,0,1,1.0,0.0,1577,1805
1985-02-14,Guinea,Mali,1,3,2,0.0,1.0,1564,1608
1985-02-14,Mauritania,Senegal,0,2,2,0.0,1.0,1407,1633
1985-02-14,Uruguay,Finland,2,1,1,1.0,0.0,1825,1511
1985-02-15,Cape Verde,Guinea-Bissau,2,0,2,1.0,0.0,1486,1495
1985-02-15,Gambia,Sierra Leone,1,1,0,0.5,0.5,1507,1508
1985-02-16,Guinea,Mauritania,1,0,1,1.0,0.0,1569,1403
1985-02-16,Mali,Senegal,2,2,0,0.5,0.5,1609,1633
1985-02-17,Ecuador,Finland,3,1,2,1.0,0.0,1541,1504
1985-02-17,Guatemala,Costa Rica,1,0,1,1.0,0.0,1628,1653
1985-02-17,Hong Kong,China PR,0,0,0,0.5,0.5,1559,1706
1985-02-17,Macau,Brunei,2,0,2,1.0,0.0,1469,1421
1985-02-17,Peru,Bolivia,3,0,3,1.0,0.0,1658,1545
1985-02-19,Cape Verde,Senegal,0,1,1,0.0,1.0,1482,1638
1985-02-19,Gambia,Mali,1,0,1,1.0,0.0,1518,1599
1985-02-20,Ivory Coast,Congo,2,1,1,1.0,0.0,1691,1589
1985-02-20,Macau,China PR,0,4,4,0.0,1.0,1466,1710
1985-02-21,Cape Verde,Mali,0,1,1,0.0,1.0,1477,1605
1985-02-21,Chile,Colombia,1,1,0,0.5,0.5,1750,1581
1985-02-21,Ecuador,Bolivia,3,0,3,1.0,0.0,1550,1537
1985-02-22,Gambia,Senegal,0,1,1,0.0,1.0,1513,1644
1985-02-22,Sudan,Libya,0,0,0,0.5,0.5,1577,1638
1985-02-23,Hong Kong,Brunei,8,0,8,1.0,0.0,1564,1417
1985-02-23,Singapore,Japan,1,3,2,0.0,1.0,1530,1689
1985-02-24,Antigua and Barbuda,Dominica,2,1,1,1.0,0.0,1478,1432
1985-02-24,Chile,Peru,1,2,1,0.0,1.0,1740,1669
1985-02-24,El Salvador,Suriname,3,0,3,1.0,0.0,1642,1621
1985-02-24,Portugal,Germany,1,2,1,0.0,1.0,1773,1939
1985-02-24,Saint Vincent and the Grenadines,Trinidad and Tobago,1,1,0,0.5,0.5,1600,1622
1985-02-24,Tunisia,Guinea,2,0,2,1.0,0.0,1689,1564
1985-02-24,Uruguay,Colombia,3,0,3,1.0,0.0,1829,1578
1985-02-26,China PR,Brunei,8,0,8,1.0,0.0,1713,1415
1985-02-26,Mexico,Finland,2,1,1,1.0,0.0,1794,1502
1985-02-26,Wales,Norway,1,1,0,0.5,0.5,1726,1633
1985-02-27,El Salvador,Suriname,3,0,3,1.0,0.0,1650,1614
1985-02-27,Greece,Albania,2,0,2,1.0,0.0,1637,1493
1985-02-27,Israel,Republic of Ireland,0,0,0,0.5,0.5,1680,1665
1985-02-27,Netherlands,Cyprus,7,1,6,1.0,0.0,1805,1393
1985-02-27,Northern Ireland,England,0,1,1,0.0,1.0,1734,1879
1985-02-27,Spain,Scotland,1,0,1,1.0,0.0,1827,1794
1985-02-27,Uruguay,Peru,2,2,0,0.5,0.5,1826,1673
1985-02-28,Paraguay,Colombia,0,3,3,0.0,1.0,1688,1589
1985-03-01,Brunei,China PR,0,4,4,0.0,1.0,1413,1716
1985-03-02,Nepal,South Korea,0,2,2,0.0,1.0,1457,1785
1985-03-03,Antigua and Barbuda,Guadeloupe,0,1,1,0.0,1.0,1471,1529
1985-03-03,Dominica,Cayman Islands,2,1,1,1.0,0.0,1442,1491
1985-03-03,Ecuador,Chile,1,1,0,0.5,0.5,1554,1737
1985-03-03,Grenada,Trinidad and Tobago,1,5,4,0.0,1.0,1536,1629
1985-03-03,Honduras,Suriname,1,1,0,0.5,0.5,1686,1616
1985-03-03,Madagascar,Zimbabwe,0,1,1,0.0,1.0,1590,1610
1985-03-05,Ivory Coast,DR Congo,2,1,1,1.0,0.0,1698,1635
1985-03-06,Costa Rica,Guatemala,2,0,2,1.0,0.0,1661,1621
1985-03-06,Honduras,Suriname,2,1,1,1.0,0.0,1693,1610
1985-03-08,Algeria,Mauritania,4,0,4,1.0,0.0,1720,1401
1985-03-08,Libya,Sudan,4,0,4,1.0,0.0,1645,1571
1985-03-08,Saint Vincent and the Grenadines,Canada,1,2,1,0.0,1.0,1592,1566
1985-03-09,Peru,Chile,1,1,0,0.5,0.5,1675,1736
1985-03-10,El Salvador,Honduras,1,2,1,0.0,1.0,1643,1701
1985-03-10,French Guiana,Guyana,0,1,1,0.0,1.0,1473,1479
1985-03-10,Malaysia,South Korea,1,0,1,1.0,0.0,1617,1774
1985-03-10,Trinidad and Tobago,Canada,1,2,1,0.0,1.0,1620,1576
1985-03-10,Uruguay,Ecuador,2,1,1,1.0,0.0,1829,1552
1985-03-12,Algeria,German DR,1,1,0,0.5,0.5,1722,1785
1985-03-13,Greece,Italy,0,0,0,0.5,0.5,1642,1847
1985-03-13,Jamaica,Canada,1,1,0,0.5,0.5,1473,1574
1985-03-14,Honduras,El Salvador,0,0,0,0.5,0.5,1700,1645
1985-03-15,Indonesia,Thailand,1,0,1,1.0,0.0,1524,1598
1985-03-15,Jordan,Qatar,1,0,1,1.0,0.0,1446,1564
1985-03-16,Nepal,Malaysia,0,0,0,0.5,0.5,1461,1614
1985-03-17,Chile,Ecuador,6,2,4,1.0,0.0,1741,1548
1985-03-17,French Guiana,Suriname,0,1,1,0.0,1.0,1469,1615
1985-03-17,Jamaica,Canada,0,0,0,0.5,0.5,1476,1572
1985-03-18,Indonesia,Bangladesh,2,0,2,1.0,0.0,1531,1446
1985-03-21,Costa Rica,Canada,1,0,1,1.0,0.0,1667,1567
1985-03-21,Indonesia,India,2,1,1,1.0,0.0,1539,1498
1985-03-21,Japan,North Korea,1,0,1,1.0,0.0,1697,1671
1985-03-21,Peru,Ecuador,1,0,1,1.0,0.0,1681,1543
1985-03-22,Mauritania,Algeria,1,1,0,0.5,0.5,1407,1717
1985-03-22,Syria,Kuwait,1,0,1,1.0,0.0,1520,1700
1985-03-23,Zimbabwe,Madagascar,5,2,3,1.0,0.0,1618,1583
1985-03-23,Thailand,Bangladesh,3,0,3,1.0,0.0,1603,1442
1985-03-23,Zambia,Malawi,1,1,0,0.5,0.5,1691,1698
1985-03-23,Alderney,Jersey,0,5,5,0.0,1.0,1302,1694
1985-03-24,Brunei,Philippines,4,1,3,1.0,0.0,1420,1328
1985-03-24,Chile,Uruguay,2,0,2,1.0,0.0,1751,1820
1985-03-24,Costa Rica,Canada,0,0,0,0.5,0.5,1665,1570
1985-03-24,Guyana,Suriname,0,1,1,0.0,1.0,1474,1621
1985-03-24,Saint Vincent and the Grenadines,Grenada,3,0,3,1.0,0.0,1599,1530
1985-03-25,Zambia,Malawi,2,2,0,0.5,0.5,1692,1698
1985-03-26,England,Republic of Ireland,2,1,1,1.0,0.0,1883,1662
1985-03-26,Thailand,India,0,0,0,0.5,0.5,1601,1501
1985-03-27,Belgium,Greece,2,0,2,1.0,0.0,1802,1638
1985-03-27,Germany,Malta,6,0,6,1.0,0.0,1940,1447
1985-03-27,Romania,Poland,0,0,0,0.5,0.5,1730,1804
1985-03-27,Russia,Austria,2,0,2,1.0,0.0,1915,1799
1985-03-27,Scotland,Wales,0,1,1,0.0,1.0,1785,1736
1985-03-27,Spain,Northern Ireland,0,0,0,0.5,0.5,1825,1737
1985-03-27,Switzerland,Czechoslovakia,2,0,2,1.0,0.0,1722,1769
1985-03-27,Yugoslavia,Luxembourg,1,0,1,1.0,0.0,1816,1335
1985-03-28,Albania,Turkey,0,0,0,0.5,0.5,1496,1587
1985-03-29,Egypt,Cameroon,2,0,2,1.0,0.0,1706,1674
1985-03-29,Jordan,Iraq,2,3,1,0.0,1.0,1445,1813
1985-03-29,Libya,Tunisia,2,0,2,1.0,0.0,1655,1680
1985-03-29,Panama,Guatemala,0,0,0,0.5,0.5,1442,1618
1985-03-29,Thailand,Indonesia,0,1,1,0.0,1.0,1592,1549
1985-03-29,Yemen,Syria,0,1,1,0.0,1.0,1394,1526
1985-03-29,Yemen DPR,Bahrain,1,4,3,0.0,1.0,1472,1477
1985-03-30,Bangladesh,India,1,2,1,0.0,1.0,1436,1508
1985-03-31,Angola,Algeria,0,0,0,0.5,0.5,1551,1714
1985-03-31,Congo,DR Congo,2,5,3,0.0,1.0,1583,1642
1985-03-31,Ecuador,Uruguay,0,2,2,0.0,1.0,1541,1823
1985-03-31,Egypt,Cameroon,2,1,1,1.0,0.0,1714,1667
1985-03-31,Ghana,Guinea,1,1,0,0.5,0.5,1735,1568
1985-03-31,Ivory Coast,Mali,6,0,6,1.0,0.0,1704,1600
1985-03-31,Kuwait,Iceland,1,1,0,0.5,0.5,1697,1545
1985-03-31,Malaysia,Nepal,5,0,5,1.0,0.0,1619,1457
1985-03-31,Togo,Senegal,0,1,1,0.0,1.0,1595,1652
1985-03-31,Malawi,Mozambique,1,1,0,0.5,0.5,1694,1497
1985-04-02,Bangladesh,Indonesia,2,1,1,1.0,0.0,1447,1539
1985-04-02,Canada,United States,2,0,2,1.0,0.0,1578,1561
1985-04-02,Syria,United Arab Emirates,2,1,1,1.0,0.0,1535,1529
1985-04-03,Guadeloupe,Trinidad and Tobago,1,1,0,0.5,0.5,1532,1618
1985-04-03,Hungary,Cyprus,2,0,2,1.0,0.0,1810,1392
1985-04-03,Italy,Portugal,2,0,2,1.0,0.0,1854,1767
1985-04-03,Malta,Jordan,3,1,2,1.0,0.0,1455,1438
1985-04-03,Romania,Turkey,3,0,3,1.0,0.0,1735,1583
1985-04-03,Yugoslavia,France,0,0,0,0.5,0.5,1819,1903
1985-04-04,United States,Canada,1,1,0,0.5,0.5,1562,1578
1985-04-05,Bahrain,United Arab Emirates,3,2,1,1.0,0.0,1487,1520
1985-04-05,Bangladesh,Thailand,1,0,1,1.0,0.0,1459,1581
1985-04-05,Egypt,Madagascar,1,0,1,1.0,0.0,1720,1578
1985-04-05,Kuwait,Yemen,5,0,5,1.0,0.0,1700,1392
1985-04-05,Qatar,Iraq,3,0,3,1.0,0.0,1577,1801
1985-04-06,Brunei,Hong Kong,1,5,4,0.0,1.0,1416,1569
1985-04-06,Bulgaria,German DR,1,0,1,1.0,0.0,1718,1776
1985-04-06,India,Indonesia,1,1,0,0.5,0.5,1509,1539
1985-04-06,Kenya,Nigeria,0,3,3,0.0,1.0,1612,1684
1985-04-06,South Korea,Nepal,4,0,4,1.0,0.0,1777,1455
1985-04-07,Ivory Coast,Ghana,0,0,0,0.5,0.5,1705,1735
1985-04-07,Mali,Togo,4,0,4,1.0,0.0,1608,1588
1985-04-07,Morocco,Malawi,2,0,2,1.0,0.0,1716,1687
1985-04-07,Syria,United Arab Emirates,0,4,4,0.0,1.0,1527,1529
1985-04-07,Uruguay,Chile,2,1,1,1.0,0.0,1830,1745
1985-04-07,Zambia,Cameroon,4,1,3,1.0,0.0,1700,1660
1985-04-09,India,Thailand,1,1,0,0.5,0.5,1511,1580
1985-04-12,Bahrain,Yemen DPR,3,3,0,0.5,0.5,1487,1473
1985-04-12,India,Bangladesh,2,1,1,1.0,0.0,1518,1453
1985-04-12,Kuwait,Syria,0,0,0,0.5,0.5,1697,1531
1985-04-12,Qatar,Jordan,2,0,2,1.0,0.0,1582,1434
1985-04-12,Saudi Arabia,United Arab Emirates,0,0,0,0.5,0.5,1662,1532
1985-04-13,Brunei,Macau,1,2,1,0.0,1.0,1410,1473
1985-04-13,Canada,Haiti,2,0,2,1.0,0.0,1587,1597
1985-04-14,DR Congo,Congo,0,0,0,0.5,0.5,1641,1585
1985-04-14,Guinea,Ghana,1,4,3,0.0,1.0,1564,1740
1985-04-14,Mali,Ivory Coast,1,1,0,0.5,0.5,1611,1703
1985-04-14,Panama,Trinidad and Tobago,0,0,0,0.5,0.5,1446,1615
1985-04-14,Senegal,Togo,1,1,0,0.5,0.5,1651,1590
1985-04-14,Tunisia,Libya,1,0,1,1.0,0.0,1688,1648
1985-04-16,Mozambique,Malawi,1,1,0,0.5,0.5,1501,1684
1985-04-17,Austria,Hungary,0,3,3,0.0,1.0,1792,1818
1985-04-17,Colombia,Paraguay,2,0,2,1.0,0.0,1600,1678
1985-04-17,German DR,Norway,1,0,1,1.0,0.0,1781,1629
1985-04-17,Germany,Bulgaria,4,1,3,1.0,0.0,1944,1715
1985-04-17,Panama,Trinidad and Tobago,1,1,0,0.5,0.5,1450,1612
1985-04-17,Poland,Finland,2,1,1,1.0,0.0,1807,1500
1985-04-17,Switzerland,Russia,2,2,0,0.5,0.5,1727,1911
1985-04-19,Algeria,Angola,3,2,1,1.0,0.0,1719,1547
1985-04-19,Colombia,Paraguay,2,2,0,0.5,0.5,1602,1677
1985-04-19,Iraq,Jordan,2,0,2,1.0,0.0,1803,1433
1985-04-19,Syria,Yemen,3,0,3,1.0,0.0,1536,1388
1985-04-19,United Arab Emirates,Saudi Arabia,1,0,1,1.0,0.0,1543,1652
1985-04-20,Barbados,Jamaica,2,2,0,0.5,0.5,1492,1477
1985-04-20,Canada,Guatemala,2,1,1,1.0,0.0,1596,1610
1985-04-20,Nigeria,Kenya,3,1,2,1.0,0.0,1691,1606
1985-04-21,Bolivia,Venezuela,4,0,4,1.0,0.0,1544,1460
1985-04-21,Cameroon,Zambia,1,1,0,0.5,0.5,1661,1700
1985-04-21,Ghana,Ivory Coast,2,0,2,1.0,0.0,1748,1696
1985-04-21,Madagascar,Egypt,1,0,1,1.0,0.0,1590,1709
1985-04-21,Malawi,Morocco,0,0,0,0.5,0.5,1685,1716
1985-04-21,Malta,Czechoslovakia,0,0,0,0.5,0.5,1461,1764
1985-04-21,Togo,Mali,3,0,3,1.0,0.0,1599,1603
1985-04-23,Peru,Uruguay,2,1,1,1.0,0.0,1693,1819
1985-04-24,Costa Rica,Trinidad and Tobago,3,0,3,1.0,0.0,1672,1606
1985-04-24,Luxembourg,Iceland,0,0,0,0.5,0.5,1340,1541
1985-04-25,Brazil,Colombia,2,1,1,1.0,0.0,1961,1601
1985-04-26,Haiti,Guatemala,0,1,1,0.0,1.0,1590,1618
1985-04-26,Yemen,Kuwait,1,3,2,0.0,1.0,1386,1700
1985-04-27,Suriname,Guadeloupe,0,1,1,0.0,1.0,1611,1543
1985-04-28,Bangladesh,Indonesia,1,1,0,0.5,0.5,1455,1538
1985-04-28,Brazil,Peru,0,1,1,0.0,1.0,1948,1707
1985-04-28,Colombia,Uruguay,2,1,1,1.0,0.0,1614,1807
1985-04-28,Costa Rica,Trinidad and Tobago,1,1,0,0.5,0.5,1671,1608
1985-04-28,Macau,Hong Kong,0,2,2,0.0,1.0,1468,1575
1985-04-28,Pakistan,North Korea,0,0,0,0.5,0.5,1481,1667
1985-04-28,Paraguay,Argentina,1,0,1,1.0,0.0,1689,1851
1985-04-29,North Korea,Nepal,8,1,7,1.0,0.0,1671,1452
1985-04-30,Czechoslovakia,Germany,1,5,4,0.0,1.0,1760,1949
1985-04-30,North Korea,Japan,0,0,0,0.5,0.5,1672,1697
1985-04-30,Pakistan,Nepal,1,0,1,1.0,0.0,1489,1445
1985-04-30,Wales,Spain,3,0,3,1.0,0.0,1747,1815
1985-05-01,Belgium,Poland,2,0,2,1.0,0.0,1811,1799
1985-05-01,Bolivia,Peru,0,0,0,0.5,0.5,1548,1704
1985-05-01,Republic of Ireland,Norway,0,0,0,0.5,0.5,1662,1630
1985-05-01,Israel,Sweden,1,1,0,0.5,0.5,1682,1733
1985-05-01,Luxembourg,Yugoslavia,0,1,1,0.0,1.0,1340,1820
1985-05-01,Netherlands,Austria,1,1,0,0.5,0.5,1805,1793
1985-05-01,Northern Ireland,Turkey,2,0,2,1.0,0.0,1742,1579
1985-05-01,Romania,England,0,0,0,0.5,0.5,1739,1880
1985-05-01,Tunisia,Algeria,1,0,1,1.0,0.0,1697,1711
1985-05-02,Brazil,Uruguay,2,0,2,1.0,0.0,1953,1803
1985-05-02,Bulgaria,France,2,0,2,1.0,0.0,1727,1892
1985-05-02,Indonesia,North Korea,0,7,7,0.0,1.0,1533,1678
1985-05-02,Pakistan,Bangladesh,1,3,2,0.0,1.0,1481,1464
1985-05-02,Russia,Switzerland,4,0,4,1.0,0.0,1916,1723
1985-05-02,Zimbabwe,Malawi,1,3,2,0.0,1.0,1612,1692
1985-05-04,Bangladesh,North Korea,0,1,1,0.0,1.0,1461,1682
1985-05-04,Hong Kong,Macau,2,0,2,1.0,0.0,1581,1463
1985-05-04,Pakistan,Indonesia,1,3,2,0.0,1.0,1475,1540
1985-05-05,Brazil,Argentina,2,1,1,1.0,0.0,1959,1846
1985-05-05,Guatemala,Canada,1,1,0,0.5,0.5,1618,1597
1985-05-05,Iraq,Qatar,2,1,1,1.0,0.0,1807,1579
1985-05-05,Trinidad and Tobago,Suriname,0,1,1,0.0,1.0,1601,1619
1985-05-06,Guernsey,Jersey,4,3,1,1.0,0.0,1662,1686
1985-05-07,Austria,Cyprus,4,0,4,1.0,0.0,1795,1391
1985-05-08,Denmark,German DR,4,1,3,1.0,0.0,1753,1773
1985-05-08,Haiti,Canada,0,2,2,0.0,1.0,1583,1605
1985-05-09,Argentina,Paraguay,1,1,0,0.5,0.5,1843,1693
1985-05-10,Mauritania,Senegal,0,0,0,0.5,0.5,1412,1647
1985-05-12,China PR,Macau,6,0,6,1.0,0.0,1720,1460
1985-05-14,Argentina,Chile,2,0,2,1.0,0.0,1849,1740
1985-05-14,Hungary,Netherlands,0,1,1,0.0,1.0,1810,1814
1985-05-15,Colombia,Brazil,1,0,1,1.0,0.0,1629,1945
1985-05-15,Guatemala,Haiti,4,0,4,1.0,0.0,1626,1576
1985-05-15,United States,Trinidad and Tobago,2,1,1,1.0,0.0,1571,1593
1985-05-18,German DR,Luxembourg,3,1,2,1.0,0.0,1775,1339
1985-05-18,Japan,Singapore,5,0,5,1.0,0.0,1702,1526
1985-05-19,China PR,Hong Kong,1,2,1,0.0,1.0,1709,1593
1985-05-19,Greece,Poland,1,4,3,0.0,1.0,1634,1804
1985-05-19,South Korea,Malaysia,2,0,2,1.0,0.0,1782,1615
1985-05-19,United States,Trinidad and Tobago,1,0,1,1.0,0.0,1580,1585
1985-05-21,Chile,Brazil,2,1,1,1.0,0.0,1753,1933
1985-05-22,Finland,England,1,1,0,0.5,0.5,1507,1874
1985-05-22,Sweden,Norway,1,0,1,1.0,0.0,1739,1625
1985-05-25,North Korea,Singapore,2,0,2,1.0,0.0,1687,1522
1985-05-25,Scotland,England,1,0,1,1.0,0.0,1796,1864
1985-05-26,Bolivia,Paraguay,1,1,0,0.5,0.5,1552,1690
1985-05-26,Colombia,Peru,1,0,1,1.0,0.0,1639,1695
1985-05-26,Costa Rica,United States,1,1,0,0.5,0.5,1669,1583
1985-05-26,Japan,Uruguay,1,4,3,0.0,1.0,1697,1809
1985-05-26,Republic of Ireland,Spain,0,0,0,0.5,0.5,1666,1812
1985-05-26,Venezuela,Argentina,2,3,1,0.0,1.0,1459,1851
1985-05-28,Iceland,Scotland,0,1,1,0.0,1.0,1539,1799
1985-05-30,Albania,Poland,0,1,1,0.0,1.0,1494,1807
1985-05-31,United States,Costa Rica,0,1,1,0.0,1.0,1577,1676
1985-06-01,Bulgaria,Yugoslavia,2,1,1,1.0,0.0,1738,1810
1985-06-01,Hong Kong,Macau,2,0,2,1.0,0.0,1599,1455
1985-06-02,Bolivia,Brazil,0,2,2,0.0,1.0,1551,1935
1985-06-02,Canada,Ghana,2,1,1,1.0,0.0,1617,1737
1985-06-02,Colombia,Argentina,1,3,2,0.0,1.0,1636,1855
1985-06-02,Republic of Ireland,Switzerland,3,0,3,1.0,0.0,1676,1714
1985-06-02,Mexico,Italy,1,1,0,0.5,0.5,1796,1853
1985-06-02,Venezuela,Peru,0,1,1,0.0,1.0,1456,1699
1985-06-03,Bahrain,Malaysia,3,1,2,1.0,0.0,1498,1605
1985-06-03,New Zealand,Fiji,5,0,5,1.0,0.0,1695,1516
1985-06-05,Denmark,Russia,4,2,2,1.0,0.0,1765,1905
1985-06-05,New Zealand,Fiji,3,0,3,1.0,0.0,1700,1512
1985-06-05,Norway,Wales,4,2,2,1.0,0.0,1636,1737
1985-06-05,Sweden,Czechoslovakia,2,0,2,1.0,0.0,1748,1752
1985-06-06,England,Italy,1,2,1,0.0,1.0,1856,1862
1985-06-06,Finland,Romania,1,1,0,0.5,0.5,1512,1735
1985-06-06,South Korea,Thailand,3,2,1,1.0,0.0,1786,1577
1985-06-07,New Zealand,Fiji,2,0,2,1.0,0.0,1705,1508
1985-06-08,Brazil,Chile,3,1,2,1.0,0.0,1940,1749
1985-06-08,South Korea,Bahrain,3,0,3,1.0,0.0,1789,1496
1985-06-09,Argentina,Venezuela,3,0,3,1.0,0.0,1857,1455
1985-06-09,Canada,Iraq,1,6,5,0.0,1.0,1613,1812
1985-06-09,Mexico,England,1,0,1,1.0,0.0,1806,1847
1985-06-09,Paraguay,Bolivia,3,0,3,1.0,0.0,1695,1547
1985-06-09,Peru,Colombia,0,0,0,0.5,0.5,1698,1638
1985-06-12,England,Germany,3,0,3,1.0,0.0,1858,1939
1985-06-12,Iceland,Spain,1,2,1,0.0,1.0,1537,1815
1985-06-15,South Korea,Iraq,2,0,2,1.0,0.0,1798,1804
1985-06-15,Mexico,Germany,2,0,2,1.0,0.0,1817,1929
1985-06-15,Nigeria,Ivory Coast,0,0,0,0.5,0.5,1692,1696
1985-06-16,Argentina,Colombia,1,0,1,1.0,0.0,1861,1635
1985-06-16,Paraguay,Brazil,0,2,2,0.0,1.0,1692,1944
1985-06-16,Peru,Venezuela,4,1,3,1.0,0.0,1702,1452
1985-06-16,United States,England,0,5,5,0.0,1.0,1575,1861
1985-06-19,Nigeria,Ivory Coast,2,0,2,1.0,0.0,1701,1688
1985-06-23,Brazil,Paraguay,1,1,0,0.5,0.5,1940,1697
1985-06-23,Ivory Coast,Nigeria,1,1,0,0.5,0.5,1689,1701
1985-06-23,Peru,Argentina,1,0,1,1.0,0.0,1714,1850
1985-06-23,Venezuela,Colombia,2,2,0,0.5,0.5,1456,1632
1985-06-24,Guinea,Gambia,1,0,1,1.0,0.0,1571,1507
1985-06-25,Barbados,Suriname,0,0,0,0.5,0.5,1495,1617
1985-06-25,Guadeloupe,Martinique,1,2,1,0.0,1.0,1537,1637
1985-06-26,Ivory Coast,Nigeria,1,1,0,0.5,0.5,1690,1701
1985-06-27,Barbados,Guadeloupe,1,1,0,0.5,0.5,1496,1537
1985-06-27,Martinique,Suriname,2,0,2,1.0,0.0,1645,1610
1985-06-30,Angola,São Tomé and Príncipe,3,2,1,1.0,0.0,1554,1476
1985-06-30,Argentina,Peru,2,2,0,0.5,0.5,1848,1717
1985-06-30,Barbados,Martinique,1,1,0,0.5,0.5,1500,1642
1985-06-30,Brazil,Bolivia,1,1,0,0.5,0.5,1934,1554
1985-06-30,Colombia,Venezuela,2,0,2,1.0,0.0,1637,1452
1985-06-30,Guadeloupe,Suriname,2,2,0,0.5,0.5,1539,1609
1985-07-01,Réunion,DR Congo,1,2,1,0.0,1.0,1464,1646
1985-07-03,Saudi Arabia,Jordan,4,0,4,1.0,0.0,1656,1430
1985-07-04,Bahrain,Iraq,1,1,0,0.5,0.5,1502,1799
1985-07-04,Fiji,Tahiti,0,1,1,0.0,1.0,1504,1701
1985-07-04,Malawi,DR Congo,0,1,1,0.0,1.0,1683,1656
1985-07-05,Jordan,Qatar,0,2,2,0.0,1.0,1426,1584
1985-07-06,Bahrain,Mauritania,2,0,2,1.0,0.0,1508,1407
1985-07-06,Malawi,Tanzania,0,0,0,0.5,0.5,1681,1575
1985-07-06,Nigeria,Tunisia,1,0,1,1.0,0.0,1709,1690
1985-07-07,Réunion,Malawi,2,8,6,0.0,1.0,1461,1685
1985-07-07,Saudi Arabia,Qatar,1,0,1,1.0,0.0,1663,1578
1985-07-08,Iraq,Mauritania,2,0,2,1.0,0.0,1801,1406
1985-07-08,Malawi,Tanzania,2,0,2,1.0,0.0,1691,1570
1985-07-09,Cape Verde,Angola,0,0,0,0.5,0.5,1479,1553
1985-07-09,Kenya,DR Congo,0,1,1,0.0,1.0,1600,1663
1985-07-10,Angola,Guinea-Bissau,3,1,2,1.0,0.0,1560,1489
1985-07-10,Bahrain,Qatar,1,1,0,0.5,0.5,1510,1577
1985-07-10,Iceland,Faroe Islands,9,0,9,1.0,0.0,1544,1466
1985-07-10,Malawi,Tanzania,0,0,0,0.5,0.5,1689,1573
1985-07-10,Saudi Arabia,Iraq,2,3,1,0.0,1.0,1659,1806
1985-07-11,Fiji,Tahiti,0,1,1,0.0,1.0,1501,1705
1985-07-12,Bahrain,Iraq,0,1,1,0.0,1.0,1508,1809
1985-07-12,Egypt,Morocco,0,0,0,0.5,0.5,1710,1716
1985-07-12,Iceland,Faroe Islands,1,0,1,1.0,0.0,1551,1460
1985-07-12,Saudi Arabia,Qatar,0,0,0,0.5,0.5,1658,1579
1985-07-13,Algeria,Zambia,2,0,2,1.0,0.0,1719,1693
1985-07-14,Fiji,Tahiti,1,2,1,0.0,1.0,1498,1709
1985-07-14,Ghana,Libya,0,0,0,0.5,0.5,1735,1651
1985-07-18,Costa Rica,Trinidad and Tobago,3,1,2,1.0,0.0,1682,1580
1985-07-20,Tunisia,Nigeria,2,0,2,1.0,0.0,1699,1701
1985-07-21,South Korea,Indonesia,2,0,2,1.0,0.0,1801,1538
1985-07-26,Libya,Ghana,2,0,2,1.0,0.0,1661,1726
1985-07-28,Kenya,Uganda,0,1,1,0.0,1.0,1593,1635
1985-07-28,Morocco,Egypt,2,0,2,1.0,0.0,1724,1703
1985-07-28,Tunisia,Saudi Arabia,1,0,1,1.0,0.0,1707,1651
1985-07-28,Zambia,Algeria,0,1,1,0.0,1.0,1686,1727
1985-07-30,Indonesia,South Korea,1,4,3,0.0,1.0,1536,1804
1985-08-04,Kenya,Algeria,0,0,0,0.5,0.5,1596,1725
1985-08-06,Thailand,Hong Kong,1,2,1,0.0,1.0,1570,1607
1985-08-07,Russia,Romania,2,0,2,1.0,0.0,1910,1731
1985-08-10,Nigeria,Zambia,0,0,0,0.5,0.5,1701,1687
1985-08-11,Costa Rica,Honduras,2,2,0,0.5,0.5,1683,1700
1985-08-11,Guinea,Mali,1,1,0,0.5,0.5,1572,1603
1985-08-11,Japan,Hong Kong,3,0,3,1.0,0.0,1703,1602
1985-08-12,Indonesia,Thailand,1,2,1,0.0,1.0,1529,1578
1985-08-13,Algeria,Kenya,3,0,3,1.0,0.0,1731,1591
1985-08-14,Norway,German DR,0,1,1,0.0,1.0,1632,1780
1985-08-17,Canada,Costa Rica,1,1,0,0.5,0.5,1615,1682
1985-08-18,Ivory Coast,Ghana,2,0,2,1.0,0.0,1699,1718
1985-08-18,Zambia,Nigeria,1,0,1,1.0,0.0,1696,1693
1985-08-18,Zimbabwe,Senegal,1,0,1,1.0,0.0,1621,1639
1985-08-21,France,Uruguay,2,0,2,1.0,0.0,1899,1803
1985-08-21,Sweden,Poland,1,0,1,1.0,0.0,1758,1798
1985-08-23,Libya,Mozambique,2,1,1,1.0,0.0,1666,1497
1985-08-25,Honduras,Canada,0,1,1,0.0,1.0,1691,1625
1985-08-25,Mali,Guinea,1,1,0,0.5,0.5,1603,1573
1985-08-25,Morocco,DR Congo,1,0,1,1.0,0.0,1731,1657
1985-08-27,Mexico,Bulgaria,1,1,0,0.5,0.5,1816,1740
1985-08-27,Mauritius,Seychelles,3,1,2,1.0,0.0,1539,1442
1985-08-27,Réunion,Comoros,1,0,1,1.0,0.0,1470,1478
1985-08-28,Romania,Finland,2,0,2,1.0,0.0,1735,1509
1985-08-28,Russia,Germany,1,0,1,1.0,0.0,1919,1921
1985-08-28,Switzerland,Turkey,0,0,0,0.5,0.5,1712,1582
1985-08-28,Madagascar,Seychelles,1,0,1,1.0,0.0,1595,1438
1985-08-29,Mauritius,Madagascar,3,1,2,1.0,0.0,1549,1586
1985-08-29,Comoros,Maldives,2,2,0,0.5,0.5,1478,1469
1985-08-30,Réunion,Maldives,9,0,9,1.0,0.0,1478,1462
1985-08-31,Mauritius,Réunion,4,4,0,0.5,0.5,1548,1480
1985-09-01,Costa Rica,Canada,0,0,0,0.5,0.5,1681,1627
1985-09-01,Ghana,Ivory Coast,0,0,0,0.5,0.5,1718,1700
1985-09-01,Senegal,Zimbabwe,3,0,3,1.0,0.0,1647,1614
1985-09-03,Israel,Taiwan,6,0,6,1.0,0.0,1687,1516
1985-09-04,Czechoslovakia,Poland,3,1,2,1.0,0.0,1762,1789
1985-09-04,Netherlands,Bulgaria,1,0,1,1.0,0.0,1821,1734
1985-09-06,Bahrain,Syria,1,1,0,0.5,0.5,1509,1536
1985-09-08,DR Congo,Morocco,0,0,0,0.5,0.5,1659,1730
1985-09-08,Honduras,Costa Rica,3,1,2,1.0,0.0,1699,1674
1985-09-08,Israel,Taiwan,5,0,5,1.0,0.0,1692,1512
1985-09-10,Norway,Egypt,3,0,3,1.0,0.0,1642,1694
1985-09-10,Wales,Scotland,1,1,0,0.5,0.5,1739,1798
1985-09-11,Denmark,Sweden,0,3,3,0.0,1.0,1757,1767
1985-09-11,England,Romania,1,1,0,0.5,0.5,1859,1738
1985-09-11,German DR,France,2,0,2,1.0,0.0,1791,1889
1985-09-11,Poland,Belgium,0,0,0,0.5,0.5,1790,1811
1985-09-11,Switzerland,Republic of Ireland,0,0,0,0.5,0.5,1712,1677
1985-09-11,Turkey,Northern Ireland,0,0,0,0.5,0.5,1586,1739
1985-09-14,Canada,Honduras,2,1,1,1.0,0.0,1637,1690
1985-09-15,Cameroon,Saudi Arabia,4,1,3,1.0,0.0,1669,1644
1985-09-15,Mozambique,Libya,2,1,1,1.0,0.0,1509,1655
1985-09-16,Papua New Guinea,China PR,1,4,3,0.0,1.0,1497,1713
1985-09-19,Papua New Guinea,China PR,1,1,0,0.5,0.5,1502,1709
1985-09-20,Mexico,Peru,0,0,0,0.5,0.5,1814,1720
1985-09-20,Syria,Bahrain,1,0,1,1.0,0.0,1544,1502
1985-09-20,United Arab Emirates,Iraq,2,3,1,0.0,1.0,1541,1812
1985-09-21,New Zealand,Australia,0,0,0,0.5,0.5,1705,1664
1985-09-22,Hong Kong,Japan,1,2,1,0.0,1.0,1597,1709
1985-09-22,Mexico,Peru,1,0,1,1.0,0.0,1820,1715
1985-09-25,Czechoslovakia,Portugal,1,0,1,1.0,0.0,1771,1759
1985-09-25,Finland,Turkey,1,0,1,1.0,0.0,1519,1577
1985-09-25,Italy,Norway,1,2,1,0.0,1.0,1850,1655
1985-09-25,Luxembourg,Bulgaria,1,3,2,0.0,1.0,1338,1736
1985-09-25,Russia,Denmark,1,0,1,1.0,0.0,1924,1753
1985-09-25,Spain,Iceland,2,1,1,1.0,0.0,1818,1549
1985-09-25,Sweden,Germany,2,2,0,0.5,0.5,1771,1918
1985-09-27,Australia,China PR,3,0,3,1.0,0.0,1674,1700
1985-09-27,Iraq,United Arab Emirates,1,2,1,0.0,1.0,1799,1555
1985-09-28,Yugoslavia,German DR,1,2,1,0.0,1.0,1802,1800
1985-10-04,Malawi,Uganda,1,0,1,1.0,0.0,1696,1629
1985-10-04,Saudi Arabia,Cameroon,2,1,1,1.0,0.0,1653,1661
1985-10-04,Zimbabwe,Tanzania,1,0,1,1.0,0.0,1622,1566
1985-10-05,New Zealand,Taiwan,5,1,4,1.0,0.0,1709,1509
1985-10-06,Malawi,Zambia,2,2,0,0.5,0.5,1696,1696
1985-10-06,Morocco,Libya,3,0,3,1.0,0.0,1737,1649
1985-10-06,Tunisia,Algeria,1,4,3,0.0,1.0,1700,1739
1985-10-06,Zimbabwe,Kenya,1,1,0,0.5,0.5,1622,1592
1985-10-08,Israel,Australia,1,2,1,0.0,1.0,1684,1683
1985-10-08,Kenya,Tanzania,3,2,1,1.0,0.0,1600,1559
1985-10-08,Uganda,Zambia,3,0,3,1.0,0.0,1639,1687
1985-10-09,Denmark,Switzerland,0,0,0,0.5,0.5,1753,1713
1985-10-09,Paraguay,Chile,0,0,0,0.5,0.5,1699,1748
1985-10-11,Kenya,Uganda,0,0,0,0.5,0.5,1601,1639
1985-10-11,Libya,Mexico,3,1,2,1.0,0.0,1661,1809
1985-10-11,Zimbabwe,Malawi,1,0,1,1.0,0.0,1632,1687
1985-10-12,New Zealand,Taiwan,5,0,5,1.0,0.0,1713,1506
1985-10-12,Malawi,Uganda,3,1,2,1.0,0.0,1694,1633
1985-10-12,Portugal,Malta,3,2,1,1.0,0.0,1762,1459
1985-10-13,Brunei,Malaysia,0,4,4,0.0,1.0,1407,1609
1985-10-13,Zimbabwe,Kenya,2,0,2,1.0,0.0,1640,1594
1985-10-15,Yemen,Mexico,0,2,2,0.0,1.0,1385,1811
1985-10-16,Austria,Yugoslavia,0,3,3,0.0,1.0,1788,1810
1985-10-16,Belgium,Netherlands,1,0,1,1.0,0.0,1820,1813
1985-10-16,Czechoslovakia,Sweden,2,1,1,1.0,0.0,1779,1763
1985-10-16,England,Turkey,5,0,5,1.0,0.0,1862,1575
1985-10-16,Germany,Portugal,0,1,1,0.0,1.0,1907,1774
1985-10-16,Greece,Bulgaria,0,2,2,0.0,1.0,1629,1742
1985-10-16,Norway,Denmark,1,5,4,0.0,1.0,1650,1759
1985-10-16,Peru,Paraguay,0,1,1,0.0,1.0,1707,1708
1985-10-16,Romania,Northern Ireland,0,1,1,0.0,1.0,1731,1747
1985-10-16,Russia,Republic of Ireland,2,0,2,1.0,0.0,1928,1674
1985-10-16,Scotland,German DR,0,0,0,0.5,0.5,1799,1800
1985-10-16,Singapore,Brunei,2,1,1,1.0,0.0,1528,1402
1985-10-16,Wales,Hungary,0,3,3,0.0,1.0,1733,1817
1985-10-18,Algeria,Tunisia,3,0,3,1.0,0.0,1747,1693
1985-10-18,Jordan,Mexico,0,0,0,0.5,0.5,1433,1805
1985-10-18,Libya,Morocco,1,0,1,1.0,0.0,1671,1728
1985-10-20,Australia,Israel,1,1,0,0.5,0.5,1684,1684
1985-10-20,Egypt,Mexico,2,1,1,1.0,0.0,1705,1795
1985-10-20,Singapore,Malaysia,2,0,2,1.0,0.0,1538,1600
1985-10-23,Australia,Taiwan,7,0,7,1.0,0.0,1689,1502
1985-10-23,Singapore,Malaysia,4,0,4,1.0,0.0,1548,1591
1985-10-25,Kuwait,Mexico,0,0,0,0.5,0.5,1703,1793
1985-10-26,Myanmar,Indonesia,2,1,1,1.0,0.0,1612,1523
1985-10-26,Japan,South Korea,1,2,1,0.0,1.0,1704,1810
1985-10-26,New Zealand,Israel,3,1,2,1.0,0.0,1721,1677
1985-10-27,Australia,Taiwan,8,0,8,1.0,0.0,1694,1498
1985-10-27,Chile,Peru,4,2,2,1.0,0.0,1756,1700
1985-10-27,Paraguay,Colombia,3,0,3,1.0,0.0,1715,1631
1985-10-30,Albania,Greece,1,1,0,0.5,0.5,1497,1627
1985-10-30,France,Luxembourg,6,0,6,1.0,0.0,1890,1338
1985-10-30,Russia,Norway,1,0,1,1.0,0.0,1931,1648
1985-11-03,Australia,New Zealand,2,0,2,1.0,0.0,1703,1713
1985-11-03,Colombia,Paraguay,2,1,1,1.0,0.0,1641,1706
1985-11-03,South Korea,Japan,1,0,1,1.0,0.0,1816,1699
1985-11-03,Peru,Chile,0,1,1,0.0,1.0,1694,1763
1985-11-05,Anguilla,British Virgin Islands,0,1,1,0.0,1.0,1492,1508
1985-11-06,France,Yugoslavia,2,0,2,1.0,0.0,1897,1804
1985-11-08,Angola,Mozambique,0,0,0,0.5,0.5,1559,1511
1985-11-10,Angola,Zimbabwe,2,3,1,0.0,1.0,1553,1647
1985-11-10,Israel,New Zealand,3,0,3,1.0,0.0,1686,1705
1985-11-10,Paraguay,Chile,3,0,3,1.0,0.0,1716,1754
1985-11-11,Mozambique,Zimbabwe,1,2,1,0.0,1.0,1506,1653
1985-11-13,England,Northern Ireland,0,0,0,0.5,0.5,1860,1750
1985-11-13,Republic of Ireland,Denmark,1,4,3,0.0,1.0,1668,1766
1985-11-13,Switzerland,Norway,1,1,0,0.5,0.5,1712,1650
1985-11-13,Turkey,Romania,1,3,2,0.0,1.0,1571,1736
1985-11-14,Mexico,Argentina,1,1,0,0.5,0.5,1795,1847
1985-11-15,Syria,Iraq,0,0,0,0.5,0.5,1550,1794
1985-11-16,German DR,Bulgaria,2,1,1,1.0,0.0,1807,1736
1985-11-16,Poland,Italy,1,0,1,1.0,0.0,1800,1841
1985-11-17,Chile,Paraguay,2,2,0,0.5,0.5,1754,1717
1985-11-17,Germany,Czechoslovakia,2,2,0,0.5,0.5,1905,1782
1985-11-17,Grenada,Dominica,0,0,0,0.5,0.5,1529,1444
1985-11-17,Malta,Sweden,1,2,1,0.0,1.0,1457,1766
1985-11-17,Mexico,Argentina,1,1,0,0.5,0.5,1797,1846
1985-11-17,Saint Lucia,Saint Vincent and the Grenadines,0,0,0,0.5,0.5,1476,1597
1985-11-18,Dominica,Saint Vincent and the Grenadines,0,0,0,0.5,0.5,1448,1594
1985-11-19,DR Congo,Zambia,0,1,1,0.0,1.0,1652,1695
1985-11-19,Egypt,Ivory Coast,0,1,1,0.0,1.0,1697,1709
1985-11-20,Netherlands,Belgium,2,1,1,1.0,0.0,1822,1812
1985-11-20,Scotland,Australia,2,0,2,1.0,0.0,1805,1698
1985-11-20,Spain,Austria,0,0,0,0.5,0.5,1818,1789
1985-11-21,DR Congo,Egypt,3,2,1,1.0,0.0,1662,1688
1985-11-21,Ivory Coast,Zambia,0,1,1,0.0,1.0,1701,1704
1985-11-23,Egypt,Zambia,1,0,1,1.0,0.0,1697,1696
1985-11-24,DR Congo,Ivory Coast,1,2,1,0.0,1.0,1655,1709
1985-11-24,Saint Kitts and Nevis,Dominica,2,1,1,1.0,0.0,1465,1441
1985-11-27,Congo,Ivory Coast,2,1,1,1.0,0.0,1596,1699
1985-11-29,Congo,Ivory Coast,0,1,1,0.0,1.0,1591,1705
1985-11-29,Iraq,Syria,3,1,2,1.0,0.0,1798,1547
1985-12-01,Dominica,Saint Kitts and Nevis,0,1,1,0.0,1.0,1434,1473
1985-12-03,Mexico,South Korea,2,1,1,1.0,0.0,1806,1808
1985-12-04,Australia,Scotland,0,0,0,0.5,0.5,1701,1803
1985-12-07,Gabon,Congo,1,0,1,1.0,0.0,1476,1581
1985-12-07,Mexico,Algeria,2,0,2,1.0,0.0,1813,1741
1985-12-08,Cameroon,Equatorial Guinea,2,0,2,1.0,0.0,1666,1486
1985-12-08,Tunisia,Poland,1,0,1,1.0,0.0,1704,1790
1985-12-08,Thailand,Malaysia,1,1,0,0.5,0.5,1579,1591
1985-12-09,Central African Republic,Congo,1,4,3,0.0,1.0,1460,1587
1985-12-09,Hungary,South Korea,1,0,1,1.0,0.0,1825,1801
1985-12-09,Indonesia,Singapore,0,1,1,0.0,1.0,1516,1556
1985-12-10,Chad,Equatorial Guinea,1,1,0,0.5,0.5,1486,1486
1985-12-10,Mexico,South Korea,2,1,1,1.0,0.0,1821,1794
1985-12-10,Malaysia,Philippines,6,0,6,1.0,0.0,1594,1326
1985-12-11,Algeria,Hungary,1,3,2,0.0,1.0,1735,1832
1985-12-11,Gabon,Central African Republic,4,0,4,1.0,0.0,1484,1453
1985-12-11,Turkey,Poland,1,1,0,0.5,0.5,1576,1786
1985-12-11,Brunei,Indonesia,1,1,0,0.5,0.5,1405,1514
1985-12-12,Chad,Cameroon,2,2,0,0.5,0.5,1490,1663
1985-12-12,Thailand,Philippines,7,0,7,1.0,0.0,1583,1323
1985-12-13,Algeria,South Korea,0,2,2,0.0,1.0,1729,1801
1985-12-13,Singapore,Brunei,3,0,3,1.0,0.0,1561,1401
1985-12-14,Gabon,Chad,3,0,3,1.0,0.0,1493,1482
1985-12-14,Mexico,Hungary,2,0,2,1.0,0.0,1830,1824
1985-12-15,Congo,Cameroon,1,0,1,1.0,0.0,1597,1654
1985-12-15,Gambia,Guinea,0,0,0,0.5,0.5,1509,1572
1985-12-15,Singapore,Malaysia,2,2,0,0.5,0.5,1562,1594
1985-12-15,Thailand,Indonesia,7,0,7,1.0,0.0,1590,1508
1985-12-16,Malaysia,Indonesia,1,0,1,1.0,0.0,1601,1502
1985-12-18,Chad,Cameroon,1,2,1,0.0,1.0,1478,1659
1985-12-18,Spain,Bulgaria,2,0,2,1.0,0.0,1825,1730
1985-12-18,Thailand,Singapore,2,0,2,1.0,0.0,1598,1555
1985-12-19,Gabon,Congo,3,0,3,1.0,0.0,1504,1587
1985-12-21,Bangladesh,Pakistan,2,1,1,1.0,0.0,1470,1467
1985-12-21,India,Nepal,2,0,2,1.0,0.0,1525,1439
1985-12-22,Pakistan,Maldives,3,1,2,1.0,0.0,1475,1455
1985-12-22,Nepal,Bhutan,1,0,1,1.0,0.0,1448,1459
1985-12-23,Bangladesh,Maldives,8,0,8,1.0,0.0,1478,1448
1985-12-23,India,Bhutan,3,0,3,1.0,0.0,1532,1453
1985-12-25,Senegal,Guinea,3,1,2,1.0,0.0,1654,1566
1985-12-25,Pakistan,Nepal,2,2,0,0.5,0.5,1475,1449
1985-12-25,Bangladesh,India,1,1,0,0.5,0.5,1480,1531
1985-12-27,Ivory Coast,Guinea,1,0,1,1.0,0.0,1710,1562
1985-12-29,Senegal,Ivory Coast,2,0,2,1.0,0.0,1664,1701
1986-01-03,Qatar,China PR,1,1,0,0.5,0.5,1582,1698
1986-01-17,Qatar,Greece,0,1,1,0.0,1.0,1576,1634
1986-01-22,Gabon,Senegal,0,1,1,0.0,1.0,1500,1669
1986-01-22,Portugal,Finland,1,1,0,0.5,0.5,1769,1525
1986-01-22,Spain,Russia,2,0,2,1.0,0.0,1836,1921
1986-01-24,Qatar,Tunisia,2,1,1,1.0,0.0,1587,1694
1986-01-25,India,China PR,0,0,0,0.5,0.5,1535,1695
1986-01-27,Oman,Tunisia,0,0,0,0.5,0.5,1396,1689
1986-01-28,China PR,Peru,3,1,2,1.0,0.0,1703,1687
1986-01-28,Israel,Scotland,0,1,1,0.0,1.0,1681,1809
1986-01-29,Canada,Paraguay,0,0,0,0.5,0.5,1639,1716
1986-01-29,Egypt,England,0,4,4,0.0,1.0,1693,1865
1986-01-30,India,Peru,0,1,1,0.0,1.0,1531,1692
1986-02-01,Senegal,Guinea,2,1,1,1.0,0.0,1675,1557
1986-02-02,Canada,Uruguay,1,3,2,0.0,1.0,1635,1808
1986-02-02,Gambia,Guinea-Bissau,3,0,3,1.0,0.0,1517,1482
1986-02-02,Mauritania,Sierra Leone,0,1,1,0.0,1.0,1401,1514
1986-02-02,Qatar,Hungary,0,3,3,0.0,1.0,1584,1828
1986-02-03,Guinea,Mali,1,1,0,0.5,0.5,1559,1602
1986-02-04,Gambia,Sierra Leone,1,2,1,0.0,1.0,1509,1523
1986-02-04,Guinea-Bissau,Mauritania,1,0,1,1.0,0.0,1489,1395
1986-02-05,Italy,Germany,1,2,1,0.0,1.0,1835,1912
1986-02-05,Jamaica,Paraguay,1,4,3,0.0,1.0,1474,1720
1986-02-05,Portugal,Luxembourg,2,0,2,1.0,0.0,1771,1337
1986-02-05,Senegal,Mali,1,0,1,1.0,0.0,1682,1596
1986-02-06,Gambia,Mauritania,3,1,2,1.0,0.0,1515,1390
1986-02-06,Guinea-Bissau,Sierra Leone,2,3,1,0.0,1.0,1482,1531
1986-02-08,Guinea,Sierra Leone,1,2,1,0.0,1.0,1551,1540
1986-02-08,Senegal,Gambia,1,0,1,1.0,0.0,1687,1511
1986-02-09,Bulgaria,German DR,1,2,1,0.0,1.0,1724,1814
1986-02-10,Senegal,Sierra Leone,3,1,2,1.0,0.0,1692,1536
1986-02-14,South Korea,Paraguay,1,3,2,0.0,1.0,1792,1730
1986-02-15,Mexico,German DR,1,2,1,0.0,1.0,1822,1823
1986-02-15,Zambia,Botswana,6,0,6,1.0,0.0,1699,1429
1986-02-16,Indonesia,Paraguay,2,3,1,0.0,1.0,1499,1734
1986-02-16,Iran,Pakistan,2,0,2,1.0,0.0,1752,1473
1986-02-16,Uruguay,Poland,2,2,0,0.5,0.5,1808,1787
1986-02-16,Zambia,Botswana,3,0,3,1.0,0.0,1702,1427
1986-02-17,Saudi Arabia,Algeria,0,0,0,0.5,0.5,1655,1728
1986-02-19,Greece,Cyprus,0,0,0,0.5,0.5,1630,1396
1986-02-19,Mexico,Russia,1,0,1,1.0,0.0,1833,1911
1986-02-19,Morocco,Bulgaria,0,0,0,0.5,0.5,1728,1725
1986-02-19,Portugal,German DR,1,3,2,0.0,1.0,1765,1830
1986-02-19,Spain,Belgium,3,0,3,1.0,0.0,1844,1805
1986-02-20,Iran,Ghana,2,0,2,1.0,0.0,1760,1711
1986-02-21,Bahrain,Finland,0,0,0,0.5,0.5,1503,1525
1986-02-21,Saudi Arabia,Algeria,1,1,0,0.5,0.5,1657,1727
1986-02-23,Liberia,Burkina Faso,0,1,1,0.0,1.0,1468,1506
1986-02-24,Bahrain,Finland,0,4,4,0.0,1.0,1496,1533
1986-02-24,Burkina Faso,Togo,0,1,1,0.0,1.0,1501,1605
1986-02-24,Ghana,Niger,2,0,2,1.0,0.0,1715,1476
1986-02-25,Algeria,Mozambique,4,1,3,1.0,0.0,1731,1503
1986-02-25,Ghana,Togo,2,2,0,0.5,0.5,1713,1608
1986-02-25,Liberia,Niger,3,0,3,1.0,0.0,1477,1468
1986-02-25,Saudi Arabia,Wales,1,2,1,0.0,1.0,1651,1740
1986-02-26,Burkina Faso,Niger,0,0,0,0.5,0.5,1501,1469
1986-02-26,France,Northern Ireland,0,0,0,0.5,0.5,1894,1754
1986-02-26,Ghana,Liberia,3,0,3,1.0,0.0,1717,1474
1986-02-26,Grenada,Norway,1,2,1,0.0,1.0,1524,1656
1986-02-26,Israel,England,1,2,1,0.0,1.0,1677,1870
1986-02-26,Qatar,Paraguay,1,1,0,0.5,0.5,1588,1731
1986-02-26,Tunisia,Cameroon,1,1,0,0.5,0.5,1689,1660
1986-02-27,Ghana,Burkina Faso,2,0,2,1.0,0.0,1721,1498
1986-02-27,Togo,Liberia,1,0,1,1.0,0.0,1614,1469
1986-02-28,Egypt,Romania,2,2,0,0.5,0.5,1694,1736
1986-02-28,Niger,Togo,3,1,2,1.0,0.0,1481,1603
1986-02-28,Saudi Arabia,Finland,0,1,1,0.0,1.0,1641,1544
1986-03-01,Ghana,Burkina Faso,2,0,2,1.0,0.0,1725,1495
1986-03-01,Qatar,Paraguay,0,3,3,0.0,1.0,1584,1736
1986-03-01,Saint Lucia,Norway,0,6,6,0.0,1.0,1472,1661
1986-03-01,Togo,Niger,3,1,2,1.0,0.0,1609,1476
1986-03-02,Burkina Faso,Niger,1,2,1,0.0,1.0,1487,1485
1986-03-02,Egypt,Romania,0,1,1,0.0,1.0,1687,1744
1986-03-02,Ghana,Togo,1,0,1,1.0,0.0,1731,1604
1986-03-03,Guadeloupe,Norway,1,2,1,0.0,1.0,1534,1667
1986-03-05,Martinique,Norway,0,1,1,0.0,1.0,1635,1675
1986-03-05,Thailand,Indonesia,1,1,0,0.5,0.5,1596,1502
1986-03-06,Mexico,Denmark,1,1,0,0.5,0.5,1832,1768
1986-03-07,Egypt,Senegal,0,1,1,0.0,1.0,1680,1700
1986-03-07,Ivory Coast,Mozambique,3,0,3,1.0,0.0,1705,1500
1986-03-08,Algeria,Morocco,0,0,0,0.5,0.5,1731,1729
1986-03-08,Bahrain,Paraguay,1,2,1,0.0,1.0,1493,1740
1986-03-08,Cameroon,Zambia,3,2,1,1.0,0.0,1669,1694
1986-03-10,Egypt,Ivory Coast,2,0,2,1.0,0.0,1689,1697
1986-03-10,Mozambique,Senegal,0,2,2,0.0,1.0,1497,1704
1986-03-11,Algeria,Zambia,0,0,0,0.5,0.5,1731,1695
1986-03-11,Bahrain,Iceland,2,1,1,1.0,0.0,1503,1540
1986-03-11,Cameroon,Morocco,1,1,0,0.5,0.5,1671,1728
1986-03-12,German DR,Netherlands,0,1,1,0.0,1.0,1822,1831
1986-03-12,Germany,Brazil,2,0,2,1.0,0.0,1921,1926
1986-03-12,Saudi Arabia,Paraguay,0,0,0,0.5,0.5,1644,1738
1986-03-12,Turkey,Switzerland,1,0,1,1.0,0.0,1587,1702
1986-03-13,Egypt,Mozambique,2,0,2,1.0,0.0,1693,1494
1986-03-13,Ivory Coast,Senegal,1,0,1,1.0,0.0,1706,1696
1986-03-14,Algeria,Cameroon,2,3,1,0.0,1.0,1722,1681
1986-03-14,Djibouti,Ethiopia,1,5,4,0.0,1.0,1418,1564
1986-03-14,Iraq,Romania,1,1,0,0.5,0.5,1797,1746
1986-03-14,Morocco,Zambia,1,0,1,1.0,0.0,1736,1688
1986-03-15,Bahrain,Iceland,0,2,2,0.0,1.0,1496,1548
1986-03-16,Hungary,Brazil,3,0,3,1.0,0.0,1839,1916
1986-03-17,Cameroon,Ivory Coast,1,0,1,1.0,0.0,1690,1698
1986-03-17,Egypt,Morocco,1,0,1,1.0,0.0,1702,1728
1986-03-18,Djibouti,Ethiopia,1,1,0,0.5,0.5,1422,1561
1986-03-19,Kuwait,Iceland,1,0,1,1.0,0.0,1708,1544
1986-03-20,Ivory Coast,Morocco,3,2,1,1.0,0.0,1707,1720
1986-03-21,Egypt,Cameroon,0,0,0,0.5,0.5,1702,1691
1986-03-22,Bahrain,Iraq,0,0,0,0.5,0.5,1502,1792
1986-03-23,Qatar,Oman,2,1,1,1.0,0.0,1589,1392
1986-03-23,Saudi Arabia,Kuwait,1,3,2,0.0,1.0,1638,1715
1986-03-24,United Arab Emirates,Iraq,2,2,0,0.5,0.5,1560,1788
1986-03-25,Bahrain,Saudi Arabia,2,1,1,1.0,0.0,1513,1628
1986-03-25,Kuwait,Oman,2,0,2,1.0,0.0,1718,1390
1986-03-26,France,Argentina,2,0,2,1.0,0.0,1901,1840
1986-03-26,Greece,German DR,2,0,2,1.0,0.0,1643,1810
1986-03-26,Republic of Ireland,Wales,0,1,1,0.0,1.0,1662,1747
1986-03-26,Italy,Austria,2,1,1,1.0,0.0,1842,1783
1986-03-26,Northern Ireland,Denmark,1,1,0,0.5,0.5,1755,1768
1986-03-26,Russia,England,0,1,1,0.0,1.0,1903,1879
1986-03-26,Scotland,Romania,3,0,3,1.0,0.0,1816,1740
1986-03-26,Spain,Poland,3,0,3,1.0,0.0,1851,1781
1986-03-27,Qatar,Iraq,1,1,0,0.5,0.5,1594,1784
1986-03-28,Saudi Arabia,Oman,3,1,2,1.0,0.0,1632,1387
1986-03-28,United Arab Emirates,Kuwait,0,1,1,0.0,1.0,1556,1723
1986-03-29,Bahrain,Qatar,0,0,0,0.5,0.5,1515,1593
1986-03-30,Iraq,Saudi Arabia,1,2,1,0.0,1.0,1773,1644
1986-03-30,Oman,United Arab Emirates,0,1,1,0.0,1.0,1383,1561
1986-04-01,Brazil,Peru,4,0,4,1.0,0.0,1920,1689
1986-04-01,Kuwait,Qatar,2,1,1,1.0,0.0,1729,1588
1986-04-02,Bahrain,Oman,0,0,0,0.5,0.5,1513,1386
1986-04-02,Saudi Arabia,United Arab Emirates,0,2,2,0.0,1.0,1635,1571
1986-04-03,Iraq,Kuwait,1,2,1,0.0,1.0,1764,1739
1986-04-05,Bahrain,United Arab Emirates,1,3,2,0.0,1.0,1507,1578
1986-04-05,Qatar,Saudi Arabia,0,2,2,0.0,1.0,1582,1642
1986-04-06,Oman,Iraq,2,3,1,0.0,1.0,1385,1766
1986-04-07,Bahrain,Kuwait,1,1,0,0.5,0.5,1512,1735
1986-04-07,Qatar,United Arab Emirates,3,2,1,1.0,0.0,1590,1571
1986-04-08,Brazil,German DR,3,0,3,1.0,0.0,1926,1805
1986-04-09,Bulgaria,Denmark,3,0,3,1.0,0.0,1734,1760
1986-04-09,Switzerland,Germany,0,1,1,0.0,1.0,1699,1925
1986-04-09,Guernsey,Alderney,7,0,7,1.0,0.0,1664,1301
1986-04-13,Mexico,Uruguay,1,0,1,1.0,0.0,1840,1801
1986-04-17,Brazil,Finland,3,0,3,1.0,0.0,1928,1543
1986-04-21,Wales,Uruguay,0,0,0,0.5,0.5,1749,1800
1986-04-23,Belgium,Bulgaria,2,0,2,1.0,0.0,1812,1728
1986-04-23,Czechoslovakia,German DR,2,0,2,1.0,0.0,1791,1797
1986-04-23,England,Scotland,2,1,1,1.0,0.0,1886,1810
1986-04-23,Republic of Ireland,Uruguay,1,1,0,0.5,0.5,1666,1797
1986-04-23,Northern Ireland,Morocco,2,1,1,1.0,0.0,1763,1713
1986-04-23,Romania,Russia,2,1,1,1.0,0.0,1752,1892
1986-04-25,China PR,Nepal,5,0,5,1.0,0.0,1707,1446
1986-04-25,Pakistan,Sri Lanka,1,0,1,1.0,0.0,1479,1370
1986-04-26,Pakistan,South Korea,1,0,1,1.0,0.0,1493,1779
1986-04-26,Eswatini,Botswana,0,1,1,0.0,1.0,1467,1437
1986-04-27,Mexico,Canada,3,0,3,1.0,0.0,1844,1632
1986-04-27,Nepal,Sri Lanka,2,2,0,0.5,0.5,1445,1372
1986-04-28,Pakistan,China PR,0,3,3,0.0,1.0,1490,1711
1986-04-29,South Korea,Nepal,5,0,5,1.0,0.0,1782,1443
1986-04-29,Netherlands,Scotland,0,0,0,0.5,0.5,1831,1811
1986-04-30,Brazil,Yugoslavia,4,2,2,1.0,0.0,1934,1799
1986-04-30,Bulgaria,North Korea,3,0,3,1.0,0.0,1736,1680
1986-04-30,South Korea,Sri Lanka,4,0,4,1.0,0.0,1784,1371
1986-04-30,Norway,Argentina,1,0,1,1.0,0.0,1687,1829
1986-05-01,China PR,Sri Lanka,3,0,3,1.0,0.0,1713,1370
1986-05-01,Sweden,Greece,0,0,0,0.5,0.5,1764,1646
1986-05-02,China PR,South Korea,1,1,0,0.5,0.5,1715,1783
1986-05-02,Pakistan,Nepal,5,0,5,1.0,0.0,1497,1437
1986-05-06,Switzerland,Algeria,2,0,2,1.0,0.0,1708,1714
1986-05-07,Brazil,Chile,1,1,0,0.5,0.5,1931,1758
1986-05-07,Russia,Finland,0,0,0,0.5,0.5,1886,1550
1986-05-09,French Guiana,Réunion,0,0,0,0.5,0.5,1470,1480
1986-05-09,Jersey,Guernsey,3,2,1,1.0,0.0,1694,1657
1986-05-10,Canada,Wales,2,0,2,1.0,0.0,1643,1739
1986-05-11,Germany,Yugoslavia,1,1,0,0.5,0.5,1923,1802
1986-05-11,Italy,China PR,2,0,2,1.0,0.0,1848,1710
1986-05-11,Japan,Algeria,2,1,1,1.0,0.0,1708,1706
1986-05-13,Norway,Denmark,1,0,1,1.0,0.0,1697,1751
1986-05-14,Austria,Sweden,1,0,1,1.0,0.0,1791,1757
1986-05-14,Germany,Netherlands,3,1,2,1.0,0.0,1929,1826
1986-05-16,Denmark,Poland,1,0,1,1.0,0.0,1760,1773
1986-05-17,Mexico,England,0,3,3,0.0,1.0,1837,1894
1986-05-19,Belgium,Yugoslavia,1,3,2,0.0,1.0,1804,1811
1986-05-19,Canada,Wales,0,3,3,0.0,1.0,1638,1745
1986-05-21,Panama,Dominican Republic,2,1,1,1.0,0.0,1460,1490
1986-05-24,Canada,England,0,1,1,0.0,1.0,1636,1897
1986-05-25,Iceland,Republic of Ireland,1,2,1,0.0,1.0,1539,1672
1986-05-27,Czechoslovakia,Republic of Ireland,0,1,1,0.0,1.0,1781,1683
1986-05-28,China PR,Iran,2,1,1,1.0,0.0,1720,1751
1986-05-29,Iceland,Czechoslovakia,1,2,1,0.0,1.0,1536,1785
1986-05-31,Bulgaria,Italy,1,1,0,0.5,0.5,1739,1846
1986-05-31,Macau,Hong Kong,2,3,1,0.0,1.0,1451,1602
1986-06-01,Canada,France,0,1,1,0.0,1.0,1634,1904
1986-06-01,Spain,Brazil,0,1,1,0.0,1.0,1845,1938
1986-06-02,Argentina,South Korea,3,1,2,1.0,0.0,1836,1777
1986-06-02,Morocco,Poland,0,0,0,0.5,0.5,1715,1772
1986-06-02,Russia,Hungary,6,0,6,1.0,0.0,1893,1833
1986-06-03,Algeria,Northern Ireland,1,1,0,0.5,0.5,1708,1762
1986-06-03,Djibouti,Ethiopia,0,2,2,0.0,1.0,1418,1566
1986-06-03,Mexico,Belgium,2,1,1,1.0,0.0,1845,1797
1986-06-03,Portugal,England,1,0,1,1.0,0.0,1776,1887
1986-06-04,Nepal,Hong Kong,4,2,2,1.0,0.0,1449,1591
1986-06-04,Paraguay,Iraq,1,0,1,1.0,0.0,1747,1758
1986-06-04,Romania,Norway,3,1,2,1.0,0.0,1759,1691
1986-06-04,Scotland,Denmark,0,1,1,0.0,1.0,1802,1770
1986-06-04,Uruguay,Germany,1,1,0,0.5,0.5,1800,1927
1986-06-05,France,Russia,1,1,0,0.5,0.5,1904,1894
1986-06-05,Italy,Argentina,1,1,0,0.5,0.5,1846,1837
1986-06-05,South Korea,Bulgaria,1,1,0,0.5,0.5,1777,1740
1986-06-06,Brazil,Algeria,1,0,1,1.0,0.0,1942,1705
1986-06-06,England,Morocco,0,0,0,0.5,0.5,1884,1719
1986-06-06,Hungary,Canada,2,0,2,1.0,0.0,1837,1631
1986-06-06,Mauritius,Réunion,0,1,1,0.0,1.0,1539,1490
1986-06-07,Mexico,Paraguay,1,1,0,0.5,0.5,1843,1750
1986-06-07,Nepal,Bhutan,4,0,4,1.0,0.0,1458,1445
1986-06-07,Northern Ireland,Spain,1,2,1,0.0,1.0,1756,1852
1986-06-07,Poland,Portugal,1,0,1,1.0,0.0,1781,1768
1986-06-08,Denmark,Uruguay,6,1,5,1.0,0.0,1779,1792
1986-06-08,Germany,Scotland,2,1,1,1.0,0.0,1933,1797
1986-06-08,Iraq,Belgium,1,2,1,0.0,1.0,1751,1805
1986-06-09,Hungary,France,0,3,3,0.0,1.0,1831,1911
1986-06-09,Russia,Canada,2,0,2,1.0,0.0,1897,1629
1986-06-10,Argentina,Bulgaria,2,0,2,1.0,0.0,1843,1735
1986-06-10,South Korea,Italy,2,3,1,0.0,1.0,1771,1853
1986-06-11,England,Poland,3,0,3,1.0,0.0,1890,1776
1986-06-11,Guyana,Barbados,2,1,1,1.0,0.0,1483,1492
1986-06-11,Mexico,Iraq,1,0,1,1.0,0.0,1849,1746
1986-06-11,Paraguay,Belgium,2,2,0,0.5,0.5,1752,1804
1986-06-11,Portugal,Morocco,1,3,2,0.0,1.0,1759,1729
1986-06-12,Algeria,Spain,0,3,3,0.0,1.0,1701,1857
1986-06-12,Northern Ireland,Brazil,0,3,3,0.0,1.0,1752,1947
1986-06-13,Denmark,Germany,2,0,2,1.0,0.0,1791,1922
1986-06-13,Réunion,Mauritius,0,0,0,0.5,0.5,1492,1538
1986-06-13,Scotland,Uruguay,0,0,0,0.5,0.5,1797,1793
1986-06-15,Mexico,Bulgaria,2,0,2,1.0,0.0,1855,1730
1986-06-15,Russia,Belgium,3,4,1,0.0,1.0,1887,1815
1986-06-16,Argentina,Uruguay,1,0,1,1.0,0.0,1850,1787
1986-06-16,Brazil,Poland,4,0,4,1.0,0.0,1952,1772
1986-06-17,Italy,France,0,2,2,0.0,1.0,1847,1918
1986-06-17,Morocco,Germany,0,1,1,0.0,1.0,1726,1926
1986-06-18,Denmark,Spain,1,5,4,0.0,1.0,1785,1864
1986-06-18,England,Paraguay,3,0,3,1.0,0.0,1895,1748
1986-06-21,Brazil,France,1,1,0,0.5,0.5,1952,1919
1986-06-21,Malawi,Zambia,0,2,2,0.0,1.0,1686,1697
1986-06-21,Mexico,Germany,0,0,0,0.5,0.5,1857,1925
1986-06-22,Argentina,England,2,1,1,1.0,0.0,1860,1886
1986-06-22,Malawi,Zambia,0,1,1,0.0,1.0,1679,1705
1986-06-22,Spain,Belgium,1,1,0,0.5,0.5,1863,1817
1986-06-25,Argentina,Belgium,2,0,2,1.0,0.0,1868,1810
1986-06-25,France,Germany,0,2,2,0.0,1.0,1912,1933
1986-06-28,France,Belgium,4,2,2,1.0,0.0,1918,1805
1986-06-29,Argentina,Germany,3,2,1,1.0,0.0,1878,1924
1986-06-30,Myanmar,India,3,1,2,1.0,0.0,1619,1525
1986-07-06,Malawi,Uganda,2,1,1,1.0,0.0,1686,1627
1986-07-08,Malawi,Uganda,0,0,0,0.5,0.5,1685,1629
1986-07-10,Malawi,Uganda,0,0,0,0.5,0.5,1684,1631
1986-07-24,Malaysia,India,3,0,3,1.0,0.0,1608,1519
1986-07-25,Japan,Syria,2,1,1,1.0,0.0,1713,1543
1986-07-26,Liberia,Guinea,0,0,0,0.5,0.5,1471,1550
1986-07-26,Malaysia,Thailand,2,0,2,1.0,0.0,1616,1589
1986-07-27,Nigeria,Togo,2,2,0,0.5,0.5,1691,1607
1986-07-28,Guinea,Ivory Coast,0,2,2,0.0,1.0,1546,1712
1986-07-29,Ghana,Nigeria,2,0,2,1.0,0.0,1739,1684
1986-07-30,India,Thailand,3,1,2,1.0,0.0,1529,1580
1986-07-30,Liberia,Ivory Coast,0,2,2,0.0,1.0,1468,1716
1986-07-31,China PR,Congo,1,1,0,0.5,0.5,1718,1590
1986-07-31,Ghana,Togo,1,1,0,0.5,0.5,1737,1610
1986-08-01,Liberia,Guinea,2,1,1,1.0,0.0,1478,1537
1986-08-01,Malaysia,Japan,2,1,1,1.0,0.0,1627,1703
1986-08-02,Ghana,Ivory Coast,0,1,1,0.0,1.0,1729,1725
1986-08-02,Liberia,Togo,1,0,1,1.0,0.0,1489,1600
1986-08-03,Australia,Czechoslovakia,1,1,0,0.5,0.5,1703,1784
1986-08-06,Australia,Czechoslovakia,0,1,1,0.0,1.0,1697,1791
1986-08-06,Finland,Sweden,1,3,2,0.0,1.0,1547,1761
1986-08-10,Australia,Czechoslovakia,0,3,3,0.0,1.0,1692,1797
1986-08-12,Bahrain,Oman,2,3,1,0.0,1.0,1502,1396
1986-08-13,Senegal,Gabon,1,0,1,1.0,0.0,1700,1497
1986-08-14,Bahrain,Oman,2,0,2,1.0,0.0,1508,1391
1986-08-16,Guinea,Gambia,2,1,1,1.0,0.0,1545,1504
1986-08-19,Switzerland,France,2,0,2,1.0,0.0,1721,1906
1986-08-20,Finland,German DR,1,0,1,1.0,0.0,1560,1785
1986-08-20,Indonesia,Algeria,0,1,1,0.0,1.0,1499,1705
1986-08-20,Norway,Romania,2,2,0,0.5,0.5,1693,1758
1986-08-20,Sweden,Russia,0,0,0,0.5,0.5,1764,1885
1986-08-23,Malaysia,Algeria,2,2,0,0.5,0.5,1629,1704
1986-08-24,China PR,North Korea,0,0,0,0.5,0.5,1718,1681
1986-08-24,Oman,Bahrain,1,0,1,1.0,0.0,1402,1498
1986-08-24,Singapore,Canada,0,1,1,0.0,1.0,1549,1636
1986-08-26,Oman,Bahrain,1,2,1,0.0,1.0,1397,1504
1986-08-27,Austria,Switzerland,1,1,0,0.5,0.5,1790,1723
1986-08-27,Canada,North Korea,0,0,0,0.5,0.5,1638,1680
1986-08-30,Gambia,Guinea,0,1,1,0.0,1.0,1497,1553
1986-08-30,Singapore,North Korea,0,2,2,0.0,1.0,1544,1686
1986-08-31,China PR,Canada,1,0,1,1.0,0.0,1725,1632
1986-09-01,Singapore,China PR,0,3,3,0.0,1.0,1540,1730
1986-09-03,Singapore,China PR,1,2,1,0.0,1.0,1536,1735
1986-09-04,Canada,North Korea,0,2,2,0.0,1.0,1626,1693
1986-09-06,China PR,North Korea,2,1,1,1.0,0.0,1743,1686
1986-09-06,Singapore,Canada,0,1,1,0.0,1.0,1531,1632
1986-09-07,Singapore,Saudi Arabia,0,4,4,0.0,1.0,1526,1648
1986-09-09,Norway,Hungary,0,0,0,0.5,0.5,1697,1828
1986-09-10,Belgium,Republic of Ireland,2,2,0,0.5,0.5,1803,1686
1986-09-10,Czechoslovakia,Netherlands,1,0,1,1.0,0.0,1806,1818
1986-09-10,Finland,Wales,1,1,0,0.5,0.5,1564,1742
1986-09-10,German DR,Denmark,0,1,1,0.0,1.0,1777,1793
1986-09-10,Iceland,France,0,0,0,0.5,0.5,1543,1900
1986-09-10,Romania,Austria,4,0,4,1.0,0.0,1767,1782
1986-09-10,Scotland,Bulgaria,0,0,0,0.5,0.5,1796,1732
1986-09-10,Sweden,England,1,0,1,1.0,0.0,1775,1876
1986-09-17,Fiji,New Zealand,2,4,2,0.0,1.0,1495,1709
1986-09-19,Fiji,New Zealand,1,2,1,0.0,1.0,1492,1713
1986-09-20,Iran,Thailand,4,0,4,1.0,0.0,1756,1576
1986-09-20,South Korea,India,3,0,3,1.0,0.0,1775,1526
1986-09-20,China PR,Bahrain,5,1,4,1.0,0.0,1747,1501
1986-09-20,Kuwait,Bangladesh,4,0,4,1.0,0.0,1738,1478
1986-09-20,Japan,Nepal,5,0,5,1.0,0.0,1707,1455
1986-09-21,Uganda,Rwanda,1,0,1,1.0,0.0,1636,1486
1986-09-21,Iraq,Oman,4,0,4,1.0,0.0,1748,1396
1986-09-21,United Arab Emirates,Pakistan,1,0,1,1.0,0.0,1578,1491
1986-09-21,Malaysia,Saudi Arabia,1,3,2,0.0,1.0,1622,1656
1986-09-21,Qatar,Indonesia,1,1,0,0.5,0.5,1588,1502
1986-09-22,China PR,India,2,1,1,1.0,0.0,1751,1523
1986-09-22,Japan,Iran,0,2,2,0.0,1.0,1701,1763
1986-09-22,Nepal,Kuwait,0,5,5,0.0,1.0,1453,1741
1986-09-23,United Arab Emirates,Thailand,2,1,1,1.0,0.0,1586,1569
1986-09-23,Pakistan,Iraq,1,5,4,0.0,1.0,1489,1751
1986-09-23,Qatar,Malaysia,1,1,0,0.5,0.5,1589,1622
1986-09-24,Denmark,Germany,0,2,2,0.0,1.0,1788,1930
1986-09-24,Iceland,Russia,1,1,0,0.5,0.5,1550,1879
1986-09-24,Norway,German DR,0,0,0,0.5,0.5,1699,1776
1986-09-24,Spain,Greece,3,1,2,1.0,0.0,1867,1643
1986-09-24,Sweden,Switzerland,2,0,2,1.0,0.0,1782,1717
1986-09-24,South Korea,Bahrain,0,0,0,0.5,0.5,1770,1507
1986-09-24,Iran,Bangladesh,4,0,4,1.0,0.0,1766,1476
1986-09-24,Japan,Kuwait,0,2,2,0.0,1.0,1694,1749
1986-09-25,Thailand,Oman,0,0,0,0.5,0.5,1566,1400
1986-09-25,United Arab Emirates,Iraq,2,1,1,1.0,0.0,1598,1740
1986-09-25,Indonesia,Saudi Arabia,0,2,2,0.0,1.0,1498,1661
1986-09-26,Bahrain,India,3,0,3,1.0,0.0,1516,1515
1986-09-26,Nepal,Bangladesh,0,1,1,0.0,1.0,1446,1484
1986-09-26,Iran,Kuwait,0,1,1,0.0,1.0,1758,1758
1986-09-27,Zambia,DR Congo,2,2,0,0.5,0.5,1704,1657
1986-09-27,Oman,Pakistan,3,1,2,1.0,0.0,1411,1479
1986-09-27,Thailand,Iraq,1,2,1,0.0,1.0,1562,1745
1986-09-27,Indonesia,Malaysia,1,0,1,1.0,0.0,1509,1612
1986-09-28,Zambia,DR Congo,0,1,1,0.0,1.0,1695,1667
1986-09-28,South Korea,China PR,4,2,2,1.0,0.0,1778,1744
1986-09-28,Japan,Bangladesh,4,0,4,1.0,0.0,1698,1481
1986-09-28,Iran,Nepal,6,0,6,1.0,0.0,1761,1444
1986-09-29,United Arab Emirates,Oman,0,0,0,0.5,0.5,1595,1415
1986-09-29,Thailand,Pakistan,6,0,6,1.0,0.0,1569,1473
1986-09-29,Qatar,Saudi Arabia,0,1,1,0.0,1.0,1583,1668
1986-09-30,Botswana,Malawi,2,0,2,1.0,0.0,1450,1672
1986-10-01,Saudi Arabia,Iraq,1,1,0,0.5,0.5,1670,1744
1986-10-01,South Korea,Iran,1,1,0,0.5,0.5,1778,1762
1986-10-01,United Arab Emirates,Indonesia,2,2,0,0.5,0.5,1594,1511
1986-10-01,Kuwait,China PR,1,1,0,0.5,0.5,1758,1745
1986-10-03,South Korea,Indonesia,4,0,4,1.0,0.0,1781,1509
1986-10-03,Saudi Arabia,Kuwait,2,2,0,0.5,0.5,1672,1757
1986-10-04,Indonesia,Kuwait,0,5,5,0.0,1.0,1506,1761
1986-10-05,Sierra Leone,Liberia,2,1,1,1.0,0.0,1543,1483
1986-10-05,Angola,Gabon,1,0,1,1.0,0.0,1560,1491
1986-10-05,Uganda,Somalia,5,0,5,1.0,0.0,1640,1433
1986-10-05,Central African Republic,Congo,1,2,1,0.0,1.0,1449,1595
1986-10-05,Ethiopia,Tanzania,4,2,2,1.0,0.0,1574,1552
1986-10-05,South Korea,Saudi Arabia,2,0,2,1.0,0.0,1787,1667
1986-10-07,Kenya,Somalia,2,1,1,1.0,0.0,1599,1429
1986-10-07,Poland,North Korea,2,2,0,0.5,0.5,1771,1688
1986-10-08,Israel,Romania,2,4,2,0.0,1.0,1672,1773
1986-10-08,Italy,Greece,2,0,2,1.0,0.0,1851,1640
1986-10-11,France,Russia,0,2,2,0.0,1.0,1892,1888
1986-10-11,Uganda,Kenya,3,1,2,1.0,0.0,1648,1592
1986-10-12,Portugal,Sweden,1,1,0,0.5,0.5,1760,1782
1986-10-14,Luxembourg,Belgium,0,6,6,0.0,1.0,1336,1805
1986-10-15,Austria,Albania,3,0,3,1.0,0.0,1785,1495
1986-10-15,Czechoslovakia,Finland,3,0,3,1.0,0.0,1810,1561
1986-10-15,England,Northern Ireland,3,0,3,1.0,0.0,1882,1747
1986-10-15,Germany,Spain,2,2,0,0.5,0.5,1929,1869
1986-10-15,Hungary,Netherlands,0,1,1,0.0,1.0,1820,1827
1986-10-15,Republic of Ireland,Scotland,0,0,0,0.5,0.5,1689,1794
1986-10-15,Poland,Greece,2,1,1,1.0,0.0,1777,1635
1986-10-19,Congo,Central African Republic,5,1,4,1.0,0.0,1600,1445
1986-10-19,Gabon,Angola,1,0,1,1.0,0.0,1501,1551
1986-10-19,Liberia,Sierra Leone,1,1,0,0.5,0.5,1485,1542
1986-10-19,Somalia,Uganda,0,0,0,0.5,0.5,1434,1644
1986-10-25,New Zealand,Australia,1,1,0,0.5,0.5,1713,1693
1986-10-28,Honduras,Panama,1,0,1,1.0,0.0,1694,1457
1986-10-29,Austria,Germany,4,1,3,1.0,0.0,1797,1918
1986-10-29,Denmark,Finland,1,0,1,1.0,0.0,1792,1558
1986-10-29,German DR,Iceland,2,0,2,1.0,0.0,1780,1547
1986-10-29,Russia,Norway,4,0,4,1.0,0.0,1893,1695
1986-10-29,Switzerland,Portugal,1,1,0,0.5,0.5,1718,1760
1986-10-29,Tunisia,Bulgaria,3,3,0,0.5,0.5,1690,1732
1986-10-29,Yugoslavia,Turkey,4,0,4,1.0,0.0,1815,1584
1986-10-30,Cuba,Panama,1,1,0,0.5,0.5,1499,1458
1986-11-02,Australia,New Zealand,2,1,1,1.0,0.0,1702,1705
1986-11-12,Czechoslovakia,Denmark,0,0,0,0.5,0.5,1810,1793
1986-11-12,England,Yugoslavia,2,0,2,1.0,0.0,1889,1809
1986-11-12,Greece,Hungary,2,1,1,1.0,0.0,1647,1809
1986-11-12,Poland,Republic of Ireland,1,0,1,1.0,0.0,1784,1683
1986-11-12,Scotland,Luxembourg,3,0,3,1.0,0.0,1796,1335
1986-11-12,Spain,Romania,1,0,1,1.0,0.0,1875,1768
1986-11-12,Turkey,Northern Ireland,0,0,0,0.5,0.5,1588,1744
1986-11-15,Italy,Switzerland,3,2,1,1.0,0.0,1857,1713
1986-11-16,Malta,Sweden,0,5,5,0.0,1.0,1455,1785
1986-11-19,Belgium,Bulgaria,1,1,0,0.5,0.5,1804,1734
1986-11-19,German DR,France,0,0,0,0.5,0.5,1783,1890
1986-11-19,Netherlands,Poland,0,0,0,0.5,0.5,1827,1785
1986-11-23,China PR,Australia,0,2,2,0.0,1.0,1737,1711
1986-11-25,Kenya,Rwanda,2,3,1,0.0,1.0,1582,1497
1986-12-03,Albania,Spain,1,2,1,0.0,1.0,1494,1877
1986-12-03,Cyprus,Greece,2,4,2,0.0,1.0,1393,1651
1986-12-04,Nepal,Bangladesh,1,0,1,1.0,0.0,1453,1473
1986-12-06,South Korea,Malaysia,2,1,1,1.0,0.0,1792,1608
1986-12-06,Malta,Italy,0,2,2,0.0,1.0,1454,1859
1986-12-07,Angola,Tanzania,1,0,1,1.0,0.0,1560,1544
1986-12-09,Equatorial Guinea,Cameroon,0,2,2,0.0,1.0,1483,1695
1986-12-10,Angola,Zambia,0,1,1,0.0,1.0,1555,1701
1986-12-10,Congo,Gabon,0,1,1,0.0,1.0,1590,1512
1986-12-11,Algeria,Ivory Coast,2,1,1,1.0,0.0,1713,1717
1986-12-11,Chad,Cameroon,1,3,2,0.0,1.0,1475,1699
1986-12-11,Nepal,South Korea,1,2,1,0.0,1.0,1452,1794
1986-12-11,Saint Lucia,Saint Vincent and the Grenadines,5,1,4,1.0,0.0,1483,1584
1986-12-12,Central African Republic,Congo,1,3,2,0.0,1.0,1441,1595
1986-12-13,Equatorial Guinea,Chad,0,1,1,0.0,1.0,1475,1484
1986-12-14,Algeria,Ivory Coast,2,1,1,1.0,0.0,1722,1709
1986-12-14,Central African Republic,Gabon,0,1,1,0.0,1.0,1435,1519
1986-12-16,Congo,Cameroon,0,1,1,0.0,1.0,1590,1705
1986-12-17,Chad,Gabon,0,0,0,0.5,0.5,1485,1519
1986-12-19,Chad,Cameroon,1,4,3,0.0,1.0,1482,1709
1986-12-21,Cyprus,Netherlands,0,2,2,0.0,1.0,1392,1829
1987-01-04,Barbados,Saint Vincent and the Grenadines,3,0,3,1.0,0.0,1503,1574
1987-01-07,Portugal,Greece,1,1,0,0.5,0.5,1758,1654
1987-01-13,El Salvador,Mexico,1,3,2,0.0,1.0,1642,1861
1987-01-14,Greece,Cyprus,3,1,2,1.0,0.0,1657,1390
1987-01-14,India,China PR,1,1,0,0.5,0.5,1520,1733
1987-01-17,Mali,Burkina Faso,2,0,2,1.0,0.0,1602,1482
1987-01-19,Guinea,Mali,1,0,1,1.0,0.0,1563,1593
1987-01-21,Spain,Netherlands,1,1,0,0.5,0.5,1876,1831
1987-01-24,Italy,Malta,5,0,5,1.0,0.0,1861,1453
1987-01-25,Niger,Mali,1,0,1,1.0,0.0,1496,1583
1987-01-27,Nigeria,Syria,1,0,1,1.0,0.0,1689,1539
1987-01-27,Saint Lucia,Guyana,1,3,2,0.0,1.0,1475,1491
1987-01-31,Ivory Coast,Ghana,0,2,2,0.0,1.0,1702,1737
1987-02-01,Liberia,Burkina Faso,2,0,2,1.0,0.0,1493,1475
1987-02-02,Niger,Ghana,0,4,4,0.0,1.0,1493,1741
1987-02-03,Liberia,Benin,0,0,0,0.5,0.5,1493,1465
1987-02-04,Niger,Ivory Coast,0,1,1,0.0,1.0,1490,1706
1987-02-04,Portugal,Belgium,1,0,1,1.0,0.0,1768,1795
1987-02-05,Burkina Faso,Benin,3,2,1,1.0,0.0,1483,1458
1987-02-07,Cayman Islands,Jamaica,1,3,2,0.0,1.0,1483,1483
1987-02-07,Tunisia,Austria,1,3,2,0.0,1.0,1685,1803
1987-02-08,Cyprus,Hungary,0,1,1,0.0,1.0,1389,1811
1987-02-08,Liberia,Ghana,1,2,1,0.0,1.0,1490,1745
1987-02-14,Portugal,Italy,0,1,1,0.0,1.0,1763,1867
1987-02-16,Kuwait,Algeria,2,0,2,1.0,0.0,1769,1715
1987-02-18,Israel,Northern Ireland,1,1,0,0.5,0.5,1674,1743
1987-02-18,Scotland,Republic of Ireland,0,1,1,0.0,1.0,1786,1694
1987-02-18,Spain,England,2,4,2,0.0,1.0,1869,1897
1987-02-18,Wales,Russia,0,0,0,0.5,0.5,1746,1890
1987-02-20,Panama,Cuba,1,0,1,1.0,0.0,1467,1491
1987-02-20,Thailand,Oman,2,0,2,1.0,0.0,1574,1411
1987-02-21,North Korea,Russia,1,0,1,1.0,0.0,1701,1878
1987-02-21,Kuwait,Iraq,2,0,2,1.0,0.0,1777,1737
1987-02-22,Guinea,Mauritania,1,0,1,1.0,0.0,1568,1386
1987-02-22,Guinea-Bissau,Mali,0,0,0,0.5,0.5,1485,1581
1987-02-22,Panama,Cuba,1,3,2,0.0,1.0,1460,1499
1987-02-23,Senegal,Sierra Leone,0,1,1,0.0,1.0,1689,1554
1987-02-24,Guinea,Mali,0,0,0,0.5,0.5,1569,1581
1987-02-24,Guinea-Bissau,Mauritania,1,1,0,0.5,0.5,1483,1389
1987-02-25,Cape Verde,Senegal,0,2,2,0.0,1.0,1476,1693
1987-02-25,Dominican Republic,Panama,0,2,2,0.0,1.0,1482,1469
1987-02-26,Guinea,Guinea-Bissau,0,0,0,0.5,0.5,1568,1485
1987-02-26,Kuwait,Iceland,1,1,0,0.5,0.5,1773,1552
1987-02-26,Mali,Mauritania,1,0,1,1.0,0.0,1585,1386
1987-02-27,Cape Verde,Sierra Leone,0,2,2,0.0,1.0,1470,1561
1987-02-27,Dominican Republic,Panama,1,2,1,0.0,1.0,1474,1478
1987-02-28,Dominican Republic,Panama,1,1,0,0.5,0.5,1475,1478
1987-02-28,Kuwait,Iceland,0,1,1,0.0,1.0,1761,1565
1987-03-01,Guinea,Senegal,1,0,1,1.0,0.0,1579,1683
1987-03-01,Mali,Sierra Leone,0,0,0,0.5,0.5,1585,1562
1987-03-02,Senegal,Sierra Leone,0,0,0,0.5,0.5,1681,1565
1987-03-03,Dominican Republic,Panama,0,1,1,0.0,1.0,1468,1486
1987-03-03,Guinea,Mali,1,0,1,1.0,0.0,1588,1577
1987-03-04,Turkey,Romania,1,3,2,0.0,1.0,1584,1773
1987-03-06,Palau,Vanuatu,2,6,4,0.0,1.0,1491,1445
1987-03-11,Greece,Romania,1,1,0,0.5,0.5,1660,1771
1987-03-14,Barbados,Guyana,2,2,0,0.5,0.5,1503,1492
1987-03-17,Mexico,China PR,3,2,1,1.0,0.0,1867,1728
1987-03-17,Jersey,Alderney,10,0,10,1.0,0.0,1696,1300
1987-03-18,Ivory Coast,DR Congo,2,1,1,1.0,0.0,1714,1660
1987-03-18,Poland,Finland,3,1,2,1.0,0.0,1789,1555
1987-03-19,United Arab Emirates,Syria,1,1,0,0.5,0.5,1593,1541
1987-03-22,Guatemala,El Salvador,2,0,2,1.0,0.0,1635,1634
1987-03-22,Ivory Coast,DR Congo,1,3,2,0.0,1.0,1705,1670
1987-03-23,United Arab Emirates,Syria,2,1,1,1.0,0.0,1600,1535
1987-03-24,Poland,Norway,4,1,3,1.0,0.0,1795,1690
1987-03-25,Israel,Germany,0,2,2,0.0,1.0,1671,1922
1987-03-25,Jordan,Cyprus,2,1,1,1.0,0.0,1440,1383
1987-03-25,Netherlands,Greece,1,1,0,0.5,0.5,1828,1664
1987-03-25,Panama,Cuba,0,0,0,0.5,0.5,1487,1499
1987-03-25,Romania,Albania,5,1,4,1.0,0.0,1774,1492
1987-03-25,Switzerland,Czechoslovakia,1,2,1,0.0,1.0,1708,1816
1987-03-25,Turkey,German DR,3,1,2,1.0,0.0,1597,1771
1987-03-25,Yugoslavia,Austria,4,0,4,1.0,0.0,1817,1796
1987-03-27,Algeria,Tunisia,1,0,1,1.0,0.0,1723,1678
1987-03-28,Botswana,Mauritius,0,0,0,0.5,0.5,1452,1537
1987-03-28,Kenya,Madagascar,2,0,2,1.0,0.0,1591,1578
1987-03-28,Nigeria,Togo,2,0,2,1.0,0.0,1695,1595
1987-03-29,Cameroon,Uganda,5,1,4,1.0,0.0,1716,1638
1987-03-29,DR Congo,Angola,3,0,3,1.0,0.0,1676,1550
1987-03-29,Ivory Coast,Congo,2,0,2,1.0,0.0,1711,1585
1987-03-29,Mozambique,Zimbabwe,1,1,0,0.5,0.5,1498,1650
1987-03-29,Portugal,Malta,2,2,0,0.5,0.5,1758,1459
1987-03-29,Senegal,Guinea,4,0,4,1.0,0.0,1687,1583
1987-03-29,Sudan,Tanzania,1,0,1,1.0,0.0,1579,1537
1987-03-30,Ghana,Sierra Leone,1,2,1,0.0,1.0,1734,1577
1987-03-31,Ecuador,Cuba,0,1,1,0.0,1.0,1533,1508
1987-04-01,Austria,Spain,2,3,1,0.0,1.0,1790,1876
1987-04-01,Belgium,Scotland,4,1,3,1.0,0.0,1803,1779
1987-04-01,Bulgaria,Republic of Ireland,2,1,1,1.0,0.0,1742,1687
1987-04-01,Northern Ireland,England,0,2,2,0.0,1.0,1739,1902
1987-04-01,Wales,Finland,4,0,4,1.0,0.0,1750,1552
1987-04-02,Ecuador,Cuba,0,0,0,0.5,0.5,1533,1509
1987-04-05,Congo,Ivory Coast,1,2,1,0.0,1.0,1580,1717
1987-04-08,Bahrain,Iraq,1,3,2,0.0,1.0,1513,1741
1987-04-08,Gabon,Ivory Coast,1,0,1,1.0,0.0,1532,1705
1987-04-08,Romania,Israel,3,2,1,1.0,0.0,1780,1666
1987-04-10,Bahrain,Iraq,1,2,1,0.0,1.0,1510,1745
1987-04-11,Angola,DR Congo,1,0,1,1.0,0.0,1561,1666
1987-04-11,Zimbabwe,Mozambique,1,0,1,1.0,0.0,1655,1494
1987-04-11,Uganda,Cameroon,3,1,2,1.0,0.0,1648,1707
1987-04-11,Sierra Leone,Ghana,0,0,0,0.5,0.5,1581,1731
1987-04-11,Tanzania,Sudan,1,1,0,0.5,0.5,1538,1579
1987-04-12,Guinea,Senegal,0,0,0,0.5,0.5,1586,1685
1987-04-12,Madagascar,Kenya,2,1,1,1.0,0.0,1587,1583
1987-04-12,Poland,Cyprus,0,0,0,0.5,0.5,1789,1390
1987-04-12,Togo,Nigeria,1,1,0,0.5,0.5,1598,1693
1987-04-14,Tunisia,Algeria,1,1,0,0.5,0.5,1680,1722
1987-04-15,Netherlands,Czechoslovakia,1,0,1,1.0,0.0,1836,1809
1987-04-15,Switzerland,Malta,4,1,3,1.0,0.0,1712,1456
1987-04-18,Germany,Italy,0,0,0,0.5,0.5,1921,1869
1987-04-18,Russia,Sweden,1,3,2,0.0,1.0,1868,1796
1987-04-26,Zimbabwe,Zambia,0,1,1,0.0,1.0,1649,1708
1987-04-29,Albania,Austria,0,1,1,0.0,1.0,1490,1793
1987-04-29,Finland,Denmark,0,1,1,0.0,1.0,1549,1797
1987-04-29,France,Iceland,2,0,2,1.0,0.0,1893,1563
1987-04-29,Greece,Poland,1,0,1,1.0,0.0,1675,1779
1987-04-29,Honduras,El Salvador,1,0,1,1.0,0.0,1701,1628
1987-04-29,Republic of Ireland,Belgium,0,0,0,0.5,0.5,1690,1801
1987-04-29,Jamaica,Cuba,2,0,2,1.0,0.0,1492,1501
1987-04-29,Netherlands,Hungary,2,0,2,1.0,0.0,1844,1804
1987-04-29,Northern Ireland,Yugoslavia,1,2,1,0.0,1.0,1733,1824
1987-04-29,Romania,Spain,3,1,2,1.0,0.0,1791,1866
1987-04-29,Russia,German DR,2,0,2,1.0,0.0,1874,1766
1987-04-29,Turkey,England,0,0,0,0.5,0.5,1603,1897
1987-04-29,Wales,Czechoslovakia,1,1,0,0.5,0.5,1752,1808
1987-04-30,Luxembourg,Bulgaria,1,4,3,0.0,1.0,1334,1744
1987-05-06,El Salvador,Honduras,1,2,1,0.0,1.0,1622,1708
1987-05-09,Guernsey,Jersey,3,4,1,0.0,1.0,1650,1704
1987-05-12,New Caledonia,Tahiti,0,0,0,0.5,0.5,1615,1707
1987-05-13,German DR,Czechoslovakia,2,0,2,1.0,0.0,1775,1800
1987-05-17,Hungary,Poland,5,3,2,1.0,0.0,1812,1772
1987-05-19,England,Brazil,1,1,0,0.5,0.5,1899,1951
1987-05-19,Switzerland,Israel,1,0,1,1.0,0.0,1719,1660
1987-05-20,Bulgaria,Luxembourg,3,0,3,1.0,0.0,1746,1333
1987-05-21,Burkina Faso,Mauritania,2,1,1,1.0,0.0,1489,1381
1987-05-23,Republic of Ireland,Brazil,1,0,1,1.0,0.0,1704,1938
1987-05-23,Scotland,England,0,0,0,0.5,0.5,1782,1897
1987-05-24,Sweden,Malta,1,0,1,1.0,0.0,1798,1455
1987-05-26,Scotland,Brazil,0,2,2,0.0,1.0,1778,1943
1987-05-27,Japan,Senegal,2,2,0,0.5,0.5,1698,1686
1987-05-28,Finland,Brazil,2,3,1,0.0,1.0,1548,1945
1987-05-28,Guadeloupe,French Guiana,4,1,3,1.0,0.0,1541,1464
1987-05-28,Luxembourg,Republic of Ireland,0,2,2,0.0,1.0,1332,1706
1987-05-28,Norway,Italy,0,0,0,0.5,0.5,1694,1866
1987-05-30,Guadeloupe,Réunion,3,0,3,1.0,0.0,1548,1486
1987-05-31,Hong Kong,Macau,5,0,5,1.0,0.0,1596,1447
1987-06-01,Israel,Brazil,0,4,4,0.0,1.0,1658,1948
1987-06-03,Denmark,Czechoslovakia,1,1,0,0.5,0.5,1798,1800
1987-06-03,Iceland,German DR,0,6,6,0.0,1.0,1560,1779
1987-06-03,Norway,Russia,0,1,1,0.0,1.0,1690,1879
1987-06-03,Sweden,Italy,1,0,1,1.0,0.0,1808,1857
1987-06-08,Egypt,United States,3,1,2,1.0,0.0,1708,1570
1987-06-09,Australia,Morocco,1,0,1,1.0,0.0,1720,1718
1987-06-10,Argentina,Italy,1,3,2,0.0,1.0,1870,1866
1987-06-10,South Korea,Egypt,0,0,0,0.5,0.5,1793,1710
1987-06-11,Colombia,Ecuador,1,0,1,1.0,0.0,1647,1528
1987-06-12,Egypt,Thailand,1,1,0,0.5,0.5,1708,1577
1987-06-12,South Korea,United States,1,0,1,1.0,0.0,1797,1567
1987-06-13,Malawi,Zimbabwe,1,4,3,0.0,1.0,1664,1658
1987-06-14,Bolivia,Paraguay,0,2,2,0.0,1.0,1551,1752
1987-06-14,Congo,Seychelles,1,1,0,0.5,0.5,1577,1442
1987-06-14,Ecuador,Colombia,3,0,3,1.0,0.0,1539,1637
1987-06-14,South Korea,Thailand,4,2,2,1.0,0.0,1801,1574
1987-06-14,Malawi,Zimbabwe,2,1,1,1.0,0.0,1672,1651
1987-06-16,Norway,France,2,0,2,1.0,0.0,1703,1881
1987-06-16,Thailand,United States,0,1,1,0.0,1.0,1566,1576
1987-06-17,Switzerland,Sweden,1,1,0,0.5,0.5,1722,1806
1987-06-18,Madagascar,Seychelles,2,0,2,1.0,0.0,1592,1438
1987-06-19,Australia,Egypt,0,0,0,0.5,0.5,1720,1709
1987-06-19,Peru,Chile,1,3,2,0.0,1.0,1683,1765
1987-06-19,Uruguay,Ecuador,2,1,1,1.0,0.0,1791,1536
1987-06-20,Argentina,Paraguay,0,1,1,0.0,1.0,1860,1763
1987-06-21,Brazil,Ecuador,4,1,3,1.0,0.0,1950,1535
1987-06-21,South Korea,Australia,1,1,0,0.5,0.5,1800,1722
1987-06-21,Madagascar,Congo,3,2,1,1.0,0.0,1600,1570
1987-06-21,Peru,Chile,2,0,2,1.0,0.0,1693,1756
1987-06-23,Uruguay,Bolivia,2,1,1,1.0,0.0,1795,1548
1987-06-24,Chile,Peru,1,0,1,1.0,0.0,1763,1687
1987-06-27,Argentina,Peru,1,1,0,0.5,0.5,1857,1691
1987-06-28,Brazil,Venezuela,5,0,5,1.0,0.0,1951,1452
1987-06-28,Paraguay,Bolivia,0,0,0,0.5,0.5,1759,1553
1987-06-28,Zambia,Ivory Coast,2,0,2,1.0,0.0,1716,1698
1987-06-30,Venezuela,Chile,1,3,2,0.0,1.0,1450,1766
1987-07-01,Bolivia,Colombia,0,2,2,0.0,1.0,1547,1644
1987-07-02,Argentina,Ecuador,3,0,3,1.0,0.0,1860,1533
1987-07-03,Chile,Brazil,4,0,4,1.0,0.0,1778,1940
1987-07-03,Malawi,Ivory Coast,1,2,1,0.0,1.0,1665,1706
1987-07-04,Nigeria,Sierra Leone,3,0,3,1.0,0.0,1699,1576
1987-07-04,Peru,Ecuador,1,1,0,0.5,0.5,1688,1537
1987-07-05,Cameroon,Sudan,2,0,2,1.0,0.0,1713,1574
1987-07-05,Colombia,Paraguay,3,0,3,1.0,0.0,1655,1749
1987-07-05,Senegal,DR Congo,0,0,0,0.5,0.5,1686,1667
1987-07-05,Zimbabwe,Kenya,1,1,0,0.5,0.5,1650,1585
1987-07-06,Malawi,Burundi,1,1,0,0.5,0.5,1661,1468
1987-07-08,Chile,Colombia,2,1,1,1.0,0.0,1784,1650
1987-07-08,Malawi,Burundi,1,1,0,0.5,0.5,1657,1473
1987-07-09,Argentina,Uruguay,0,1,1,0.0,1.0,1851,1805
1987-07-11,Argentina,Colombia,1,2,1,0.0,1.0,1839,1663
1987-07-11,Malawi,Burundi,2,4,2,0.0,1.0,1646,1485
1987-07-12,Chile,Uruguay,0,1,1,0.0,1.0,1777,1813
1987-07-18,Kenya,Zimbabwe,0,0,0,0.5,0.5,1587,1649
1987-07-18,Sierra Leone,Nigeria,2,0,2,1.0,0.0,1587,1689
1987-07-18,Sudan,Cameroon,1,0,1,1.0,0.0,1586,1702
1987-07-19,DR Congo,Senegal,0,0,0,0.5,0.5,1668,1686
1987-07-19,Ivory Coast,Malawi,2,0,2,1.0,0.0,1713,1640
1987-07-25,São Tomé and Príncipe,Guinea-Bissau,0,2,2,0.0,1.0,1469,1493
1987-07-26,Angola,Guinea-Bissau,0,0,0,0.5,0.5,1560,1495
1987-07-26,Liberia,Morocco,2,1,1,1.0,0.0,1503,1706
1987-07-27,Liberia,Ghana,0,0,0,0.5,0.5,1508,1727
1987-07-27,São Tomé and Príncipe,Angola,1,1,0,0.5,0.5,1472,1558
1987-07-28,German DR,Hungary,0,0,0,0.5,0.5,1780,1812
1987-08-01,Kenya,Tunisia,1,0,1,1.0,0.0,1598,1670
1987-08-01,Cameroon,Madagascar,3,0,3,1.0,0.0,1708,1595
1987-08-02,Egypt,Senegal,1,0,1,1.0,0.0,1717,1679
1987-08-02,Ivory Coast,Malawi,1,0,1,1.0,0.0,1720,1634
1987-08-03,Kenya,Cameroon,3,3,0,0.5,0.5,1601,1706
1987-08-03,Tunisia,Madagascar,0,3,3,0.0,1.0,1661,1605
1987-08-04,Indonesia,Algeria,2,1,1,1.0,0.0,1519,1710
1987-08-04,Egypt,Ivory Coast,2,1,1,1.0,0.0,1726,1712
1987-08-04,Malawi,Senegal,2,0,2,1.0,0.0,1644,1670
1987-08-05,Kenya,Madagascar,2,1,1,1.0,0.0,1610,1597
1987-08-05,Cameroon,Tunisia,3,1,2,1.0,0.0,1713,1655
1987-08-06,Indonesia,South Korea,1,1,0,0.5,0.5,1525,1795
1987-08-06,Ivory Coast,Senegal,1,0,1,1.0,0.0,1720,1663
1987-08-06,Malawi,Egypt,2,1,1,1.0,0.0,1654,1717
1987-08-07,Algeria,South Korea,2,0,2,1.0,0.0,1720,1786
1987-08-08,Senegal,Tunisia,1,0,1,1.0,0.0,1671,1648
1987-08-08,Ivory Coast,Madagascar,1,1,0,0.5,0.5,1718,1600
1987-08-09,Indonesia,Algeria,2,1,1,1.0,0.0,1538,1708
1987-08-09,Cameroon,Egypt,1,1,0,0.5,0.5,1714,1717
1987-08-10,Kenya,Malawi,1,1,0,0.5,0.5,1612,1653
1987-08-12,Germany,France,2,1,1,1.0,0.0,1929,1874
1987-08-12,Norway,Sweden,0,0,0,0.5,0.5,1706,1804
1987-08-12,Cameroon,Malawi,1,3,2,0.0,1.0,1705,1663
1987-08-12,Kenya,Egypt,0,1,1,0.0,1.0,1607,1723
1987-08-18,Switzerland,Austria,2,2,0,0.5,0.5,1724,1792
1987-08-19,Poland,German DR,2,0,2,1.0,0.0,1781,1772
1987-08-26,Sweden,Denmark,1,0,1,1.0,0.0,1812,1791
1987-08-29,Yugoslavia,Russia,0,1,1,0.0,1.0,1818,1886
1987-09-02,Australia,New Zealand,1,1,0,0.5,0.5,1722,1706
1987-09-02,Poland,Romania,3,1,2,1.0,0.0,1790,1783
1987-09-04,Guyana,Grenada,1,1,0,0.5,0.5,1493,1524
1987-09-06,Guyana,Grenada,3,0,3,1.0,0.0,1502,1516
1987-09-09,Finland,Czechoslovakia,3,0,3,1.0,0.0,1561,1788
1987-09-09,Germany,England,3,1,2,1.0,0.0,1937,1890
1987-09-09,Iceland,Norway,2,1,1,1.0,0.0,1572,1695
1987-09-09,Republic of Ireland,Luxembourg,2,1,1,1.0,0.0,1708,1331
1987-09-09,Netherlands,Belgium,0,0,0,0.5,0.5,1844,1802
1987-09-09,New Zealand,Australia,1,0,1,1.0,0.0,1715,1714
1987-09-09,Russia,France,1,1,0,0.5,0.5,1886,1875
1987-09-09,Scotland,Hungary,2,0,2,1.0,0.0,1787,1804
1987-09-09,Wales,Denmark,1,0,1,1.0,0.0,1761,1783
1987-09-10,Singapore,Malaysia,0,0,0,0.5,0.5,1528,1607
1987-09-10,Thailand,Brunei,3,1,2,1.0,0.0,1571,1397
1987-09-12,Indonesia,Brunei,2,0,2,1.0,0.0,1543,1393
1987-09-13,Guyana,Trinidad and Tobago,1,2,1,0.0,1.0,1496,1587
1987-09-14,Indonesia,Thailand,0,0,0,0.5,0.5,1544,1571
1987-09-16,Thailand,Malaysia,0,2,2,0.0,1.0,1564,1615
1987-09-20,Indonesia,Malaysia,1,0,1,1.0,0.0,1554,1606
1987-09-23,Bulgaria,Belgium,2,0,2,1.0,0.0,1756,1793
1987-09-23,German DR,Tunisia,2,0,2,1.0,0.0,1778,1643
1987-09-23,Germany,Denmark,1,0,1,1.0,0.0,1942,1779
1987-09-23,Italy,Yugoslavia,1,0,1,1.0,0.0,1873,1812
1987-09-23,Norway,Iceland,0,1,1,0.0,1.0,1685,1583
1987-09-23,Poland,Hungary,3,2,1,1.0,0.0,1799,1796
1987-09-23,Russia,Greece,3,0,3,1.0,0.0,1890,1672
1987-09-23,Spain,Luxembourg,2,0,2,1.0,0.0,1867,1331
1987-09-23,Sweden,Portugal,0,1,1,0.0,1.0,1803,1768
1987-09-30,El Salvador,Canada,2,1,1,1.0,0.0,1631,1624
1987-10-02,Honduras,Canada,1,1,0,0.5,0.5,1707,1626
1987-10-06,Mexico,Canada,4,0,4,1.0,0.0,1871,1623
1987-10-07,El Salvador,Guatemala,1,0,1,1.0,0.0,1640,1627
1987-10-07,Romania,Greece,2,2,0,0.5,0.5,1781,1675
1987-10-10,German DR,Russia,1,1,0,0.5,0.5,1781,1888
1987-10-14,Denmark,Wales,1,0,1,1.0,0.0,1787,1754
1987-10-14,England,Turkey,8,0,8,1.0,0.0,1893,1601
1987-10-14,France,Norway,1,1,0,0.5,0.5,1872,1689
1987-10-14,Germany,Sweden,1,1,0,0.5,0.5,1939,1807
1987-10-14,Hungary,Greece,3,0,3,1.0,0.0,1802,1670
1987-10-14,Republic of Ireland,Bulgaria,2,0,2,1.0,0.0,1718,1747
1987-10-14,Poland,Netherlands,0,2,2,0.0,1.0,1793,1851
1987-10-14,Scotland,Belgium,2,0,2,1.0,0.0,1796,1785
1987-10-14,Spain,Austria,2,0,2,1.0,0.0,1874,1786
1987-10-14,Yugoslavia,Northern Ireland,3,0,3,1.0,0.0,1819,1727
1987-10-17,Switzerland,Italy,0,0,0,0.5,0.5,1728,1870
1987-10-24,Zambia,Angola,2,0,2,1.0,0.0,1721,1554
1987-10-27,Barbados,Martinique,1,1,0,0.5,0.5,1506,1633
1987-10-27,Czechoslovakia,Poland,3,1,2,1.0,0.0,1797,1785
1987-10-28,Albania,Romania,0,1,1,0.0,1.0,1488,1784
1987-10-28,German DR,Norway,3,1,2,1.0,0.0,1787,1684
1987-10-28,Netherlands,Cyprus,8,0,8,1.0,0.0,1853,1389
1987-10-28,Russia,Iceland,2,0,2,1.0,0.0,1891,1581
1987-10-31,Liberia,Ghana,0,2,2,0.0,1.0,1505,1731
1987-11-07,Kuwait,Egypt,0,2,2,0.0,1.0,1753,1732
1987-11-08,Mali,Central African Republic,3,1,2,1.0,0.0,1582,1431
1987-11-10,Republic of Ireland,Israel,5,0,5,1.0,0.0,1725,1652
1987-11-11,Belgium,Luxembourg,3,0,3,1.0,0.0,1787,1330
1987-11-11,Bulgaria,Scotland,0,1,1,0.0,1.0,1741,1803
1987-11-11,Cyprus,Poland,0,1,1,0.0,1.0,1388,1787
1987-11-11,Czechoslovakia,Wales,2,0,2,1.0,0.0,1805,1747
1987-11-11,French Guiana,Suriname,1,1,0,0.5,0.5,1468,1606
1987-11-11,Northern Ireland,Turkey,1,0,1,1.0,0.0,1733,1596
1987-11-11,Portugal,Switzerland,0,0,0,0.5,0.5,1768,1729
1987-11-11,Yugoslavia,England,1,4,3,0.0,1.0,1813,1900
1987-11-14,Italy,Sweden,2,1,1,1.0,0.0,1877,1801
1987-11-15,Malta,Switzerland,1,1,0,0.5,0.5,1461,1724
1987-11-18,Austria,Romania,0,0,0,0.5,0.5,1786,1785
1987-11-18,France,German DR,0,1,1,0.0,1.0,1863,1797
1987-11-18,Hungary,Germany,0,0,0,0.5,0.5,1806,1936
1987-11-18,Spain,Albania,5,0,5,1.0,0.0,1876,1487
1987-11-18,Togo,Central African Republic,1,0,1,1.0,0.0,1603,1427
1987-11-21,India,Pakistan,0,0,0,0.5,0.5,1519,1475
1987-11-21,Nepal,Bangladesh,1,0,1,1.0,0.0,1461,1465
1987-11-22,Burkina Faso,Nigeria,0,0,0,0.5,0.5,1494,1685
1987-11-22,Ivory Coast,Togo,3,0,3,1.0,0.0,1724,1598
1987-11-22,Pakistan,Maldives,1,0,1,1.0,0.0,1483,1441
1987-11-22,Bangladesh,Bhutan,3,0,3,1.0,0.0,1473,1438
1987-11-23,India,Maldives,5,0,5,1.0,0.0,1526,1435
1987-11-23,Nepal,Bhutan,6,2,4,1.0,0.0,1469,1431
1987-11-25,Pakistan,Bangladesh,1,0,1,1.0,0.0,1491,1466
1987-11-26,India,Nepal,1,0,1,1.0,0.0,1533,1463
1987-11-29,Barbados,Trinidad and Tobago,0,4,4,0.0,1.0,1500,1594
1987-11-29,Gabon,Angola,0,0,0,0.5,0.5,1533,1554
1987-12-02,Hungary,Cyprus,1,0,1,1.0,0.0,1808,1387
1987-12-02,Israel,Malta,1,1,0,0.5,0.5,1648,1466
1987-12-02,Luxembourg,Scotland,0,0,0,0.5,0.5,1338,1796
1987-12-02,Tunisia,Malawi,2,3,1,0.0,1.0,1636,1671
1987-12-05,Italy,Portugal,3,0,3,1.0,0.0,1883,1763
1987-12-05,Suriname,French Guiana,1,0,1,1.0,0.0,1611,1464
1987-12-06,Mali,Burkina Faso,1,2,1,0.0,1.0,1573,1504
1987-12-06,Trinidad and Tobago,Barbados,5,1,4,1.0,0.0,1600,1495
1987-12-07,Chad,Central African Republic,2,1,1,1.0,0.0,1489,1421
1987-12-08,Angola,Cuba,3,2,1,1.0,0.0,1561,1495
1987-12-08,Benin,Ghana,1,1,0,0.5,0.5,1464,1726
1987-12-08,Cameroon,Equatorial Guinea,1,0,1,1.0,0.0,1709,1472
1987-12-09,Brazil,Chile,2,1,1,1.0,0.0,1945,1773
1987-12-09,Central African Republic,Gabon,1,1,0,0.5,0.5,1424,1531
1987-12-09,Netherlands,Cyprus,4,0,4,1.0,0.0,1855,1386
1987-12-09,New Caledonia,American Samoa,10,0,10,1.0,0.0,1621,1487
1987-12-09,Papua New Guinea,Tahiti,0,0,0,0.5,0.5,1507,1703
1987-12-09,Vanuatu,Wallis Islands and Futuna,6,1,5,1.0,0.0,1454,1468
1987-12-10,American Samoa,Vanuatu,0,7,7,0.0,1.0,1479,1463
1987-12-10,Angola,Benin,0,0,0,0.5,0.5,1559,1467
1987-12-10,Burkina Faso,Mali,1,2,1,0.0,1.0,1498,1580
1987-12-10,Cameroon,Equatorial Guinea,0,0,0,0.5,0.5,1705,1477
1987-12-10,Cuba,Ghana,1,1,0,0.5,0.5,1500,1722
1987-12-10,New Caledonia,Papua New Guinea,2,0,2,1.0,0.0,1627,1502
1987-12-10,Tahiti,Wallis Islands and Futuna,4,0,4,1.0,0.0,1707,1465
1987-12-11,Algeria,Tunisia,0,0,0,0.5,0.5,1707,1638
1987-12-11,Chad,Gabon,1,1,0,0.5,0.5,1490,1531
1987-12-12,American Samoa,Wallis Islands and Futuna,1,5,4,0.0,1.0,1471,1474
1987-12-12,Brazil,Germany,1,1,0,0.5,0.5,1945,1937
1987-12-12,New Caledonia,Tahiti,2,3,1,0.0,1.0,1621,1714
1987-12-12,Papua New Guinea,Vanuatu,1,1,0,0.5,0.5,1502,1464
1987-12-13,Burkina Faso,Mali,2,1,1,1.0,0.0,1508,1571
1987-12-13,Ethiopia,Tanzania,0,0,0,0.5,0.5,1574,1539
1987-12-13,Malawi,Zimbabwe,1,1,0,0.5,0.5,1671,1650
1987-12-13,Mauritania,Tunisia,1,2,1,0.0,1.0,1379,1641
1987-12-13,Togo,Ivory Coast,1,0,1,1.0,0.0,1609,1714
1987-12-14,Kenya,Zanzibar,0,0,0,0.5,0.5,1602,1336
1987-12-14,Uganda,Zambia,4,0,4,1.0,0.0,1658,1712
1987-12-15,Algeria,Mauritania,3,0,3,1.0,0.0,1710,1377
1987-12-15,American Samoa,Papua New Guinea,0,20,20,0.0,1.0,1464,1510
1987-12-15,Chad,Equatorial Guinea,4,0,4,1.0,0.0,1498,1470
1987-12-15,New Caledonia,Wallis Islands and Futuna,5,1,4,1.0,0.0,1626,1470
1987-12-15,Tahiti,Vanuatu,2,1,1,1.0,0.0,1718,1461
1987-12-16,Argentina,Germany,1,0,1,1.0,0.0,1850,1927
1987-12-16,Cameroon,Gabon,1,0,1,1.0,0.0,1710,1527
1987-12-16,Greece,Netherlands,0,3,3,0.0,1.0,1666,1860
1987-12-16,Israel,Switzerland,0,2,2,0.0,1.0,1642,1731
1987-12-16,Kenya,Tanzania,3,2,1,1.0,0.0,1609,1533
1987-12-16,Turkey,Yugoslavia,2,3,1,0.0,1.0,1593,1817
1987-12-16,Uganda,Zimbabwe,0,0,0,0.5,0.5,1658,1651
1987-12-17,Ethiopia,Zanzibar,0,0,0,0.5,0.5,1570,1341
1987-12-17,Malawi,Zambia,2,1,1,1.0,0.0,1680,1704
1987-12-17,Malaysia,South Korea,0,1,1,0.0,1.0,1602,1791
1987-12-17,New Caledonia,Vanuatu,6,0,6,1.0,0.0,1631,1457
1987-12-17,Papua New Guinea,Wallis Islands and Futuna,2,0,2,1.0,0.0,1518,1463
1987-12-18,Chad,Cameroon,0,1,1,0.0,1.0,1495,1714
1987-12-18,Equatorial Guinea,Gabon,0,0,0,0.5,0.5,1472,1526
1987-12-19,Ivory Coast,Senegal,1,0,1,1.0,0.0,1722,1664
1987-12-19,New Caledonia,Tahiti,1,0,1,1.0,0.0,1641,1709
1987-12-19,Papua New Guinea,Vanuatu,3,1,2,1.0,0.0,1525,1451
1987-12-19,Tanzania,Zanzibar,0,2,2,0.0,1.0,1521,1354
1987-12-20,Ethiopia,Kenya,2,1,1,1.0,0.0,1579,1601
1987-12-20,Liberia,Burkina Faso,1,0,1,1.0,0.0,1514,1500
1987-12-20,Malawi,Uganda,0,2,2,0.0,1.0,1672,1667
1987-12-20,Malta,Portugal,0,1,1,0.0,1.0,1464,1766
1987-12-22,Burkina Faso,Senegal,0,1,1,0.0,1.0,1496,1669
1987-12-23,Liberia,Ivory Coast,1,2,1,0.0,1.0,1511,1726
1987-12-23,Zanzibar,Zimbabwe,0,1,1,0.0,1.0,1352,1654
1987-12-24,Ethiopia,Uganda,3,0,3,1.0,0.0,1589,1658
1987-12-26,Uganda,Zanzibar,2,0,2,1.0,0.0,1661,1350
1987-12-27,Ethiopia,Zimbabwe,1,1,0,0.5,0.5,1591,1653
1988-01-03,Gambia,Ghana,0,2,2,0.0,1.0,1494,1726
1988-01-05,Algeria,Congo,4,1,3,1.0,0.0,1715,1566
1988-01-05,Gambia,Ghana,0,0,0,0.5,0.5,1499,1722
1988-01-06,Guatemala,Costa Rica,1,2,1,0.0,1.0,1621,1681
1988-01-06,South Korea,Egypt,1,1,0,0.5,0.5,1790,1734
1988-01-10,Guatemala,United States,1,0,1,1.0,0.0,1628,1570
1988-01-12,Czechoslovakia,Finland,0,2,2,0.0,1.0,1793,1574
1988-01-12,German DR,Sweden,1,4,3,0.0,1.0,1790,1809
1988-01-13,Guatemala,United States,0,1,1,0.0,1.0,1619,1580
1988-01-13,Honduras,Mexico,0,1,1,0.0,1.0,1703,1876
1988-01-14,Thailand,Indonesia,3,3,0,0.5,0.5,1564,1555
1988-01-15,Czechoslovakia,German DR,1,0,1,1.0,0.0,1801,1783
1988-01-15,Finland,Sweden,0,1,1,0.0,1.0,1571,1813
1988-01-15,Jordan,United Arab Emirates,0,1,1,0.0,1.0,1436,1605
1988-01-18,Indonesia,Oman,3,0,3,1.0,0.0,1560,1407
1988-01-18,Jordan,United Arab Emirates,2,0,2,1.0,0.0,1448,1594
1988-01-19,Israel,Belgium,2,3,1,0.0,1.0,1638,1792
1988-01-20,Thailand,Oman,3,1,2,1.0,0.0,1569,1403
1988-01-21,Malaysia,South Korea,0,0,0,0.5,0.5,1606,1787
1988-01-21,Qatar,Bulgaria,2,3,1,0.0,1.0,1579,1746
1988-01-23,United Arab Emirates,Bulgaria,0,3,3,0.0,1.0,1590,1751
1988-01-27,Israel,France,1,1,0,0.5,0.5,1643,1859
1988-01-27,Spain,German DR,0,0,0,0.5,0.5,1874,1786
1988-01-27,United Arab Emirates,Japan,1,1,0,0.5,0.5,1593,1696
1988-01-30,United Arab Emirates,Japan,2,0,2,1.0,0.0,1604,1686
1988-02-02,Austria,Morocco,1,3,2,0.0,1.0,1777,1716
1988-02-02,France,Switzerland,2,1,1,1.0,0.0,1865,1726
1988-02-02,Oman,Japan,1,1,0,0.5,0.5,1409,1681
1988-02-03,Egypt,Bulgaria,1,0,1,1.0,0.0,1743,1743
1988-02-03,Israel,Romania,0,2,2,0.0,1.0,1639,1790
1988-02-04,United Arab Emirates,Thailand,3,0,3,1.0,0.0,1612,1562
1988-02-05,Austria,Switzerland,1,2,1,0.0,1.0,1768,1736
1988-02-05,China PR,Yemen,0,0,0,0.5,0.5,1722,1392
1988-02-05,France,Morocco,2,1,1,1.0,0.0,1870,1712
1988-02-06,Bangladesh,India,0,0,0,0.5,0.5,1468,1532
1988-02-06,Poland,Romania,2,2,0,0.5,0.5,1788,1790
1988-02-07,Malta,Finland,2,0,2,1.0,0.0,1475,1561
1988-02-07,United Arab Emirates,Yemen,2,1,1,1.0,0.0,1616,1389
1988-02-08,China PR,Bangladesh,4,0,4,1.0,0.0,1726,1465
1988-02-09,Thailand,India,1,0,1,1.0,0.0,1570,1525
1988-02-10,Israel,Poland,1,3,2,0.0,1.0,1635,1793
1988-02-10,Malta,Tunisia,2,1,1,1.0,0.0,1487,1630
1988-02-10,United Arab Emirates,China PR,0,0,0,0.5,0.5,1619,1724
1988-02-11,Yemen,India,1,0,1,1.0,0.0,1400,1515
1988-02-12,Thailand,Bangladesh,1,1,0,0.5,0.5,1568,1468
1988-02-13,Finland,Tunisia,3,0,3,1.0,0.0,1571,1621
1988-02-13,United Arab Emirates,India,3,0,3,1.0,0.0,1625,1510
1988-02-14,Benin,Mali,1,2,1,0.0,1.0,1462,1577
1988-02-14,China PR,Thailand,5,0,5,1.0,0.0,1729,1564
1988-02-14,Yemen,Bangladesh,0,0,0,0.5,0.5,1402,1467
1988-02-16,China PR,India,1,1,0,0.5,0.5,1725,1515
1988-02-16,Yemen,Thailand,3,3,0,0.5,0.5,1406,1561
1988-02-17,Greece,Northern Ireland,3,2,1,1.0,0.0,1676,1724
1988-02-17,Israel,England,0,0,0,0.5,0.5,1641,1895
1988-02-17,Saudi Arabia,Scotland,2,2,0,0.5,0.5,1670,1794
1988-02-17,United Arab Emirates,Bangladesh,4,0,4,1.0,0.0,1630,1463
1988-02-18,Bermuda,Canada,0,0,0,0.5,0.5,1451,1620
1988-02-20,Italy,Russia,4,1,3,1.0,0.0,1892,1883
1988-02-23,United Arab Emirates,Egypt,1,2,1,0.0,1.0,1625,1749
1988-02-24,Spain,Czechoslovakia,1,2,1,0.0,1.0,1865,1811
1988-02-25,Djibouti,Yemen DPR,4,1,3,1.0,0.0,1428,1464
1988-02-25,Iraq,Tunisia,2,0,2,1.0,0.0,1751,1616
1988-02-26,United Arab Emirates,Egypt,1,1,0,0.5,0.5,1628,1747
1988-03-02,Costa Rica,Guatemala,2,1,1,1.0,0.0,1688,1613
1988-03-02,Saudi Arabia,Oman,2,0,2,1.0,0.0,1673,1407
1988-03-03,Morocco,German DR,2,1,1,1.0,0.0,1722,1777
1988-03-03,Qatar,Kuwait,1,1,0,0.5,0.5,1583,1750
1988-03-03,United Arab Emirates,Bahrain,2,0,2,1.0,0.0,1634,1505
1988-03-04,Iraq,Oman,1,1,0,0.5,0.5,1745,1414
1988-03-05,Kuwait,United Arab Emirates,0,1,1,0.0,1.0,1740,1645
1988-03-05,Saudi Arabia,Qatar,0,0,0,0.5,0.5,1671,1586
1988-03-06,Dominica,Antigua and Barbuda,0,0,0,0.5,0.5,1435,1471
1988-03-07,Oman,Bahrain,0,2,2,0.0,1.0,1409,1511
1988-03-08,Iraq,Kuwait,1,0,1,1.0,0.0,1753,1733
1988-03-08,Qatar,United Arab Emirates,2,1,1,1.0,0.0,1596,1636
1988-03-09,Saudi Arabia,Bahrain,1,0,1,1.0,0.0,1676,1507
1988-03-10,Libya,Malta,1,0,1,1.0,0.0,1676,1483
1988-03-10,Oman,Qatar,2,1,1,1.0,0.0,1421,1585
1988-03-10,United Arab Emirates,Iraq,0,0,0,0.5,0.5,1639,1751
1988-03-11,Guadeloupe,Suriname,0,2,2,0.0,1.0,1542,1618
1988-03-12,Kuwait,Bahrain,0,1,1,0.0,1.0,1721,1520
1988-03-13,Algeria,Ivory Coast,1,1,0,0.5,0.5,1716,1726
1988-03-13,Gambia,Mali,2,1,1,1.0,0.0,1509,1568
1988-03-13,Morocco,DR Congo,1,1,0,0.5,0.5,1721,1670
1988-03-13,Qatar,Iraq,0,3,3,0.0,1.0,1581,1756
1988-03-13,Saudi Arabia,United Arab Emirates,2,2,0,0.5,0.5,1676,1640
1988-03-14,Cameroon,Egypt,1,0,1,1.0,0.0,1723,1739
1988-03-14,Kenya,Nigeria,0,3,3,0.0,1.0,1595,1692
1988-03-14,Oman,Kuwait,0,2,2,0.0,1.0,1419,1724
1988-03-16,Bahrain,Qatar,1,0,1,1.0,0.0,1530,1572
1988-03-16,Guatemala,Uruguay,1,0,1,1.0,0.0,1626,1801
1988-03-16,Hungary,Turkey,1,0,1,1.0,0.0,1812,1590
1988-03-16,Ivory Coast,DR Congo,1,1,0,0.5,0.5,1725,1672
1988-03-16,Morocco,Algeria,1,0,1,1.0,0.0,1729,1709
1988-03-16,Saudi Arabia,Iraq,0,2,2,0.0,1.0,1670,1763
1988-03-17,Cameroon,Nigeria,1,1,0,0.5,0.5,1723,1693
1988-03-17,Egypt,Kenya,3,0,3,1.0,0.0,1744,1591
1988-03-17,United Arab Emirates,Oman,1,0,1,1.0,0.0,1644,1416
1988-03-18,Bahrain,Iraq,0,1,1,0.0,1.0,1527,1767
1988-03-18,El Salvador,Honduras,0,0,0,0.5,0.5,1642,1702
1988-03-18,Saudi Arabia,Kuwait,0,0,0,0.5,0.5,1672,1723
1988-03-19,Algeria,DR Congo,1,0,1,1.0,0.0,1717,1665
1988-03-19,Morocco,Ivory Coast,0,0,0,0.5,0.5,1729,1726
1988-03-20,Antigua and Barbuda,Dominica,2,1,1,1.0,0.0,1479,1428
1988-03-20,Cameroon,Kenya,0,0,0,0.5,0.5,1721,1594
1988-03-20,Egypt,Nigeria,0,0,0,0.5,0.5,1743,1695
1988-03-22,Malta,Scotland,1,1,0,0.5,0.5,1489,1789
1988-03-23,Algeria,Nigeria,1,1,0,0.5,0.5,1717,1696
1988-03-23,Bulgaria,Czechoslovakia,2,0,2,1.0,0.0,1753,1802
1988-03-23,England,Netherlands,2,2,0,0.5,0.5,1895,1861
1988-03-23,France,Spain,2,1,1,1.0,0.0,1878,1858
1988-03-23,Greece,Russia,0,4,4,0.0,1.0,1673,1887
1988-03-23,Republic of Ireland,Romania,2,0,2,1.0,0.0,1735,1781
1988-03-23,Morocco,Cameroon,0,1,1,0.0,1.0,1721,1730
1988-03-23,Northern Ireland,Poland,1,1,0,0.5,0.5,1726,1792
1988-03-23,Wales,Yugoslavia,1,2,1,0.0,1.0,1741,1824
1988-03-26,Belgium,Hungary,3,0,3,1.0,0.0,1801,1804
1988-03-26,Morocco,Algeria,1,1,0,0.5,0.5,1721,1718
1988-03-26,Peru,Canada,1,3,2,0.0,1.0,1679,1630
1988-03-26,Alderney,Guernsey,1,5,4,0.0,1.0,1299,1652
1988-03-27,Cameroon,Nigeria,1,0,1,1.0,0.0,1738,1689
1988-03-29,Mexico,El Salvador,8,0,8,1.0,0.0,1880,1639
1988-03-30,Colombia,Canada,3,0,3,1.0,0.0,1671,1623
1988-03-30,German DR,Romania,3,3,0,0.5,0.5,1778,1781
1988-03-31,Argentina,Russia,2,4,2,0.0,1.0,1843,1895
1988-03-31,Germany,Sweden,1,1,0,0.5,0.5,1925,1816
1988-03-31,Yugoslavia,Italy,1,1,0,0.5,0.5,1826,1891
1988-04-02,Germany,Argentina,1,0,1,1.0,0.0,1932,1837
1988-04-02,Sweden,Russia,2,0,2,1.0,0.0,1826,1886
1988-04-05,Jamaica,Canada,0,4,4,0.0,1.0,1487,1629
1988-04-06,Greece,Austria,2,2,0,0.5,0.5,1676,1766
1988-04-07,Jamaica,Canada,0,0,0,0.5,0.5,1491,1626
1988-04-07,Malaysia,Pakistan,4,0,4,1.0,0.0,1612,1486
1988-04-08,Kuwait,Japan,1,0,1,1.0,0.0,1731,1674
1988-04-10,El Salvador,Guatemala,0,0,0,0.5,0.5,1639,1627
1988-04-10,Jordan,Pakistan,1,0,1,1.0,0.0,1457,1478
1988-04-11,Malaysia,Japan,0,1,1,0.0,1.0,1606,1681
1988-04-12,Kuwait,Jordan,0,0,0,0.5,0.5,1726,1463
1988-04-13,Bulgaria,German DR,1,1,0,0.5,0.5,1754,1778
1988-04-14,Malaysia,Jordan,0,0,0,0.5,0.5,1603,1467
1988-04-15,Kuwait,Pakistan,3,0,3,1.0,0.0,1730,1475
1988-04-16,Japan,Jordan,1,1,0,0.5,0.5,1677,1472
1988-04-17,Guyana,Trinidad and Tobago,0,4,4,0.0,1.0,1491,1606
1988-04-18,Japan,Pakistan,4,1,3,1.0,0.0,1681,1472
1988-04-18,Malaysia,Kuwait,0,5,5,0.0,1.0,1598,1736
1988-04-19,Guadeloupe,Suriname,1,1,0,0.5,0.5,1544,1617
1988-04-21,El Salvador,Guatemala,1,0,1,1.0,0.0,1647,1620
1988-04-26,Mexico,Honduras,4,1,3,1.0,0.0,1885,1698
1988-04-27,Austria,Denmark,1,0,1,1.0,0.0,1775,1779
1988-04-27,Czechoslovakia,Russia,1,1,0,0.5,0.5,1804,1885
1988-04-27,Germany,Switzerland,1,0,1,1.0,0.0,1936,1733
1988-04-27,Hungary,England,0,0,0,0.5,0.5,1807,1893
1988-04-27,Republic of Ireland,Yugoslavia,2,0,2,1.0,0.0,1746,1816
1988-04-27,Luxembourg,Italy,0,3,3,0.0,1.0,1338,1892
1988-04-27,Northern Ireland,France,0,0,0,0.5,0.5,1730,1875
1988-04-27,Spain,Scotland,0,0,0,0.5,0.5,1857,1791
1988-04-27,Sweden,Wales,4,1,3,1.0,0.0,1833,1735
1988-04-28,Gambia,Senegal,0,4,4,0.0,1.0,1505,1674
1988-04-28,Guinea-Bissau,Sierra Leone,0,0,0,0.5,0.5,1498,1585
1988-04-29,Cape Verde,Mali,1,3,2,0.0,1.0,1465,1574
1988-04-29,Guinea,Mauritania,1,1,0,0.5,0.5,1582,1382
1988-04-30,Cuba,Guatemala,0,1,1,0.0,1.0,1495,1626
1988-04-30,Gambia,Sierra Leone,1,3,2,0.0,1.0,1499,1592
1988-04-30,Guinea-Bissau,Senegal,1,1,0,0.5,0.5,1502,1671
1988-05-01,Cape Verde,Mauritania,3,2,1,1.0,0.0,1472,1376
1988-05-01,Guinea,Mali,1,0,1,1.0,0.0,1590,1567
1988-05-02,Guinea-Bissau,Gambia,3,1,2,1.0,0.0,1510,1492
1988-05-02,Senegal,Sierra Leone,2,2,0,0.5,0.5,1670,1594
1988-05-02,Jersey,Guernsey,0,1,1,0.0,1.0,1695,1662
1988-05-03,Cape Verde,Guinea,1,1,0,0.5,0.5,1475,1588
1988-05-03,Mali,Mauritania,2,2,0,0.5,0.5,1563,1381
1988-05-04,Hungary,Iceland,3,0,3,1.0,0.0,1811,1578
1988-05-05,Guinea,Sierra Leone,3,0,3,1.0,0.0,1597,1586
1988-05-05,Mali,Senegal,1,1,0,0.5,0.5,1566,1668
1988-05-07,Senegal,Sierra Leone,2,1,1,1.0,0.0,1675,1580
1988-05-08,China PR,North Korea,0,0,0,0.5,0.5,1725,1702
1988-05-08,Guinea,Mali,0,0,0,0.5,0.5,1597,1567
1988-05-08,Trinidad and Tobago,Guyana,1,0,1,1.0,0.0,1612,1486
1988-05-10,Hungary,Denmark,2,2,0,0.5,0.5,1811,1780
1988-05-11,Guadeloupe,Togo,2,1,1,1.0,0.0,1554,1600
1988-05-12,Jamaica,Puerto Rico,1,0,1,1.0,0.0,1497,1378
1988-05-13,Réunion,Togo,1,0,1,1.0,0.0,1497,1590
1988-05-15,Guatemala,Cuba,1,1,0,0.5,0.5,1624,1498
1988-05-15,Macau,Hong Kong,0,2,2,0.0,1.0,1443,1601
1988-05-17,Hungary,Austria,0,4,4,0.0,1.0,1803,1784
1988-05-17,Scotland,Colombia,0,0,0,0.5,0.5,1789,1674
1988-05-19,Canada,Greece,0,1,1,0.0,1.0,1620,1683
1988-05-19,Finland,Colombia,1,3,2,0.0,1.0,1566,1680
1988-05-21,Canada,Greece,0,3,3,0.0,1.0,1614,1690
1988-05-21,England,Scotland,1,0,1,1.0,0.0,1899,1784
1988-05-21,Northern Ireland,Malta,3,0,3,1.0,0.0,1734,1486
1988-05-22,Republic of Ireland,Poland,3,1,2,1.0,0.0,1756,1783
1988-05-23,Chile,Greece,0,1,1,0.0,1.0,1764,1700
1988-05-24,England,Colombia,1,1,0,0.5,0.5,1895,1685
1988-05-24,Netherlands,Bulgaria,1,2,1,0.0,1.0,1851,1765
1988-05-25,Burkina Faso,Ghana,3,0,3,1.0,0.0,1509,1710
1988-05-25,Canada,Chile,1,0,1,1.0,0.0,1626,1753
1988-05-25,Nepal,Hong Kong,0,0,0,0.5,0.5,1467,1598
1988-05-26,Syria,North Korea,2,1,1,1.0,0.0,1547,1691
1988-05-27,Iran,Hong Kong,2,0,2,1.0,0.0,1767,1594
1988-05-28,Canada,Greece,0,0,0,0.5,0.5,1628,1699
1988-05-28,Nepal,North Korea,0,1,1,0.0,1.0,1464,1695
1988-05-28,Switzerland,England,0,1,1,0.0,1.0,1729,1900
1988-05-29,Puerto Rico,Jamaica,1,2,1,0.0,1.0,1373,1503
1988-05-29,Syria,Iran,1,1,0,0.5,0.5,1552,1763
1988-05-31,North Korea,Hong Kong,1,0,1,1.0,0.0,1701,1589
1988-06-01,Denmark,Czechoslovakia,0,1,1,0.0,1.0,1773,1812
1988-06-01,Malta,Wales,2,3,1,0.0,1.0,1483,1739
1988-06-01,Nepal,Syria,0,3,3,0.0,1.0,1458,1559
1988-06-01,Netherlands,Romania,2,0,2,1.0,0.0,1858,1775
1988-06-01,Norway,Republic of Ireland,0,0,0,0.5,0.5,1686,1755
1988-06-01,Russia,Poland,2,1,1,1.0,0.0,1891,1778
1988-06-01,Spain,Sweden,1,3,2,0.0,1.0,1849,1842
1988-06-01,United States,Chile,1,1,0,0.5,0.5,1584,1750
1988-06-02,Iran,North Korea,0,0,0,0.5,0.5,1762,1703
1988-06-02,Japan,China PR,0,3,3,0.0,1.0,1675,1732
1988-06-03,Libya,Burkina Faso,3,0,3,1.0,0.0,1681,1505
1988-06-03,Syria,Hong Kong,2,0,2,1.0,0.0,1568,1581
1988-06-03,United States,Chile,1,3,2,0.0,1.0,1580,1755
1988-06-04,Germany,Yugoslavia,1,1,0,0.5,0.5,1934,1819
1988-06-04,Italy,Wales,0,1,1,0.0,1.0,1881,1751
1988-06-04,Nepal,Iran,0,3,3,0.0,1.0,1456,1765
1988-06-04,Zambia,Zimbabwe,3,2,1,1.0,0.0,1711,1647
1988-06-05,Denmark,Belgium,3,1,2,1.0,0.0,1782,1793
1988-06-05,Switzerland,Spain,1,1,0,0.5,0.5,1732,1847
1988-06-05,United States,Chile,0,3,3,0.0,1.0,1576,1760
1988-06-07,United States,Ecuador,0,1,1,0.0,1.0,1568,1546
1988-06-09,Seychelles,Tanzania,1,1,0,0.5,0.5,1440,1520
1988-06-10,Germany,Italy,1,1,0,0.5,0.5,1933,1883
1988-06-10,Mozambique,Malawi,1,2,1,0.0,1.0,1490,1677
1988-06-10,United States,Ecuador,0,2,2,0.0,1.0,1560,1555
1988-06-11,Denmark,Spain,2,3,1,0.0,1.0,1776,1854
1988-06-12,England,Republic of Ireland,0,1,1,0.0,1.0,1889,1767
1988-06-12,Netherlands,Russia,0,1,1,0.0,1.0,1851,1899
1988-06-12,United States,Ecuador,0,0,0,0.5,0.5,1560,1556
1988-06-14,Germany,Denmark,2,0,2,1.0,0.0,1938,1772
1988-06-14,Italy,Spain,1,0,1,1.0,0.0,1891,1847
1988-06-14,Mozambique,Malawi,1,1,0,0.5,0.5,1494,1674
1988-06-14,United States,Costa Rica,1,0,1,1.0,0.0,1571,1678
1988-06-15,England,Netherlands,1,3,2,0.0,1.0,1881,1860
1988-06-15,Honduras,Ecuador,1,1,0,0.5,0.5,1695,1560
1988-06-15,Republic of Ireland,Russia,1,1,0,0.5,0.5,1770,1897
1988-06-17,Bahrain,South Korea,2,0,2,1.0,0.0,1541,1774
1988-06-17,Canada,Costa Rica,0,1,1,0.0,1.0,1622,1685
1988-06-17,Germany,Spain,2,0,2,1.0,0.0,1944,1842
1988-06-17,Honduras,Ecuador,0,1,1,0.0,1.0,1685,1571
1988-06-17,Indonesia,Yemen DPR,1,0,1,1.0,0.0,1566,1459
1988-06-17,Italy,Denmark,2,0,2,1.0,0.0,1897,1767
1988-06-18,England,Russia,1,3,2,0.0,1.0,1874,1905
1988-06-18,Republic of Ireland,Netherlands,0,1,1,0.0,1.0,1765,1866
1988-06-19,Antigua and Barbuda,Curaçao,0,1,1,0.0,1.0,1473,1532
1988-06-19,Indonesia,Bahrain,0,0,0,0.5,0.5,1566,1542
1988-06-19,South Korea,Zambia,4,0,4,1.0,0.0,1781,1705
1988-06-19,South Korea,Yemen DPR,1,1,0,0.5,0.5,1776,1465
1988-06-21,Germany,Netherlands,1,2,1,0.0,1.0,1935,1876
1988-06-21,Saudi Arabia,New Zealand,0,2,2,0.0,1.0,1665,1723
1988-06-22,Bahrain,Yemen DPR,2,0,2,1.0,0.0,1549,1459
1988-06-22,Indonesia,South Korea,0,4,4,0.0,1.0,1563,1780
1988-06-22,Russia,Italy,2,0,2,1.0,0.0,1913,1890
1988-06-23,Saudi Arabia,New Zealand,2,3,1,0.0,1.0,1659,1730
1988-06-25,Russia,Netherlands,0,2,2,0.0,1.0,1905,1885
1988-06-29,Hong Kong,Saudi Arabia,0,3,3,0.0,1.0,1575,1666
1988-07-01,Curaçao,Costa Rica,1,1,0,0.5,0.5,1536,1682
1988-07-01,Hong Kong,Saudi Arabia,0,1,1,0.0,1.0,1570,1672
1988-07-03,Burkina Faso,Libya,2,0,2,1.0,0.0,1517,1670
1988-07-03,Curaçao,Costa Rica,1,0,1,1.0,0.0,1548,1671
1988-07-05,Guadeloupe,Trinidad and Tobago,0,3,3,0.0,1.0,1548,1619
1988-07-05,Martinique,Antigua and Barbuda,2,2,0,0.5,0.5,1630,1477
1988-07-06,Argentina,Saudi Arabia,2,2,0,0.5,0.5,1834,1676
1988-07-06,Malawi,Zambia,1,0,1,1.0,0.0,1683,1697
1988-07-07,Antigua and Barbuda,Trinidad and Tobago,1,1,0,0.5,0.5,1481,1616
1988-07-07,Australia,Brazil,0,1,1,0.0,1.0,1711,1949
1988-07-07,Martinique,Guadeloupe,2,1,1,1.0,0.0,1637,1542
1988-07-08,Jordan,Bahrain,0,0,0,0.5,0.5,1474,1548
1988-07-08,Malawi,Zambia,0,1,1,0.0,1.0,1676,1705
1988-07-09,Antigua and Barbuda,Guadeloupe,0,0,0,0.5,0.5,1483,1541
1988-07-09,Australia,Saudi Arabia,3,0,3,1.0,0.0,1719,1669
1988-07-09,Iraq,Tunisia,1,1,0,0.5,0.5,1764,1620
1988-07-09,Martinique,Trinidad and Tobago,0,3,3,0.0,1.0,1629,1625
1988-07-10,Argentina,Brazil,0,0,0,0.5,0.5,1837,1947
1988-07-10,Malawi,Zambia,1,1,0,0.5,0.5,1677,1705
1988-07-11,Iraq,Lebanon,0,0,0,0.5,0.5,1759,1479
1988-07-12,Bahrain,Syria,1,2,1,0.0,1.0,1541,1576
1988-07-13,Brazil,Saudi Arabia,4,1,3,1.0,0.0,1950,1667
1988-07-13,Egypt,Tunisia,1,0,1,1.0,0.0,1749,1615
1988-07-14,Australia,Argentina,4,1,3,1.0,0.0,1730,1827
1988-07-15,Canada,Poland,1,2,1,0.0,1.0,1618,1783
1988-07-15,Egypt,Lebanon,3,0,3,1.0,0.0,1752,1477
1988-07-16,Argentina,Saudi Arabia,2,0,2,1.0,0.0,1832,1663
1988-07-16,Jordan,Syria,2,0,2,1.0,0.0,1485,1566
1988-07-16,Uganda,Malawi,1,0,1,1.0,0.0,1670,1669
1988-07-17,Australia,Brazil,0,2,2,0.0,1.0,1727,1954
1988-07-17,Costa Rica,Panama,1,1,0,0.5,0.5,1668,1491
1988-07-17,Egypt,Iraq,0,0,0,0.5,0.5,1753,1759
1988-07-17,Lebanon,Tunisia,1,1,0,0.5,0.5,1481,1612
1988-07-19,Egypt,Syria,0,0,0,0.5,0.5,1750,1570
1988-07-19,Jordan,Iraq,0,3,3,0.0,1.0,1483,1762
1988-07-21,Iraq,Syria,1,1,0,0.5,0.5,1758,1575
1988-07-21,Jordan,Egypt,0,2,2,0.0,1.0,1481,1753
1988-07-24,Burkina Faso,Niger,1,0,1,1.0,0.0,1525,1483
1988-07-24,Jamaica,United States,0,0,0,0.5,0.5,1505,1570
1988-07-25,Benin,Ghana,1,1,0,0.5,0.5,1467,1706
1988-07-27,Burkina Faso,Ghana,3,1,2,1.0,0.0,1537,1695
1988-07-27,Mali,Niger,1,0,1,1.0,0.0,1574,1477
1988-07-28,Norway,Brazil,1,1,0,0.5,0.5,1692,1949
1988-07-29,Benin,Mali,0,1,1,0.0,1.0,1462,1580
1988-07-29,Curaçao,Antigua and Barbuda,3,1,2,1.0,0.0,1555,1477
1988-07-29,Ghana,Niger,0,3,3,0.0,1.0,1683,1490
1988-07-30,Malawi,Uganda,3,1,2,1.0,0.0,1678,1662
1988-07-31,Burkina Faso,Benin,1,0,1,1.0,0.0,1544,1456
1988-07-31,Ghana,Mali,1,0,1,1.0,0.0,1689,1575
1988-07-31,Panama,Costa Rica,0,2,2,0.0,1.0,1487,1673
1988-08-01,Angola,Gabon,4,1,3,1.0,0.0,1567,1519
1988-08-02,Benin,Niger,0,5,5,0.0,1.0,1449,1498
1988-08-02,Burkina Faso,Mali,2,1,1,1.0,0.0,1553,1567
1988-08-03,Austria,Brazil,0,2,2,0.0,1.0,1780,1954
1988-08-03,Zambia,Malawi,4,1,3,1.0,0.0,1713,1671
1988-08-04,Burkina Faso,Niger,1,0,1,1.0,0.0,1560,1492
1988-08-04,Finland,Bulgaria,1,1,0,0.5,0.5,1571,1761
1988-08-04,Zambia,Malawi,7,1,6,1.0,0.0,1721,1664
1988-08-05,El Salvador,Guatemala,1,2,1,0.0,1.0,1639,1633
1988-08-05,Indonesia,Thailand,1,0,1,1.0,0.0,1571,1554
1988-08-05,Tunisia,Guinea,5,0,5,1.0,0.0,1620,1590
1988-08-06,Albania,Cuba,0,0,0,0.5,0.5,1488,1498
1988-08-07,Angola,Sudan,0,0,0,0.5,0.5,1568,1586
1988-08-07,Colombia,Uruguay,2,1,1,1.0,0.0,1696,1791
1988-08-07,Ghana,Liberia,0,0,0,0.5,0.5,1686,1515
1988-08-07,Iceland,Bulgaria,2,3,1,0.0,1.0,1574,1766
1988-08-09,Norway,Bulgaria,1,1,0,0.5,0.5,1694,1765
1988-08-13,United States,Jamaica,5,1,4,1.0,0.0,1577,1499
1988-08-17,Finland,Russia,0,0,0,0.5,0.5,1577,1900
1988-08-21,Guinea,Tunisia,3,0,3,1.0,0.0,1599,1612
1988-08-21,Liberia,Ghana,2,0,2,1.0,0.0,1527,1675
1988-08-24,France,Czechoslovakia,1,1,0,0.5,0.5,1874,1814
1988-08-24,Iceland,Faroe Islands,1,0,1,1.0,0.0,1580,1455
1988-08-24,Poland,Bulgaria,3,2,1,1.0,0.0,1791,1758
1988-08-24,Switzerland,Yugoslavia,0,2,2,0.0,1.0,1726,1826
1988-08-31,Austria,Hungary,0,0,0,0.5,0.5,1781,1803
1988-08-31,Finland,Germany,0,4,4,0.0,1.0,1576,1937
1988-08-31,German DR,Greece,1,0,1,1.0,0.0,1785,1693
1988-08-31,Iceland,Russia,1,1,0,0.5,0.5,1586,1895
1988-08-31,Sweden,Denmark,1,2,1,0.0,1.0,1833,1777
1988-09-07,Ecuador,Paraguay,1,5,4,0.0,1.0,1567,1754
1988-09-12,Honduras,Paraguay,0,0,0,0.5,0.5,1687,1753
1988-09-13,Chile,Ecuador,3,1,2,1.0,0.0,1764,1564
1988-09-14,England,Denmark,1,0,1,1.0,0.0,1880,1772
1988-09-14,Netherlands,Wales,1,0,1,1.0,0.0,1891,1746
1988-09-14,Northern Ireland,Republic of Ireland,0,0,0,0.5,0.5,1735,1765
1988-09-14,Norway,Scotland,1,2,1,0.0,1.0,1689,1790
1988-09-14,Spain,Yugoslavia,1,2,1,0.0,1.0,1834,1835
1988-09-15,Honduras,Paraguay,0,2,2,0.0,1.0,1681,1760
1988-09-20,Czechoslovakia,Austria,4,2,2,1.0,0.0,1822,1774
1988-09-20,Romania,Albania,3,0,3,1.0,0.0,1778,1486
1988-09-21,German DR,Poland,1,2,1,0.0,1.0,1778,1799
1988-09-21,Germany,Russia,1,0,1,1.0,0.0,1945,1888
1988-09-21,Iceland,Hungary,0,3,3,0.0,1.0,1583,1807
1988-09-21,Luxembourg,Switzerland,1,4,3,0.0,1.0,1337,1728
1988-09-21,Peru,Paraguay,0,1,1,0.0,1.0,1673,1767
1988-09-21,Turkey,Greece,3,1,2,1.0,0.0,1601,1683
1988-09-25,El Salvador,Honduras,0,0,0,0.5,0.5,1640,1681
1988-09-26,Curaçao,Venezuela,0,0,0,0.5,0.5,1553,1453
1988-09-26,Malawi,Mozambique,1,1,0,0.5,0.5,1661,1498
1988-09-27,Ecuador,Uruguay,1,2,1,0.0,1.0,1561,1795
1988-09-27,Paraguay,Chile,2,0,2,1.0,0.0,1775,1757
1988-09-28,Denmark,Iceland,1,0,1,1.0,0.0,1777,1579
1988-09-28,France,Norway,1,0,1,1.0,0.0,1879,1685
1988-09-28,Malawi,Mozambique,1,0,1,1.0,0.0,1666,1494
1988-09-29,Chile,Ecuador,0,0,0,0.5,0.5,1753,1566
1988-09-29,Paraguay,Uruguay,3,1,2,1.0,0.0,1784,1787
1988-10-01,Curaçao,El Salvador,0,1,1,0.0,1.0,1547,1647
1988-10-01,Tanzania,Eswatini,1,1,0,0.5,0.5,1519,1469
1988-10-02,Indonesia,Qatar,0,1,1,0.0,1.0,1564,1580
1988-10-02,Liberia,Mali,0,1,1,0.0,1.0,1520,1575
1988-10-02,Angola,Equatorial Guinea,0,1,1,0.0,1.0,1558,1483
1988-10-02,Mauritius,Seychelles,3,0,3,1.0,0.0,1543,1435
1988-10-02,Trinidad and Tobago,Canada,1,2,1,0.0,1.0,1617,1627
1988-10-04,Indonesia,Qatar,1,4,3,0.0,1.0,1557,1588
1988-10-09,Gabon,Burkina Faso,3,0,3,1.0,0.0,1528,1552
1988-10-09,Guatemala,Canada,1,0,1,1.0,0.0,1641,1620
1988-10-09,Singapore,Qatar,0,1,1,0.0,1.0,1522,1595
1988-10-12,Belgium,Brazil,1,2,1,0.0,1.0,1789,1959
1988-10-12,Cyprus,Malta,0,1,1,0.0,1.0,1381,1489
1988-10-12,New Zealand,Australia,1,2,1,0.0,1.0,1722,1736
1988-10-12,Spain,Argentina,1,1,0,0.5,0.5,1834,1833
1988-10-12,Sweden,Portugal,0,0,0,0.5,0.5,1832,1768
1988-10-12,Turkey,Iceland,1,1,0,0.5,0.5,1601,1580
1988-10-12,Uruguay,Paraguay,2,0,2,1.0,0.0,1795,1777
1988-10-15,Canada,Guatemala,3,2,1,1.0,0.0,1629,1633
1988-10-16,Seychelles,Mauritius,1,0,1,1.0,0.0,1446,1533
1988-10-16,Australia,New Zealand,2,0,2,1.0,0.0,1744,1715
1988-10-16,El Salvador,Curaçao,5,0,5,1.0,0.0,1653,1542
1988-10-16,Equatorial Guinea,Angola,0,0,0,0.5,0.5,1485,1557
1988-10-16,Mali,Liberia,3,0,3,1.0,0.0,1582,1514
1988-10-16,Eswatini,Tanzania,1,1,0,0.5,0.5,1471,1518
1988-10-18,Israel,Malta,2,0,2,1.0,0.0,1646,1485
1988-10-18,Luxembourg,Czechoslovakia,0,2,2,0.0,1.0,1337,1823
1988-10-19,Belgium,Switzerland,1,0,1,1.0,0.0,1796,1722
1988-10-19,Bulgaria,Romania,1,3,2,0.0,1.0,1751,1786
1988-10-19,England,Sweden,0,0,0,0.5,0.5,1879,1834
1988-10-19,German DR,Iceland,2,0,2,1.0,0.0,1782,1577
1988-10-19,Germany,Netherlands,0,0,0,0.5,0.5,1944,1893
1988-10-19,Greece,Denmark,1,1,0,0.5,0.5,1686,1775
1988-10-19,Hungary,Northern Ireland,1,0,1,1.0,0.0,1814,1729
1988-10-19,Republic of Ireland,Tunisia,4,0,4,1.0,0.0,1770,1608
1988-10-19,Italy,Norway,2,1,1,1.0,0.0,1894,1682
1988-10-19,Poland,Albania,1,0,1,1.0,0.0,1802,1484
1988-10-19,Russia,Austria,2,0,2,1.0,0.0,1894,1769
1988-10-19,Scotland,Yugoslavia,1,1,0,0.5,0.5,1792,1834
1988-10-19,Wales,Finland,2,2,0,0.5,0.5,1743,1580
1988-10-21,Solomon Islands,Fiji,1,1,0,0.5,0.5,1472,1492
1988-10-22,Cyprus,France,1,1,0,0.5,0.5,1389,1872
1988-10-23,Burkina Faso,Gabon,1,0,1,1.0,0.0,1560,1521
1988-10-23,New Caledonia,Vanuatu,6,1,5,1.0,0.0,1646,1447
1988-10-24,Fiji,Vanuatu,8,0,8,1.0,0.0,1499,1441
1988-10-24,Solomon Islands,New Caledonia,1,0,1,1.0,0.0,1484,1635
1988-10-25,Chile,Peru,2,0,2,1.0,0.0,1760,1667
1988-10-25,Fiji,New Caledonia,2,0,2,1.0,0.0,1510,1625
1988-10-25,Solomon Islands,Vanuatu,5,0,5,1.0,0.0,1492,1434
1988-10-26,Japan,South Korea,0,1,1,0.0,1.0,1670,1786
1988-10-26,New Caledonia,Vanuatu,0,1,1,0.0,1.0,1613,1447
1988-10-26,Solomon Islands,Fiji,1,3,2,0.0,1.0,1485,1518
1988-10-29,Algeria,Angola,1,1,0,0.5,0.5,1715,1561
1988-10-30,Trinidad and Tobago,Honduras,0,0,0,0.5,0.5,1619,1680
1988-11-01,Chile,Uruguay,1,1,0,0.5,0.5,1761,1795
1988-11-02,Austria,Turkey,3,2,1,1.0,0.0,1774,1597
1988-11-02,Cyprus,Norway,0,3,3,0.0,1.0,1387,1685
1988-11-02,Denmark,Bulgaria,1,1,0,0.5,0.5,1775,1752
1988-11-02,Romania,Greece,3,0,3,1.0,0.0,1792,1681
1988-11-03,Kuwait,Finland,0,0,0,0.5,0.5,1733,1584
1988-11-04,Czechoslovakia,Norway,3,2,1,1.0,0.0,1828,1681
1988-11-05,Albania,Sweden,1,2,1,0.0,1.0,1483,1836
1988-11-06,Ethiopia,Zambia,0,0,0,0.5,0.5,1594,1719
1988-11-06,Kuwait,Finland,0,0,0,0.5,0.5,1730,1588
1988-11-06,Malawi,Tanzania,0,0,0,0.5,0.5,1663,1522
1988-11-08,Kenya,Zanzibar,2,0,2,1.0,0.0,1598,1347
1988-11-08,Tunisia,Angola,5,0,5,1.0,0.0,1615,1555
1988-11-08,Uganda,Zimbabwe,0,0,0,0.5,0.5,1662,1648
1988-11-09,El Salvador,Guatemala,0,0,0,0.5,0.5,1653,1634
1988-11-09,Indonesia,Qatar,0,1,1,0.0,1.0,1550,1603
1988-11-09,Uruguay,Chile,3,1,2,1.0,0.0,1803,1754
1988-11-10,Kenya,Tanzania,2,0,2,1.0,0.0,1605,1516
1988-11-10,Malawi,Zanzibar,1,0,1,1.0,0.0,1666,1345
1988-11-11,Ethiopia,Uganda,2,1,1,1.0,0.0,1604,1653
1988-11-11,Sudan,Angola,1,2,1,0.0,1.0,1578,1564
1988-11-11,Zambia,Zimbabwe,1,1,0,0.5,0.5,1718,1650
1988-11-12,Malawi,Kenya,3,0,3,1.0,0.0,1673,1599
1988-11-12,Tanzania,Zanzibar,0,1,1,0.0,1.0,1505,1357
1988-11-13,Algeria,Mali,7,0,7,1.0,0.0,1721,1577
1988-11-13,DR Congo,Congo,1,0,1,1.0,0.0,1671,1561
1988-11-13,Ethiopia,Zimbabwe,1,2,1,0.0,1.0,1598,1657
1988-11-13,Honduras,Trinidad and Tobago,1,1,0,0.5,0.5,1679,1621
1988-11-13,Uganda,Zambia,0,3,3,0.0,1.0,1647,1725
1988-11-14,Fiji,New Zealand,1,1,0,0.5,0.5,1523,1711
1988-11-14,Saudi Arabia,Egypt,0,0,0,0.5,0.5,1666,1751
1988-11-15,Greece,Hungary,3,0,3,1.0,0.0,1692,1804
1988-11-16,Czechoslovakia,Belgium,0,0,0,0.5,0.5,1828,1797
1988-11-16,Italy,Netherlands,1,0,1,1.0,0.0,1902,1886
1988-11-16,Kuwait,Egypt,2,2,0,0.5,0.5,1731,1751
1988-11-16,Portugal,Luxembourg,1,0,1,1.0,0.0,1770,1336
1988-11-16,Saudi Arabia,England,1,1,0,0.5,0.5,1671,1875
1988-11-16,Spain,Republic of Ireland,2,0,2,1.0,0.0,1841,1764
1988-11-17,Cape Verde,Senegal,0,1,1,0.0,1.0,1472,1679
1988-11-17,Fiji,New Zealand,2,0,2,1.0,0.0,1535,1700
1988-11-17,Kenya,Zambia,0,1,1,0.0,1.0,1594,1731
1988-11-17,United Arab Emirates,Jordan,2,1,1,1.0,0.0,1649,1477
1988-11-18,Angola,Senegal,1,2,1,0.0,1.0,1559,1685
1988-11-19,Cape Verde,Angola,2,3,1,0.0,1.0,1466,1566
1988-11-19,Fiji,New Zealand,1,0,1,1.0,0.0,1547,1689
1988-11-19,Kenya,Zimbabwe,0,0,0,0.5,0.5,1596,1656
1988-11-19,Malawi,Zambia,3,1,2,1.0,0.0,1683,1722
1988-11-19,Yugoslavia,France,3,2,1,1.0,0.0,1843,1864
1988-11-20,United Arab Emirates,Jordan,3,2,1,1.0,0.0,1654,1473
1988-11-21,Syria,Russia,0,2,2,0.0,1.0,1573,1897
1988-11-23,Kuwait,Russia,0,1,1,0.0,1.0,1727,1902
1988-11-23,Malta,Cyprus,1,1,0,0.5,0.5,1483,1390
1988-11-23,Peru,Chile,1,1,0,0.5,0.5,1669,1753
1988-11-23,Romania,Israel,3,0,3,1.0,0.0,1797,1642
1988-11-24,United Arab Emirates,Algeria,1,1,0,0.5,0.5,1656,1720
1988-11-25,Guinea,Sierra Leone,1,0,1,1.0,0.0,1607,1573
1988-11-26,Fiji,Australia,1,0,1,1.0,0.0,1560,1732
1988-11-26,Liberia,Sierra Leone,0,0,0,0.5,0.5,1516,1572
1988-11-27,Kuwait,Russia,0,2,2,0.0,1.0,1723,1907
1988-11-27,Liberia,Guinea,0,1,1,0.0,1.0,1511,1613
1988-11-29,Saudi Arabia,Tunisia,1,0,1,1.0,0.0,1678,1609
1988-11-30,Cameroon,Gabon,0,0,0,0.5,0.5,1734,1526
1988-11-30,Congo,Chad,2,1,1,1.0,0.0,1568,1489
1988-11-30,Turkey,German DR,3,1,2,1.0,0.0,1609,1771
1988-12-02,Cameroon,Equatorial Guinea,2,1,1,1.0,0.0,1738,1482
1988-12-02,Central African Republic,Chad,2,1,1,1.0,0.0,1434,1480
1988-12-02,Qatar,Iran,0,2,2,0.0,1.0,1599,1770
1988-12-02,Syria,Saudi Arabia,0,2,2,0.0,1.0,1568,1684
1988-12-03,Australia,Fiji,5,1,4,1.0,0.0,1737,1556
1988-12-03,Kuwait,Bahrain,0,0,0,0.5,0.5,1720,1545
1988-12-03,United Arab Emirates,South Korea,0,1,1,0.0,1.0,1651,1792
1988-12-04,Central African Republic,Congo,0,1,1,0.0,1.0,1429,1574
1988-12-04,China PR,Syria,3,0,3,1.0,0.0,1737,1564
1988-12-04,Equatorial Guinea,Gabon,0,3,3,0.0,1.0,1476,1533
1988-12-04,Japan,Iran,0,0,0,0.5,0.5,1673,1768
1988-12-05,Qatar,United Arab Emirates,2,1,1,1.0,0.0,1609,1642
1988-12-05,Saudi Arabia,Kuwait,0,0,0,0.5,0.5,1685,1720
1988-12-06,Bahrain,China PR,0,1,1,0.0,1.0,1542,1741
1988-12-06,Cameroon,Congo,2,0,2,1.0,0.0,1743,1570
1988-12-06,Central African Republic,Gabon,0,0,0,0.5,0.5,1432,1531
1988-12-06,South Korea,Japan,2,0,2,1.0,0.0,1798,1668
1988-12-06,Morocco,Egypt,0,0,0,0.5,0.5,1722,1751
1988-12-08,Cameroon,Gabon,0,1,1,0.0,1.0,1731,1544
1988-12-08,Central African Republic,Congo,0,3,3,0.0,1.0,1428,1575
1988-12-08,Iran,United Arab Emirates,1,0,1,1.0,0.0,1774,1637
1988-12-08,Malaysia,Indonesia,0,0,0,0.5,0.5,1597,1552
1988-12-08,Syria,Kuwait,1,0,1,1.0,0.0,1576,1709
1988-12-09,Oman,Singapore,1,3,2,0.0,1.0,1411,1528
1988-12-09,Qatar,South Korea,2,3,1,0.0,1.0,1605,1803
1988-12-09,Saudi Arabia,Bahrain,1,1,0,0.5,0.5,1682,1546
1988-12-10,Ivory Coast,Tunisia,1,0,1,1.0,0.0,1732,1604
1988-12-10,Kuwait,China PR,2,2,0,0.5,0.5,1710,1741
1988-12-10,Malaysia,Thailand,0,0,0,0.5,0.5,1597,1555
1988-12-10,United Arab Emirates,Japan,1,0,1,1.0,0.0,1646,1660
1988-12-11,Bahrain,Syria,0,1,1,0.0,1.0,1539,1584
1988-12-11,South Korea,Iran,3,0,3,1.0,0.0,1811,1767
1988-12-11,Malta,Hungary,2,2,0,0.5,0.5,1489,1799
1988-12-11,Yugoslavia,Cyprus,4,0,4,1.0,0.0,1845,1389
1988-12-11,New Zealand,Taiwan,4,0,4,1.0,0.0,1693,1495
1988-12-12,China PR,Saudi Arabia,0,1,1,0.0,1.0,1732,1692
1988-12-12,Indonesia,Thailand,0,0,0,0.5,0.5,1553,1555
1988-12-12,Qatar,Japan,3,0,3,1.0,0.0,1615,1651
1988-12-14,Egypt,Switzerland,1,3,2,0.0,1.0,1743,1731
1988-12-14,South Korea,China PR,2,1,1,1.0,0.0,1818,1726
1988-12-14,Uruguay,Peru,3,0,3,1.0,0.0,1809,1664
1988-12-15,Saudi Arabia,Iran,1,0,1,1.0,0.0,1702,1758
1988-12-15,Morocco,Gabon,5,2,3,1.0,0.0,1727,1540
1988-12-15,New Zealand,Taiwan,4,1,3,1.0,0.0,1697,1492
1988-12-17,China PR,Iran,0,0,0,0.5,0.5,1727,1758
1988-12-18,Ivory Coast,Tunisia,1,1,0,0.5,0.5,1730,1607
1988-12-18,South Korea,Saudi Arabia,0,0,0,0.5,0.5,1816,1705
1988-12-20,Liberia,Tunisia,1,1,0,0.5,0.5,1514,1605
1988-12-20,Zambia,Egypt,1,2,1,0.0,1.0,1715,1751
1988-12-21,Spain,Northern Ireland,4,0,4,1.0,0.0,1847,1724
1988-12-22,Italy,Scotland,2,0,2,1.0,0.0,1908,1787
1988-12-22,Morocco,Guinea,1,0,1,1.0,0.0,1733,1608
1988-12-30,DR Congo,Angola,0,0,0,0.5,0.5,1669,1569
1989-01-04,Israel,Netherlands,0,2,2,0.0,1.0,1639,1890
1989-01-06,Algeria,Zimbabwe,3,0,3,1.0,0.0,1727,1650
1989-01-06,Egypt,Liberia,2,0,2,1.0,0.0,1755,1511
1989-01-06,Oman,Iraq,1,1,0,0.5,0.5,1418,1752
1989-01-06,Pakistan,Kuwait,0,1,1,0.0,1.0,1469,1714
1989-01-06,Qatar,Jordan,1,0,1,1.0,0.0,1620,1469
1989-01-07,Kenya,Malawi,1,1,0,0.5,0.5,1598,1682
1989-01-07,Nigeria,Gabon,1,0,1,1.0,0.0,1694,1536
1989-01-08,Cameroon,Angola,1,1,0,0.5,0.5,1728,1573
1989-01-08,DR Congo,Tunisia,3,1,2,1.0,0.0,1676,1599
1989-01-08,Ivory Coast,Libya,1,0,1,1.0,0.0,1737,1664
1989-01-08,Morocco,Zambia,1,0,1,1.0,0.0,1741,1708
1989-01-11,Egypt,Finland,2,1,1,1.0,0.0,1760,1584
1989-01-11,Malta,Israel,1,2,1,0.0,1.0,1485,1644
1989-01-13,Egypt,Finland,2,1,1,1.0,0.0,1765,1580
1989-01-13,Jordan,Iraq,0,1,1,0.0,1.0,1467,1755
1989-01-13,Kuwait,United Arab Emirates,3,2,1,1.0,0.0,1721,1640
1989-01-13,Oman,Qatar,0,0,0,0.5,0.5,1423,1616
1989-01-18,Albania,Greece,1,1,0,0.5,0.5,1488,1688
1989-01-20,Iran,Japan,2,2,0,0.5,0.5,1756,1654
1989-01-20,Jordan,Oman,2,0,2,1.0,0.0,1474,1417
1989-01-20,Qatar,Iraq,1,0,1,1.0,0.0,1628,1744
1989-01-20,United Arab Emirates,Pakistan,5,0,5,1.0,0.0,1645,1465
1989-01-21,Malawi,Egypt,1,1,0,0.5,0.5,1684,1764
1989-01-22,Angola,Nigeria,2,2,0,0.5,0.5,1576,1692
1989-01-22,Gabon,Cameroon,1,3,2,0.0,1.0,1533,1732
1989-01-22,Liberia,Kenya,0,0,0,0.5,0.5,1513,1597
1989-01-22,Malta,Spain,0,2,2,0.0,1.0,1484,1849
1989-01-22,Tunisia,Morocco,2,1,1,1.0,0.0,1611,1730
1989-01-22,Zambia,DR Congo,4,2,2,1.0,0.0,1716,1669
1989-01-22,Zimbabwe,Ivory Coast,0,0,0,0.5,0.5,1652,1736
1989-01-25,Greece,Portugal,1,2,1,0.0,1.0,1682,1777
1989-01-27,India,North Korea,1,2,1,0.0,1.0,1511,1708
1989-01-27,Iraq,Oman,3,1,2,1.0,0.0,1747,1415
1989-01-27,Jordan,Qatar,1,1,0,0.5,0.5,1478,1625
1989-01-27,Kuwait,Pakistan,2,0,2,1.0,0.0,1724,1463
1989-01-28,Thailand,Malaysia,1,0,1,1.0,0.0,1564,1589
1989-01-29,Ecuador,Chile,1,0,1,1.0,0.0,1578,1742
1989-01-29,Senegal,DR Congo,1,1,0,0.5,0.5,1685,1670
1989-01-30,Thailand,Indonesia,3,0,3,1.0,0.0,1572,1546
1989-01-31,Senegal,DR Congo,2,1,1,1.0,0.0,1693,1663
1989-02-01,Chile,Peru,0,0,0,0.5,0.5,1741,1666
1989-02-03,Colombia,Peru,1,0,1,1.0,0.0,1704,1659
1989-02-03,Indonesia,Malaysia,1,3,2,0.0,1.0,1539,1597
1989-02-03,Iraq,Jordan,4,0,4,1.0,0.0,1750,1476
1989-02-03,Qatar,Oman,3,0,3,1.0,0.0,1629,1412
1989-02-03,United Arab Emirates,Kuwait,1,0,1,1.0,0.0,1655,1715
1989-02-04,China PR,North Korea,3,1,2,1.0,0.0,1735,1701
1989-02-05,Colombia,Chile,1,0,1,1.0,0.0,1713,1733
1989-02-07,Republic of Ireland,France,0,0,0,0.5,0.5,1767,1862
1989-02-08,Algeria,Finland,2,0,2,1.0,0.0,1732,1576
1989-02-08,Cyprus,Scotland,2,3,1,0.0,1.0,1388,1789
1989-02-08,Greece,England,1,2,1,0.0,1.0,1679,1879
1989-02-08,Israel,Wales,3,3,0,0.5,0.5,1647,1741
1989-02-08,Malta,Denmark,0,2,2,0.0,1.0,1482,1778
1989-02-08,Northern Ireland,Spain,0,2,2,0.0,1.0,1719,1855
1989-02-08,Thailand,China PR,2,0,2,1.0,0.0,1584,1724
1989-02-10,Denmark,Finland,0,0,0,0.5,0.5,1774,1581
1989-02-10,Iraq,Qatar,2,2,0,0.5,0.5,1748,1632
1989-02-10,Malta,Algeria,0,1,1,0.0,1.0,1479,1736
1989-02-10,Oman,Jordan,0,2,2,0.0,1.0,1406,1483
1989-02-10,Pakistan,United Arab Emirates,1,4,3,0.0,1.0,1460,1659
1989-02-12,Algeria,Denmark,0,0,0,0.5,0.5,1737,1774
1989-02-12,Guatemala,Poland,0,1,1,0.0,1.0,1630,1807
1989-02-12,Hong Kong,China PR,0,0,0,0.5,0.5,1574,1721
1989-02-12,Malta,Finland,0,0,0,0.5,0.5,1482,1579
1989-02-13,Egypt,German DR,0,4,4,0.0,1.0,1757,1779
1989-02-14,Mexico,Poland,3,1,2,1.0,0.0,1892,1801
1989-02-15,Portugal,Belgium,1,1,0,0.5,0.5,1778,1797
1989-02-19,Thailand,Bangladesh,1,0,1,1.0,0.0,1590,1458
1989-02-21,Bulgaria,Russia,1,2,1,0.0,1.0,1748,1912
1989-02-21,Costa Rica,El Salvador,1,1,0,0.5,0.5,1673,1654
1989-02-21,Guatemala,Mexico,1,2,1,0.0,1.0,1628,1895
1989-02-22,Greece,Norway,4,2,2,1.0,0.0,1688,1673
1989-02-22,Italy,Denmark,1,0,1,1.0,0.0,1914,1769
1989-02-23,China PR,Bangladesh,2,0,2,1.0,0.0,1724,1456
1989-02-23,Costa Rica,Guatemala,2,3,1,0.0,1.0,1664,1638
1989-02-23,El Salvador,Mexico,0,2,2,0.0,1.0,1651,1899
1989-02-23,Thailand,Iran,0,3,3,0.0,1.0,1586,1761
1989-02-27,Bangladesh,Iran,1,2,1,0.0,1.0,1454,1764
1989-02-28,Thailand,China PR,0,3,3,0.0,1.0,1582,1729
1989-03-03,Guatemala,El Salvador,3,0,3,1.0,0.0,1647,1643
1989-03-04,Bangladesh,China PR,0,2,2,0.0,1.0,1452,1732
1989-03-05,Israel,New Zealand,1,0,1,1.0,0.0,1657,1688
1989-03-08,Albania,England,0,2,2,0.0,1.0,1487,1881
1989-03-08,Bangladesh,Thailand,3,1,2,1.0,0.0,1463,1572
1989-03-08,Greece,German DR,3,2,1,1.0,0.0,1699,1769
1989-03-08,Hungary,Republic of Ireland,0,0,0,0.5,0.5,1799,1768
1989-03-08,Scotland,France,2,0,2,1.0,0.0,1799,1853
1989-03-09,Colombia,Argentina,1,0,1,1.0,0.0,1724,1823
1989-03-10,Yemen,Syria,0,1,1,0.0,1.0,1402,1589
1989-03-12,Australia,New Zealand,4,1,3,1.0,0.0,1744,1682
1989-03-12,Jamaica,Paraguay,0,3,3,0.0,1.0,1497,1780
1989-03-15,Brazil,Ecuador,1,0,1,1.0,0.0,1961,1577
1989-03-15,Martinique,Paraguay,0,2,2,0.0,1.0,1625,1785
1989-03-15,Saudi Arabia,Syria,5,4,1,1.0,0.0,1711,1584
1989-03-15,Tunisia,Egypt,0,0,0,0.5,0.5,1615,1754
1989-03-17,Guadeloupe,Paraguay,0,2,2,0.0,1.0,1538,1789
1989-03-17,Iran,Bangladesh,1,0,1,1.0,0.0,1767,1461
1989-03-18,Alderney,Jersey,0,4,4,0.0,1.0,1298,1697
1989-03-19,Guatemala,Costa Rica,1,0,1,1.0,0.0,1656,1656
1989-03-19,Israel,Australia,1,1,0,0.5,0.5,1659,1743
1989-03-19,Trinidad and Tobago,Paraguay,2,2,0,0.5,0.5,1625,1786
1989-03-20,Yemen,Saudi Arabia,0,1,1,0.0,1.0,1400,1714
1989-03-22,Algeria,Morocco,1,1,0,0.5,0.5,1737,1731
1989-03-22,Bulgaria,Germany,1,2,1,0.0,1.0,1745,1948
1989-03-22,German DR,Finland,1,1,0,0.5,0.5,1766,1583
1989-03-22,Netherlands,Russia,2,0,2,1.0,0.0,1899,1904
1989-03-22,Trinidad and Tobago,Paraguay,1,1,0,0.5,0.5,1629,1783
1989-03-23,Spain,Malta,4,0,4,1.0,0.0,1857,1481
1989-03-25,Austria,Italy,0,1,1,0.0,1.0,1770,1919
1989-03-25,Syria,Yemen,2,0,2,1.0,0.0,1589,1396
1989-03-26,Barbados,Jamaica,1,1,0,0.5,0.5,1496,1497
1989-03-26,Ethiopia,Malawi,1,1,0,0.5,0.5,1600,1683
1989-03-26,Venezuela,Paraguay,1,2,1,0.0,1.0,1451,1786
1989-03-27,Qatar,Malaysia,1,0,1,1.0,0.0,1640,1590
1989-03-28,Barbados,Jamaica,1,1,0,0.5,0.5,1497,1497
1989-03-28,Ethiopia,Malawi,1,0,1,1.0,0.0,1610,1674
1989-03-29,Greece,Turkey,0,1,1,0.0,1.0,1689,1620
1989-03-29,Portugal,Angola,6,0,6,1.0,0.0,1782,1573
1989-03-29,Romania,Italy,1,0,1,1.0,0.0,1808,1909
1989-03-30,Syria,Saudi Arabia,0,0,0,0.5,0.5,1592,1712
1989-03-30,Venezuela,Paraguay,0,0,0,0.5,0.5,1457,1781
1989-03-31,Aruba,Trinidad and Tobago,0,7,7,0.0,1.0,1488,1634
1989-03-31,Ethiopia,Zambia,0,1,1,0.0,1.0,1605,1722
1989-04-01,Curaçao,Trinidad and Tobago,1,1,0,0.5,0.5,1545,1632
1989-04-02,Costa Rica,Guatemala,2,1,1,1.0,0.0,1664,1648
1989-04-02,Curaçao,Aruba,1,0,1,1.0,0.0,1552,1482
1989-04-02,Ethiopia,Zambia,2,2,0,0.5,0.5,1608,1720
1989-04-02,New Zealand,Australia,2,0,2,1.0,0.0,1692,1734
1989-04-04,Algeria,Tunisia,2,0,2,1.0,0.0,1743,1610
1989-04-04,Hungary,Switzerland,3,0,3,1.0,0.0,1806,1725
1989-04-05,Greece,Yugoslavia,1,4,3,0.0,1.0,1685,1850
1989-04-05,Saudi Arabia,Yemen,1,0,1,1.0,0.0,1715,1394
1989-04-07,Sudan,Kenya,1,0,1,1.0,0.0,1587,1589
1989-04-09,Angola,Ivory Coast,0,2,2,0.0,1.0,1569,1741
1989-04-09,Ethiopia,Egypt,1,0,1,1.0,0.0,1620,1743
1989-04-09,Gabon,Ghana,1,0,1,1.0,0.0,1545,1664
1989-04-09,Mali,Morocco,0,0,0,0.5,0.5,1581,1728
1989-04-09,Mauritius,Zimbabwe,1,4,3,0.0,1.0,1528,1658
1989-04-09,New Zealand,Israel,2,2,0,0.5,0.5,1692,1660
1989-04-09,Eswatini,Malawi,0,2,2,0.0,1.0,1468,1678
1989-04-11,Austria,Czechoslovakia,1,2,1,0.0,1.0,1764,1835
1989-04-12,Barbados,Bermuda,1,2,1,0.0,1.0,1488,1461
1989-04-12,Brazil,Paraguay,2,0,2,1.0,0.0,1966,1777
1989-04-12,Denmark,Canada,2,0,2,1.0,0.0,1774,1625
1989-04-12,German DR,Turkey,0,2,2,0.0,1.0,1755,1632
1989-04-12,Hungary,Malta,1,1,0,0.5,0.5,1801,1487
1989-04-12,Poland,Romania,2,1,1,1.0,0.0,1810,1800
1989-04-13,Angola,Mozambique,1,1,0,0.5,0.5,1568,1496
1989-04-13,Ecuador,Argentina,2,2,0,0.5,0.5,1582,1819
1989-04-14,Barbados,Bermuda,2,1,1,1.0,0.0,1496,1454
1989-04-14,Faroe Islands,Canada,1,0,1,1.0,0.0,1467,1614
1989-04-15,Guinea,Nigeria,1,1,0,0.5,0.5,1610,1691
1989-04-16,Australia,Israel,1,1,0,0.5,0.5,1733,1662
1989-04-16,Costa Rica,United States,1,0,1,1.0,0.0,1671,1571
1989-04-16,Faroe Islands,Canada,0,1,1,0.0,1.0,1463,1619
1989-04-16,Mozambique,Zambia,0,1,1,0.0,1.0,1493,1724
1989-04-16,Trinidad and Tobago,Bermuda,1,1,0,0.5,0.5,1629,1458
1989-04-18,Trinidad and Tobago,Bermuda,0,1,1,0.0,1.0,1618,1470
1989-04-20,Chile,Argentina,1,1,0,0.5,0.5,1735,1818
1989-04-21,Egypt,Ethiopia,6,1,5,1.0,0.0,1749,1615
1989-04-22,Italy,Uruguay,1,1,0,0.5,0.5,1907,1812
1989-04-22,Nigeria,Guinea,3,0,3,1.0,0.0,1698,1604
1989-04-23,Antigua and Barbuda,Jamaica,1,0,1,1.0,0.0,1486,1489
1989-04-23,Ghana,Gabon,1,0,1,1.0,0.0,1670,1540
1989-04-23,Ivory Coast,Angola,4,1,3,1.0,0.0,1746,1564
1989-04-23,Kenya,Sudan,1,0,1,1.0,0.0,1597,1580
1989-04-23,Malawi,Eswatini,1,1,0,0.5,0.5,1674,1473
1989-04-23,Morocco,Mali,1,1,0,0.5,0.5,1725,1585
1989-04-23,Saint Kitts and Nevis,French Guiana,1,0,1,1.0,0.0,1481,1457
1989-04-23,Saint Lucia,Dominica,0,0,0,0.5,0.5,1474,1430
1989-04-23,Trinidad and Tobago,Aruba,11,0,11,1.0,0.0,1624,1477
1989-04-23,Zimbabwe,Mauritius,1,0,1,1.0,0.0,1664,1523
1989-04-26,Bulgaria,Denmark,0,2,2,0.0,1.0,1738,1782
1989-04-26,Curaçao,Martinique,3,1,2,1.0,0.0,1562,1616
1989-04-26,England,Albania,5,0,5,1.0,0.0,1883,1486
1989-04-26,Greece,Romania,0,0,0,0.5,0.5,1688,1798
1989-04-26,Republic of Ireland,Spain,1,0,1,1.0,0.0,1779,1847
1989-04-26,Italy,Hungary,4,0,4,1.0,0.0,1913,1796
1989-04-26,Malta,Northern Ireland,0,2,2,0.0,1.0,1484,1723
1989-04-26,Netherlands,Germany,1,1,0,0.5,0.5,1901,1947
1989-04-26,Portugal,Switzerland,3,1,2,1.0,0.0,1789,1719
1989-04-26,Russia,German DR,3,0,3,1.0,0.0,1909,1751
1989-04-26,Scotland,Cyprus,2,1,1,1.0,0.0,1801,1387
1989-04-26,Wales,Sweden,0,2,2,0.0,1.0,1736,1842
1989-04-29,Belgium,Czechoslovakia,2,1,1,1.0,0.0,1806,1827
1989-04-29,France,Yugoslavia,0,0,0,0.5,0.5,1853,1851
1989-04-30,United States,Costa Rica,1,0,1,1.0,0.0,1582,1661
1989-04-30,Zambia,Mozambique,3,0,3,1.0,0.0,1728,1490
1989-05-01,Guernsey,Jersey,0,4,4,0.0,1.0,1655,1705
1989-05-02,Norway,Poland,0,3,3,0.0,1.0,1669,1815
1989-05-03,Uruguay,Ecuador,3,1,2,1.0,0.0,1816,1579
1989-05-05,El Salvador,Paraguay,1,2,1,0.0,1.0,1638,1783
1989-05-05,Guatemala,Chile,0,1,1,0.0,1.0,1642,1742
1989-05-05,South Korea,Japan,1,0,1,1.0,0.0,1821,1650
1989-05-07,El Salvador,Chile,0,1,1,0.0,1.0,1633,1748
1989-05-07,Grenada,Saint Kitts and Nevis,2,1,1,1.0,0.0,1524,1474
1989-05-07,Guatemala,Paraguay,1,2,1,0.0,1.0,1638,1788
1989-05-07,Jamaica,Guadeloupe,1,3,2,0.0,1.0,1483,1545
1989-05-07,Sint Maarten,British Virgin Islands,1,2,1,0.0,1.0,1493,1516
1989-05-07,Sweden,Poland,2,1,1,1.0,0.0,1850,1808
1989-05-09,Czechoslovakia,Luxembourg,4,0,4,1.0,0.0,1828,1336
1989-05-10,Brazil,Peru,4,1,3,1.0,0.0,1969,1657
1989-05-10,French Guiana,Trinidad and Tobago,1,3,2,0.0,1.0,1453,1629
1989-05-10,Japan,China PR,2,2,0,0.5,0.5,1652,1731
1989-05-10,Turkey,Russia,0,1,1,0.0,1.0,1630,1912
1989-05-13,Dominica,Antigua and Barbuda,0,1,1,0.0,1.0,1424,1493
1989-05-13,Hong Kong,Macau,2,1,1,1.0,0.0,1580,1438
1989-05-13,Japan,China PR,2,0,2,1.0,0.0,1662,1722
1989-05-13,Singapore,Indonesia,1,2,1,0.0,1.0,1521,1547
1989-05-13,United States,Trinidad and Tobago,1,1,0,0.5,0.5,1584,1628
1989-05-15,Paraguay,Peru,1,1,0,0.5,0.5,1786,1660
1989-05-16,Namibia,Angola,0,1,1,0.0,1.0,1494,1571
1989-05-17,Denmark,Greece,7,1,6,1.0,0.0,1788,1683
1989-05-17,Romania,Bulgaria,1,0,1,1.0,0.0,1805,1732
1989-05-18,Peru,Venezuela,2,1,1,1.0,0.0,1664,1454
1989-05-20,German DR,Austria,1,1,0,0.5,0.5,1752,1764
1989-05-21,Aruba,Grenada,0,0,0,0.5,0.5,1479,1523
1989-05-21,Guadeloupe,Dominica,0,0,0,0.5,0.5,1543,1427
1989-05-21,Indonesia,North Korea,0,0,0,0.5,0.5,1551,1698
1989-05-21,Martinique,British Virgin Islands,0,0,0,0.5,0.5,1614,1519
1989-05-21,Norway,Cyprus,3,1,2,1.0,0.0,1672,1385
1989-05-21,Saint Kitts and Nevis,Trinidad and Tobago,0,2,2,0.0,1.0,1470,1633
1989-05-21,Saint Vincent and the Grenadines,Curaçao,3,2,1,1.0,0.0,1582,1555
1989-05-22,Hong Kong,Japan,0,0,0,0.5,0.5,1582,1661
1989-05-23,Ecuador,Uruguay,1,1,0,0.5,0.5,1584,1812
1989-05-23,England,Chile,0,0,0,0.5,0.5,1881,1751
1989-05-23,South Korea,Singapore,3,0,3,1.0,0.0,1824,1519
1989-05-23,Malaysia,Nepal,2,0,2,1.0,0.0,1596,1451
1989-05-24,Guinea-Bissau,Senegal,0,0,0,0.5,0.5,1514,1690
1989-05-24,Morocco,Algeria,1,0,1,1.0,0.0,1734,1735
1989-05-24,Peru,Brazil,1,1,0,0.5,0.5,1670,1964
1989-05-25,Bolivia,Paraguay,3,2,1,1.0,0.0,1560,1774
1989-05-25,South Korea,Nepal,9,0,9,1.0,0.0,1826,1450
1989-05-25,Malaysia,Singapore,1,0,1,1.0,0.0,1603,1513
1989-05-25,Mali,Cape Verde,1,1,0,0.5,0.5,1583,1469
1989-05-25,Mauritania,Sierra Leone,1,2,1,0.0,1.0,1378,1576
1989-05-26,Northern Ireland,Chile,0,1,1,0.0,1.0,1716,1759
1989-05-27,Belgium,Yugoslavia,1,0,1,1.0,0.0,1816,1842
1989-05-27,Cape Verde,Guinea-Bissau,2,3,1,0.0,1.0,1463,1521
1989-05-27,Hong Kong,North Korea,1,2,1,0.0,1.0,1577,1704
1989-05-27,South Korea,Malaysia,3,0,3,1.0,0.0,1830,1600
1989-05-27,Mali,Senegal,2,2,0,0.5,0.5,1586,1688
1989-05-27,Scotland,England,0,2,2,0.0,1.0,1795,1888
1989-05-27,Singapore,Nepal,3,0,3,1.0,0.0,1520,1444
1989-05-28,Indonesia,Japan,0,0,0,0.5,0.5,1554,1659
1989-05-28,Republic of Ireland,Malta,2,0,2,1.0,0.0,1782,1482
1989-05-28,Trinidad and Tobago,Costa Rica,1,1,0,0.5,0.5,1634,1661
1989-05-30,Cape Verde,Senegal,2,1,1,1.0,0.0,1476,1676
1989-05-30,Guinea,Mauritania,3,1,2,1.0,0.0,1608,1375
1989-05-30,Iran,Thailand,3,0,3,1.0,0.0,1771,1569
1989-05-30,Mali,Guinea-Bissau,2,1,1,1.0,0.0,1593,1515
1989-05-30,Scotland,Chile,2,0,2,1.0,0.0,1803,1752
1989-05-31,Finland,Netherlands,0,1,1,0.0,1.0,1581,1904
1989-05-31,Norway,Austria,4,1,3,1.0,0.0,1683,1754
1989-05-31,Russia,Iceland,1,1,0,0.5,0.5,1907,1583
1989-05-31,Sweden,Algeria,2,0,2,1.0,0.0,1856,1730
1989-05-31,Wales,Germany,0,0,0,0.5,0.5,1741,1943
1989-06-01,Ivory Coast,DR Congo,1,1,0,0.5,0.5,1745,1665
1989-06-01,Luxembourg,Belgium,0,5,5,0.0,1.0,1336,1817
1989-06-01,Paraguay,Bolivia,2,0,2,1.0,0.0,1778,1557
1989-06-02,Cape Verde,Guinea,0,1,1,0.0,1.0,1471,1614
1989-06-02,Mali,Sierra Leone,1,0,1,1.0,0.0,1601,1569
1989-06-03,Cape Verde,Sierra Leone,1,0,1,1.0,0.0,1482,1559
1989-06-03,Curaçao,British Virgin Islands,4,0,4,1.0,0.0,1563,1512
1989-06-03,Egypt,Chile,2,0,2,1.0,0.0,1758,1744
1989-06-03,England,Poland,3,0,3,1.0,0.0,1895,1802
1989-06-03,Malawi,Tunisia,1,0,1,1.0,0.0,1681,1604
1989-06-03,Nepal,South Korea,0,4,4,0.0,1.0,1443,1832
1989-06-03,Singapore,Malaysia,2,2,0,0.5,0.5,1522,1599
1989-06-04,Dominica,Jamaica,0,0,0,0.5,0.5,1429,1482
1989-06-04,Gabon,DR Congo,0,0,0,0.5,0.5,1543,1663
1989-06-04,Hong Kong,Indonesia,1,1,0,0.5,0.5,1577,1555
1989-06-04,Republic of Ireland,Hungary,2,0,2,1.0,0.0,1791,1788
1989-06-04,Japan,North Korea,2,1,1,1.0,0.0,1669,1695
1989-06-04,Mali,Guinea,3,0,3,1.0,0.0,1610,1606
1989-06-04,United States,Peru,3,0,3,1.0,0.0,1594,1661
1989-06-05,Malaysia,South Korea,0,3,3,0.0,1.0,1596,1836
1989-06-05,Singapore,Nepal,7,0,7,1.0,0.0,1529,1437
1989-06-06,Grenada,Trinidad and Tobago,1,0,1,1.0,0.0,1534,1624
1989-06-07,Denmark,England,1,1,0,0.5,0.5,1791,1893
1989-06-07,Malaysia,Nepal,3,0,3,1.0,0.0,1601,1433
1989-06-07,Martinique,Sint Maarten,10,0,10,1.0,0.0,1620,1488
1989-06-07,Singapore,South Korea,0,3,3,0.0,1.0,1527,1839
1989-06-07,Switzerland,Czechoslovakia,0,1,1,0.0,1.0,1714,1834
1989-06-08,Bolivia,Uruguay,0,0,0,0.5,0.5,1563,1807
1989-06-08,Brazil,Portugal,4,0,4,1.0,0.0,1969,1785
1989-06-08,Canada,Belgium,0,2,2,0.0,1.0,1616,1821
1989-06-08,French Guiana,Aruba,4,0,4,1.0,0.0,1462,1471
1989-06-10,Kenya,Egypt,0,0,0,0.5,0.5,1601,1755
1989-06-10,Nigeria,Cameroon,2,0,2,1.0,0.0,1707,1724
1989-06-11,Angola,Gabon,2,0,2,1.0,0.0,1579,1536
1989-06-11,DR Congo,Morocco,0,0,0,0.5,0.5,1665,1733
1989-06-11,Costa Rica,Trinidad and Tobago,1,0,1,1.0,0.0,1669,1617
1989-06-11,Ivory Coast,Algeria,0,0,0,0.5,0.5,1745,1731
1989-06-11,Japan,Indonesia,5,0,5,1.0,0.0,1675,1550
1989-06-11,Liberia,Malawi,1,0,1,1.0,0.0,1525,1670
1989-06-11,Zambia,Tunisia,1,0,1,1.0,0.0,1734,1599
1989-06-14,Denmark,Sweden,6,0,6,1.0,0.0,1801,1847
1989-06-14,Iceland,Austria,0,0,0,0.5,0.5,1587,1751
1989-06-14,Norway,Yugoslavia,1,2,1,0.0,1.0,1679,1847
1989-06-14,Uruguay,Bolivia,1,0,1,1.0,0.0,1811,1560
1989-06-16,Brazil,Sweden,1,2,1,0.0,1.0,1959,1858
1989-06-16,Trinidad and Tobago,Peru,2,1,1,1.0,0.0,1627,1652
1989-06-16,Zimbabwe,Zambia,0,0,0,0.5,0.5,1666,1733
1989-06-17,United States,Guatemala,2,1,1,1.0,0.0,1604,1629
1989-06-18,Aruba,Saint Kitts and Nevis,1,4,3,0.0,1.0,1463,1479
1989-06-18,Denmark,Brazil,4,0,4,1.0,0.0,1813,1948
1989-06-18,Jamaica,Saint Lucia,1,1,0,0.5,0.5,1482,1475
1989-06-18,Japan,Hong Kong,0,0,0,0.5,0.5,1673,1580
1989-06-18,Sint Maarten,Curaçao,1,2,1,0.0,1.0,1482,1570
1989-06-19,Uruguay,Chile,2,2,0,0.5,0.5,1810,1746
1989-06-20,Ecuador,Peru,1,2,1,0.0,1.0,1578,1659
1989-06-21,Switzerland,Brazil,1,0,1,1.0,0.0,1727,1936
1989-06-22,Bolivia,Chile,0,1,1,0.0,1.0,1556,1751
1989-06-24,Malawi,Kenya,1,0,1,1.0,0.0,1677,1595
1989-06-24,United States,Colombia,0,1,1,0.0,1.0,1599,1730
1989-06-25,Angola,Cameroon,1,2,1,0.0,1.0,1575,1729
1989-06-25,El Salvador,Costa Rica,2,4,2,0.0,1.0,1626,1677
1989-06-25,Gabon,Nigeria,2,1,1,1.0,0.0,1548,1696
1989-06-25,Indonesia,Hong Kong,3,2,1,1.0,0.0,1559,1572
1989-06-25,North Korea,Japan,2,0,2,1.0,0.0,1703,1666
1989-06-25,Liberia,Egypt,1,0,1,1.0,0.0,1538,1743
1989-06-25,Tunisia,DR Congo,1,0,1,1.0,0.0,1609,1656
1989-06-25,Venezuela,Peru,3,1,2,1.0,0.0,1467,1647
1989-06-25,Zambia,Morocco,2,1,1,1.0,0.0,1741,1725
1989-06-25,Zimbabwe,Algeria,1,2,1,0.0,1.0,1660,1738
1989-06-26,South Korea,Czechoslovakia,0,0,0,0.5,0.5,1839,1835
1989-06-27,Chile,Bolivia,2,1,1,1.0,0.0,1755,1553
1989-06-27,Haiti,Colombia,0,4,4,0.0,1.0,1572,1735
1989-06-30,Grenada,French Guiana,0,0,0,0.5,0.5,1533,1464
1989-07-01,Brazil,Venezuela,3,1,2,1.0,0.0,1938,1466
1989-07-01,Paraguay,Peru,5,2,3,1.0,0.0,1784,1642
1989-07-02,Argentina,Chile,1,0,1,1.0,0.0,1825,1749
1989-07-02,Grenada,Saint Vincent and the Grenadines,2,0,2,1.0,0.0,1543,1573
1989-07-02,North Korea,Hong Kong,4,1,3,1.0,0.0,1709,1567
1989-07-02,Uruguay,Ecuador,0,1,1,0.0,1.0,1798,1591
1989-07-03,Barbados,Guadeloupe,1,0,1,1.0,0.0,1506,1534
1989-07-03,Brazil,Peru,0,0,0,0.5,0.5,1933,1648
1989-07-03,Venezuela,Colombia,2,4,2,0.0,1.0,1464,1738
1989-07-04,Argentina,Ecuador,0,0,0,0.5,0.5,1821,1596
1989-07-04,Curaçao,Saint Vincent and the Grenadines,1,1,0,0.5,0.5,1571,1573
1989-07-04,Uruguay,Bolivia,3,0,3,1.0,0.0,1802,1550
1989-07-05,Barbados,Trinidad and Tobago,0,3,3,0.0,1.0,1501,1633
1989-07-05,Colombia,Paraguay,0,1,1,0.0,1.0,1732,1791
1989-07-05,Peru,Venezuela,1,1,0,0.5,0.5,1645,1468
1989-07-06,Chile,Uruguay,0,3,3,0.0,1.0,1743,1809
1989-07-06,Curaçao,Grenada,1,1,0,0.5,0.5,1571,1544
1989-07-06,Ecuador,Bolivia,0,0,0,0.5,0.5,1595,1552
1989-07-06,Malawi,Gabon,2,0,2,1.0,0.0,1683,1543
1989-07-06,Faroe Islands,Ynys Môn,6,0,6,1.0,0.0,1472,1492
1989-07-06,Greenland,Shetland,4,1,3,1.0,0.0,1463,1491
1989-07-07,Brazil,Colombia,0,0,0,0.5,0.5,1929,1737
1989-07-07,Gabon,Mozambique,1,0,1,1.0,0.0,1550,1484
1989-07-07,Guadeloupe,Trinidad and Tobago,2,0,2,1.0,0.0,1545,1623
1989-07-07,Paraguay,Venezuela,3,0,3,1.0,0.0,1794,1466
1989-07-08,Bolivia,Chile,0,5,5,0.0,1.0,1549,1747
1989-07-08,Uruguay,Argentina,0,1,1,0.0,1.0,1802,1829
1989-07-08,Faroe Islands,Shetland,4,0,4,1.0,0.0,1481,1483
1989-07-08,Åland Islands,Ynys Môn,4,5,1,0.0,1.0,1492,1501
1989-07-09,Brazil,Paraguay,2,0,2,1.0,0.0,1935,1789
1989-07-09,Colombia,Peru,1,1,0,0.5,0.5,1735,1648
1989-07-09,Grenada,Trinidad and Tobago,1,2,1,0.0,1.0,1538,1630
1989-07-09,North Korea,Indonesia,2,1,1,1.0,0.0,1714,1555
1989-07-09,Malawi,Mozambique,0,1,1,0.0,1.0,1671,1497
1989-07-09,Faroe Islands,Greenland,3,0,3,1.0,0.0,1489,1456
1989-07-09,Åland Islands,Shetland,2,0,2,1.0,0.0,1500,1476
1989-07-10,Argentina,Bolivia,0,0,0,0.5,0.5,1824,1555
1989-07-10,Chile,Ecuador,2,1,1,1.0,0.0,1752,1591
1989-07-10,Kenya,DR Congo,0,1,1,0.0,1.0,1589,1663
1989-07-11,Malawi,Mozambique,0,2,2,0.0,1.0,1660,1509
1989-07-11,Åland Islands,Greenland,3,0,3,1.0,0.0,1507,1450
1989-07-11,Ynys Môn,Shetland,3,0,3,1.0,0.0,1509,1469
1989-07-12,Brazil,Argentina,2,0,2,1.0,0.0,1941,1819
1989-07-12,Paraguay,Uruguay,0,3,3,0.0,1.0,1782,1810
1989-07-12,Faroe Islands,Åland Islands,7,1,6,1.0,0.0,1498,1499
1989-07-12,Ynys Môn,Greenland,1,0,1,1.0,0.0,1516,1444
1989-07-14,Argentina,Uruguay,0,2,2,0.0,1.0,1811,1819
1989-07-14,Brazil,Paraguay,3,0,3,1.0,0.0,1946,1778
1989-07-15,China PR,Iran,2,0,2,1.0,0.0,1732,1762
1989-07-16,Brazil,Uruguay,1,0,1,1.0,0.0,1952,1814
1989-07-16,Costa Rica,El Salvador,1,0,1,1.0,0.0,1684,1620
1989-07-16,Egypt,DR Congo,2,0,2,1.0,0.0,1750,1657
1989-07-16,Nigeria,Zimbabwe,3,0,3,1.0,0.0,1704,1653
1989-07-16,Malawi,Kenya,2,3,1,0.0,1.0,1651,1599
1989-07-16,Zambia,Gabon,3,0,3,1.0,0.0,1745,1547
1989-07-16,Mali,Ivory Coast,2,2,0,0.5,0.5,1613,1743
1989-07-16,Paraguay,Argentina,0,0,0,0.5,0.5,1779,1811
1989-07-16,Senegal,Tunisia,3,0,3,1.0,0.0,1683,1603
1989-07-22,Iran,China PR,3,2,1,1.0,0.0,1770,1725
1989-07-23,Brazil,Japan,1,0,1,1.0,0.0,1955,1664
1989-07-25,Chile,Peru,2,1,1,1.0,0.0,1758,1643
1989-07-26,Algeria,Qatar,1,1,0,0.5,0.5,1736,1643
1989-07-28,DR Congo,Egypt,0,0,0,0.5,0.5,1660,1748
1989-07-29,Kenya,Malawi,0,0,0,0.5,0.5,1601,1650
1989-07-29,China PR,Thailand,2,0,2,1.0,0.0,1730,1565
1989-07-30,Gabon,Zambia,2,1,1,1.0,0.0,1560,1733
1989-07-30,Ivory Coast,Mali,3,1,2,1.0,0.0,1749,1608
1989-07-30,Trinidad and Tobago,El Salvador,2,0,2,1.0,0.0,1638,1613
1989-07-30,Tunisia,Senegal,0,1,1,0.0,1.0,1597,1690
1989-07-30,Venezuela,Brazil,0,4,4,0.0,1.0,1466,1956
1989-07-30,Zimbabwe,Nigeria,1,1,0,0.5,0.5,1655,1703
1989-08-05,Tunisia,Malawi,3,0,3,1.0,0.0,1607,1641
1989-08-06,Uruguay,Colombia,0,0,0,0.5,0.5,1813,1737
1989-08-06,Venezuela,Chile,1,3,2,0.0,1.0,1464,1761
1989-08-10,Mexico,South Korea,4,2,2,1.0,0.0,1906,1833
1989-08-12,Egypt,Malawi,1,0,1,1.0,0.0,1754,1636
1989-08-12,Kenya,Liberia,1,0,1,1.0,0.0,1608,1532
1989-08-12,Nigeria,Angola,1,0,1,1.0,0.0,1709,1570
1989-08-13,Cameroon,Gabon,2,1,1,1.0,0.0,1734,1556
1989-08-13,Chile,Brazil,1,1,0,0.5,0.5,1766,1952
1989-08-13,DR Congo,Zambia,1,0,1,1.0,0.0,1670,1724
1989-08-13,El Salvador,Trinidad and Tobago,0,0,0,0.5,0.5,1614,1638
1989-08-13,Ivory Coast,Zimbabwe,5,0,5,1.0,0.0,1755,1650
1989-08-13,Morocco,Tunisia,0,0,0,0.5,0.5,1723,1610
1989-08-13,United States,South Korea,1,2,1,0.0,1.0,1596,1837
1989-08-16,Sweden,France,2,4,2,0.0,1.0,1850,1862
1989-08-20,Bolivia,Peru,2,1,1,1.0,0.0,1565,1634
1989-08-20,Brazil,Venezuela,6,0,6,1.0,0.0,1953,1464
1989-08-20,Colombia,Ecuador,2,0,2,1.0,0.0,1742,1587
1989-08-20,Guatemala,Trinidad and Tobago,0,1,1,0.0,1.0,1622,1646
1989-08-21,Indonesia,Brunei,6,0,6,1.0,0.0,1560,1389
1989-08-21,Malaysia,Philippines,3,0,3,1.0,0.0,1604,1321
1989-08-22,Thailand,Myanmar,3,0,3,1.0,0.0,1575,1610
1989-08-23,Austria,Iceland,2,1,1,1.0,0.0,1756,1583
1989-08-23,Belgium,Denmark,3,0,3,1.0,0.0,1829,1806
1989-08-23,Finland,Yugoslavia,2,2,0,0.5,0.5,1587,1842
1989-08-23,German DR,Bulgaria,1,1,0,0.5,0.5,1752,1733
1989-08-23,Norway,Greece,0,0,0,0.5,0.5,1680,1683
1989-08-23,Poland,Russia,1,1,0,0.5,0.5,1805,1905
1989-08-23,Malaysia,Brunei,2,1,1,1.0,0.0,1608,1386
1989-08-23,Indonesia,Philippines,5,1,4,1.0,0.0,1564,1318
1989-08-24,Singapore,Thailand,1,1,0,0.5,0.5,1529,1574
1989-08-25,Algeria,Ivory Coast,1,0,1,1.0,0.0,1745,1747
1989-08-25,Brunei,Philippines,2,0,2,1.0,0.0,1393,1312
1989-08-25,Malaysia,Indonesia,2,0,2,1.0,0.0,1615,1558
1989-08-26,Egypt,Kenya,2,0,2,1.0,0.0,1759,1604
1989-08-26,Malawi,Liberia,0,0,0,0.5,0.5,1634,1535
1989-08-26,Singapore,Myanmar,4,0,4,1.0,0.0,1539,1601
1989-08-27,Cameroon,Nigeria,1,0,1,1.0,0.0,1742,1702
1989-08-27,Chile,Venezuela,5,0,5,1.0,0.0,1769,1462
1989-08-27,Gabon,Angola,1,0,1,1.0,0.0,1565,1562
1989-08-27,Morocco,DR Congo,1,1,0,0.5,0.5,1722,1672
1989-08-27,Paraguay,Colombia,2,1,1,1.0,0.0,1787,1735
1989-08-27,Peru,Uruguay,0,2,2,0.0,1.0,1630,1818
1989-08-27,Tunisia,Zambia,1,0,1,1.0,0.0,1621,1714
1989-08-28,Singapore,Indonesia,1,0,1,1.0,0.0,1548,1550
1989-08-28,Malaysia,Thailand,1,0,1,1.0,0.0,1623,1567
1989-08-30,Indonesia,Thailand,1,1,0,0.5,0.5,1551,1567
1989-08-31,Portugal,Romania,0,0,0,0.5,0.5,1786,1805
1989-08-31,Malaysia,Singapore,3,1,2,1.0,0.0,1630,1542
1989-09-01,Trinidad and Tobago,Panama,2,0,2,1.0,0.0,1651,1483
1989-09-03,Bolivia,Uruguay,2,1,1,1.0,0.0,1578,1806
1989-09-03,Brazil,Chile,1,0,1,1.0,0.0,1958,1765
1989-09-03,Ecuador,Colombia,0,0,0,0.5,0.5,1591,1732
1989-09-03,Trinidad and Tobago,Guatemala,2,1,1,1.0,0.0,1659,1615
1989-09-05,Czechoslovakia,Romania,2,0,2,1.0,0.0,1843,1798
1989-09-05,Norway,France,1,1,0,0.5,0.5,1684,1859
1989-09-05,Poland,Greece,3,0,3,1.0,0.0,1811,1678
1989-09-06,Austria,Russia,0,0,0,0.5,0.5,1760,1902
1989-09-06,Belgium,Portugal,3,0,3,1.0,0.0,1837,1779
1989-09-06,Finland,Wales,1,0,1,1.0,0.0,1599,1730
1989-09-06,Iceland,German DR,0,3,3,0.0,1.0,1579,1757
1989-09-06,Republic of Ireland,Germany,1,1,0,0.5,0.5,1795,1940
1989-09-06,Netherlands,Denmark,2,2,0,0.5,0.5,1902,1809
1989-09-06,Northern Ireland,Hungary,1,2,1,0.0,1.0,1710,1795
1989-09-06,Sweden,England,0,0,0,0.5,0.5,1851,1893
1989-09-06,Yugoslavia,Scotland,3,1,2,1.0,0.0,1850,1796
1989-09-10,Paraguay,Ecuador,2,1,1,1.0,0.0,1791,1588
1989-09-10,Peru,Bolivia,1,2,1,0.0,1.0,1621,1588
1989-09-16,South Korea,Egypt,0,1,1,0.0,1.0,1828,1769
1989-09-17,Colombia,Paraguay,2,1,1,1.0,0.0,1742,1782
1989-09-17,El Salvador,United States,0,1,1,0.0,1.0,1606,1605
1989-09-17,Uruguay,Bolivia,2,0,2,1.0,0.0,1810,1585
1989-09-20,Iceland,Turkey,2,1,1,1.0,0.0,1589,1621
1989-09-20,Italy,Bulgaria,4,0,4,1.0,0.0,1918,1729
1989-09-20,Kuwait,China PR,2,0,2,1.0,0.0,1724,1722
1989-09-20,Spain,Poland,1,0,1,1.0,0.0,1855,1804
1989-09-20,Switzerland,Portugal,1,2,1,0.0,1.0,1721,1786
1989-09-20,Yugoslavia,Greece,3,0,3,1.0,0.0,1855,1674
1989-09-21,Bangladesh,Sri Lanka,3,0,3,1.0,0.0,1467,1365
1989-09-22,Kuwait,Qatar,1,0,1,1.0,0.0,1731,1637
1989-09-24,Ecuador,Paraguay,3,1,2,1.0,0.0,1601,1770
1989-09-24,Uruguay,Peru,2,0,2,1.0,0.0,1815,1617
1989-09-25,Kuwait,Egypt,0,0,0,0.5,0.5,1732,1769
1989-09-25,India,Sri Lanka,2,1,1,1.0,0.0,1516,1361
1989-10-04,Germany,Finland,6,1,5,1.0,0.0,1942,1598
1989-10-04,Malta,Austria,1,2,1,0.0,1.0,1480,1763
1989-10-06,Czechoslovakia,Portugal,2,1,1,1.0,0.0,1850,1780
1989-10-08,Algeria,Egypt,0,0,0,0.5,0.5,1746,1769
1989-10-08,Cameroon,Tunisia,2,0,2,1.0,0.0,1748,1616
1989-10-08,German DR,Russia,2,1,1,1.0,0.0,1769,1891
1989-10-08,Guatemala,United States,0,0,0,0.5,0.5,1615,1606
1989-10-08,Sweden,Albania,3,1,2,1.0,0.0,1853,1485
1989-10-11,Bulgaria,Greece,4,0,4,1.0,0.0,1736,1668
1989-10-11,Cyprus,Malta,0,0,0,0.5,0.5,1388,1478
1989-10-11,Denmark,Romania,3,0,3,1.0,0.0,1817,1791
1989-10-11,France,Scotland,3,0,3,1.0,0.0,1866,1790
1989-10-11,Hungary,Spain,2,2,0,0.5,0.5,1797,1854
1989-10-11,Republic of Ireland,Northern Ireland,3,0,3,1.0,0.0,1802,1704
1989-10-11,Luxembourg,Portugal,0,3,3,0.0,1.0,1335,1782
1989-10-11,Poland,England,0,0,0,0.5,0.5,1807,1891
1989-10-11,Switzerland,Belgium,2,2,0,0.5,0.5,1724,1835
1989-10-11,Wales,Netherlands,1,2,1,0.0,1.0,1726,1907
1989-10-11,Yugoslavia,Norway,1,0,1,1.0,0.0,1860,1680
1989-10-12,China PR,Saudi Arabia,2,1,1,1.0,0.0,1730,1708
1989-10-12,United Arab Emirates,North Korea,0,0,0,0.5,0.5,1661,1713
1989-10-13,South Korea,Qatar,0,0,0,0.5,0.5,1824,1642
1989-10-14,Italy,Brazil,0,1,1,0.0,1.0,1911,1966
1989-10-15,Colombia,Israel,1,0,1,1.0,0.0,1749,1656
1989-10-15,Iraq,Kuwait,1,0,1,1.0,0.0,1756,1725
1989-10-16,South Korea,North Korea,1,0,1,1.0,0.0,1830,1708
1989-10-16,Qatar,Saudi Arabia,1,1,0,0.5,0.5,1644,1707
1989-10-17,China PR,United Arab Emirates,1,2,1,0.0,1.0,1721,1671
1989-10-20,China PR,South Korea,0,1,1,0.0,1.0,1716,1836
1989-10-20,North Korea,Qatar,2,0,2,1.0,0.0,1715,1638
1989-10-20,Maldives,Nepal,0,0,0,0.5,0.5,1435,1434
1989-10-21,Saudi Arabia,United Arab Emirates,0,0,0,0.5,0.5,1707,1672
1989-10-22,Liberia,Guinea,2,0,2,1.0,0.0,1545,1597
1989-10-22,Trinidad and Tobago,Finland,0,1,1,0.0,1.0,1650,1608
1989-10-22,Pakistan,Nepal,0,0,0,0.5,0.5,1460,1435
1989-10-23,Bangladesh,India,1,1,0,0.5,0.5,1469,1515
1989-10-24,North Korea,China PR,0,1,1,0.0,1.0,1708,1724
1989-10-24,United Arab Emirates,Qatar,1,1,0,0.5,0.5,1672,1639
1989-10-24,Pakistan,Maldives,2,0,2,1.0,0.0,1468,1428
1989-10-25,Belgium,Luxembourg,1,1,0,0.5,0.5,1828,1343
1989-10-25,Czechoslovakia,Switzerland,3,0,3,1.0,0.0,1856,1719
1989-10-25,Hungary,Greece,1,1,0,0.5,0.5,1795,1671
1989-10-25,Kuwait,Norway,2,2,0,0.5,0.5,1724,1682
1989-10-25,Malta,German DR,0,4,4,0.0,1.0,1476,1772
1989-10-25,Poland,Sweden,0,2,2,0.0,1.0,1801,1860
1989-10-25,Saudi Arabia,South Korea,0,2,2,0.0,1.0,1702,1842
1989-10-25,Trinidad and Tobago,Finland,2,0,2,1.0,0.0,1658,1601
1989-10-25,Turkey,Austria,3,0,3,1.0,0.0,1633,1752
1989-10-26,India,Nepal,2,1,1,1.0,0.0,1522,1429
1989-10-26,Pakistan,Bangladesh,1,0,1,1.0,0.0,1477,1461
1989-10-28,Cyprus,Yugoslavia,1,2,1,0.0,1.0,1388,1861
1989-10-28,Fiji,Papua New Guinea,2,1,1,1.0,0.0,1564,1518
1989-10-28,Qatar,China PR,2,1,1,1.0,0.0,1649,1715
1989-10-28,Saudi Arabia,North Korea,2,0,2,1.0,0.0,1711,1700
1989-10-28,Solomon Islands,Vanuatu,2,0,2,1.0,0.0,1493,1440
1989-10-28,United Arab Emirates,South Korea,1,1,0,0.5,0.5,1676,1839
1989-10-30,Fiji,Vanuatu,2,1,1,1.0,0.0,1570,1435
1989-10-30,Israel,Colombia,0,0,0,0.5,0.5,1659,1747
1989-10-30,Kuwait,Lebanon,5,0,5,1.0,0.0,1728,1478
1989-10-30,New Caledonia,Solomon Islands,2,0,2,1.0,0.0,1619,1488
1989-10-31,Fiji,New Caledonia,3,0,3,1.0,0.0,1580,1610
1989-10-31,Guinea,Iraq,1,0,1,1.0,0.0,1609,1745
1989-10-31,Papua New Guinea,Vanuatu,3,0,3,1.0,0.0,1525,1429
1989-11-01,Iran,Yemen DPR,2,0,2,1.0,0.0,1773,1457
1989-11-01,Tunisia,Algeria,0,0,0,0.5,0.5,1619,1744
1989-11-02,Lebanon,Uganda,0,2,2,0.0,1.0,1474,1652
1989-11-03,Guinea,Iran,1,1,0,0.5,0.5,1613,1770
1989-11-03,Iraq,Yemen DPR,6,2,4,1.0,0.0,1748,1455
1989-11-03,New Caledonia,Vanuatu,5,1,4,1.0,0.0,1615,1425
1989-11-03,Papua New Guinea,Solomon Islands,0,0,0,0.5,0.5,1525,1489
1989-11-03,Qatar,Egypt,0,2,2,0.0,1.0,1644,1775
1989-11-04,Fiji,Solomon Islands,0,0,0,0.5,0.5,1578,1492
1989-11-04,Kuwait,Uganda,1,1,0,0.5,0.5,1727,1654
1989-11-04,New Caledonia,Papua New Guinea,2,1,1,1.0,0.0,1621,1520
1989-11-05,Guinea,Yemen DPR,0,1,1,0.0,1.0,1602,1467
1989-11-05,Iran,Iraq,0,0,0,0.5,0.5,1770,1749
1989-11-05,United States,El Salvador,0,0,0,0.5,0.5,1606,1606
1989-11-08,Iran,Uganda,2,2,0,0.5,0.5,1768,1657
1989-11-08,Kuwait,Iraq,1,2,1,0.0,1.0,1720,1757
1989-11-11,Italy,Algeria,1,0,1,1.0,0.0,1916,1740
1989-11-12,Iraq,Uganda,1,1,0,0.5,0.5,1755,1660
1989-11-12,Kuwait,Iran,1,0,1,1.0,0.0,1730,1759
1989-11-14,Brazil,Yugoslavia,0,0,0,0.5,0.5,1964,1864
1989-11-14,United States,Bermuda,2,1,1,1.0,0.0,1612,1465
1989-11-15,Albania,Poland,1,2,1,0.0,1.0,1483,1804
1989-11-15,Austria,German DR,3,0,3,1.0,0.0,1761,1764
1989-11-15,England,Italy,0,0,0,0.5,0.5,1892,1916
1989-11-15,Germany,Wales,2,1,1,1.0,0.0,1946,1723
1989-11-15,Greece,Bulgaria,1,0,1,1.0,0.0,1681,1727
1989-11-15,Malta,Republic of Ireland,0,2,2,0.0,1.0,1474,1805
1989-11-15,Netherlands,Finland,3,0,3,1.0,0.0,1910,1599
1989-11-15,Portugal,Czechoslovakia,0,0,0,0.5,0.5,1784,1855
1989-11-15,Romania,Denmark,3,1,2,1.0,0.0,1800,1809
1989-11-15,Russia,Turkey,2,0,2,1.0,0.0,1894,1631
1989-11-15,Scotland,Norway,1,1,0,0.5,0.5,1788,1685
1989-11-15,Spain,Hungary,4,0,4,1.0,0.0,1861,1789
1989-11-15,Switzerland,Luxembourg,2,1,1,1.0,0.0,1721,1342
1989-11-17,Egypt,Algeria,1,0,1,1.0,0.0,1783,1733
1989-11-18,France,Cyprus,2,0,2,1.0,0.0,1867,1388
1989-11-19,Trinidad and Tobago,United States,0,1,1,0.0,1.0,1649,1622
1989-11-19,Tunisia,Cameroon,0,1,1,0.0,1.0,1614,1754
1989-11-21,Senegal,Central African Republic,3,0,3,1.0,0.0,1693,1426
1989-11-26,Ghana,Guinea,1,1,0,0.5,0.5,1669,1604
1989-11-28,Liberia,Guinea,2,0,2,1.0,0.0,1555,1595
1989-11-29,Liberia,Ghana,1,1,0,0.5,0.5,1558,1667
1989-12-01,Botswana,Zambia,2,1,1,1.0,0.0,1466,1701
1989-12-02,Central African Republic,Chad,1,1,0,0.5,0.5,1428,1479
1989-12-02,Kenya,Uganda,2,1,1,1.0,0.0,1614,1651
1989-12-02,Malawi,Zanzibar,0,0,0,0.5,0.5,1629,1363
1989-12-03,Tanzania,Zimbabwe,0,3,3,0.0,1.0,1501,1655
1989-12-03,Congo,Gabon,1,0,1,1.0,0.0,1583,1558
1989-12-04,Central African Republic,Cameroon,1,2,1,0.0,1.0,1426,1757
1989-12-05,Congo,Gabon,0,2,2,0.0,1.0,1575,1567
1989-12-05,Kenya,Tanzania,2,1,1,1.0,0.0,1620,1496
1989-12-06,Chad,Cameroon,0,1,1,0.0,1.0,1477,1760
1989-12-06,Uganda,Zimbabwe,1,1,0,0.5,0.5,1652,1655
1989-12-06,Zambia,Zanzibar,1,0,1,1.0,0.0,1704,1361
1989-12-08,Chad,Congo,2,1,1,1.0,0.0,1488,1565
1989-12-08,Tanzania,Uganda,1,5,4,0.0,1.0,1492,1657
1989-12-09,Kenya,Zimbabwe,2,1,1,1.0,0.0,1629,1647
1989-12-09,Malawi,Zambia,0,0,0,0.5,0.5,1631,1703
1989-12-10,Central African Republic,Gabon,2,0,2,1.0,0.0,1438,1556
1989-12-11,Chad,Cameroon,0,0,0,0.5,0.5,1494,1755
1989-12-12,Chad,Gabon,0,2,2,0.0,1.0,1488,1563
1989-12-13,England,Yugoslavia,2,1,1,1.0,0.0,1900,1857
1989-12-13,Spain,Switzerland,2,1,1,1.0,0.0,1866,1717
1989-12-13,Uganda,Zambia,3,1,2,1.0,0.0,1667,1694
1989-12-13,Central African Republic,Cameroon,1,2,1,0.0,1.0,1436,1758
1989-12-14,Kenya,Malawi,0,1,1,0.0,1.0,1622,1639
1989-12-15,Kenya,Zambia,1,0,1,1.0,0.0,1632,1685
1989-12-16,Malawi,Uganda,3,3,0,0.5,0.5,1640,1667
1989-12-20,Netherlands,Brazil,0,1,1,0.0,1.0,1904,1971
1989-12-21,Italy,Argentina,0,0,0,0.5,0.5,1914,1814
1989-12-24,Senegal,Sierra Leone,1,0,1,1.0,0.0,1699,1554
1989-12-31,Senegal,Algeria,0,0,0,0.5,0.5,1700,1733
1990-01-12,Algeria,Mali,5,0,5,1.0,0.0,1739,1603
1990-01-14,Algeria,Cameroon,3,1,2,1.0,0.0,1748,1750
1990-01-17,Greece,Belgium,2,0,2,1.0,0.0,1693,1817
1990-01-17,Mexico,Argentina,2,0,2,1.0,0.0,1912,1809
1990-01-20,Malawi,Tanzania,2,2,0,0.5,0.5,1637,1496
1990-01-20,Eswatini,Botswana,3,1,2,1.0,0.0,1481,1459
1990-01-21,Botswana,Malawi,2,2,0,0.5,0.5,1463,1634
1990-01-21,Kuwait,France,0,1,1,0.0,1.0,1726,1872
1990-01-21,Eswatini,Tanzania,0,1,1,0.0,1.0,1474,1504
1990-01-23,Botswana,Tanzania,0,0,0,0.5,0.5,1464,1504
1990-01-24,France,German DR,3,0,3,1.0,0.0,1878,1759
1990-01-24,Liberia,Senegal,0,1,1,0.0,1.0,1554,1705
1990-01-25,Nigeria,Ivory Coast,2,0,2,1.0,0.0,1712,1738
1990-01-25,United Arab Emirates,Egypt,1,2,1,0.0,1.0,1671,1789
1990-01-26,Kuwait,German DR,1,2,1,0.0,1.0,1719,1767
1990-01-27,Ivory Coast,Liberia,1,0,1,1.0,0.0,1743,1550
1990-01-27,United Arab Emirates,Egypt,1,0,1,1.0,0.0,1682,1779
1990-01-28,Nigeria,Senegal,1,1,0,0.5,0.5,1712,1706
1990-01-29,Thailand,Kenya,2,1,1,1.0,0.0,1577,1623
1990-02-02,Colombia,Uruguay,0,2,2,0.0,1.0,1741,1822
1990-02-02,Indonesia,Kenya,2,3,1,0.0,1.0,1545,1630
1990-02-02,Iran,Poland,0,2,2,0.0,1.0,1753,1811
1990-02-02,United States,Costa Rica,0,2,2,0.0,1.0,1616,1691
1990-02-04,Algeria,Romania,0,0,0,0.5,0.5,1750,1799
1990-02-04,Costa Rica,Uruguay,0,2,2,0.0,1.0,1686,1828
1990-02-04,Iran,Poland,0,1,1,0.0,1.0,1747,1818
1990-02-04,South Korea,Norway,2,3,1,0.0,1.0,1828,1697
1990-02-04,United States,Colombia,1,1,0,0.5,0.5,1619,1739
1990-02-05,Thailand,Indonesia,1,1,0,0.5,0.5,1577,1546
1990-02-05,United Arab Emirates,Denmark,1,1,0,0.5,0.5,1685,1807
1990-02-07,Malta,Norway,1,1,0,0.5,0.5,1479,1693
1990-02-10,Malta,South Korea,1,2,1,0.0,1.0,1478,1830
1990-02-10,Uganda,Mauritius,4,1,3,1.0,0.0,1672,1519
1990-02-11,Kuwait,Poland,1,1,0,0.5,0.5,1722,1816
1990-02-11,Togo,Cameroon,1,1,0,0.5,0.5,1594,1747
1990-02-12,United Arab Emirates,Finland,1,1,0,0.5,0.5,1684,1601
1990-02-13,Bermuda,United States,0,1,1,0.0,1.0,1461,1624
1990-02-14,Egypt,Denmark,0,0,0,0.5,0.5,1780,1807
1990-02-14,United Arab Emirates,Sweden,2,1,1,1.0,0.0,1696,1849
1990-02-15,Iraq,South Korea,0,0,0,0.5,0.5,1757,1829
1990-02-15,Kuwait,Finland,0,1,1,0.0,1.0,1712,1612
1990-02-17,United Arab Emirates,Sweden,0,2,2,0.0,1.0,1692,1854
1990-02-18,Egypt,South Korea,0,0,0,0.5,0.5,1782,1828
1990-02-20,Colombia,Russia,0,0,0,0.5,0.5,1743,1891
1990-02-21,Belgium,Sweden,0,0,0,0.5,0.5,1818,1854
1990-02-21,Gambia,Guinea-Bissau,0,1,1,0.0,1.0,1485,1523
1990-02-21,Kuwait,Bahrain,1,0,1,1.0,0.0,1717,1535
1990-02-21,Morocco,Ivory Coast,2,1,1,1.0,0.0,1731,1735
1990-02-21,Netherlands,Italy,0,0,0,0.5,0.5,1905,1914
1990-02-21,Spain,Czechoslovakia,1,0,1,1.0,0.0,1874,1848
1990-02-22,Costa Rica,Russia,1,2,1,0.0,1.0,1683,1895
1990-02-22,Oman,United Arab Emirates,1,1,0,0.5,0.5,1412,1687
1990-02-23,Qatar,Bahrain,0,0,0,0.5,0.5,1642,1538
1990-02-24,Kuwait,Oman,1,1,0,0.5,0.5,1712,1418
1990-02-24,United States,Russia,1,3,2,0.0,1.0,1622,1898
1990-02-27,Qatar,United Arab Emirates,0,0,0,0.5,0.5,1644,1686
1990-02-28,Egypt,Austria,0,0,0,0.5,0.5,1782,1762
1990-02-28,France,Germany,2,1,1,1.0,0.0,1888,1937
1990-03-01,Bahrain,Oman,0,0,0,0.5,0.5,1536,1421
1990-03-02,Algeria,Nigeria,5,1,4,1.0,0.0,1758,1705
1990-03-02,Ivory Coast,Egypt,3,1,2,1.0,0.0,1745,1773
1990-03-03,Cameroon,Zambia,0,1,1,0.0,1.0,1738,1695
1990-03-03,Senegal,Kenya,0,0,0,0.5,0.5,1705,1632
1990-03-04,Oman,Qatar,2,4,2,0.0,1.0,1418,1648
1990-03-05,Algeria,Ivory Coast,3,0,3,1.0,0.0,1766,1738
1990-03-05,Bahrain,United Arab Emirates,1,0,1,1.0,0.0,1548,1675
1990-03-05,Nigeria,Egypt,1,0,1,1.0,0.0,1715,1764
1990-03-06,Cameroon,Senegal,0,2,2,0.0,1.0,1730,1714
1990-03-06,Mozambique,Angola,2,1,1,1.0,0.0,1519,1553
1990-03-06,Zambia,Kenya,1,0,1,1.0,0.0,1702,1626
1990-03-07,Kuwait,Qatar,2,0,2,1.0,0.0,1719,1642
1990-03-07,Lesotho,Zimbabwe,1,4,3,0.0,1.0,1430,1651
1990-03-08,Algeria,Egypt,2,0,2,1.0,0.0,1774,1757
1990-03-08,Angola,Zimbabwe,0,2,2,0.0,1.0,1548,1657
1990-03-08,Nigeria,Ivory Coast,1,0,1,1.0,0.0,1724,1730
1990-03-09,Cameroon,Kenya,2,0,2,1.0,0.0,1736,1621
1990-03-09,Kuwait,United Arab Emirates,6,1,5,1.0,0.0,1726,1669
1990-03-09,Zambia,Senegal,0,0,0,0.5,0.5,1703,1714
1990-03-10,Angola,Lesotho,3,1,2,1.0,0.0,1554,1425
1990-03-10,Mozambique,Zimbabwe,3,1,2,1.0,0.0,1531,1646
1990-03-10,United States,Finland,2,1,1,1.0,0.0,1630,1605
1990-03-11,Mozambique,Lesotho,3,0,3,1.0,0.0,1537,1420
1990-03-12,Algeria,Senegal,2,1,1,1.0,0.0,1781,1708
1990-03-12,Nigeria,Zambia,2,0,2,1.0,0.0,1732,1696
1990-03-15,Senegal,Zambia,0,1,1,0.0,1.0,1700,1705
1990-03-16,Algeria,Nigeria,1,0,1,1.0,0.0,1788,1726
1990-03-16,Jamaica,Barbados,0,1,1,0.0,1.0,1475,1509
1990-03-18,Jamaica,Barbados,1,0,1,1.0,0.0,1484,1501
1990-03-20,Hungary,United States,2,0,2,1.0,0.0,1794,1626
1990-03-20,Mexico,Uruguay,2,1,1,1.0,0.0,1919,1822
1990-03-21,Basque Country,Romania,2,2,0,0.5,0.5,1611,1795
1990-03-24,Sint Maarten,Cayman Islands,1,1,0,0.5,0.5,1483,1483
1990-03-24,Saint Kitts and Nevis,Antigua and Barbuda,3,1,2,1.0,0.0,1488,1485
1990-03-24,Saint Martin,British Virgin Islands,3,0,3,1.0,0.0,1509,1504
1990-03-27,Northern Ireland,Norway,2,3,1,0.0,1.0,1696,1702
1990-03-28,Egypt,Romania,1,3,2,0.0,1.0,1750,1803
1990-03-28,England,Brazil,1,0,1,1.0,0.0,1910,1962
1990-03-28,German DR,United States,3,2,1,1.0,0.0,1772,1622
1990-03-28,Greece,Israel,2,1,1,1.0,0.0,1701,1652
1990-03-28,Hungary,France,1,3,2,0.0,1.0,1789,1894
1990-03-28,Republic of Ireland,Wales,1,0,1,1.0,0.0,1812,1717
1990-03-28,Luxembourg,Iceland,1,2,1,0.0,1.0,1339,1593
1990-03-28,Poland,Yugoslavia,0,0,0,0.5,0.5,1817,1857
1990-03-28,Russia,Netherlands,2,1,1,1.0,0.0,1907,1897
1990-03-28,Scotland,Argentina,1,0,1,1.0,0.0,1797,1801
1990-03-28,Spain,Austria,2,3,1,0.0,1.0,1864,1773
1990-03-31,Switzerland,Italy,0,1,1,0.0,1.0,1714,1918
1990-03-31,Guernsey,Alderney,4,0,4,1.0,0.0,1657,1297
1990-04-01,Zambia,Tanzania,2,0,2,1.0,0.0,1709,1501
1990-04-03,Bermuda,Iceland,0,4,4,0.0,1.0,1456,1599
1990-04-03,Switzerland,Romania,2,1,1,1.0,0.0,1725,1793
1990-04-04,Czechoslovakia,Egypt,0,1,1,0.0,1.0,1838,1761
1990-04-08,United States,Iceland,4,1,3,1.0,0.0,1630,1592
1990-04-11,Algeria,Sweden,1,1,0,0.5,0.5,1790,1853
1990-04-11,Austria,Hungary,3,0,3,1.0,0.0,1782,1781
1990-04-11,Denmark,Turkey,1,0,1,1.0,0.0,1812,1627
1990-04-11,German DR,Egypt,2,0,2,1.0,0.0,1780,1754
1990-04-14,Bermuda,Antigua and Barbuda,2,2,0,0.5,0.5,1457,1485
1990-04-15,Barbados,Saint Lucia,1,0,1,1.0,0.0,1509,1468
1990-04-16,Bermuda,Antigua and Barbuda,3,0,3,1.0,0.0,1466,1477
1990-04-17,Grenada,Curaçao,1,1,0,0.5,0.5,1539,1571
1990-04-17,Mexico,Colombia,2,0,2,1.0,0.0,1924,1739
1990-04-22,Martinique,French Guiana,4,0,4,1.0,0.0,1625,1460
1990-04-22,Saint Vincent and the Grenadines,Dominica,2,1,1,1.0,0.0,1578,1425
1990-04-22,United States,Colombia,0,1,1,0.0,1.0,1625,1745
1990-04-25,England,Czechoslovakia,4,2,2,1.0,0.0,1917,1832
1990-04-25,Germany,Uruguay,3,3,0,0.5,0.5,1935,1825
1990-04-25,Republic of Ireland,Russia,1,0,1,1.0,0.0,1823,1897
1990-04-25,Israel,Romania,1,4,3,0.0,1.0,1648,1798
1990-04-25,Scotland,German DR,0,1,1,0.0,1.0,1789,1789
1990-04-25,Sweden,Wales,4,2,2,1.0,0.0,1859,1712
1990-04-29,Barbados,Antigua and Barbuda,1,0,1,1.0,0.0,1517,1470
1990-04-29,Gabon,Martinique,0,2,2,0.0,1.0,1557,1632
1990-04-29,Jamaica,Saint Kitts and Nevis,3,0,3,1.0,0.0,1493,1480
1990-04-29,Suriname,Guyana,5,0,5,1.0,0.0,1623,1481
1990-05-01,Guadeloupe,Martinique,1,0,1,1.0,0.0,1555,1623
1990-05-03,Austria,Argentina,1,1,0,0.5,0.5,1783,1801
1990-05-04,Colombia,Poland,2,1,1,1.0,0.0,1755,1808
1990-05-05,Brazil,Bulgaria,2,1,1,1.0,0.0,1966,1724
1990-05-05,United States,Malta,1,0,1,1.0,0.0,1630,1474
1990-05-06,Cayman Islands,Jamaica,1,2,1,0.0,1.0,1476,1501
1990-05-06,Costa Rica,Poland,0,2,2,0.0,1.0,1678,1814
1990-05-06,Saint Martin,Guadeloupe,2,1,1,1.0,0.0,1519,1546
1990-05-07,Jersey,Guernsey,2,1,1,1.0,0.0,1712,1651
1990-05-08,Switzerland,Argentina,1,1,0,0.5,0.5,1727,1800
1990-05-08,Andalusia,Uruguay,1,1,0,0.5,0.5,1499,1820
1990-05-09,United States,Poland,3,1,2,1.0,0.0,1642,1803
1990-05-13,Brazil,German DR,3,3,0,0.5,0.5,1963,1793
1990-05-13,Canada,Mexico,2,1,1,1.0,0.0,1630,1911
1990-05-13,Dominica,French Guiana,1,1,0,0.5,0.5,1426,1460
1990-05-13,Saint Lucia,Bermuda,0,2,2,0.0,1.0,1460,1475
1990-05-15,England,Denmark,1,0,1,1.0,0.0,1923,1807
1990-05-15,Grenada,Suriname,3,1,2,1.0,0.0,1549,1614
1990-05-16,Republic of Ireland,Finland,1,1,0,0.5,0.5,1819,1610
1990-05-16,Israel,Russia,3,2,1,1.0,0.0,1661,1885
1990-05-16,Scotland,Egypt,1,3,2,0.0,1.0,1781,1763
1990-05-17,Barbados,Suriname,5,0,5,1.0,0.0,1528,1604
1990-05-18,Mauritania,Gambia,2,0,2,1.0,0.0,1386,1475
1990-05-18,Northern Ireland,Uruguay,1,0,1,1.0,0.0,1707,1810
1990-05-18,Zimbabwe,Eswatini,4,4,0,0.5,0.5,1643,1478
1990-05-19,Scotland,Poland,1,1,0,0.5,0.5,1782,1803
1990-05-19,Saint Kitts and Nevis,Guadeloupe,2,0,2,1.0,0.0,1490,1537
1990-05-20,Guyana,Curaçao,1,1,0,0.5,0.5,1484,1569
1990-05-20,Jamaica,Saint Martin,1,0,1,1.0,0.0,1510,1511
1990-05-20,Wales,Costa Rica,1,0,1,1.0,0.0,1720,1671
1990-05-21,Poland,United Arab Emirates,4,0,4,1.0,0.0,1809,1664
1990-05-21,Romania,Egypt,1,0,1,1.0,0.0,1806,1756
1990-05-22,England,Uruguay,1,2,1,0.0,1.0,1913,1821
1990-05-22,Israel,Argentina,1,2,1,0.0,1.0,1657,1805
1990-05-26,Belgium,Romania,2,2,0,0.5,0.5,1818,1807
1990-05-26,Bermuda,Barbados,1,1,0,0.5,0.5,1477,1527
1990-05-26,Egypt,Colombia,1,1,0,0.5,0.5,1756,1756
1990-05-26,Gambia,Burkina Faso,0,0,0,0.5,0.5,1477,1559
1990-05-26,Germany,Czechoslovakia,1,0,1,1.0,0.0,1941,1827
1990-05-26,Turkey,Republic of Ireland,0,0,0,0.5,0.5,1632,1815
1990-05-26,Yugoslavia,Spain,0,1,1,0.0,1.0,1850,1872
1990-05-27,Antigua and Barbuda,Saint Lucia,0,2,2,0.0,1.0,1462,1469
1990-05-27,Curaçao,Suriname,1,1,0,0.5,0.5,1570,1604
1990-05-27,Georgia,Lithuania,2,2,0,0.5,0.5,1507,1466
1990-05-27,Guyana,Grenada,0,0,0,0.5,0.5,1486,1548
1990-05-27,Sweden,Finland,6,0,6,1.0,0.0,1863,1607
1990-05-28,Hungary,United Arab Emirates,3,0,3,1.0,0.0,1787,1659
1990-05-28,Malta,Scotland,1,2,1,0.0,1.0,1472,1785
1990-05-29,Bermuda,Barbados,3,0,3,1.0,0.0,1487,1518
1990-05-30,Austria,Netherlands,3,2,1,1.0,0.0,1794,1887
1990-05-30,Burkina Faso,Ghana,1,0,1,1.0,0.0,1570,1657
1990-05-30,French Guiana,Saint Vincent and the Grenadines,2,2,0,0.5,0.5,1463,1576
1990-05-30,Germany,Denmark,1,0,1,1.0,0.0,1947,1802
1990-05-30,Guadeloupe,Jamaica,0,0,0,0.5,0.5,1537,1511
1990-05-30,Iceland,Albania,2,0,2,1.0,0.0,1598,1478
1990-05-30,Italy,Greece,0,0,0,0.5,0.5,1914,1706
1990-05-30,Liechtenstein,United States,1,4,3,0.0,1.0,1505,1648
1990-05-30,Martinique,Dominica,0,0,0,0.5,0.5,1619,1431
1990-05-31,Andalusia,Yugoslavia,0,0,0,0.5,0.5,1506,1844
1990-06-01,Jordan,Iraq,0,2,2,0.0,1.0,1481,1760
1990-06-02,Belgium,Mexico,3,0,3,1.0,0.0,1829,1901
1990-06-02,Hungary,Colombia,3,1,2,1.0,0.0,1795,1749
1990-06-02,Malta,Republic of Ireland,0,3,3,0.0,1.0,1471,1817
1990-06-02,Switzerland,United States,2,1,1,1.0,0.0,1734,1642
1990-06-02,Tunisia,England,1,1,0,0.5,0.5,1620,1908
1990-06-03,Gambia,Mauritania,2,1,1,1.0,0.0,1483,1381
1990-06-03,Yugoslavia,Netherlands,0,2,2,0.0,1.0,1837,1895
1990-06-06,Belgium,Poland,1,1,0,0.5,0.5,1829,1810
1990-06-06,Norway,Denmark,1,2,1,0.0,1.0,1697,1808
1990-06-07,Namibia,Mauritius,1,2,1,0.0,1.0,1487,1527
1990-06-08,Argentina,Cameroon,0,1,1,0.0,1.0,1796,1746
1990-06-09,Italy,Austria,1,0,1,1.0,0.0,1920,1789
1990-06-09,Russia,Romania,0,2,2,0.0,1.0,1876,1817
1990-06-09,United Arab Emirates,Colombia,0,2,2,0.0,1.0,1654,1755
1990-06-10,Botswana,Mauritius,0,1,1,0.0,1.0,1458,1534
1990-06-10,Brazil,Sweden,2,1,1,1.0,0.0,1969,1858
1990-06-10,Germany,Yugoslavia,4,1,3,1.0,0.0,1953,1832
1990-06-10,United States,Czechoslovakia,1,5,4,0.0,1.0,1638,1832
1990-06-11,Costa Rica,Scotland,1,0,1,1.0,0.0,1682,1775
1990-06-11,England,Republic of Ireland,1,1,0,0.5,0.5,1906,1820
1990-06-12,Belgium,South Korea,2,0,2,1.0,0.0,1837,1821
1990-06-12,Netherlands,Egypt,1,1,0,0.5,0.5,1892,1760
1990-06-13,Argentina,Russia,2,0,2,1.0,0.0,1806,1867
1990-06-13,Uruguay,Spain,0,0,0,0.5,0.5,1823,1871
1990-06-14,Cameroon,Romania,2,1,1,1.0,0.0,1756,1808
1990-06-14,Italy,United States,1,0,1,1.0,0.0,1923,1636
1990-06-14,Yugoslavia,Colombia,1,0,1,1.0,0.0,1839,1749
1990-06-15,Austria,Czechoslovakia,0,1,1,0.0,1.0,1782,1840
1990-06-15,Germany,United Arab Emirates,5,1,4,1.0,0.0,1956,1652
1990-06-16,Brazil,Costa Rica,1,0,1,1.0,0.0,1972,1680
1990-06-16,England,Netherlands,0,0,0,0.5,0.5,1906,1893
1990-06-16,Sweden,Scotland,1,2,1,0.0,1.0,1849,1785
1990-06-17,Belgium,Uruguay,3,1,2,1.0,0.0,1845,1816
1990-06-17,Republic of Ireland,Egypt,0,0,0,0.5,0.5,1819,1762
1990-06-17,South Korea,Spain,1,3,2,0.0,1.0,1815,1878
1990-06-18,Argentina,Romania,1,1,0,0.5,0.5,1807,1808
1990-06-18,Cameroon,Russia,0,4,4,0.0,1.0,1751,1873
1990-06-19,Austria,United States,2,1,1,1.0,0.0,1787,1632
1990-06-19,Germany,Colombia,1,1,0,0.5,0.5,1952,1754
1990-06-19,Italy,Czechoslovakia,2,0,2,1.0,0.0,1930,1834
1990-06-19,Yugoslavia,United Arab Emirates,4,1,3,1.0,0.0,1844,1648
1990-06-20,Brazil,Scotland,1,0,1,1.0,0.0,1977,1781
1990-06-20,Sweden,Costa Rica,1,2,1,0.0,1.0,1838,1692
1990-06-21,Belgium,Spain,1,2,1,0.0,1.0,1838,1886
1990-06-21,England,Egypt,1,0,1,1.0,0.0,1911,1758
1990-06-21,Republic of Ireland,Netherlands,1,1,0,0.5,0.5,1821,1892
1990-06-21,South Korea,Uruguay,0,1,1,0.0,1.0,1808,1824
1990-06-23,Cameroon,Colombia,2,1,1,1.0,0.0,1760,1746
1990-06-23,Czechoslovakia,Costa Rica,4,1,3,1.0,0.0,1839,1688
1990-06-24,Brazil,Argentina,0,1,1,0.0,1.0,1966,1819
1990-06-24,Germany,Netherlands,2,1,1,1.0,0.0,1959,1886
1990-06-25,Republic of Ireland,Romania,0,0,0,0.5,0.5,1821,1809
1990-06-25,Italy,Uruguay,2,0,2,1.0,0.0,1936,1819
1990-06-26,England,Belgium,1,0,1,1.0,0.0,1918,1832
1990-06-26,Spain,Yugoslavia,1,2,1,0.0,1.0,1878,1853
1990-06-30,Italy,Republic of Ireland,1,0,1,1.0,0.0,1942,1816
1990-06-30,Yugoslavia,Argentina,0,0,0,0.5,0.5,1853,1820
1990-07-01,Cameroon,England,2,3,1,0.0,1.0,1756,1923
1990-07-01,Germany,Czechoslovakia,1,0,1,1.0,0.0,1965,1834
1990-07-03,Italy,Argentina,1,1,0,0.5,0.5,1940,1823
1990-07-04,Germany,England,1,1,0,0.5,0.5,1965,1924
1990-07-06,Malawi,Tanzania,2,0,2,1.0,0.0,1640,1496
1990-07-07,Italy,England,2,1,1,1.0,0.0,1948,1917
1990-07-08,Germany,Argentina,1,0,1,1.0,0.0,1970,1819
1990-07-09,Barbados,Grenada,1,1,0,0.5,0.5,1519,1548
1990-07-09,Malawi,Tanzania,1,1,0,0.5,0.5,1637,1500
1990-07-10,Barbados,Grenada,4,0,4,1.0,0.0,1528,1540
1990-07-11,Malawi,Tanzania,0,0,0,0.5,0.5,1634,1504
1990-07-23,Barbados,Martinique,2,2,0,0.5,0.5,1531,1617
1990-07-27,China PR,North Korea,2,0,2,1.0,0.0,1723,1693
1990-07-27,Japan,South Korea,0,2,2,0.0,1.0,1660,1813
1990-07-27,Trinidad and Tobago,Jamaica,0,0,0,0.5,0.5,1646,1515
1990-07-29,China PR,Japan,1,0,1,1.0,0.0,1730,1654
1990-07-29,South Korea,North Korea,1,0,1,1.0,0.0,1819,1688
1990-07-29,Togo,Mali,0,0,0,0.5,0.5,1595,1603
1990-07-31,China PR,South Korea,0,1,1,0.0,1.0,1725,1825
1990-07-31,Japan,North Korea,0,1,1,0.0,1.0,1647,1696
1990-08-03,China PR,South Korea,1,1,0,0.5,0.5,1728,1823
1990-08-04,Malawi,DR Congo,1,0,1,1.0,0.0,1643,1664
1990-08-06,Malawi,DR Congo,1,0,1,1.0,0.0,1652,1656
1990-08-08,Faroe Islands,Iceland,2,3,1,0.0,1.0,1493,1604
1990-08-08,Malawi,DR Congo,0,0,0,0.5,0.5,1653,1656
1990-08-09,Tunisia,Morocco,0,0,0,0.5,0.5,1623,1729
1990-08-11,Réunion,Congo,2,1,1,1.0,0.0,1507,1556
1990-08-12,Gabon,Mali,0,0,0,0.5,0.5,1559,1602
1990-08-12,Eswatini,Mozambique,0,0,0,0.5,0.5,1480,1536
1990-08-12,Zambia,DR Congo,0,0,0,0.5,0.5,1708,1658
1990-08-13,Mozambique,Zimbabwe,2,3,1,0.0,1.0,1531,1649
1990-08-15,France,Poland,0,0,0,0.5,0.5,1893,1812
1990-08-16,New Zealand,China PR,2,1,1,1.0,0.0,1701,1720
1990-08-17,Egypt,Ethiopia,2,0,2,1.0,0.0,1763,1611
1990-08-17,Sudan,Mozambique,1,0,1,1.0,0.0,1587,1525
1990-08-18,Indonesia,Singapore,6,0,6,1.0,0.0,1554,1535
1990-08-18,Malawi,Congo,0,1,1,0.0,1.0,1643,1567
1990-08-19,Cameroon,Mali,0,0,0,0.5,0.5,1753,1606
1990-08-19,Guinea,Sierra Leone,1,2,1,0.0,1.0,1587,1563
1990-08-19,DR Congo,Tanzania,2,0,2,1.0,0.0,1663,1500
1990-08-19,Gabon,Uganda,1,0,1,1.0,0.0,1570,1662
1990-08-19,Ivory Coast,Mauritania,2,0,2,1.0,0.0,1732,1380
1990-08-19,Morocco,Niger,2,0,2,1.0,0.0,1733,1489
1990-08-19,Angola,Madagascar,0,1,1,0.0,1.0,1548,1607
1990-08-19,Tunisia,Chad,2,1,1,1.0,0.0,1629,1483
1990-08-19,Zambia,Eswatini,5,0,5,1.0,0.0,1712,1477
1990-08-19,Burkina Faso,Benin,2,0,2,1.0,0.0,1576,1444
1990-08-19,Nigeria,Togo,3,0,3,1.0,0.0,1732,1590
1990-08-21,Austria,Switzerland,1,3,2,0.0,1.0,1778,1744
1990-08-21,Madagascar,Comoros,1,0,1,1.0,0.0,1613,1473
1990-08-22,Norway,Sweden,1,2,1,0.0,1.0,1693,1843
1990-08-23,Réunion,Comoros,0,1,1,0.0,1.0,1499,1482
1990-08-24,New Zealand,China PR,1,0,1,1.0,0.0,1710,1712
1990-08-25,Botswana,Eswatini,3,2,1,1.0,0.0,1467,1469
1990-08-25,Indonesia,Australia,0,3,3,0.0,1.0,1550,1738
1990-08-25,Zambia,Zimbabwe,3,1,2,1.0,0.0,1719,1643
1990-08-25,Madagascar,Réunion,0,0,0,0.5,0.5,1611,1502
1990-08-25,Mauritius,Seychelles,2,0,2,1.0,0.0,1541,1440
1990-08-26,Botswana,Zimbabwe,0,7,7,0.0,1.0,1463,1648
1990-08-27,Mali,Burkina Faso,2,1,1,1.0,0.0,1614,1569
1990-08-27,Mauritius,Comoros,4,0,4,1.0,0.0,1548,1476
1990-08-27,Madagascar,Seychelles,6,0,6,1.0,0.0,1616,1436
1990-08-29,Finland,Czechoslovakia,1,1,0,0.5,0.5,1612,1830
1990-08-29,Portugal,Germany,1,1,0,0.5,0.5,1788,1967
1990-08-29,Russia,Romania,1,2,1,0.0,1.0,1864,1819
1990-08-29,Seychelles,Comoros,3,1,2,1.0,0.0,1445,1468
1990-08-30,Mozambique,Angola,0,2,2,0.0,1.0,1518,1556
1990-08-30,Madagascar,Mauritius,5,1,4,1.0,0.0,1623,1542
1990-09-01,Sierra Leone,Cameroon,1,1,0,0.5,0.5,1567,1750
1990-09-01,Uganda,DR Congo,2,1,1,1.0,0.0,1671,1655
1990-09-01,Tanzania,Gabon,0,0,0,0.5,0.5,1502,1569
1990-09-01,Ghana,Nigeria,1,0,1,1.0,0.0,1667,1723
1990-09-01,Eswatini,Angola,1,1,0,0.5,0.5,1471,1555
1990-09-01,Madagascar,Zambia,0,0,0,0.5,0.5,1626,1717
1990-09-02,Congo,Zimbabwe,2,0,2,1.0,0.0,1577,1639
1990-09-02,Burkina Faso,Togo,2,0,2,1.0,0.0,1578,1582
1990-09-02,Chad,Egypt,0,0,0,0.5,0.5,1489,1758
1990-09-02,Mali,Guinea,1,1,0,0.5,0.5,1614,1588
1990-09-02,Morocco,Mauritania,4,0,4,1.0,0.0,1735,1379
1990-09-02,Mozambique,Kenya,2,1,1,1.0,0.0,1529,1611
1990-09-05,Greece,Albania,1,0,1,1.0,0.0,1710,1475
1990-09-05,Hungary,Turkey,4,1,3,1.0,0.0,1800,1628
1990-09-05,Iceland,France,1,2,1,0.0,1.0,1602,1896
1990-09-05,Sweden,Denmark,0,1,1,0.0,1.0,1835,1817
1990-09-06,South Korea,Australia,1,0,1,1.0,0.0,1830,1732
1990-09-08,Malaysia,Yemen,0,1,1,0.0,1.0,1618,1407
1990-09-09,South Korea,Australia,1,0,1,1.0,0.0,1836,1727
1990-09-11,Denmark,Wales,1,0,1,1.0,0.0,1823,1715
1990-09-12,Belgium,German DR,0,2,2,0.0,1.0,1824,1802
1990-09-12,England,Hungary,1,0,1,1.0,0.0,1923,1795
1990-09-12,Faroe Islands,Austria,1,0,1,1.0,0.0,1507,1765
1990-09-12,Finland,Portugal,0,0,0,0.5,0.5,1616,1785
1990-09-12,Republic of Ireland,Morocco,1,0,1,1.0,0.0,1823,1729
1990-09-12,Northern Ireland,Yugoslavia,0,2,2,0.0,1.0,1703,1858
1990-09-12,Russia,Norway,2,0,2,1.0,0.0,1869,1689
1990-09-12,Scotland,Romania,2,1,1,1.0,0.0,1790,1811
1990-09-12,Spain,Brazil,3,0,3,1.0,0.0,1888,1957
1990-09-12,Switzerland,Bulgaria,2,0,2,1.0,0.0,1752,1717
1990-09-13,Singapore,Malaysia,3,0,3,1.0,0.0,1545,1609
1990-09-15,United States,Trinidad and Tobago,3,0,3,1.0,0.0,1641,1638
1990-09-23,South Korea,Singapore,7,0,7,1.0,0.0,1839,1543
1990-09-23,China PR,Pakistan,3,0,3,1.0,0.0,1716,1474
1990-09-23,Kuwait,Hong Kong,2,1,1,1.0,0.0,1731,1563
1990-09-23,Yemen,Thailand,0,0,0,0.5,0.5,1411,1574
1990-09-24,Iran,Malaysia,3,0,3,1.0,0.0,1752,1605
1990-09-24,Saudi Arabia,Bangladesh,4,0,4,1.0,0.0,1715,1458
1990-09-25,China PR,Singapore,5,1,4,1.0,0.0,1721,1539
1990-09-25,Pakistan,South Korea,0,7,7,0.0,1.0,1473,1841
1990-09-25,Hong Kong,Thailand,0,2,2,0.0,1.0,1556,1582
1990-09-25,Yemen,Kuwait,0,0,0,0.5,0.5,1417,1726
1990-09-26,Czechoslovakia,Iceland,1,0,1,1.0,0.0,1834,1599
1990-09-26,Italy,Netherlands,1,0,1,1.0,0.0,1955,1880
1990-09-26,Romania,Poland,2,1,1,1.0,0.0,1820,1804
1990-09-26,Sweden,Bulgaria,2,0,2,1.0,0.0,1841,1712
1990-09-26,Malaysia,North Korea,0,0,0,0.5,0.5,1608,1694
1990-09-26,Bangladesh,Japan,0,3,3,0.0,1.0,1454,1652
1990-09-27,China PR,South Korea,0,2,2,0.0,1.0,1716,1847
1990-09-27,Singapore,Pakistan,6,1,5,1.0,0.0,1546,1467
1990-09-27,Hong Kong,Yemen,2,0,2,1.0,0.0,1561,1413
1990-09-27,Thailand,Kuwait,2,1,1,1.0,0.0,1594,1715
1990-09-28,North Korea,Iran,1,2,1,0.0,1.0,1688,1759
1990-09-28,Japan,Saudi Arabia,0,2,2,0.0,1.0,1646,1722
1990-09-30,Aruba,Curaçao,1,3,2,0.0,1.0,1458,1576
1990-09-30,Benin,Nigeria,0,1,1,0.0,1.0,1442,1726
1990-09-30,Botswana,Cameroon,0,0,0,0.5,0.5,1469,1745
1990-09-30,Niger,Ivory Coast,0,1,1,0.0,1.0,1486,1736
1990-09-30,Togo,Ghana,0,1,1,0.0,1.0,1576,1674
1990-10-01,South Korea,Kuwait,1,0,1,1.0,0.0,1853,1710
1990-10-01,Iran,Japan,1,0,1,1.0,0.0,1765,1641
1990-10-01,China PR,Thailand,0,1,1,0.0,1.0,1706,1605
1990-10-01,Saudi Arabia,North Korea,0,0,0,0.5,0.5,1722,1689
1990-10-03,South Korea,Iran,0,1,1,0.0,1.0,1844,1775
1990-10-03,Thailand,North Korea,0,1,1,0.0,1.0,1599,1696
1990-10-05,South Korea,Thailand,1,0,1,1.0,0.0,1848,1596
1990-10-06,Iran,North Korea,0,0,0,0.5,0.5,1774,1698
1990-10-10,Denmark,Faroe Islands,4,1,3,1.0,0.0,1826,1505
1990-10-10,Greece,Egypt,6,1,5,1.0,0.0,1720,1749
1990-10-10,Norway,Hungary,0,0,0,0.5,0.5,1692,1793
1990-10-10,Poland,United States,2,3,1,0.0,1.0,1793,1653
1990-10-10,Spain,Iceland,2,1,1,1.0,0.0,1891,1597
1990-10-10,Sweden,Germany,1,3,2,0.0,1.0,1836,1973
1990-10-11,North Korea,South Korea,2,1,1,1.0,0.0,1710,1837
1990-10-13,France,Czechoslovakia,2,1,1,1.0,0.0,1903,1828
1990-10-14,Benin,Togo,1,1,0,0.5,0.5,1445,1574
1990-10-14,Niger,Mauritania,7,1,6,1.0,0.0,1492,1374
1990-10-14,Ghana,Burkina Faso,2,0,2,1.0,0.0,1680,1573
1990-10-17,Croatia,United States,2,1,1,1.0,0.0,1567,1643
1990-10-17,England,Poland,2,0,2,1.0,0.0,1929,1788
1990-10-17,Hungary,Italy,1,1,0,0.5,0.5,1797,1952
1990-10-17,Republic of Ireland,Turkey,5,0,5,1.0,0.0,1827,1625
1990-10-17,Northern Ireland,Denmark,1,1,0,0.5,0.5,1706,1824
1990-10-17,Portugal,Netherlands,1,0,1,1.0,0.0,1796,1870
1990-10-17,Romania,Bulgaria,0,3,3,0.0,1.0,1810,1723
1990-10-17,Scotland,Switzerland,2,1,1,1.0,0.0,1798,1745
1990-10-17,Wales,Belgium,3,1,2,1.0,0.0,1726,1814
1990-10-23,South Korea,North Korea,1,0,1,1.0,0.0,1843,1705
1990-10-31,Greece,Malta,4,0,4,1.0,0.0,1724,1468
1990-10-31,Hungary,Cyprus,4,2,2,1.0,0.0,1799,1387
1990-10-31,Luxembourg,Germany,2,3,1,0.0,1.0,1339,1974
1990-10-31,Norway,Cameroon,6,1,5,1.0,0.0,1702,1736
1990-10-31,Yugoslavia,Austria,4,1,3,1.0,0.0,1864,1760
1990-11-01,Fiji,Solomon Islands,0,0,0,0.5,0.5,1577,1494
1990-11-01,Vanuatu,New Caledonia,1,0,1,1.0,0.0,1438,1609
1990-11-03,Italy,Russia,0,0,0,0.5,0.5,1951,1871
1990-11-03,New Caledonia,Papua New Guinea,2,1,1,1.0,0.0,1615,1515
1990-11-03,Vanuatu,Solomon Islands,1,1,0,0.5,0.5,1440,1493
1990-11-05,New Caledonia,Fiji,0,0,0,0.5,0.5,1615,1578
1990-11-05,Vanuatu,Papua New Guinea,1,0,1,1.0,0.0,1450,1506
1990-11-06,Solomon Islands,Papua New Guinea,1,0,1,1.0,0.0,1502,1498
1990-11-06,Vanuatu,Fiji,1,1,0,0.5,0.5,1453,1576
1990-11-07,Tunisia,Norway,1,3,2,0.0,1.0,1623,1709
1990-11-08,Brazil,Chile,0,0,0,0.5,0.5,1953,1770
1990-11-08,Fiji,Papua New Guinea,1,0,1,1.0,0.0,1583,1492
1990-11-08,New Caledonia,Solomon Islands,3,1,2,1.0,0.0,1621,1497
1990-11-09,Angola,Mozambique,4,2,2,1.0,0.0,1563,1522
1990-11-10,Congo,Mozambique,1,0,1,1.0,0.0,1584,1516
1990-11-11,Angola,Congo,1,0,1,1.0,0.0,1572,1576
1990-11-11,Tunisia,Finland,1,2,1,0.0,1.0,1615,1625
1990-11-14,Austria,Northern Ireland,0,0,0,0.5,0.5,1759,1708
1990-11-14,Bulgaria,Scotland,1,1,0,0.5,0.5,1725,1797
1990-11-14,Cyprus,Norway,0,3,3,0.0,1.0,1385,1712
1990-11-14,Czechoslovakia,Spain,3,2,1,1.0,0.0,1838,1882
1990-11-14,Denmark,Yugoslavia,0,2,2,0.0,1.0,1817,1872
1990-11-14,Republic of Ireland,England,1,1,0,0.5,0.5,1830,1927
1990-11-14,Luxembourg,Wales,0,1,1,0.0,1.0,1338,1728
1990-11-14,San Marino,Switzerland,0,4,4,0.0,1.0,1497,1749
1990-11-14,Turkey,Poland,0,1,1,0.0,1.0,1621,1793
1990-11-17,Albania,France,0,1,1,0.0,1.0,1474,1905
1990-11-18,Ethiopia,Tunisia,0,2,2,0.0,1.0,1604,1623
1990-11-18,Trinidad and Tobago,United States,0,0,0,0.5,0.5,1639,1643
1990-11-21,Netherlands,Greece,2,0,2,1.0,0.0,1875,1720
1990-11-21,United States,Russia,0,0,0,0.5,0.5,1648,1867
1990-11-24,Trinidad and Tobago,Russia,0,2,2,0.0,1.0,1636,1871
1990-11-25,Malta,Finland,1,1,0,0.5,0.5,1472,1622
1990-11-29,Tanzania,Uganda,1,1,0,0.5,0.5,1506,1668
1990-11-30,Guatemala,Russia,0,3,3,0.0,1.0,1613,1874
1990-12-05,Romania,San Marino,6,0,6,1.0,0.0,1813,1495
1990-12-08,Congo,Chad,3,0,3,1.0,0.0,1583,1483
1990-12-08,Zanzibar,Tanzania,0,0,0,0.5,0.5,1365,1503
1990-12-09,Cameroon,Gabon,2,1,1,1.0,0.0,1741,1565
1990-12-09,Kenya,Uganda,2,2,0,0.5,0.5,1613,1667
1990-12-09,Malawi,Zimbabwe,0,0,0,0.5,0.5,1643,1640
1990-12-11,Central African Republic,Gabon,0,1,1,0.0,1.0,1431,1571
1990-12-11,Malawi,Tanzania,1,0,1,1.0,0.0,1648,1499
1990-12-12,Chad,Equatorial Guinea,1,0,1,1.0,0.0,1491,1469
1990-12-12,Kenya,Sudan,1,2,1,0.0,1.0,1605,1596
1990-12-12,Mexico,Brazil,0,0,0,0.5,0.5,1903,1952
1990-12-12,Zanzibar,Zimbabwe,0,1,1,0.0,1.0,1363,1643
1990-12-13,Central African Republic,Cameroon,0,3,3,0.0,1.0,1429,1744
1990-12-13,Congo,Equatorial Guinea,6,0,6,1.0,0.0,1589,1464
1990-12-14,Sudan,Uganda,2,2,0,0.5,0.5,1598,1666
1990-12-14,Tanzania,Zimbabwe,2,0,2,1.0,0.0,1511,1632
1990-12-14,Zanzibar,Malawi,2,1,1,1.0,0.0,1377,1635
1990-12-15,Chad,Cameroon,0,1,1,0.0,1.0,1488,1748
1990-12-15,Congo,Gabon,1,0,1,1.0,0.0,1597,1564
1990-12-17,Central African Republic,Equatorial Guinea,3,3,0,0.5,0.5,1430,1464
1990-12-17,Chad,Gabon,2,1,1,1.0,0.0,1498,1555
1990-12-17,Tanzania,Uganda,1,1,0,0.5,0.5,1515,1663
1990-12-17,Zanzibar,Sudan,0,1,1,0.0,1.0,1374,1602
1990-12-18,Algeria,Senegal,1,0,1,1.0,0.0,1796,1695
1990-12-18,Congo,Cameroon,2,1,1,1.0,0.0,1609,1737
1990-12-19,Germany,Switzerland,4,0,4,1.0,0.0,1978,1746
1990-12-19,Greece,Poland,1,2,1,0.0,1.0,1714,1800
1990-12-19,Malta,Netherlands,0,8,8,0.0,1.0,1471,1877
1990-12-19,Portugal,United States,1,0,1,1.0,0.0,1801,1644
1990-12-19,Spain,Albania,9,0,9,1.0,0.0,1884,1473
1990-12-19,Zanzibar,Tanzania,1,2,1,0.0,1.0,1370,1520
1990-12-20,Sudan,Uganda,0,2,2,0.0,1.0,1596,1670
1990-12-22,Croatia,Romania,2,0,2,1.0,0.0,1580,1801
1990-12-22,Cyprus,Italy,0,4,4,0.0,1.0,1385,1952
1991-01-06,Burkina Faso,Mali,2,0,2,1.0,0.0,1582,1606
1991-01-09,Burkina Faso,Niger,2,2,0,0.5,0.5,1580,1495
1991-01-11,Russia,Zambia,4,0,4,1.0,0.0,1879,1713
1991-01-13,Burkina Faso,Nigeria,1,1,0,0.5,0.5,1584,1723
1991-01-13,Ghana,Benin,4,0,4,1.0,0.0,1684,1442
1991-01-13,Morocco,Ivory Coast,3,1,2,1.0,0.0,1738,1728
1991-01-14,Hungary,Russia,1,1,0,0.5,0.5,1801,1878
1991-01-16,Spain,Portugal,1,1,0,0.5,0.5,1883,1803
1991-01-17,India,Hungary,1,2,1,0.0,1.0,1520,1804
1991-01-20,India,Zambia,1,0,1,1.0,0.0,1533,1701
1991-01-21,Cameroon,Algeria,0,0,0,0.5,0.5,1739,1795
1991-01-21,Senegal,Ivory Coast,0,0,0,0.5,0.5,1696,1728
1991-01-22,Senegal,Algeria,2,2,0,0.5,0.5,1699,1793
1991-01-23,Ivory Coast,Cameroon,1,1,0,0.5,0.5,1729,1739
1991-01-23,Greece,Portugal,3,2,1,1.0,0.0,1725,1793
1991-01-23,Hungary,Zambia,4,1,3,1.0,0.0,1810,1696
1991-01-24,India,Russia,1,3,2,0.0,1.0,1532,1880
1991-01-27,Benin,Burkina Faso,1,2,1,0.0,1.0,1438,1589
1991-01-27,Niger,Morocco,1,0,1,1.0,0.0,1508,1726
1991-01-27,Togo,Nigeria,0,0,0,0.5,0.5,1578,1720
1991-01-29,Mexico,Colombia,0,0,0,0.5,0.5,1900,1750
1991-01-30,Australia,Czechoslovakia,0,1,1,0.0,1.0,1722,1844
1991-02-01,United States,Switzerland,0,1,1,0.0,1.0,1639,1752
1991-02-03,Colombia,Switzerland,2,3,1,0.0,1.0,1743,1760
1991-02-05,Northern Ireland,Poland,3,1,2,1.0,0.0,1719,1790
1991-02-06,Malaysia,Indonesia,1,2,1,0.0,1.0,1599,1560
1991-02-06,Australia,Czechoslovakia,0,2,2,0.0,1.0,1717,1850
1991-02-06,England,Cameroon,2,0,2,1.0,0.0,1932,1735
1991-02-06,Guinea-Bissau,Gambia,2,1,1,1.0,0.0,1531,1476
1991-02-06,Scotland,Russia,0,1,1,0.0,1.0,1791,1887
1991-02-06,Wales,Republic of Ireland,0,3,3,0.0,1.0,1723,1836
1991-02-07,Guinea-Bissau,Mauritania,2,0,2,1.0,0.0,1536,1370
1991-02-09,Malta,Portugal,0,1,1,0.0,1.0,1469,1796
1991-02-13,Italy,Belgium,0,0,0,0.5,0.5,1949,1818
1991-02-15,Algeria,Cameroon,0,0,0,0.5,0.5,1792,1737
1991-02-15,Senegal,Ivory Coast,0,0,0,0.5,0.5,1700,1729
1991-02-17,Gambia,Mauritania,0,0,0,0.5,0.5,1474,1373
1991-02-17,Ivory Coast,Cameroon,3,2,1,1.0,0.0,1738,1729
1991-02-17,Senegal,Algeria,1,3,2,0.0,1.0,1695,1798
1991-02-19,Argentina,Hungary,2,0,2,1.0,0.0,1827,1803
1991-02-20,France,Spain,3,1,2,1.0,0.0,1913,1876
1991-02-20,Portugal,Malta,5,0,5,1.0,0.0,1799,1467
1991-02-21,Bermuda,United States,1,0,1,1.0,0.0,1499,1628
1991-02-27,Belgium,Luxembourg,3,0,3,1.0,0.0,1819,1338
1991-02-27,Brazil,Paraguay,1,1,0,0.5,0.5,1949,1774
1991-02-27,Cyprus,Greece,1,1,0,0.5,0.5,1392,1719
1991-02-27,Turkey,Yugoslavia,1,1,0,0.5,0.5,1626,1868
1991-03-02,Suriname,French Guiana,3,0,3,1.0,0.0,1609,1459
1991-03-05,Algeria,Tunisia,2,1,1,1.0,0.0,1803,1619
1991-03-09,Uganda,Sudan,0,1,1,0.0,1.0,1661,1606
1991-03-12,Liechtenstein,Switzerland,0,6,6,0.0,1.0,1503,1763
1991-03-12,United States,Mexico,2,2,0,0.5,0.5,1634,1895
1991-03-13,Argentina,Mexico,0,0,0,0.5,0.5,1829,1894
1991-03-13,Netherlands,Malta,1,0,1,1.0,0.0,1879,1466
1991-03-13,Poland,Finland,1,1,0,0.5,0.5,1787,1626
1991-03-14,Canada,Mexico,0,3,3,0.0,1.0,1628,1897
1991-03-16,United States,Canada,2,0,2,1.0,0.0,1642,1621
1991-03-23,Alderney,Jersey,1,4,3,0.0,1.0,1296,1714
1991-03-27,Argentina,Brazil,3,3,0,0.5,0.5,1832,1947
1991-03-27,Belgium,Wales,1,1,0,0.5,0.5,1817,1726
1991-03-27,Czechoslovakia,Poland,4,0,4,1.0,0.0,1857,1781
1991-03-27,England,Republic of Ireland,1,1,0,0.5,0.5,1930,1839
1991-03-27,Germany,Russia,2,1,1,1.0,0.0,1984,1882
1991-03-27,Morocco,Greece,0,0,0,0.5,0.5,1726,1720
1991-03-27,San Marino,Romania,1,3,2,0.0,1.0,1493,1804
1991-03-27,Scotland,Bulgaria,1,1,0,0.5,0.5,1790,1727
1991-03-27,Spain,Hungary,2,4,2,0.0,1.0,1867,1813
1991-03-27,Tunisia,Turkey,0,0,0,0.5,0.5,1620,1626
1991-03-27,Yugoslavia,Northern Ireland,4,1,3,1.0,0.0,1873,1715
1991-03-30,France,Albania,5,0,5,1.0,0.0,1915,1472
1991-04-03,Algeria,Morocco,2,2,0,0.5,0.5,1802,1728
1991-04-03,Cyprus,Hungary,0,2,2,0.0,1.0,1391,1815
1991-04-03,Switzerland,Romania,0,0,0,0.5,0.5,1764,1804
1991-04-07,Mali,Burkina Faso,5,1,4,1.0,0.0,1614,1582
1991-04-07,Sudan,Uganda,1,1,0,0.5,0.5,1608,1660
1991-04-07,Tunisia,Algeria,0,0,0,0.5,0.5,1624,1799
1991-04-09,Denmark,Bulgaria,1,1,0,0.5,0.5,1815,1730
1991-04-09,Mexico,Chile,1,0,1,1.0,0.0,1903,1765
1991-04-12,Mauritania,Morocco,0,2,2,0.0,1.0,1372,1730
1991-04-13,Nigeria,Ghana,0,0,0,0.5,0.5,1720,1685
1991-04-14,Angola,Zambia,1,2,1,0.0,1.0,1567,1702
1991-04-14,DR Congo,Gabon,2,1,1,1.0,0.0,1661,1550
1991-04-14,Guinea,Cameroon,0,0,0,0.5,0.5,1592,1726
1991-04-14,Mali,Sierra Leone,0,0,0,0.5,0.5,1613,1569
1991-04-14,Nicaragua,El Salvador,2,3,1,0.0,1.0,1349,1609
1991-04-14,Sudan,Kenya,1,0,1,1.0,0.0,1616,1598
1991-04-14,Eswatini,Madagascar,0,1,1,0.0,1.0,1467,1631
1991-04-14,Tunisia,Egypt,2,2,0,0.5,0.5,1627,1747
1991-04-14,Uganda,Tanzania,3,2,1,1.0,0.0,1665,1516
1991-04-14,Zimbabwe,Malawi,4,0,4,1.0,0.0,1641,1627
1991-04-17,Austria,Norway,0,0,0,0.5,0.5,1758,1714
1991-04-17,Congo,Benin,1,2,1,0.0,1.0,1598,1450
1991-04-17,Costa Rica,Mexico,0,0,0,0.5,0.5,1693,1899
1991-04-17,Greece,Sweden,2,2,0,0.5,0.5,1723,1834
1991-04-17,Hungary,Russia,0,1,1,0.0,1.0,1809,1889
1991-04-17,Netherlands,Finland,2,0,2,1.0,0.0,1883,1623
1991-04-17,Poland,Turkey,3,0,3,1.0,0.0,1786,1622
1991-04-17,Spain,Romania,0,2,2,0.0,1.0,1858,1814
1991-04-21,Togo,Burkina Faso,1,0,1,1.0,0.0,1587,1574
1991-04-27,Nigeria,Benin,3,0,3,1.0,0.0,1723,1448
1991-04-27,Uganda,Gabon,0,0,0,0.5,0.5,1663,1553
1991-04-27,Tanzania,DR Congo,1,0,1,1.0,0.0,1528,1650
1991-04-28,Chad,Tunisia,0,0,0,0.5,0.5,1501,1625
1991-04-28,Congo,Malawi,2,1,1,1.0,0.0,1607,1619
1991-04-28,Mali,Cameroon,0,2,2,0.0,1.0,1608,1732
1991-04-28,Mozambique,Sudan,1,0,1,1.0,0.0,1527,1606
1991-04-28,Sierra Leone,Guinea,0,1,1,0.0,1.0,1562,1600
1991-04-28,Eswatini,Zambia,2,1,1,1.0,0.0,1480,1690
1991-04-29,Ghana,Togo,2,0,2,1.0,0.0,1691,1582
1991-04-30,Ivory Coast,Niger,1,0,1,1.0,0.0,1742,1505
1991-05-01,Albania,Czechoslovakia,0,2,2,0.0,1.0,1471,1859
1991-05-01,Bulgaria,Switzerland,2,3,1,0.0,1.0,1723,1772
1991-05-01,Germany,Belgium,1,0,1,1.0,0.0,1989,1813
1991-05-01,Republic of Ireland,Poland,0,0,0,0.5,0.5,1838,1788
1991-05-01,Italy,Hungary,3,1,2,1.0,0.0,1954,1805
1991-05-01,Northern Ireland,Faroe Islands,1,1,0,0.5,0.5,1711,1510
1991-05-01,Norway,Cyprus,3,0,3,1.0,0.0,1717,1389
1991-05-01,San Marino,Scotland,0,2,2,0.0,1.0,1491,1793
1991-05-01,Sweden,Austria,6,0,6,1.0,0.0,1841,1752
1991-05-01,Turkey,England,0,1,1,0.0,1.0,1620,1933
1991-05-01,Wales,Iceland,1,0,1,1.0,0.0,1732,1592
1991-05-01,Yugoslavia,Denmark,1,2,1,0.0,1.0,1864,1825
1991-05-04,Madagascar,Angola,0,0,0,0.5,0.5,1630,1569
1991-05-05,Jamaica,Haiti,2,1,1,1.0,0.0,1525,1563
1991-05-05,Senegal,Ivory Coast,0,0,0,0.5,0.5,1697,1741
1991-05-05,United States,Uruguay,1,0,1,1.0,0.0,1654,1808
1991-05-06,Jamaica,Haiti,2,0,2,1.0,0.0,1534,1555
1991-05-06,Guernsey,Jersey,3,0,3,1.0,0.0,1661,1705
1991-05-07,Malta,Iceland,1,4,3,0.0,1.0,1461,1598
1991-05-07,Mexico,Uruguay,0,2,2,0.0,1.0,1889,1819
1991-05-08,Aruba,Suriname,0,1,1,0.0,1.0,1454,1614
1991-05-08,Martinique,DR Congo,0,0,0,0.5,0.5,1618,1650
1991-05-10,Cayman Islands,British Virgin Islands,2,1,1,1.0,0.0,1485,1496
1991-05-10,Guyana,Aruba,4,1,3,1.0,0.0,1494,1447
1991-05-10,Puerto Rico,Haiti,2,3,1,0.0,1.0,1369,1560
1991-05-10,Saint Lucia,Montserrat,3,0,3,1.0,0.0,1478,1492
1991-05-12,Dominican Republic,Haiti,1,1,0,0.5,0.5,1471,1558
1991-05-12,Guyana,Suriname,1,1,0,0.5,0.5,1497,1612
1991-05-12,New Zealand,Australia,0,1,1,0.0,1.0,1703,1725
1991-05-12,Panama,Honduras,2,0,2,1.0,0.0,1496,1667
1991-05-12,Saint Kitts and Nevis,Cayman Islands,1,1,0,0.5,0.5,1490,1486
1991-05-14,Anguilla,Montserrat,1,1,0,0.5,0.5,1492,1492
1991-05-14,Hong Kong,Malaysia,2,0,2,1.0,0.0,1570,1591
1991-05-14,Puerto Rico,Dominican Republic,1,3,2,0.0,1.0,1364,1477
1991-05-14,Saint Kitts and Nevis,British Virgin Islands,0,0,0,0.5,0.5,1491,1496
1991-05-15,Australia,New Zealand,2,1,1,1.0,0.0,1733,1696
1991-05-15,Martinique,French Guiana,1,2,1,0.0,1.0,1607,1471
1991-05-16,Finland,Malta,2,0,2,1.0,0.0,1628,1457
1991-05-16,Saint Lucia,Anguilla,6,0,6,1.0,0.0,1487,1484
1991-05-16,Yugoslavia,Faroe Islands,7,0,7,1.0,0.0,1866,1509
1991-05-17,Guadeloupe,French Guiana,1,0,1,1.0,0.0,1544,1465
1991-05-18,Honduras,Panama,3,0,3,1.0,0.0,1672,1492
1991-05-19,Martinique,Guadeloupe,3,1,2,1.0,0.0,1614,1538
1991-05-19,United States,Argentina,0,1,1,0.0,1.0,1650,1837
1991-05-21,England,Russia,3,1,2,1.0,0.0,1940,1883
1991-05-21,Guyana,Haiti,1,1,0,0.5,0.5,1499,1557
1991-05-22,Austria,Faroe Islands,3,0,3,1.0,0.0,1756,1506
1991-05-22,Republic of Ireland,Chile,1,1,0,0.5,0.5,1837,1767
1991-05-22,San Marino,Bulgaria,0,3,3,0.0,1.0,1488,1727
1991-05-23,Argentina,Russia,1,1,0,0.5,0.5,1839,1882
1991-05-23,Dominican Republic,Trinidad and Tobago,0,7,7,0.0,1.0,1473,1641
1991-05-23,Norway,Romania,1,0,1,1.0,0.0,1728,1804
1991-05-23,Saint Lucia,Martinique,0,0,0,0.5,0.5,1490,1612
1991-05-24,Jamaica,Guyana,6,0,6,1.0,0.0,1542,1492
1991-05-25,Dominican Republic,Saint Lucia,0,0,0,0.5,0.5,1474,1490
1991-05-25,England,Argentina,2,2,0,0.5,0.5,1938,1842
1991-05-25,Martinique,Trinidad and Tobago,0,1,1,0.0,1.0,1605,1649
1991-05-26,Albania,Iceland,1,0,1,1.0,0.0,1482,1588
1991-05-26,Costa Rica,Honduras,2,0,2,1.0,0.0,1701,1665
1991-05-26,Guatemala,El Salvador,0,0,0,0.5,0.5,1613,1610
1991-05-26,Jamaica,Cayman Islands,3,2,1,1.0,0.0,1549,1480
1991-05-27,Dominican Republic,Martinique,1,4,3,0.0,1.0,1469,1611
1991-05-27,Saint Lucia,Trinidad and Tobago,2,1,1,1.0,0.0,1502,1638
1991-05-28,Brazil,Bulgaria,3,0,3,1.0,0.0,1951,1724
1991-05-28,Cayman Islands,Guyana,1,2,1,0.0,1.0,1473,1500
1991-05-29,Costa Rica,El Salvador,7,1,6,1.0,0.0,1707,1605
1991-05-29,Guatemala,Honduras,0,0,0,0.5,0.5,1615,1664
1991-05-29,Poland,Wales,0,0,0,0.5,0.5,1787,1734
1991-05-29,Russia,Cyprus,4,0,4,1.0,0.0,1883,1389
1991-05-30,Chile,Uruguay,2,1,1,1.0,0.0,1777,1810
1991-05-30,Guyana,Trinidad and Tobago,1,3,2,0.0,1.0,1496,1643
1991-05-30,Jamaica,Saint Lucia,2,0,2,1.0,0.0,1556,1496
1991-06-01,Australia,England,0,1,1,0.0,1.0,1730,1942
1991-06-01,United States,Republic of Ireland,1,1,0,0.5,0.5,1654,1834
1991-06-02,Costa Rica,Guatemala,1,0,1,1.0,0.0,1713,1610
1991-06-02,Guyana,Saint Lucia,1,4,3,0.0,1.0,1488,1504
1991-06-02,Honduras,El Salvador,2,1,1,1.0,0.0,1671,1599
1991-06-02,Jamaica,Trinidad and Tobago,2,0,2,1.0,0.0,1566,1634
1991-06-02,Japan,Thailand,1,0,1,1.0,0.0,1648,1590
1991-06-03,New Zealand,England,0,1,1,0.0,1.0,1693,1946
1991-06-05,Denmark,Austria,2,1,1,1.0,0.0,1832,1750
1991-06-05,Finland,Netherlands,1,1,0,0.5,0.5,1634,1878
1991-06-05,Iceland,Czechoslovakia,0,1,1,0.0,1.0,1586,1862
1991-06-05,Norway,Italy,2,1,1,1.0,0.0,1741,1942
1991-06-05,Sweden,Colombia,2,2,0,0.5,0.5,1839,1746
1991-06-05,Switzerland,San Marino,7,0,7,1.0,0.0,1775,1486
1991-06-05,Wales,Germany,1,0,1,1.0,0.0,1748,1976
1991-06-06,Peru,Ecuador,0,1,1,0.0,1.0,1609,1610
1991-06-07,Indonesia,Malta,0,3,3,0.0,1.0,1550,1468
1991-06-07,South Korea,Egypt,0,0,0,0.5,0.5,1841,1750
1991-06-08,New Zealand,England,0,2,2,0.0,1.0,1690,1950
1991-06-09,Egypt,Malta,5,2,3,1.0,0.0,1753,1466
1991-06-09,Ivory Coast,Senegal,2,0,2,1.0,0.0,1748,1691
1991-06-09,South Korea,Indonesia,3,0,3,1.0,0.0,1844,1548
1991-06-11,Egypt,Indonesia,6,0,6,1.0,0.0,1757,1545
1991-06-11,South Korea,Malta,1,1,0,0.5,0.5,1838,1473
1991-06-12,Denmark,Italy,0,2,2,0.0,1.0,1827,1948
1991-06-12,Malaysia,England,2,4,2,0.0,1.0,1590,1952
1991-06-12,Peru,Uruguay,1,0,1,1.0,0.0,1622,1798
1991-06-13,Sweden,Russia,2,3,1,0.0,1.0,1833,1890
1991-06-14,Bolivia,Paraguay,0,1,1,0.0,1.0,1581,1779
1991-06-14,South Korea,Australia,0,0,0,0.5,0.5,1836,1733
1991-06-15,Sweden,Denmark,4,0,4,1.0,0.0,1841,1820
1991-06-16,Italy,Russia,1,1,0,0.5,0.5,1947,1892
1991-06-16,South Korea,Egypt,2,0,2,1.0,0.0,1843,1751
1991-06-16,Paraguay,Bolivia,0,0,0,0.5,0.5,1775,1586
1991-06-19,Ecuador,Chile,2,1,1,1.0,0.0,1622,1766
1991-06-19,Slovenia,Croatia,0,1,1,0.0,1.0,1494,1587
1991-06-20,Mozambique,Botswana,2,0,2,1.0,0.0,1534,1463
1991-06-20,Uruguay,Peru,0,0,0,0.5,0.5,1795,1626
1991-06-22,Mozambique,Eswatini,2,1,1,1.0,0.0,1541,1474
1991-06-22,Philippines,Brunei,2,1,1,1.0,0.0,1322,1384
1991-06-24,Faroe Islands,Shetland,3,0,3,1.0,0.0,1514,1462
1991-06-24,Jersey,Greenland,4,3,1,1.0,0.0,1708,1442
1991-06-24,Ynys Môn,Guernsey,1,0,1,1.0,0.0,1528,1650
1991-06-24,Åland Islands,Isle of Wight,1,0,1,1.0,0.0,1508,1492
1991-06-25,Costa Rica,Colombia,0,1,1,0.0,1.0,1706,1754
1991-06-25,Ecuador,Peru,2,2,0,0.5,0.5,1623,1626
1991-06-25,Mozambique,Botswana,1,1,0,0.5,0.5,1540,1465
1991-06-25,Faroe Islands,Greenland,3,2,1,1.0,0.0,1521,1436
1991-06-25,Jersey,Shetland,2,0,2,1.0,0.0,1712,1459
1991-06-25,Åland Islands,Guernsey,2,0,2,1.0,0.0,1520,1639
1991-06-25,Ynys Môn,Isle of Wight,5,1,4,1.0,0.0,1536,1485
1991-06-26,Uruguay,Chile,2,1,1,1.0,0.0,1803,1759
1991-06-26,Faroe Islands,Jersey,5,3,2,1.0,0.0,1534,1700
1991-06-26,Shetland,Greenland,5,2,3,1.0,0.0,1467,1429
1991-06-26,Åland Islands,Ynys Môn,0,1,1,0.0,1.0,1513,1544
1991-06-26,Isle of Wight,Guernsey,1,1,0,0.5,0.5,1489,1636
1991-06-27,Brazil,Argentina,1,1,0,0.5,0.5,1949,1845
1991-06-28,Canada,Honduras,2,4,2,0.0,1.0,1615,1678
1991-06-28,Gambia,Ghana,2,3,1,0.0,1.0,1471,1695
1991-06-28,Mexico,Jamaica,4,1,3,1.0,0.0,1892,1564
1991-06-28,Isle of Wight,Greenland,3,1,2,1.0,0.0,1496,1423
1991-06-28,Shetland,Guernsey,2,1,1,1.0,0.0,1479,1625
1991-06-28,Åland Islands,Jersey,0,2,2,0.0,1.0,1509,1705
1991-06-29,Costa Rica,Guatemala,2,0,2,1.0,0.0,1712,1605
1991-06-29,United States,Trinidad and Tobago,2,1,1,1.0,0.0,1662,1627
1991-06-29,Faroe Islands,Ynys Môn,2,0,2,1.0,0.0,1543,1536
1991-06-30,Canada,Mexico,1,3,2,0.0,1.0,1613,1895
1991-06-30,Chile,Ecuador,3,1,2,1.0,0.0,1765,1618
1991-06-30,Jamaica,Honduras,0,5,5,0.0,1.0,1559,1684
1991-07-01,Trinidad and Tobago,Costa Rica,2,1,1,1.0,0.0,1637,1703
1991-07-01,United States,Guatemala,3,0,3,1.0,0.0,1669,1599
1991-07-02,Moldova,Georgia,2,4,2,0.0,1.0,1499,1515
1991-07-02,Jamaica,Canada,2,3,1,0.0,1.0,1553,1620
1991-07-02,Mexico,Honduras,1,1,0,0.5,0.5,1891,1689
1991-07-03,Trinidad and Tobago,Guatemala,0,1,1,0.0,1.0,1629,1608
1991-07-03,United States,Costa Rica,3,2,1,1.0,0.0,1678,1695
1991-07-05,Honduras,Costa Rica,2,0,2,1.0,0.0,1698,1687
1991-07-05,United States,Mexico,2,0,2,1.0,0.0,1691,1879
1991-07-06,Chile,Venezuela,2,0,2,1.0,0.0,1768,1460
1991-07-06,Malawi,Kenya,0,2,2,0.0,1.0,1611,1607
1991-07-06,Paraguay,Peru,1,0,1,1.0,0.0,1780,1622
1991-07-07,Bolivia,Uruguay,1,1,0,0.5,0.5,1591,1799
1991-07-07,Colombia,Ecuador,1,0,1,1.0,0.0,1760,1613
1991-07-07,Gabon,Ghana,0,1,1,0.0,1.0,1549,1700
1991-07-07,Mexico,Costa Rica,2,0,2,1.0,0.0,1883,1684
1991-07-07,United States,Honduras,0,0,0,0.5,0.5,1692,1698
1991-07-08,Argentina,Venezuela,3,0,3,1.0,0.0,1847,1459
1991-07-08,Chile,Peru,4,2,2,1.0,0.0,1773,1618
1991-07-08,Malawi,Kenya,1,1,0,0.5,0.5,1611,1608
1991-07-09,Bolivia,Brazil,1,2,1,0.0,1.0,1590,1951
1991-07-09,Congo,DR Congo,0,0,0,0.5,0.5,1608,1650
1991-07-09,Ecuador,Uruguay,1,1,0,0.5,0.5,1617,1796
1991-07-10,Chile,Argentina,0,1,1,0.0,1.0,1767,1854
1991-07-10,Malawi,Kenya,1,1,0,0.5,0.5,1611,1609
1991-07-10,Paraguay,Venezuela,5,0,5,1.0,0.0,1783,1457
1991-07-11,Bolivia,Colombia,0,0,0,0.5,0.5,1594,1757
1991-07-11,Brazil,Uruguay,1,1,0,0.5,0.5,1948,1800
1991-07-12,Argentina,Paraguay,4,1,3,1.0,0.0,1861,1777
1991-07-12,Egypt,Chad,5,1,4,1.0,0.0,1755,1498
1991-07-12,Peru,Venezuela,5,1,4,1.0,0.0,1623,1453
1991-07-13,Bolivia,Ecuador,0,4,4,0.0,1.0,1587,1625
1991-07-13,Brazil,Colombia,0,2,2,0.0,1.0,1936,1770
1991-07-13,Burkina Faso,Ghana,2,1,1,1.0,0.0,1585,1690
1991-07-14,Argentina,Peru,3,2,1,1.0,0.0,1865,1620
1991-07-14,Cameroon,Sierra Leone,1,0,1,1.0,0.0,1737,1558
1991-07-14,Chile,Paraguay,4,0,4,1.0,0.0,1776,1769
1991-07-14,DR Congo,Uganda,1,0,1,1.0,0.0,1659,1655
1991-07-14,Gabon,Tanzania,1,0,1,1.0,0.0,1557,1521
1991-07-14,Guinea,Mali,2,1,1,1.0,0.0,1609,1600
1991-07-14,Kenya,Mozambique,1,0,1,1.0,0.0,1616,1534
1991-07-14,Togo,Benin,2,0,2,1.0,0.0,1588,1443
1991-07-14,Zambia,Madagascar,2,1,1,1.0,0.0,1697,1624
1991-07-14,Zimbabwe,Congo,2,2,0,0.5,0.5,1641,1609
1991-07-15,Angola,Eswatini,1,1,0,0.5,0.5,1567,1477
1991-07-15,Brazil,Ecuador,3,1,2,1.0,0.0,1939,1623
1991-07-15,Colombia,Uruguay,0,1,1,0.0,1.0,1763,1808
1991-07-15,Faroe Islands,Turkey,1,1,0,0.5,0.5,1545,1619
1991-07-17,Argentina,Brazil,3,2,1,1.0,0.0,1875,1930
1991-07-17,Chile,Colombia,1,1,0,0.5,0.5,1776,1764
1991-07-17,Iceland,Turkey,5,1,4,1.0,0.0,1595,1611
1991-07-19,Brazil,Colombia,2,0,2,1.0,0.0,1935,1760
1991-07-19,Chile,Argentina,0,0,0,0.5,0.5,1779,1873
1991-07-21,Argentina,Colombia,2,1,1,1.0,0.0,1879,1755
1991-07-21,Chile,Brazil,0,2,2,0.0,1.0,1775,1940
1991-07-24,Ivory Coast,Guinea,0,0,0,0.5,0.5,1745,1613
1991-07-26,Egypt,Tunisia,2,2,0,0.5,0.5,1753,1628
1991-07-26,Mauritania,Niger,0,1,1,0.0,1.0,1367,1511
1991-07-27,Japan,South Korea,0,1,1,0.0,1.0,1645,1847
1991-07-27,Malawi,Zimbabwe,2,2,0,0.5,0.5,1612,1641
1991-07-27,Nigeria,Burkina Faso,7,1,6,1.0,0.0,1728,1581
1991-07-28,Benin,Ghana,0,0,0,0.5,0.5,1448,1686
1991-07-28,Zambia,Angola,1,0,1,1.0,0.0,1703,1562
1991-07-28,Cameroon,Guinea,1,0,1,1.0,0.0,1743,1608
1991-07-28,Gabon,DR Congo,0,0,0,0.5,0.5,1560,1657
1991-07-28,Kenya,Sudan,2,1,1,1.0,0.0,1624,1599
1991-07-28,Ivory Coast,Morocco,2,0,2,1.0,0.0,1753,1723
1991-07-28,Sierra Leone,Mali,2,0,2,1.0,0.0,1567,1592
1991-07-29,Tanzania,Uganda,1,1,0,0.5,0.5,1524,1653
1991-08-08,Czechoslovakia,Yugoslavia,0,0,0,0.5,0.5,1863,1866
1991-08-08,Norway,Sweden,1,2,1,0.0,1.0,1736,1847
1991-08-11,Benin,Ivory Coast,0,3,3,0.0,1.0,1446,1756
1991-08-14,Poland,France,1,5,4,0.0,1.0,1782,1921
1991-08-19,Malawi,Mozambique,1,0,1,1.0,0.0,1619,1528
1991-08-20,Malawi,Mozambique,2,0,2,1.0,0.0,1625,1523
1991-08-21,Bulgaria,Turkey,0,0,0,0.5,0.5,1722,1614
1991-08-21,Czechoslovakia,Switzerland,1,1,0,0.5,0.5,1862,1777
1991-08-21,Poland,Sweden,2,0,2,1.0,0.0,1792,1838
1991-08-28,Norway,Russia,0,1,1,0.0,1.0,1732,1897
1991-08-28,Romania,United States,0,2,2,0.0,1.0,1794,1703
1991-09-01,Ivory Coast,Benin,1,0,1,1.0,0.0,1759,1444
1991-09-04,Czechoslovakia,France,1,2,1,0.0,1.0,1856,1928
1991-09-04,Greece,Albania,0,2,2,0.0,1.0,1711,1495
1991-09-04,Iceland,Denmark,0,0,0,0.5,0.5,1600,1816
1991-09-04,Portugal,Austria,1,1,0,0.5,0.5,1798,1752
1991-09-04,Spain,Uruguay,2,1,1,1.0,0.0,1865,1802
1991-09-04,Sweden,Yugoslavia,4,3,1,1.0,0.0,1847,1858
1991-09-04,Turkey,United States,1,1,0,0.5,0.5,1617,1701
1991-09-08,Mali,Guinea,0,0,0,0.5,0.5,1593,1608
1991-09-09,Guam,Tahiti,0,15,15,0.0,1.0,1485,1713
1991-09-09,Papua New Guinea,Solomon Islands,0,0,0,0.5,0.5,1493,1497
1991-09-10,Fiji,New Caledonia,3,1,2,1.0,0.0,1592,1613
1991-09-10,Vanuatu,Wallis Islands and Futuna,4,0,4,1.0,0.0,1462,1455
1991-09-11,England,Germany,0,1,1,0.0,1.0,1945,1984
1991-09-11,Faroe Islands,Northern Ireland,0,5,5,0.0,1.0,1541,1716
1991-09-11,Hungary,Republic of Ireland,1,2,1,0.0,1.0,1798,1842
1991-09-11,Luxembourg,Belgium,0,2,2,0.0,1.0,1338,1814
1991-09-11,Netherlands,Poland,1,1,0,0.5,0.5,1877,1794
1991-09-11,New Caledonia,Tahiti,2,2,0,0.5,0.5,1616,1711
1991-09-11,Portugal,Finland,1,0,1,1.0,0.0,1803,1630
1991-09-11,Solomon Islands,Wallis Islands and Futuna,5,0,5,1.0,0.0,1505,1448
1991-09-11,Switzerland,Scotland,2,2,0,0.5,0.5,1778,1793
1991-09-11,Wales,Brazil,1,0,1,1.0,0.0,1761,1928
1991-09-12,Bermuda,Jamaica,1,1,0,0.5,0.5,1501,1552
1991-09-12,Fiji,Guam,14,1,13,1.0,0.0,1598,1480
1991-09-12,Papua New Guinea,Vanuatu,0,1,1,0.0,1.0,1485,1471
1991-09-14,Fiji,Tahiti,3,0,3,1.0,0.0,1609,1701
1991-09-14,Solomon Islands,Vanuatu,3,0,3,1.0,0.0,1513,1464
1991-09-14,United States,Jamaica,1,0,1,1.0,0.0,1706,1548
1991-09-15,Guam,New Caledonia,0,18,18,0.0,1.0,1475,1622
1991-09-15,Papua New Guinea,Wallis Islands and Futuna,5,0,5,1.0,0.0,1493,1441
1991-09-17,Fiji,Vanuatu,3,1,2,1.0,0.0,1614,1460
1991-09-17,New Caledonia,Solomon Islands,1,4,3,0.0,1.0,1612,1524
1991-09-17,Wallis Islands and Futuna,Tahiti,0,5,5,0.0,1.0,1439,1704
1991-09-18,Wallis Islands and Futuna,Guam,5,0,5,1.0,0.0,1448,1467
1991-09-20,Fiji,Solomon Islands,1,1,0,0.5,0.5,1612,1527
1991-09-20,New Caledonia,Vanuatu,3,1,2,1.0,0.0,1617,1456
1991-09-21,Botswana,Eswatini,2,1,1,1.0,0.0,1474,1469
1991-09-21,Egypt,Nigeria,1,2,1,0.0,1.0,1745,1737
1991-09-21,Uganda,Zimbabwe,1,2,1,0.0,1.0,1645,1650
1991-09-22,Cameroon,Mali,1,0,1,1.0,0.0,1748,1589
1991-09-22,Mauritius,Tunisia,0,3,3,0.0,1.0,1536,1635
1991-09-23,Egypt,Zimbabwe,2,3,1,0.0,1.0,1735,1661
1991-09-23,Nigeria,Uganda,8,1,7,1.0,0.0,1743,1640
1991-09-24,Cameroon,Tunisia,0,1,1,0.0,1.0,1738,1646
1991-09-24,Mali,Mauritius,5,0,5,1.0,0.0,1596,1530
1991-09-25,Bulgaria,Italy,2,1,1,1.0,0.0,1735,1935
1991-09-25,Egypt,Uganda,1,0,1,1.0,0.0,1741,1635
1991-09-25,Faroe Islands,Denmark,0,4,4,0.0,1.0,1539,1819
1991-09-25,Iceland,Spain,2,0,2,1.0,0.0,1614,1852
1991-09-25,Nigeria,Zimbabwe,1,0,1,1.0,0.0,1750,1655
1991-09-25,Norway,Czechoslovakia,2,3,1,0.0,1.0,1727,1862
1991-09-25,Russia,Hungary,2,2,0,0.5,0.5,1895,1801
1991-09-26,Cameroon,Mauritius,1,0,1,1.0,0.0,1742,1527
1991-09-26,Mali,Tunisia,0,0,0,0.5,0.5,1598,1645
1991-09-28,Cameroon,Nigeria,1,0,1,1.0,0.0,1751,1742
1991-09-28,Egypt,Mali,0,0,0,0.5,0.5,1738,1602
1991-09-28,Mauritius,Uganda,3,0,3,1.0,0.0,1538,1625
1991-09-28,Tunisia,Zimbabwe,3,1,2,1.0,0.0,1654,1647
1991-09-30,Botswana,Ghana,0,0,0,0.5,0.5,1479,1682
1991-09-30,Cameroon,Tunisia,1,0,1,1.0,0.0,1757,1649
1991-09-30,Nigeria,Zimbabwe,3,0,3,1.0,0.0,1748,1642
1991-10-05,Singapore,Indonesia,2,0,2,1.0,0.0,1554,1538
1991-10-09,Austria,Denmark,0,3,3,0.0,1.0,1746,1826
1991-10-09,Finland,Greece,1,1,0,0.5,0.5,1632,1710
1991-10-09,Hungary,Belgium,0,2,2,0.0,1.0,1794,1822
1991-10-09,Switzerland,Sweden,3,1,2,1.0,0.0,1788,1838
1991-10-12,Luxembourg,Portugal,1,1,0,0.5,0.5,1345,1797
1991-10-12,Russia,Italy,0,0,0,0.5,0.5,1896,1935
1991-10-12,Spain,France,1,2,1,0.0,1.0,1846,1935
1991-10-13,Algeria,Iran,1,0,1,1.0,0.0,1807,1767
1991-10-16,Bulgaria,San Marino,4,0,4,1.0,0.0,1739,1483
1991-10-16,Cyprus,Iceland,1,1,0,0.5,0.5,1394,1610
1991-10-16,Czechoslovakia,Albania,2,1,1,1.0,0.0,1864,1494
1991-10-16,England,Turkey,1,0,1,1.0,0.0,1948,1615
1991-10-16,Faroe Islands,Yugoslavia,0,2,2,0.0,1.0,1537,1861
1991-10-16,Germany,Wales,4,1,3,1.0,0.0,1988,1758
1991-10-16,Netherlands,Portugal,1,0,1,1.0,0.0,1884,1791
1991-10-16,Northern Ireland,Austria,2,1,1,1.0,0.0,1725,1738
1991-10-16,Poland,Republic of Ireland,3,3,0,0.5,0.5,1796,1841
1991-10-16,Romania,Scotland,1,0,1,1.0,0.0,1802,1786
1991-10-19,United States,North Korea,1,2,1,0.0,1.0,1698,1714
1991-10-30,Brazil,Yugoslavia,3,1,2,1.0,0.0,1935,1855
1991-10-30,Greece,Finland,2,0,2,1.0,0.0,1717,1626
1991-10-30,Hungary,Norway,0,0,0,0.5,0.5,1793,1729
1991-10-31,Ghana,Senegal,2,3,1,0.0,1.0,1675,1699
1991-10-31,Ivory Coast,Nigeria,2,0,2,1.0,0.0,1767,1741
1991-11-02,Ghana,Nigeria,1,0,1,1.0,0.0,1685,1732
1991-11-02,Ivory Coast,Senegal,1,0,1,1.0,0.0,1774,1693
1991-11-09,Tanzania,Kenya,1,1,0,0.5,0.5,1527,1622
1991-11-13,Austria,Yugoslavia,0,2,2,0.0,1.0,1733,1861
1991-11-13,Cyprus,Russia,0,3,3,0.0,1.0,1394,1897
1991-11-13,Denmark,Northern Ireland,2,1,1,1.0,0.0,1832,1720
1991-11-13,Italy,Norway,1,1,0,0.5,0.5,1931,1734
1991-11-13,Poland,England,1,1,0,0.5,0.5,1800,1945
1991-11-13,Romania,Switzerland,1,0,1,1.0,0.0,1810,1781
1991-11-13,Scotland,San Marino,4,0,4,1.0,0.0,1789,1481
1991-11-13,Spain,Czechoslovakia,2,1,1,1.0,0.0,1855,1856
1991-11-13,Turkey,Republic of Ireland,1,3,2,0.0,1.0,1612,1845
1991-11-13,Wales,Luxembourg,1,0,1,1.0,0.0,1760,1344
1991-11-15,Lithuania,Estonia,4,1,3,1.0,0.0,1473,1382
1991-11-16,Estonia,Latvia,0,2,2,0.0,1.0,1377,1502
1991-11-16,Tanzania,Kenya,1,2,1,0.0,1.0,1522,1628
1991-11-17,Lithuania,Latvia,1,1,0,0.5,0.5,1474,1502
1991-11-20,Belgium,Germany,0,1,1,0.0,1.0,1818,1993
1991-11-20,Bulgaria,Romania,1,1,0,0.5,0.5,1741,1809
1991-11-20,France,Iceland,3,1,2,1.0,0.0,1938,1608
1991-11-20,Mexico,Uruguay,1,1,0,0.5,0.5,1882,1804
1991-11-20,Portugal,Greece,1,0,1,1.0,0.0,1798,1711
1991-11-22,Cape Verde,Guinea-Bissau,2,1,1,1.0,0.0,1492,1527
1991-11-23,Gambia,Mali,1,0,1,1.0,0.0,1482,1592
1991-11-23,Ivory Coast,Niger,5,2,3,1.0,0.0,1777,1509
1991-11-23,Kenya,Zambia,0,1,1,0.0,1.0,1622,1710
1991-11-24,Guinea,Sierra Leone,0,1,1,0.0,1.0,1600,1576
1991-11-24,Senegal,Guinea-Bissau,4,0,4,1.0,0.0,1698,1523
1991-11-24,Sudan,Tanzania,1,1,0,0.5,0.5,1598,1524
1991-11-24,United States,Costa Rica,1,1,0,0.5,0.5,1698,1685
1991-11-25,Malawi,Zanzibar,1,0,1,1.0,0.0,1628,1368
1991-11-25,Singapore,Thailand,0,0,0,0.5,0.5,1555,1590
1991-11-26,Gambia,Guinea,0,0,0,0.5,0.5,1485,1598
1991-11-26,Mali,Sierra Leone,1,1,0,0.5,0.5,1592,1577
1991-11-26,Indonesia,Malaysia,2,0,2,1.0,0.0,1548,1581
1991-11-26,Philippines,Vietnam,2,2,0,0.5,0.5,1326,1497
1991-11-27,Costa Rica,Mexico,1,1,0,0.5,0.5,1690,1878
1991-11-27,Malta,Libya,2,0,2,1.0,0.0,1486,1652
1991-11-27,Senegal,Cape Verde,0,0,0,0.5,0.5,1694,1497
1991-11-27,Tunisia,Ivory Coast,5,3,2,1.0,0.0,1660,1767
1991-11-27,Uganda,Sudan,2,0,2,1.0,0.0,1633,1591
1991-11-27,Zambia,Zanzibar,3,2,1,1.0,0.0,1712,1367
1991-11-27,Thailand,Myanmar,4,0,4,1.0,0.0,1599,1593
1991-11-28,Gambia,Sierra Leone,0,0,0,0.5,0.5,1488,1575
1991-11-28,Guinea,Mali,0,2,2,0.0,1.0,1590,1601
1991-11-28,Kenya,Malawi,1,0,1,1.0,0.0,1631,1620
1991-11-28,Indonesia,Vietnam,1,0,1,1.0,0.0,1555,1491
1991-11-28,Philippines,Malaysia,1,0,1,1.0,0.0,1340,1568
1991-11-29,Singapore,Myanmar,2,1,1,1.0,0.0,1564,1585
1991-11-30,Cape Verde,Sierra Leone,0,0,0,0.5,0.5,1499,1574
1991-11-30,Kenya,Zanzibar,3,2,1,1.0,0.0,1634,1365
1991-11-30,Senegal,Gambia,2,0,2,1.0,0.0,1698,1485
1991-11-30,Uganda,Tanzania,5,0,5,1.0,0.0,1639,1519
1991-11-30,Philippines,Indonesia,1,2,1,0.0,1.0,1337,1559
1991-11-30,Malaysia,Vietnam,2,1,1,1.0,0.0,1575,1485
1991-12-01,Malawi,Zambia,0,0,0,0.5,0.5,1623,1710
1991-12-02,Senegal,Cape Verde,1,0,1,1.0,0.0,1702,1496
1991-12-02,Philippines,Thailand,2,6,4,0.0,1.0,1335,1602
1991-12-02,Indonesia,Singapore,0,0,0,0.5,0.5,1560,1564
1991-12-03,Egypt,Poland,4,0,4,1.0,0.0,1748,1791
1991-12-04,Greece,Netherlands,0,2,2,0.0,1.0,1707,1889
1991-12-04,Mexico,Hungary,3,0,3,1.0,0.0,1885,1787
1991-12-04,Morocco,Mali,3,0,3,1.0,0.0,1729,1596
1991-12-04,Uganda,Kenya,1,3,2,0.0,1.0,1631,1643
1991-12-04,Philippines,Singapore,0,2,2,0.0,1.0,1332,1568
1991-12-04,Indonesia,Thailand,0,0,0,0.5,0.5,1561,1602
1991-12-05,Egypt,Poland,0,0,0,0.5,0.5,1749,1791
1991-12-05,Sudan,Zambia,2,3,1,0.0,1.0,1586,1716
1991-12-07,Kenya,Zambia,0,2,2,0.0,1.0,1637,1723
1991-12-07,Uganda,Sudan,3,1,2,1.0,0.0,1638,1580
1991-12-08,El Salvador,Hungary,1,1,0,0.5,0.5,1603,1784
1991-12-09,Kuwait,Poland,0,2,2,0.0,1.0,1704,1798
1991-12-16,Algeria,Senegal,3,1,2,1.0,0.0,1813,1697
1991-12-18,Brazil,Czechoslovakia,2,1,1,1.0,0.0,1942,1850
1991-12-18,Germany,Luxembourg,4,0,4,1.0,0.0,1994,1344
1991-12-21,Egypt,Romania,3,1,2,1.0,0.0,1759,1800
1991-12-21,Italy,Cyprus,2,0,2,1.0,0.0,1932,1394
1991-12-22,Malta,Greece,1,1,0,0.5,0.5,1491,1703
1991-12-22,Pakistan,India,0,0,0,0.5,0.5,1469,1531
1991-12-22,Sri Lanka,Nepal,2,2,0,0.5,0.5,1363,1428
1991-12-24,Egypt,Romania,1,1,0,0.5,0.5,1760,1800
1991-12-24,Pakistan,Bangladesh,1,0,1,1.0,0.0,1477,1447
1991-12-24,Maldives,Nepal,1,0,1,1.0,0.0,1436,1420
1991-12-25,Tunisia,Cameroon,2,2,0,0.5,0.5,1663,1755
1991-12-26,Morocco,Algeria,1,1,0,0.5,0.5,1731,1812
1991-12-26,Bangladesh,India,2,1,1,1.0,0.0,1457,1522
1991-12-26,Sri Lanka,Maldives,0,1,1,0.0,1.0,1357,1443
1991-12-28,Bangladesh,Nepal,2,0,2,1.0,0.0,1465,1413
1991-12-29,Pakistan,Maldives,2,0,2,1.0,0.0,1485,1436
1991-12-30,Malawi,Zambia,0,2,2,0.0,1.0,1618,1729
1992-01-04,Egypt,Czechoslovakia,2,0,2,1.0,0.0,1771,1840
1992-01-05,DR Congo,Ivory Coast,2,0,2,1.0,0.0,1668,1757
1992-01-05,Guyana,Barbados,0,2,2,0.0,1.0,1481,1539
1992-01-07,Egypt,Norway,0,0,0,0.5,0.5,1771,1735
1992-01-12,Cameroon,Morocco,1,0,1,1.0,0.0,1763,1724
1992-01-12,Senegal,Nigeria,1,2,1,0.0,1.0,1690,1740
1992-01-13,Algeria,Ivory Coast,0,3,3,0.0,1.0,1803,1767
1992-01-13,Egypt,Zambia,0,1,1,0.0,1.0,1763,1738
1992-01-14,Morocco,DR Congo,1,1,0,0.5,0.5,1723,1670
1992-01-14,Nigeria,Kenya,2,1,1,1.0,0.0,1746,1632
1992-01-15,Ivory Coast,Congo,0,0,0,0.5,0.5,1764,1613
1992-01-15,Portugal,Spain,0,0,0,0.5,0.5,1800,1854
1992-01-15,Zambia,Ghana,0,1,1,0.0,1.0,1729,1695
1992-01-16,Cameroon,DR Congo,1,1,0,0.5,0.5,1761,1673
1992-01-16,Senegal,Kenya,3,0,3,1.0,0.0,1697,1626
1992-01-17,Algeria,Congo,1,1,0,0.5,0.5,1800,1617
1992-01-17,Egypt,Ghana,0,1,1,0.0,1.0,1754,1705
1992-01-19,Nigeria,DR Congo,1,0,1,1.0,0.0,1753,1667
1992-01-19,Senegal,Cameroon,0,1,1,0.0,1.0,1691,1768
1992-01-20,Ghana,Congo,2,1,1,1.0,0.0,1712,1611
1992-01-20,Ivory Coast,Zambia,1,0,1,1.0,0.0,1772,1722
1992-01-23,Cameroon,Ivory Coast,0,0,0,0.5,0.5,1769,1772
1992-01-23,Nigeria,Ghana,1,2,1,0.0,1.0,1745,1721
1992-01-25,Cameroon,Nigeria,1,2,1,0.0,1.0,1761,1754
1992-01-25,United States,Russia,0,1,1,0.0,1.0,1695,1901
1992-01-26,Australia,Sweden,0,0,0,0.5,0.5,1736,1836
1992-01-26,Ghana,Ivory Coast,0,0,0,0.5,0.5,1723,1771
1992-01-29,Albania,Greece,1,0,1,1.0,0.0,1507,1691
1992-01-29,Australia,Sweden,1,0,1,1.0,0.0,1747,1826
1992-01-29,El Salvador,Russia,0,3,3,0.0,1.0,1601,1904
1992-02-02,Australia,Sweden,1,0,1,1.0,0.0,1757,1817
1992-02-02,United States,Russia,2,1,1,1.0,0.0,1708,1892
1992-02-04,Bermuda,Norway,1,3,2,0.0,1.0,1498,1739
1992-02-10,Malta,Iceland,1,0,1,1.0,0.0,1502,1598
1992-02-12,Costa Rica,United States,0,0,0,0.5,0.5,1691,1708
1992-02-12,Greece,Romania,1,0,1,1.0,0.0,1702,1790
1992-02-12,Israel,Russia,1,2,1,0.0,1.0,1654,1896
1992-02-12,Portugal,Netherlands,2,0,2,1.0,0.0,1811,1879
1992-02-12,Turkey,Finland,1,1,0,0.5,0.5,1613,1626
1992-02-18,El Salvador,United States,2,0,2,1.0,0.0,1612,1698
1992-02-19,England,France,2,0,2,1.0,0.0,1953,1931
1992-02-19,Republic of Ireland,Wales,0,1,1,0.0,1.0,1836,1770
1992-02-19,Italy,San Marino,4,0,4,1.0,0.0,1934,1480
1992-02-19,Scotland,Northern Ireland,1,0,1,1.0,0.0,1796,1714
1992-02-19,Spain,Russia,1,1,0,0.5,0.5,1855,1896
1992-02-22,Tunisia,Nigeria,1,1,0,0.5,0.5,1666,1752
1992-02-26,Brazil,United States,3,0,3,1.0,0.0,1946,1695
1992-02-26,Tunisia,Belgium,2,1,1,1.0,0.0,1678,1807
1992-03-02,United Arab Emirates,Iceland,0,1,1,0.0,1.0,1639,1608
1992-03-03,Israel,Cyprus,2,1,1,1.0,0.0,1657,1392
1992-03-04,Costa Rica,El Salvador,2,0,2,1.0,0.0,1698,1606
1992-03-04,Saint Vincent and the Grenadines,Curaçao,2,2,0,0.5,0.5,1576,1576
1992-03-05,Dominica,Guadeloupe,0,0,0,0.5,0.5,1434,1536
1992-03-06,Barbados,Curaçao,1,0,1,1.0,0.0,1548,1568
1992-03-08,Grenada,Curaçao,0,1,1,0.0,1.0,1533,1576
1992-03-08,Mexico,Russia,4,0,4,1.0,0.0,1894,1888
1992-03-11,Mexico,Russia,1,1,0,0.5,0.5,1894,1889
1992-03-11,Spain,United States,2,0,2,1.0,0.0,1860,1691
1992-03-17,El Salvador,Honduras,1,1,0,0.5,0.5,1609,1696
1992-03-18,Morocco,United States,3,1,2,1.0,0.0,1731,1684
1992-03-21,Dominican Republic,Puerto Rico,1,2,1,0.0,1.0,1459,1375
1992-03-21,Guernsey,Alderney,9,1,8,1.0,0.0,1628,1294
1992-03-22,Saint Lucia,Saint Vincent and the Grenadines,1,0,1,1.0,0.0,1514,1567
1992-03-25,Cyprus,Greece,1,3,2,0.0,1.0,1390,1705
1992-03-25,Czechoslovakia,England,2,2,0,0.5,0.5,1843,1951
1992-03-25,France,Belgium,3,3,0,0.5,0.5,1929,1810
1992-03-25,Hungary,Austria,2,1,1,1.0,0.0,1791,1727
1992-03-25,Republic of Ireland,Switzerland,2,1,1,1.0,0.0,1843,1775
1992-03-25,Italy,Germany,1,0,1,1.0,0.0,1944,1985
1992-03-25,Luxembourg,Turkey,2,3,1,0.0,1.0,1342,1616
1992-03-25,Netherlands,Yugoslavia,2,0,2,1.0,0.0,1887,1854
1992-03-25,Scotland,Finland,1,1,0,0.5,0.5,1793,1630
1992-03-29,Puerto Rico,Dominican Republic,1,1,0,0.5,0.5,1377,1458
1992-03-29,Saint Vincent and the Grenadines,Saint Lucia,3,1,2,1.0,0.0,1574,1508
1992-04-01,Cayman Islands,Martinique,0,7,7,0.0,1.0,1469,1616
1992-04-02,Canada,China PR,5,2,3,1.0,0.0,1630,1697
1992-04-03,Sint Maarten,Cayman Islands,4,2,2,1.0,0.0,1491,1462
1992-04-04,United States,China PR,5,0,5,1.0,0.0,1693,1689
1992-04-05,Sint Maarten,Martinique,1,1,0,0.5,0.5,1494,1614
1992-04-05,Togo,Ghana,1,0,1,1.0,0.0,1599,1713
1992-04-08,Israel,Iceland,2,2,0,0.5,0.5,1656,1610
1992-04-08,Romania,Latvia,2,0,2,1.0,0.0,1793,1500
1992-04-08,Turkey,Denmark,2,1,1,1.0,0.0,1629,1820
1992-04-12,Jamaica,Bermuda,0,0,0,0.5,0.5,1547,1500
1992-04-14,Austria,Lithuania,4,0,4,1.0,0.0,1731,1471
1992-04-15,Antigua and Barbuda,Montserrat,5,0,5,1.0,0.0,1471,1484
1992-04-15,Brazil,Finland,3,1,2,1.0,0.0,1949,1628
1992-04-15,Saint Kitts and Nevis,British Virgin Islands,4,0,4,1.0,0.0,1500,1488
1992-04-17,Antigua and Barbuda,British Virgin Islands,2,0,2,1.0,0.0,1480,1480
1992-04-17,Saint Kitts and Nevis,Montserrat,10,0,10,1.0,0.0,1508,1477
1992-04-19,Barbados,Trinidad and Tobago,1,2,1,0.0,1.0,1542,1636
1992-04-19,Curaçao,Antigua and Barbuda,1,1,0,0.5,0.5,1574,1483
1992-04-19,Singapore,Malaysia,1,1,0,0.5,0.5,1569,1575
1992-04-20,China PR,Indonesia,2,0,2,1.0,0.0,1695,1556
1992-04-22,Belgium,Cyprus,1,0,1,1.0,0.0,1812,1389
1992-04-22,Czechoslovakia,Germany,1,1,0,0.5,0.5,1847,1982
1992-04-22,Singapore,Indonesia,1,2,1,0.0,1.0,1561,1565
1992-04-22,Spain,Albania,3,0,3,1.0,0.0,1862,1506
1992-04-22,Tunisia,Sweden,0,1,1,0.0,1.0,1674,1822
1992-04-23,China PR,Malaysia,4,0,4,1.0,0.0,1701,1570
1992-04-24,Indonesia,Malaysia,1,1,0,0.5,0.5,1566,1570
1992-04-24,Guyana,Suriname,1,2,1,0.0,1.0,1476,1618
1992-04-26,Antigua and Barbuda,Curaçao,3,0,3,1.0,0.0,1494,1564
1992-04-26,Bermuda,Haiti,1,0,1,1.0,0.0,1510,1548
1992-04-26,Singapore,China PR,0,1,1,0.0,1.0,1557,1706
1992-04-28,Northern Ireland,Lithuania,2,2,0,0.5,0.5,1710,1476
1992-04-28,Switzerland,Bulgaria,0,2,2,0.0,1.0,1767,1750
1992-04-29,Austria,Wales,1,1,0,0.5,0.5,1732,1770
1992-04-29,Denmark,Norway,1,0,1,1.0,0.0,1827,1733
1992-04-29,El Salvador,Costa Rica,1,1,0,0.5,0.5,1612,1696
1992-04-29,Republic of Ireland,United States,4,1,3,1.0,0.0,1848,1689
1992-04-29,Russia,England,2,2,0,0.5,0.5,1891,1950
1992-04-29,Ukraine,Hungary,1,3,2,0.0,1.0,1515,1794
1992-04-30,Uruguay,Brazil,1,0,1,1.0,0.0,1816,1938
1992-05-02,Anguilla,Cuba,0,3,3,0.0,1.0,1477,1506
1992-05-04,Jersey,Guernsey,2,3,1,0.0,1.0,1696,1638
1992-05-06,French Guiana,Guyana,1,1,0,0.5,0.5,1466,1476
1992-05-06,Romania,Faroe Islands,7,0,7,1.0,0.0,1796,1535
1992-05-07,Sweden,Poland,5,0,5,1.0,0.0,1830,1791
1992-05-08,Aruba,French Guiana,0,2,2,0.0,1.0,1440,1474
1992-05-08,Congo,Haiti,4,1,3,1.0,0.0,1618,1542
1992-05-09,Congo,Guadeloupe,1,1,0,0.5,0.5,1617,1538
1992-05-09,Cuba,Anguilla,5,0,5,1.0,0.0,1514,1470
1992-05-09,Suriname,French Guiana,3,2,1,1.0,0.0,1623,1470
1992-05-11,Iran,Pakistan,7,0,7,1.0,0.0,1770,1483
1992-05-12,Hungary,England,0,1,1,0.0,1.0,1790,1955
1992-05-13,Greece,Iceland,1,0,1,1.0,0.0,1711,1605
1992-05-13,Norway,Faroe Islands,2,0,2,1.0,0.0,1737,1532
1992-05-14,Finland,Bulgaria,0,3,3,0.0,1.0,1623,1756
1992-05-14,Kuwait,Syria,0,0,0,0.5,0.5,1702,1595
1992-05-14,United Arab Emirates,Qatar,1,0,1,1.0,0.0,1648,1634
1992-05-15,India,Iran,0,3,3,0.0,1.0,1519,1774
1992-05-17,England,Brazil,1,1,0,0.5,0.5,1955,1939
1992-05-17,Qatar,Kuwait,0,0,0,0.5,0.5,1636,1701
1992-05-17,United Arab Emirates,Syria,2,0,2,1.0,0.0,1655,1589
1992-05-17,United States,Scotland,0,1,1,0.0,1.0,1684,1799
1992-05-19,Austria,Poland,2,4,2,0.0,1.0,1726,1798
1992-05-19,Bahrain,Algeria,0,0,0,0.5,0.5,1553,1796
1992-05-20,Canada,Scotland,1,3,2,0.0,1.0,1626,1804
1992-05-20,Moldova,Lithuania,1,1,0,0.5,0.5,1499,1477
1992-05-20,Romania,Wales,5,1,4,1.0,0.0,1804,1763
1992-05-20,United Arab Emirates,Syria,0,0,0,0.5,0.5,1654,1591
1992-05-23,Jamaica,Puerto Rico,2,1,1,1.0,0.0,1552,1373
1992-05-24,Guatemala,Ecuador,1,1,0,0.5,0.5,1609,1623
1992-05-25,Haiti,Bermuda,2,1,1,1.0,0.0,1550,1503
1992-05-25,Suriname,Guyana,1,1,0,0.5,0.5,1620,1480
1992-05-26,Ethiopia,Sudan,5,1,4,1.0,0.0,1612,1573
1992-05-26,Republic of Ireland,Albania,2,0,2,1.0,0.0,1850,1505
1992-05-26,Malta,Latvia,1,0,1,1.0,0.0,1510,1493
1992-05-27,Costa Rica,Ecuador,2,1,1,1.0,0.0,1703,1617
1992-05-27,Netherlands,Austria,3,2,1,1.0,0.0,1892,1722
1992-05-27,Poland,Czechoslovakia,1,0,1,1.0,0.0,1808,1838
1992-05-27,Sweden,Hungary,2,1,1,1.0,0.0,1838,1783
1992-05-27,Switzerland,France,2,1,1,1.0,0.0,1779,1918
1992-05-29,Qatar,Syria,4,2,2,1.0,0.0,1643,1585
1992-05-30,Germany,Turkey,1,0,1,1.0,0.0,1984,1628
1992-05-30,Japan,Argentina,0,1,1,0.0,1.0,1642,1883
1992-05-30,Netherlands,Wales,4,0,4,1.0,0.0,1898,1758
1992-05-30,Puerto Rico,Jamaica,0,1,1,0.0,1.0,1369,1557
1992-05-30,United States,Republic of Ireland,3,1,2,1.0,0.0,1696,1839
1992-05-31,Italy,Portugal,0,0,0,0.5,0.5,1942,1814
1992-05-31,Qatar,Oman,4,0,4,1.0,0.0,1647,1415
1992-05-31,Trinidad and Tobago,Barbados,3,0,3,1.0,0.0,1642,1537
1992-06-01,Kazakhstan,Turkmenistan,1,0,1,1.0,0.0,1517,1493
1992-06-02,Germany,Northern Ireland,1,1,0,0.5,0.5,1979,1716
1992-06-03,Albania,Lithuania,1,0,1,1.0,0.0,1513,1470
1992-06-03,Argentina,Wales,1,0,1,1.0,0.0,1889,1753
1992-06-03,Denmark,Russia,1,1,0,0.5,0.5,1829,1890
1992-06-03,Estonia,Slovenia,1,1,0,0.5,0.5,1380,1492
1992-06-03,Faroe Islands,Belgium,0,3,3,0.0,1.0,1530,1815
1992-06-03,Finland,England,1,2,1,0.0,1.0,1621,1958
1992-06-03,Hungary,Iceland,1,2,1,0.0,1.0,1772,1617
1992-06-03,North Korea,Taiwan,6,0,6,1.0,0.0,1718,1489
1992-06-03,Macau,Hong Kong,2,2,0,0.5,0.5,1441,1568
1992-06-03,Norway,Scotland,0,0,0,0.5,0.5,1739,1803
1992-06-03,United States,Portugal,1,0,1,1.0,0.0,1707,1804
1992-06-04,Republic of Ireland,Italy,0,2,2,0.0,1.0,1834,1948
1992-06-05,France,Netherlands,1,1,0,0.5,0.5,1918,1899
1992-06-05,Hong Kong,Taiwan,0,0,0,0.5,0.5,1567,1491
1992-06-05,North Korea,Macau,2,0,2,1.0,0.0,1721,1439
1992-06-06,United States,Italy,1,1,0,0.5,0.5,1712,1944
1992-06-07,Guatemala,Nicaragua,7,1,6,1.0,0.0,1612,1347
1992-06-07,Republic of Ireland,Portugal,2,0,2,1.0,0.0,1842,1797
1992-06-07,Japan,Wales,0,1,1,0.0,1.0,1637,1759
1992-06-07,North Korea,Hong Kong,0,0,0,0.5,0.5,1718,1571
1992-06-07,Macau,Taiwan,2,0,2,1.0,0.0,1449,1482
1992-06-07,New Zealand,Fiji,3,0,3,1.0,0.0,1697,1606
1992-06-10,Sweden,France,1,1,0,0.5,0.5,1840,1917
1992-06-11,Denmark,England,0,0,0,0.5,0.5,1832,1956
1992-06-12,Netherlands,Scotland,1,0,1,1.0,0.0,1905,1798
1992-06-12,Russia,Germany,1,1,0,0.5,0.5,1893,1977
1992-06-13,Canada,Hong Kong,3,1,2,1.0,0.0,1633,1565
1992-06-13,United States,Australia,0,1,1,0.0,1.0,1706,1764
1992-06-14,Antigua and Barbuda,Bermuda,0,3,3,0.0,1.0,1487,1511
1992-06-14,France,England,0,0,0,0.5,0.5,1918,1956
1992-06-14,Gabon,Togo,1,0,1,1.0,0.0,1569,1591
1992-06-14,Guinea-Bissau,Cape Verde,3,1,2,1.0,0.0,1531,1489
1992-06-14,Lesotho,Botswana,0,0,0,0.5,0.5,1422,1478
1992-06-14,Sweden,Denmark,1,0,1,1.0,0.0,1848,1825
1992-06-15,Netherlands,Russia,0,0,0,0.5,0.5,1905,1894
1992-06-15,Scotland,Germany,0,2,2,0.0,1.0,1794,1982
1992-06-16,Faroe Islands,Cyprus,0,2,2,0.0,1.0,1519,1401
1992-06-17,France,Denmark,1,2,1,0.0,1.0,1908,1836
1992-06-17,Sweden,England,2,1,1,1.0,0.0,1859,1946
1992-06-17,Tajikistan,Uzbekistan,2,2,0,0.5,0.5,1500,1500
1992-06-18,Argentina,Australia,2,0,2,1.0,0.0,1895,1759
1992-06-18,Netherlands,Germany,3,1,2,1.0,0.0,1915,1973
1992-06-18,Scotland,Russia,3,0,3,1.0,0.0,1805,1884
1992-06-19,Antigua and Barbuda,Suriname,1,1,0,0.5,0.5,1490,1618
1992-06-19,South Korea,Bangladesh,6,0,6,1.0,0.0,1849,1464
1992-06-20,Guadeloupe,Jamaica,0,1,1,0.0,1.0,1531,1565
1992-06-20,Mozambique,Eswatini,4,1,3,1.0,0.0,1530,1463
1992-06-21,Antigua and Barbuda,Martinique,1,4,3,0.0,1.0,1485,1620
1992-06-21,Gabon,Burundi,0,1,1,0.0,1.0,1560,1495
1992-06-21,Sweden,Germany,2,3,1,0.0,1.0,1854,1979
1992-06-21,Thailand,South Korea,2,1,1,1.0,0.0,1615,1837
1992-06-21,Uruguay,Australia,2,0,2,1.0,0.0,1823,1753
1992-06-22,Cuba,Jamaica,0,0,0,0.5,0.5,1516,1564
1992-06-22,Netherlands,Denmark,2,2,0,0.5,0.5,1914,1838
1992-06-23,Thailand,Bangladesh,1,0,1,1.0,0.0,1620,1460
1992-06-24,Jamaica,Martinique,1,0,1,1.0,0.0,1574,1611
1992-06-24,Trinidad and Tobago,Cuba,1,0,1,1.0,0.0,1648,1511
1992-06-26,Denmark,Germany,2,0,2,1.0,0.0,1850,1968
1992-06-26,Sudan,Eritrea,1,1,0,0.5,0.5,1572,1502
1992-06-27,Cuba,Martinique,1,1,0,0.5,0.5,1514,1609
1992-06-27,Trinidad and Tobago,Jamaica,3,1,2,1.0,0.0,1655,1568
1992-06-27,United States,Ukraine,0,0,0,0.5,0.5,1702,1520
1992-06-27,Vanuatu,New Zealand,1,4,3,0.0,1.0,1453,1701
1992-06-28,Botswana,Lesotho,0,4,4,0.0,1.0,1469,1432
1992-06-28,Cape Verde,Guinea-Bissau,1,0,1,1.0,0.0,1498,1523
1992-06-28,Chad,Eritrea,0,1,1,0.0,1.0,1491,1510
1992-06-28,China PR,Slovakia,2,3,1,0.0,1.0,1694,1491
1992-06-28,Honduras,Panama,4,0,4,1.0,0.0,1700,1489
1992-06-28,Uzbekistan,Turkmenistan,2,1,1,1.0,0.0,1508,1486
1992-06-30,Honduras,Panama,4,0,4,1.0,0.0,1704,1486
1992-06-30,Sudan,Chad,1,0,1,1.0,0.0,1579,1485
1992-07-01,New Zealand,Vanuatu,8,0,8,1.0,0.0,1705,1450
1992-07-03,Kazakhstan,Libya,1,0,1,1.0,0.0,1528,1642
1992-07-04,Bermuda,Antigua and Barbuda,2,1,1,1.0,0.0,1519,1478
1992-07-04,Uruguay,Ecuador,3,1,2,1.0,0.0,1827,1614
1992-07-05,Australia,Croatia,1,0,1,1.0,0.0,1758,1583
1992-07-05,Guatemala,Poland,2,2,0,0.5,0.5,1617,1804
1992-07-05,Guinea-Bissau,Cape Verde,1,0,1,1.0,0.0,1531,1491
1992-07-05,Trinidad and Tobago,Jamaica,1,2,1,0.0,1.0,1646,1578
1992-07-06,Malawi,Zimbabwe,0,0,0,0.5,0.5,1619,1642
1992-07-07,South Africa,Cameroon,1,0,1,1.0,0.0,1602,1750
1992-07-08,Australia,Croatia,3,1,2,1.0,0.0,1763,1579
1992-07-08,Malawi,Zimbabwe,0,0,0,0.5,0.5,1620,1642
1992-07-09,South Africa,Cameroon,1,2,1,0.0,1.0,1598,1755
1992-07-10,Latvia,Estonia,2,1,1,1.0,0.0,1499,1375
1992-07-11,Estonia,Lithuania,1,1,0,0.5,0.5,1378,1468
1992-07-11,South Africa,Cameroon,2,2,0,0.5,0.5,1602,1752
1992-07-11,Turkmenistan,Tajikistan,3,3,0,0.5,0.5,1487,1500
1992-07-11,Solomon Islands,Tahiti,1,1,0,0.5,0.5,1531,1701
1992-07-12,Australia,Croatia,0,0,0,0.5,0.5,1760,1583
1992-07-12,Latvia,Lithuania,2,3,1,0.0,1.0,1491,1477
1992-07-12,New Caledonia,Tahiti,0,1,1,0.0,1.0,1611,1708
1992-07-16,Kazakhstan,Uzbekistan,1,0,1,1.0,0.0,1536,1501
1992-07-19,Guatemala,Honduras,0,0,0,0.5,0.5,1619,1703
1992-07-19,Nicaragua,El Salvador,0,5,5,0.0,1.0,1345,1615
1992-07-20,Vanuatu,Tahiti,1,2,1,0.0,1.0,1448,1711
1992-07-22,Cameroon,Egypt,0,1,1,0.0,1.0,1745,1762
1992-07-22,New Caledonia,Tahiti,1,2,1,0.0,1.0,1606,1717
1992-07-23,El Salvador,Nicaragua,5,1,4,1.0,0.0,1618,1343
1992-07-25,Fiji,Solomon Islands,2,1,1,1.0,0.0,1613,1525
1992-07-25,Vanuatu,New Caledonia,0,1,1,0.0,1.0,1444,1611
1992-07-26,El Salvador,Mexico,1,2,1,0.0,1.0,1616,1897
1992-07-26,Honduras,Guatemala,2,0,2,1.0,0.0,1710,1613
1992-07-26,Ivory Coast,Egypt,2,0,2,1.0,0.0,1779,1755
1992-07-27,Vanuatu,Solomon Islands,1,3,2,0.0,1.0,1438,1532
1992-07-28,Fiji,New Caledonia,2,2,0,0.5,0.5,1613,1612
1992-07-28,Ivory Coast,Egypt,2,2,0,0.5,0.5,1779,1756
1992-07-30,New Caledonia,Solomon Islands,1,0,1,1.0,0.0,1619,1526
1992-07-30,Vanuatu,Fiji,0,2,2,0.0,1.0,1434,1618
1992-07-31,Brazil,Mexico,5,0,5,1.0,0.0,1947,1890
1992-07-31,United States,Colombia,0,1,1,0.0,1.0,1696,1762
1992-08-01,Lesotho,Namibia,2,0,2,1.0,0.0,1442,1478
1992-08-02,Suriname,Saint Vincent and the Grenadines,0,0,0,0.5,0.5,1617,1576
1992-08-02,Lesotho,Namibia,2,2,0,0.5,0.5,1443,1478
1992-08-02,Mexico,Colombia,0,0,0,0.5,0.5,1888,1765
1992-08-02,Uruguay,Costa Rica,2,1,1,1.0,0.0,1833,1698
1992-08-02,United States,Brazil,0,1,1,0.0,1.0,1693,1951
1992-08-05,Faroe Islands,Israel,1,1,0,0.5,0.5,1523,1653
1992-08-06,Ecuador,Costa Rica,1,1,0,0.5,0.5,1616,1697
1992-08-08,Indonesia,Malaysia,1,1,0,0.5,0.5,1567,1570
1992-08-08,Lesotho,Mauritius,1,0,1,1.0,0.0,1454,1528
1992-08-09,Iceland,Israel,0,2,2,0.0,1.0,1610,1661
1992-08-09,Lesotho,Mauritius,2,2,0,0.5,0.5,1456,1527
1992-08-09,Libya,Niger,0,0,0,0.5,0.5,1640,1512
1992-08-11,Australia,Malaysia,0,1,1,0.0,1.0,1749,1582
1992-08-12,El Salvador,Honduras,0,3,3,0.0,1.0,1611,1716
1992-08-12,Latvia,Lithuania,1,2,1,0.0,1.0,1483,1486
1992-08-12,Libya,Mali,0,1,1,0.0,1.0,1631,1606
1992-08-14,Algeria,Guinea-Bissau,3,1,2,1.0,0.0,1799,1529
1992-08-14,Indonesia,Australia,0,3,3,0.0,1.0,1563,1754
1992-08-14,Mali,Libya,2,1,1,1.0,0.0,1615,1623
1992-08-15,Uganda,Ethiopia,3,1,2,1.0,0.0,1646,1605
1992-08-15,Malawi,Egypt,1,0,1,1.0,0.0,1631,1746
1992-08-15,Zambia,Mauritius,3,1,2,1.0,0.0,1726,1524
1992-08-16,Jamaica,Trinidad and Tobago,1,1,0,0.5,0.5,1580,1645
1992-08-16,Benin,Niger,1,2,1,0.0,1.0,1438,1519
1992-08-16,Sudan,Nigeria,0,0,0,0.5,0.5,1583,1749
1992-08-16,Burundi,Congo,1,0,1,1.0,0.0,1506,1607
1992-08-16,DR Congo,Mozambique,2,0,2,1.0,0.0,1672,1526
1992-08-16,Estonia,Switzerland,0,6,6,0.0,1.0,1377,1781
1992-08-16,Gabon,Cameroon,0,0,0,0.5,0.5,1564,1742
1992-08-16,Lesotho,Kenya,2,2,0,0.5,0.5,1460,1623
1992-08-16,Panama,Costa Rica,1,0,1,1.0,0.0,1499,1685
1992-08-16,Zimbabwe,South Africa,4,1,3,1.0,0.0,1650,1595
1992-08-18,Ethiopia,Iraq,0,13,13,0.0,1.0,1601,1765
1992-08-18,Jordan,Sudan,3,0,3,1.0,0.0,1492,1573
1992-08-18,Moldova,Pakistan,5,0,5,1.0,0.0,1507,1476
1992-08-19,Bulgaria,Mexico,1,1,0,0.5,0.5,1759,1886
1992-08-19,Czechoslovakia,Austria,2,2,0,0.5,0.5,1836,1725
1992-08-20,Congo,Iraq,0,3,3,0.0,1.0,1603,1770
1992-08-20,Jordan,Pakistan,2,0,2,1.0,0.0,1500,1469
1992-08-20,Moldova,Sudan,2,1,1,1.0,0.0,1517,1564
1992-08-22,China PR,North Korea,2,2,0,0.5,0.5,1695,1718
1992-08-22,Congo,Ethiopia,3,0,3,1.0,0.0,1611,1594
1992-08-22,Japan,South Korea,0,0,0,0.5,0.5,1642,1833
1992-08-22,Jordan,Moldova,1,0,1,1.0,0.0,1509,1509
1992-08-22,Pakistan,Sudan,0,4,4,0.0,1.0,1464,1570
1992-08-23,Costa Rica,Panama,5,1,4,1.0,0.0,1690,1495
1992-08-23,Uzbekistan,Kyrgyzstan,3,0,3,1.0,0.0,1509,1485
1992-08-24,China PR,Japan,0,2,2,0.0,1.0,1686,1652
1992-08-24,South Korea,North Korea,1,1,0,0.5,0.5,1831,1721
1992-08-26,China PR,South Korea,0,2,2,0.0,1.0,1682,1836
1992-08-26,Finland,Poland,0,0,0,0.5,0.5,1625,1801
1992-08-26,France,Brazil,0,2,2,0.0,1.0,1901,1959
1992-08-26,Hungary,Ukraine,2,1,1,1.0,0.0,1776,1517
1992-08-26,Iraq,Moldova,1,0,1,1.0,0.0,1773,1507
1992-08-26,Japan,North Korea,4,1,3,1.0,0.0,1662,1712
1992-08-26,Jordan,Congo,2,1,1,1.0,0.0,1520,1601
1992-08-26,Latvia,Denmark,0,0,0,0.5,0.5,1490,1844
1992-08-26,Norway,Sweden,2,2,0,0.5,0.5,1742,1852
1992-08-26,Romania,Mexico,2,0,2,1.0,0.0,1814,1877
1992-08-26,Turkey,Bulgaria,3,2,1,1.0,0.0,1639,1749
1992-08-28,Congo,Moldova,1,3,2,0.0,1.0,1591,1518
1992-08-28,Jordan,Iraq,2,0,2,1.0,0.0,1533,1761
1992-08-29,China PR,North Korea,0,0,0,0.5,0.5,1683,1712
1992-08-29,Japan,South Korea,2,2,0,0.5,0.5,1666,1833
1992-08-29,Kenya,DR Congo,1,3,2,0.0,1.0,1617,1679
1992-08-29,Malawi,Mali,1,1,0,0.5,0.5,1631,1616
1992-08-29,Nigeria,Uganda,2,0,2,1.0,0.0,1755,1641
1992-08-29,Sierra Leone,Algeria,1,0,1,1.0,0.0,1587,1787
1992-08-30,Saint Vincent and the Grenadines,Suriname,2,1,1,1.0,0.0,1585,1609
1992-08-30,Cameroon,Benin,2,0,2,1.0,0.0,1745,1436
1992-08-30,Ethiopia,Sudan,3,0,3,1.0,0.0,1602,1563
1992-08-30,Guinea,Burundi,2,2,0,0.5,0.5,1589,1508
1992-08-30,Mauritius,Zimbabwe,0,1,1,0.0,1.0,1519,1656
1992-08-30,Mozambique,Lesotho,3,0,3,1.0,0.0,1533,1454
1992-08-30,Niger,Gabon,1,3,2,0.0,1.0,1513,1571
1992-08-30,Senegal,Guinea-Bissau,3,0,3,1.0,0.0,1696,1525
1992-08-30,South Africa,Zambia,0,1,1,0.0,1.0,1590,1732
1992-09-02,Austria,Portugal,1,1,0,0.5,0.5,1727,1796
1992-09-02,Czechoslovakia,Belgium,1,2,1,0.0,1.0,1828,1824
1992-09-02,Greece,Cyprus,2,3,1,0.0,1.0,1698,1415
1992-09-02,Lithuania,Georgia,1,0,1,1.0,0.0,1495,1507
1992-09-03,Canada,United States,0,2,2,0.0,1.0,1627,1700
1992-09-04,Solomon Islands,Australia,1,2,1,0.0,1.0,1523,1758
1992-09-08,Egypt,Jordan,1,1,0,0.5,0.5,1742,1538
1992-09-09,Syria,Saudi Arabia,1,1,0,0.5,0.5,1589,1719
1992-09-09,Bulgaria,France,2,0,2,1.0,0.0,1761,1890
1992-09-09,Denmark,Germany,1,2,1,0.0,1.0,1839,1974
1992-09-09,Finland,Sweden,0,1,1,0.0,1.0,1622,1856
1992-09-09,Republic of Ireland,Latvia,4,0,4,1.0,0.0,1844,1489
1992-09-09,Luxembourg,Hungary,0,3,3,0.0,1.0,1341,1778
1992-09-09,Netherlands,Italy,2,3,1,0.0,1.0,1907,1952
1992-09-09,Northern Ireland,Albania,3,0,3,1.0,0.0,1720,1510
1992-09-09,Norway,San Marino,10,0,10,1.0,0.0,1745,1478
1992-09-09,Poland,Israel,1,1,0,0.5,0.5,1798,1665
1992-09-09,Spain,England,1,0,1,1.0,0.0,1872,1937
1992-09-09,Switzerland,Scotland,3,1,2,1.0,0.0,1790,1797
1992-09-09,Wales,Faroe Islands,6,0,6,1.0,0.0,1763,1520
1992-09-10,Kuwait,Jordan,4,1,3,1.0,0.0,1706,1534
1992-09-11,Syria,Palestine,0,0,0,0.5,0.5,1587,1482
1992-09-11,Tahiti,Australia,0,3,3,0.0,1.0,1710,1766
1992-09-12,Egypt,Kuwait,1,0,1,1.0,0.0,1750,1699
1992-09-12,Fiji,Vanuatu,3,0,3,1.0,0.0,1623,1430
1992-09-13,Saudi Arabia,Palestine,2,1,1,1.0,0.0,1723,1479
1992-09-13,El Salvador,Honduras,3,1,2,1.0,0.0,1622,1706
1992-09-14,Turkmenistan,Kazakhstan,1,1,0,0.5,0.5,1489,1535
1992-09-15,Syria,Egypt,0,0,0,0.5,0.5,1591,1747
1992-09-15,Saudi Arabia,Kuwait,2,0,2,1.0,0.0,1731,1692
1992-09-17,Syria,Kuwait,1,2,1,0.0,1.0,1586,1698
1992-09-17,Egypt,Saudi Arabia,3,2,1,1.0,0.0,1755,1724
1992-09-17,Georgia,Azerbaijan,6,3,3,1.0,0.0,1515,1484
1992-09-18,Honduras,El Salvador,1,1,0,0.5,0.5,1705,1624
1992-09-20,Australia,Tahiti,2,0,2,1.0,0.0,1773,1704
1992-09-22,Honduras,Jamaica,5,1,4,1.0,0.0,1711,1575
1992-09-23,Brazil,Costa Rica,4,2,2,1.0,0.0,1962,1688
1992-09-23,Czechoslovakia,Faroe Islands,4,0,4,1.0,0.0,1831,1518
1992-09-23,Hungary,Israel,0,0,0,0.5,0.5,1776,1668
1992-09-23,Latvia,Spain,0,0,0,0.5,0.5,1496,1866
1992-09-23,Lithuania,Denmark,0,0,0,0.5,0.5,1502,1833
1992-09-23,Norway,Netherlands,2,1,1,1.0,0.0,1757,1896
1992-09-23,Poland,Turkey,1,0,1,1.0,0.0,1803,1635
1992-09-23,Uruguay,Argentina,0,0,0,0.5,0.5,1835,1894
1992-09-24,Honduras,Jamaica,7,0,7,1.0,0.0,1717,1570
1992-09-26,Australia,Solomon Islands,6,1,5,1.0,0.0,1777,1520
1992-09-26,Kyrgyzstan,Kazakhstan,1,1,0,0.5,0.5,1487,1534
1992-09-26,Vanuatu,Fiji,0,3,3,0.0,1.0,1427,1627
1992-09-27,Saint Vincent and the Grenadines,Jamaica,0,1,1,0.0,1.0,1577,1579
1992-09-30,Botswana,Kenya,1,3,2,0.0,1.0,1465,1622
1992-10-02,Iran,Cameroon,1,1,0,0.5,0.5,1774,1746
1992-10-03,Botswana,Kenya,0,1,1,0.0,1.0,1461,1627
1992-10-03,Kyrgyzstan,Uzbekistan,2,6,4,0.0,1.0,1480,1517
1992-10-04,Gabon,Chad,1,0,1,1.0,0.0,1578,1479
1992-10-04,Guinea-Bissau,Sierra Leone,0,3,3,0.0,1.0,1519,1594
1992-10-04,Iran,Cameroon,0,0,0,0.5,0.5,1774,1747
1992-10-04,Jamaica,Saint Vincent and the Grenadines,3,3,0,0.5,0.5,1579,1578
1992-10-04,Mali,Morocco,2,1,1,1.0,0.0,1627,1721
1992-10-06,Saudi Arabia,Cameroon,2,1,1,1.0,0.0,1733,1739
1992-10-07,Cyprus,Malta,3,0,3,1.0,0.0,1426,1500
1992-10-07,El Salvador,Mexico,0,2,2,0.0,1.0,1621,1881
1992-10-07,Iceland,Greece,0,1,1,0.0,1.0,1604,1705
1992-10-07,San Marino,Norway,0,2,2,0.0,1.0,1476,1760
1992-10-07,Sweden,Bulgaria,2,0,2,1.0,0.0,1862,1756
1992-10-09,Algeria,Burundi,3,1,2,1.0,0.0,1790,1506
1992-10-09,Tahiti,Solomon Islands,4,2,2,1.0,0.0,1709,1516
1992-10-09,United States,Canada,0,0,0,0.5,0.5,1699,1629
1992-10-09,Zimbabwe,Togo,1,0,1,1.0,0.0,1663,1585
1992-10-10,Nigeria,South Africa,4,0,4,1.0,0.0,1760,1586
1992-10-10,Ivory Coast,Botswana,6,0,6,1.0,0.0,1782,1459
1992-10-11,DR Congo,Liberia,4,2,2,1.0,0.0,1685,1545
1992-10-11,Egypt,Angola,1,0,1,1.0,0.0,1759,1559
1992-10-11,Gabon,Mozambique,3,1,2,1.0,0.0,1585,1527
1992-10-11,Madagascar,Namibia,3,0,3,1.0,0.0,1629,1474
1992-10-11,Morocco,Ethiopia,5,0,5,1.0,0.0,1727,1597
1992-10-11,Qatar,Hungary,1,4,3,0.0,1.0,1642,1782
1992-10-11,Tunisia,Benin,5,1,4,1.0,0.0,1678,1433
1992-10-11,Zambia,Tanzania,2,0,2,1.0,0.0,1736,1516
1992-10-13,Qatar,Hungary,1,1,0,0.5,0.5,1646,1779
1992-10-14,Armenia,Moldova,0,0,0,0.5,0.5,1494,1518
1992-10-14,Belgium,Romania,1,0,1,1.0,0.0,1832,1807
1992-10-14,Cyprus,Wales,0,1,1,0.0,1.0,1424,1766
1992-10-14,Denmark,Republic of Ireland,0,0,0,0.5,0.5,1834,1844
1992-10-14,England,Norway,1,1,0,0.5,0.5,1934,1764
1992-10-14,France,Austria,2,0,2,1.0,0.0,1895,1723
1992-10-14,Germany,Mexico,1,1,0,0.5,0.5,1972,1884
1992-10-14,Italy,Switzerland,2,2,0,0.5,0.5,1949,1794
1992-10-14,Lithuania,Slovakia,0,1,1,0.0,1.0,1494,1500
1992-10-14,Netherlands,Poland,2,2,0,0.5,0.5,1894,1806
1992-10-14,Northern Ireland,Spain,0,0,0,0.5,0.5,1724,1863
1992-10-14,Russia,Iceland,1,0,1,1.0,0.0,1887,1602
1992-10-14,Scotland,Portugal,0,0,0,0.5,0.5,1797,1797
1992-10-14,Turkmenistan,Kyrgyzstan,4,0,4,1.0,0.0,1497,1473
1992-10-14,Uzbekistan,Kazakhstan,1,1,0,0.5,0.5,1518,1534
1992-10-15,Saudi Arabia,United States,3,0,3,1.0,0.0,1741,1692
1992-10-16,Argentina,Ivory Coast,4,0,4,1.0,0.0,1900,1777
1992-10-18,Bermuda,El Salvador,1,0,1,1.0,0.0,1530,1611
1992-10-18,Cameroon,Eswatini,5,0,5,1.0,0.0,1742,1461
1992-10-18,Jamaica,Canada,1,1,0,0.5,0.5,1581,1628
1992-10-18,Kuwait,Iran,1,1,0,0.5,0.5,1700,1773
1992-10-18,Niger,Mali,0,2,2,0.0,1.0,1508,1633
1992-10-19,United States,Ivory Coast,5,2,3,1.0,0.0,1702,1768
1992-10-20,Saudi Arabia,Argentina,1,3,2,0.0,1.0,1737,1905
1992-10-21,South Korea,United Arab Emirates,0,0,0,0.5,0.5,1830,1658
1992-10-22,Croatia,Mexico,3,0,3,1.0,0.0,1597,1871
1992-10-22,Kuwait,Oman,4,0,4,1.0,0.0,1703,1413
1992-10-25,South Africa,Congo,1,0,1,1.0,0.0,1595,1583
1992-10-25,Benin,Morocco,0,1,1,0.0,1.0,1431,1730
1992-10-25,Bermuda,Jamaica,1,1,0,0.5,0.5,1532,1580
1992-10-25,Burundi,Ghana,1,0,1,1.0,0.0,1519,1701
1992-10-25,El Salvador,Canada,1,1,0,0.5,0.5,1612,1628
1992-10-25,Ethiopia,Tunisia,0,0,0,0.5,0.5,1599,1677
1992-10-25,Kazakhstan,Kyrgyzstan,2,0,2,1.0,0.0,1541,1467
1992-10-25,Malta,Estonia,0,0,0,0.5,0.5,1498,1380
1992-10-25,Mozambique,Senegal,0,1,1,0.0,1.0,1523,1701
1992-10-25,Namibia,Zambia,0,4,4,0.0,1.0,1472,1739
1992-10-25,Niger,Ivory Coast,0,0,0,0.5,0.5,1514,1763
1992-10-25,Eswatini,DR Congo,1,0,1,1.0,0.0,1474,1673
1992-10-25,Tanzania,Madagascar,0,0,0,0.5,0.5,1519,1627
1992-10-25,Togo,Egypt,1,4,3,0.0,1.0,1581,1764
1992-10-25,Turkmenistan,Uzbekistan,1,0,1,1.0,0.0,1506,1510
1992-10-28,Austria,Israel,5,2,3,1.0,0.0,1730,1662
1992-10-28,Belarus,Ukraine,1,1,0,0.5,0.5,1507,1517
1992-10-28,Lithuania,Latvia,1,1,0,0.5,0.5,1495,1496
1992-10-28,Russia,Luxembourg,2,0,2,1.0,0.0,1888,1341
1992-10-28,Turkey,San Marino,4,1,3,1.0,0.0,1640,1472
1992-10-29,Qatar,Thailand,1,1,0,0.5,0.5,1646,1621
1992-10-29,Saudi Arabia,China PR,1,1,0,0.5,0.5,1736,1685
1992-10-30,Japan,United Arab Emirates,0,0,0,0.5,0.5,1666,1659
1992-10-30,North Korea,Iran,0,2,2,0.0,1.0,1706,1780
1992-10-31,China PR,Thailand,0,0,0,0.5,0.5,1684,1623
1992-10-31,Saudi Arabia,Qatar,1,1,0,0.5,0.5,1734,1649
1992-11-01,Canada,Jamaica,1,0,1,1.0,0.0,1635,1574
1992-11-01,El Salvador,Bermuda,4,1,3,1.0,0.0,1619,1526
1992-11-01,Japan,North Korea,1,1,0,0.5,0.5,1667,1706
1992-11-01,United Arab Emirates,Iran,0,0,0,0.5,0.5,1662,1778
1992-11-02,China PR,Qatar,2,1,1,1.0,0.0,1692,1642
1992-11-02,Egypt,Kuwait,1,1,0,0.5,0.5,1763,1705
1992-11-02,Saudi Arabia,Thailand,4,0,4,1.0,0.0,1740,1618
1992-11-03,Japan,Iran,1,0,1,1.0,0.0,1678,1768
1992-11-03,United Arab Emirates,North Korea,2,1,1,1.0,0.0,1672,1697
1992-11-06,Japan,China PR,3,2,1,1.0,0.0,1687,1684
1992-11-06,Saudi Arabia,United Arab Emirates,2,0,2,1.0,0.0,1747,1666
1992-11-07,Tunisia,Finland,1,1,0,0.5,0.5,1676,1624
1992-11-07,Zimbabwe,Malawi,0,1,1,0.0,1.0,1655,1640
1992-11-08,Saint Vincent and the Grenadines,Mexico,0,4,4,0.0,1.0,1576,1874
1992-11-08,Canada,El Salvador,2,3,1,0.0,1.0,1627,1628
1992-11-08,China PR,United Arab Emirates,1,1,0,0.5,0.5,1684,1667
1992-11-08,Costa Rica,Honduras,2,3,1,0.0,1.0,1681,1725
1992-11-08,Jamaica,Bermuda,3,2,1,1.0,0.0,1581,1520
1992-11-08,Japan,Saudi Arabia,1,0,1,1.0,0.0,1697,1738
1992-11-08,Morocco,Egypt,0,0,0,0.5,0.5,1731,1763
1992-11-08,Sierra Leone,Senegal,2,0,2,1.0,0.0,1605,1691
1992-11-09,Zimbabwe,Malawi,4,1,3,1.0,0.0,1663,1633
1992-11-11,Albania,Latvia,1,1,0,0.5,0.5,1510,1497
1992-11-11,Bulgaria,Portugal,1,2,1,0.0,1.0,1749,1805
1992-11-11,Greece,Hungary,0,0,0,0.5,0.5,1707,1778
1992-11-11,Israel,Sweden,1,3,2,0.0,1.0,1659,1866
1992-11-14,France,Finland,2,1,1,1.0,0.0,1898,1622
1992-11-14,Romania,Czechoslovakia,1,1,0,0.5,0.5,1808,1831
1992-11-15,Saint Vincent and the Grenadines,Costa Rica,0,1,1,0.0,1.0,1571,1687
1992-11-15,Canada,Bermuda,4,2,2,1.0,0.0,1633,1515
1992-11-15,Ethiopia,Zanzibar,3,0,3,1.0,0.0,1603,1362
1992-11-15,Kenya,Uganda,1,1,0,0.5,0.5,1628,1641
1992-11-15,Mexico,Honduras,2,0,2,1.0,0.0,1879,1721
1992-11-15,Niger,Mali,0,1,1,0.0,1.0,1509,1639
1992-11-16,Tanzania,Malawi,1,1,0,0.5,0.5,1522,1631
1992-11-17,Ethiopia,Zambia,2,3,1,0.0,1.0,1598,1745
1992-11-17,United Arab Emirates,Senegal,1,1,0,0.5,0.5,1668,1691
1992-11-18,Belgium,Wales,2,0,2,1.0,0.0,1839,1760
1992-11-18,Cyprus,Slovenia,1,1,0,0.5,0.5,1426,1491
1992-11-18,England,Turkey,4,0,4,1.0,0.0,1937,1638
1992-11-18,Germany,Austria,0,0,0,0.5,0.5,1968,1735
1992-11-18,Kenya,Seychelles,2,1,1,1.0,0.0,1633,1441
1992-11-18,Northern Ireland,Denmark,0,1,1,0.0,1.0,1719,1840
1992-11-18,Poland,Latvia,1,0,1,1.0,0.0,1809,1495
1992-11-18,Scotland,Italy,0,0,0,0.5,0.5,1801,1946
1992-11-18,Spain,Republic of Ireland,0,0,0,0.5,0.5,1863,1845
1992-11-18,Switzerland,Malta,3,0,3,1.0,0.0,1797,1496
1992-11-18,Tanzania,Zanzibar,0,1,1,0.0,1.0,1511,1374
1992-11-19,Malawi,Zambia,1,0,1,1.0,0.0,1642,1735
1992-11-19,United Arab Emirates,Senegal,2,2,0,0.5,0.5,1669,1691
1992-11-20,Egypt,Kuwait,1,1,0,0.5,0.5,1762,1707
1992-11-20,Tanzania,Ethiopia,2,1,1,1.0,0.0,1521,1589
1992-11-21,Seychelles,Uganda,2,5,3,0.0,1.0,1438,1645
1992-11-21,Zambia,Zanzibar,8,0,8,1.0,0.0,1737,1373
1992-11-22,Saint Vincent and the Grenadines,Honduras,0,4,4,0.0,1.0,1567,1726
1992-11-22,Ethiopia,Malawi,1,2,1,0.0,1.0,1583,1649
1992-11-22,Jamaica,El Salvador,0,2,2,0.0,1.0,1575,1635
1992-11-22,Mexico,Costa Rica,4,0,4,1.0,0.0,1883,1684
1992-11-23,Tanzania,Zambia,1,2,1,0.0,1.0,1518,1741
1992-11-24,Algeria,United Arab Emirates,0,0,0,0.5,0.5,1788,1672
1992-11-24,Malawi,Zanzibar,3,1,2,1.0,0.0,1652,1371
1992-11-24,Peru,Ecuador,1,1,0,0.5,0.5,1620,1617
1992-11-25,Brazil,Uruguay,1,2,1,0.0,1.0,1952,1846
1992-11-25,Uganda,Zambia,0,0,0,0.5,0.5,1648,1739
1992-11-26,Argentina,Poland,2,0,2,1.0,0.0,1911,1804
1992-11-27,Qatar,Oman,2,0,2,1.0,0.0,1646,1410
1992-11-28,Honduras,Saint Vincent and the Grenadines,4,0,4,1.0,0.0,1731,1563
1992-11-28,Malawi,Zambia,0,4,4,0.0,1.0,1646,1746
1992-11-28,Saudi Arabia,Bahrain,1,2,1,0.0,1.0,1727,1565
1992-11-28,United Arab Emirates,Kuwait,0,2,2,0.0,1.0,1665,1715
1992-11-29,Costa Rica,Mexico,2,0,2,1.0,0.0,1697,1871
1992-11-29,Cyprus,Romania,1,4,3,0.0,1.0,1425,1810
1992-11-29,Uruguay,Poland,0,1,1,0.0,1.0,1838,1813
1992-11-30,Kuwait,Oman,2,1,1,1.0,0.0,1718,1408
1992-12-01,Saudi Arabia,United Arab Emirates,0,1,1,0.0,1.0,1718,1675
1992-12-01,Qatar,Bahrain,1,0,1,1.0,0.0,1653,1559
1992-12-02,China PR,Norway,2,1,1,1.0,0.0,1694,1755
1992-12-02,Guatemala,Jamaica,2,1,1,1.0,0.0,1621,1568
1992-12-02,Israel,Bulgaria,0,2,2,0.0,1.0,1654,1755
1992-12-03,Qatar,Kuwait,4,0,4,1.0,0.0,1663,1709
1992-12-04,Bahrain,United Arab Emirates,0,2,2,0.0,1.0,1554,1681
1992-12-04,Oman,Saudi Arabia,0,2,2,0.0,1.0,1406,1721
1992-12-05,Honduras,Costa Rica,2,1,1,1.0,0.0,1739,1690
1992-12-06,Mexico,Saint Vincent and the Grenadines,11,0,11,1.0,0.0,1874,1561
1992-12-06,Bermuda,Canada,0,0,0,0.5,0.5,1518,1631
1992-12-06,El Salvador,Jamaica,2,1,1,1.0,0.0,1642,1562
1992-12-06,Kuwait,Saudi Arabia,1,2,1,0.0,1.0,1702,1729
1992-12-06,Qatar,United Arab Emirates,1,0,1,1.0,0.0,1672,1673
1992-12-07,Bahrain,Oman,3,0,3,1.0,0.0,1559,1402
1992-12-08,Singapore,Malaysia,3,0,3,1.0,0.0,1566,1574
1992-12-09,Oman,United Arab Emirates,0,1,1,0.0,1.0,1400,1676
1992-12-10,Kuwait,Bahrain,0,1,1,0.0,1.0,1691,1571
1992-12-10,Qatar,Saudi Arabia,0,1,1,0.0,1.0,1666,1736
1992-12-13,Costa Rica,Saint Vincent and the Grenadines,5,0,5,1.0,0.0,1696,1556
1992-12-13,Honduras,Mexico,1,1,0,0.5,0.5,1742,1872
1992-12-13,Niger,Ghana,0,1,1,0.0,1.0,1506,1705
1992-12-16,Brazil,Germany,3,1,2,1.0,0.0,1961,1960
1992-12-16,Guinea,Sierra Leone,0,0,0,0.5,0.5,1590,1605
1992-12-16,Spain,Latvia,5,0,5,1.0,0.0,1865,1494
1992-12-16,Turkey,Netherlands,1,3,2,0.0,1.0,1636,1897
1992-12-19,Malta,Italy,1,2,1,0.0,1.0,1495,1948
1992-12-19,Tanzania,Namibia,2,0,2,1.0,0.0,1525,1466
1992-12-19,Gabon,Senegal,3,2,1,1.0,0.0,1596,1681
1992-12-20,Botswana,Niger,0,1,1,0.0,1.0,1453,1513
1992-12-20,Congo,Nigeria,0,1,1,0.0,1.0,1579,1765
1992-12-20,Ethiopia,Benin,3,1,2,1.0,0.0,1588,1427
1992-12-20,Ghana,Algeria,2,0,2,1.0,0.0,1715,1779
1992-12-20,Guinea,Kenya,4,0,4,1.0,0.0,1599,1625
1992-12-20,Madagascar,Zambia,2,0,2,1.0,0.0,1638,1736
1992-12-20,Tunisia,Morocco,1,1,0,0.5,0.5,1678,1730
1992-12-20,Uruguay,Germany,1,4,3,0.0,1.0,1833,1966
1992-12-20,Zimbabwe,Egypt,2,1,1,1.0,0.0,1674,1752
1992-12-22,Cyprus,Georgia,1,0,1,1.0,0.0,1436,1505
1992-12-26,Burkina Faso,Mali,3,1,2,1.0,0.0,1591,1630
1993-01-01,Ghana,Mali,1,1,0,0.5,0.5,1714,1632
1993-01-02,Gabon,Burkina Faso,1,1,0,0.5,0.5,1596,1592
1993-01-02,Kuwait,Lebanon,2,0,2,1.0,0.0,1695,1471
1993-01-03,Burkina Faso,Mali,1,0,1,1.0,0.0,1601,1624
1993-01-03,Gabon,Ghana,2,3,1,0.0,1.0,1591,1720
1993-01-08,Uganda,Tanzania,3,1,2,1.0,0.0,1654,1520
1993-01-10,Angola,Zimbabwe,1,1,0,0.5,0.5,1562,1672
1993-01-10,Botswana,South Africa,0,2,2,0.0,1.0,1449,1600
1993-01-10,DR Congo,Cameroon,1,2,1,0.0,1.0,1667,1749
1993-01-10,Senegal,Algeria,1,2,1,0.0,1.0,1676,1785
1993-01-10,Tunisia,Bulgaria,3,0,3,1.0,0.0,1688,1746
1993-01-10,Uganda,Tanzania,2,0,2,1.0,0.0,1660,1515
1993-01-16,South Africa,Nigeria,0,0,0,0.5,0.5,1604,1762
1993-01-16,Tanzania,Zambia,1,3,2,0.0,1.0,1512,1740
1993-01-17,Benin,Tunisia,0,5,5,0.0,1.0,1425,1691
1993-01-17,Botswana,Ivory Coast,0,0,0,0.5,0.5,1455,1758
1993-01-17,Burundi,Algeria,0,0,0,0.5,0.5,1525,1780
1993-01-17,Ethiopia,Morocco,0,1,1,0.0,1.0,1584,1735
1993-01-17,Mozambique,Gabon,1,1,0,0.5,0.5,1525,1590
1993-01-17,Namibia,Madagascar,0,1,1,0.0,1.0,1462,1643
1993-01-17,Eswatini,Cameroon,0,0,0,0.5,0.5,1480,1744
1993-01-17,Togo,Zimbabwe,1,2,1,0.0,1.0,1576,1678
1993-01-18,Angola,Egypt,0,0,0,0.5,0.5,1566,1749
1993-01-19,North Korea,Bolivia,2,1,1,1.0,0.0,1703,1582
1993-01-20,Guinea-Bissau,Guinea,2,1,1,1.0,0.0,1529,1590
1993-01-20,India,Finland,0,0,0,0.5,0.5,1522,1620
1993-01-20,Italy,Mexico,2,0,2,1.0,0.0,1955,1866
1993-01-20,Zambia,Namibia,4,0,4,1.0,0.0,1743,1460
1993-01-22,Cameroon,Finland,0,0,0,0.5,0.5,1742,1623
1993-01-23,Japan,Switzerland,1,1,0,0.5,0.5,1700,1795
1993-01-23,Ghana,Niger,4,0,4,1.0,0.0,1724,1510
1993-01-23,Guinea-Bissau,Algeria,1,4,3,0.0,1.0,1526,1784
1993-01-23,Venezuela,Peru,0,0,0,0.5,0.5,1457,1617
1993-01-24,India,Cameroon,1,1,0,0.5,0.5,1527,1738
1993-01-24,Malta,Portugal,0,1,1,0.0,1.0,1493,1808
1993-01-25,Bolivia,Russia,1,2,1,0.0,1.0,1580,1891
1993-01-26,India,Finland,0,2,2,0.0,1.0,1522,1629
1993-01-27,Ecuador,Belarus,1,1,0,0.5,0.5,1615,1510
1993-01-27,Peru,Honduras,1,1,0,0.5,0.5,1620,1740
1993-01-27,Spain,Mexico,1,1,0,0.5,0.5,1866,1866
1993-01-28,Cameroon,Finland,2,0,2,1.0,0.0,1744,1624
1993-01-29,Bolivia,Honduras,3,1,2,1.0,0.0,1592,1729
1993-01-30,India,Cameroon,2,2,0,0.5,0.5,1527,1740
1993-01-30,Peru,Belarus,1,1,0,0.5,0.5,1618,1513
1993-01-30,Senegal,Mozambique,6,1,5,1.0,0.0,1681,1521
1993-01-30,United States,Denmark,2,2,0,0.5,0.5,1706,1837
1993-01-31,Congo,South Africa,0,1,1,0.0,1.0,1572,1612
1993-01-31,Ecuador,Romania,3,0,3,1.0,0.0,1628,1798
1993-01-31,Egypt,Togo,3,0,3,1.0,0.0,1754,1572
1993-01-31,Ghana,Burundi,1,0,1,1.0,0.0,1728,1522
1993-01-31,Ivory Coast,Niger,1,0,1,1.0,0.0,1762,1507
1993-01-31,North Korea,Finland,3,2,1,1.0,0.0,1710,1618
1993-01-31,Morocco,Benin,5,0,5,1.0,0.0,1738,1423
1993-01-31,Tunisia,Ethiopia,3,0,3,1.0,0.0,1697,1579
1993-01-31,Zimbabwe,Angola,2,1,1,1.0,0.0,1684,1561
1993-02-01,Cyprus,Poland,0,0,0,0.5,0.5,1443,1807
1993-02-03,Israel,Poland,0,0,0,0.5,0.5,1658,1804
1993-02-03,Peru,Romania,0,2,2,0.0,1.0,1614,1803
1993-02-05,Malaysia,Singapore,2,1,1,1.0,0.0,1582,1559
1993-02-06,Ghana,Indonesia,2,0,2,1.0,0.0,1733,1559
1993-02-06,United States,Romania,1,1,0,0.5,0.5,1709,1801
1993-02-07,Malaysia,Thailand,1,1,0,0.5,0.5,1583,1618
1993-02-09,Singapore,Thailand,1,1,0,0.5,0.5,1561,1617
1993-02-10,Mexico,Romania,0,2,2,0.0,1.0,1857,1811
1993-02-10,Portugal,Norway,1,1,0,0.5,0.5,1807,1757
1993-02-10,Thailand,China PR,1,0,1,1.0,0.0,1627,1685
1993-02-13,Cyprus,Belgium,0,3,3,0.0,1.0,1442,1841
1993-02-13,United States,Russia,0,1,1,0.0,1.0,1705,1896
1993-02-16,Costa Rica,Nicaragua,6,0,6,1.0,0.0,1698,1342
1993-02-16,Thailand,China PR,0,4,4,0.0,1.0,1621,1692
1993-02-17,Albania,Northern Ireland,1,2,1,0.0,1.0,1507,1723
1993-02-17,El Salvador,Russia,1,2,1,0.0,1.0,1639,1900
1993-02-17,England,San Marino,6,0,6,1.0,0.0,1939,1471
1993-02-17,Greece,Luxembourg,2,0,2,1.0,0.0,1709,1340
1993-02-17,Republic of Ireland,Wales,2,1,1,1.0,0.0,1852,1754
1993-02-17,Israel,France,0,4,4,0.0,1.0,1655,1902
1993-02-17,Scotland,Malta,3,0,3,1.0,0.0,1804,1491
1993-02-18,Argentina,Brazil,1,1,0,0.5,0.5,1913,1960
1993-02-18,United Arab Emirates,Bulgaria,1,0,1,1.0,0.0,1686,1737
1993-02-19,Costa Rica,Nicaragua,2,0,2,1.0,0.0,1700,1341
1993-02-20,Finland,Estonia,0,0,0,0.5,0.5,1614,1385
1993-02-20,Latvia,Lithuania,1,2,1,0.0,1.0,1487,1503
1993-02-20,United Arab Emirates,Bulgaria,1,3,2,0.0,1.0,1680,1744
1993-02-21,Estonia,Latvia,0,2,2,0.0,1.0,1380,1493
1993-02-21,Finland,Lithuania,3,0,3,1.0,0.0,1620,1498
1993-02-21,United States,Russia,0,0,0,0.5,0.5,1710,1896
1993-02-24,Argentina,Denmark,1,1,0,0.5,0.5,1912,1839
1993-02-24,Kuwait,China PR,1,0,1,1.0,0.0,1703,1685
1993-02-24,Netherlands,Turkey,3,1,2,1.0,0.0,1900,1634
1993-02-24,Portugal,Italy,1,3,2,0.0,1.0,1803,1960
1993-02-24,Spain,Lithuania,5,0,5,1.0,0.0,1868,1497
1993-02-24,Venezuela,Colombia,0,0,0,0.5,0.5,1463,1760
1993-02-26,Algeria,Ghana,2,1,1,1.0,0.0,1791,1727
1993-02-27,Kenya,Guinea,2,0,2,1.0,0.0,1633,1583
1993-02-27,Nigeria,Congo,2,0,2,1.0,0.0,1767,1568
1993-02-27,Senegal,Gabon,1,0,1,1.0,0.0,1687,1585
1993-02-27,Zambia,Madagascar,3,1,2,1.0,0.0,1749,1638
1993-02-28,Benin,Ethiopia,1,0,1,1.0,0.0,1435,1568
1993-02-28,Morocco,Tunisia,0,0,0,0.5,0.5,1738,1698
1993-02-28,Niger,Botswana,2,1,1,1.0,0.0,1514,1449
1993-02-28,Togo,Angola,0,1,1,0.0,1.0,1564,1570
1993-03-01,Cameroon,DR Congo,0,0,0,0.5,0.5,1739,1669
1993-03-02,Jordan,Syria,1,1,0,0.5,0.5,1536,1585
1993-03-03,Martinique,French Guiana,2,1,1,1.0,0.0,1614,1466
1993-03-03,Paraguay,Bolivia,1,0,1,1.0,0.0,1774,1588
1993-03-05,El Salvador,Costa Rica,0,1,1,0.0,1.0,1633,1707
1993-03-05,Honduras,Panama,2,0,2,1.0,0.0,1733,1492
1993-03-07,El Salvador,Panama,1,1,0,0.5,0.5,1630,1496
1993-03-07,Honduras,Costa Rica,2,0,2,1.0,0.0,1741,1700
1993-03-07,Japan,Hungary,0,1,1,0.0,1.0,1694,1785
1993-03-09,Canada,South Korea,0,2,2,0.0,1.0,1628,1834
1993-03-09,Costa Rica,Panama,2,0,2,1.0,0.0,1704,1493
1993-03-09,Honduras,El Salvador,3,0,3,1.0,0.0,1747,1625
1993-03-10,Austria,Greece,2,1,1,1.0,0.0,1743,1702
1993-03-10,Hungary,United States,0,0,0,0.5,0.5,1784,1712
1993-03-10,San Marino,Turkey,0,0,0,0.5,0.5,1475,1631
1993-03-11,Canada,South Korea,2,0,2,1.0,0.0,1641,1822
1993-03-11,Guyana,Cayman Islands,3,2,1,1.0,0.0,1488,1455
1993-03-11,Puerto Rico,Barbados,1,0,1,1.0,0.0,1381,1526
1993-03-12,Cayman Islands,Barbados,1,6,5,0.0,1.0,1449,1533
1993-03-12,El Salvador,Bolivia,2,2,0,0.5,0.5,1625,1589
1993-03-12,Guyana,Puerto Rico,0,2,2,0.0,1.0,1478,1392
1993-03-12,Qatar,Jordan,1,2,1,0.0,1.0,1656,1547
1993-03-14,Guyana,Barbados,0,3,3,0.0,1.0,1472,1540
1993-03-14,Honduras,Bolivia,0,0,0,0.5,0.5,1744,1593
1993-03-14,Japan,United States,3,1,2,1.0,0.0,1703,1704
1993-03-14,Puerto Rico,Cayman Islands,4,0,4,1.0,0.0,1402,1440
1993-03-16,Honduras,Bolivia,0,0,0,0.5,0.5,1741,1597
1993-03-16,Kuwait,Syria,2,1,1,1.0,0.0,1709,1580
1993-03-17,Brazil,Poland,2,2,0,0.5,0.5,1957,1808
1993-03-17,Tunisia,Switzerland,0,1,1,0.0,1.0,1693,1801
1993-03-20,Alderney,Guernsey,0,10,10,0.0,1.0,1293,1640
1993-03-23,El Salvador,United States,2,2,0,0.5,0.5,1627,1703
1993-03-24,Costa Rica,Canada,0,1,1,0.0,1.0,1695,1651
1993-03-24,Cyprus,Czech Republic,1,1,0,0.5,0.5,1444,1499
1993-03-24,French Guiana,Guadeloupe,2,1,1,1.0,0.0,1476,1522
1993-03-24,Israel,Russia,2,2,0,0.5,0.5,1660,1892
1993-03-24,Italy,Malta,6,1,5,1.0,0.0,1962,1490
1993-03-24,Netherlands,San Marino,6,0,6,1.0,0.0,1902,1474
1993-03-24,Scotland,Germany,0,1,1,0.0,1.0,1800,1971
1993-03-25,Honduras,United States,4,1,3,1.0,0.0,1749,1696
1993-03-26,Lebanon,Jordan,1,0,1,1.0,0.0,1481,1538
1993-03-27,Austria,France,0,1,1,0.0,1.0,1739,1907
1993-03-27,Malawi,Zambia,1,0,1,1.0,0.0,1657,1739
1993-03-30,Qatar,Norway,1,6,5,0.0,1.0,1651,1763
1993-03-30,Slovakia,Lithuania,2,2,0,0.5,0.5,1500,1498
1993-03-31,Chile,Bolivia,2,1,1,1.0,0.0,1780,1593
1993-03-31,Colombia,Costa Rica,4,1,3,1.0,0.0,1767,1689
1993-03-31,Denmark,Spain,1,0,1,1.0,0.0,1848,1860
1993-03-31,Hungary,Greece,0,1,1,0.0,1.0,1775,1712
1993-03-31,Republic of Ireland,Northern Ireland,3,0,3,1.0,0.0,1858,1718
1993-03-31,Poland,Lithuania,1,1,0,0.5,0.5,1803,1504
1993-03-31,Switzerland,Portugal,1,1,0,0.5,0.5,1802,1803
1993-03-31,Turkey,England,0,2,2,0.0,1.0,1629,1942
1993-03-31,Wales,Belgium,2,0,2,1.0,0.0,1764,1832
1993-04-02,Malaysia,United Arab Emirates,0,1,1,0.0,1.0,1578,1686
1993-04-02,Saint Kitts and Nevis,British Virgin Islands,5,1,4,1.0,0.0,1516,1473
1993-04-03,Niger,Benin,2,2,0,0.5,0.5,1513,1437
1993-04-04,Anguilla,Antigua and Barbuda,0,4,4,0.0,1.0,1463,1486
1993-04-04,Dominican Republic,British Virgin Islands,3,1,2,1.0,0.0,1467,1465
1993-04-04,El Salvador,Mexico,2,1,1,1.0,0.0,1640,1845
1993-04-04,Honduras,Canada,2,2,0,0.5,0.5,1747,1654
1993-04-04,Kuwait,Egypt,1,3,2,0.0,1.0,1703,1761
1993-04-05,Antigua and Barbuda,Sint Maarten,0,2,2,0.0,1.0,1479,1502
1993-04-06,Anguilla,Sint Maarten,0,1,1,0.0,1.0,1456,1510
1993-04-06,Saint Kitts and Nevis,Dominican Republic,2,2,0,0.5,0.5,1515,1469
1993-04-07,Slovenia,Estonia,2,0,2,1.0,0.0,1497,1375
1993-04-08,Japan,Thailand,1,0,1,1.0,0.0,1710,1615
1993-04-08,Sri Lanka,United Arab Emirates,0,4,4,0.0,1.0,1355,1689
1993-04-09,Algeria,Sierra Leone,0,0,0,0.5,0.5,1788,1609
1993-04-09,Egypt,Mali,2,1,1,1.0,0.0,1766,1620
1993-04-09,North Korea,Vietnam,3,0,3,1.0,0.0,1714,1482
1993-04-09,Oman,Malaysia,1,0,1,1.0,0.0,1412,1567
1993-04-09,Qatar,Indonesia,3,1,2,1.0,0.0,1657,1554
1993-04-10,South Africa,Mauritius,0,0,0,0.5,0.5,1610,1522
1993-04-10,Zambia,Zimbabwe,0,0,0,0.5,0.5,1738,1686
1993-04-10,Ghana,Liberia,0,0,0,0.5,0.5,1724,1549
1993-04-11,Canada,El Salvador,2,0,2,1.0,0.0,1662,1633
1993-04-11,Ethiopia,Nigeria,1,0,1,1.0,0.0,1581,1755
1993-04-11,Gabon,Benin,2,0,2,1.0,0.0,1590,1433
1993-04-11,Guinea,Congo,1,0,1,1.0,0.0,1591,1561
1993-04-11,Guinea-Bissau,Senegal,0,3,3,0.0,1.0,1522,1692
1993-04-11,Japan,Bangladesh,8,0,8,1.0,0.0,1714,1457
1993-04-11,North Korea,Singapore,2,1,1,1.0,0.0,1719,1557
1993-04-11,Lesotho,DR Congo,1,1,0,0.5,0.5,1459,1665
1993-04-11,Mexico,Honduras,3,0,3,1.0,0.0,1851,1742
1993-04-11,Morocco,Malawi,0,1,1,0.0,1.0,1729,1667
1993-04-11,Mozambique,Kenya,0,0,0,0.5,0.5,1524,1631
1993-04-11,Niger,Cameroon,0,0,0,0.5,0.5,1518,1735
1993-04-11,Sudan,Uganda,1,1,0,0.5,0.5,1566,1658
1993-04-11,Qatar,Vietnam,4,0,4,1.0,0.0,1662,1478
1993-04-11,Thailand,Sri Lanka,1,0,1,1.0,0.0,1618,1353
1993-04-13,North Korea,Indonesia,4,0,4,1.0,0.0,1724,1550
1993-04-13,Poland,Finland,2,1,1,1.0,0.0,1808,1616
1993-04-13,Sri Lanka,Bangladesh,0,1,1,0.0,1.0,1348,1463
1993-04-13,United Arab Emirates,Thailand,1,0,1,1.0,0.0,1696,1612
1993-04-13,Vietnam,Singapore,2,3,1,0.0,1.0,1472,1564
1993-04-14,Austria,Bulgaria,3,1,2,1.0,0.0,1748,1736
1993-04-14,Denmark,Latvia,2,0,2,1.0,0.0,1850,1492
1993-04-14,Germany,Ghana,6,1,5,1.0,0.0,1975,1721
1993-04-14,Guadeloupe,Martinique,1,4,3,0.0,1.0,1517,1620
1993-04-14,Italy,Estonia,2,0,2,1.0,0.0,1963,1375
1993-04-14,Lithuania,Albania,3,1,2,1.0,0.0,1513,1499
1993-04-14,Luxembourg,Russia,0,4,4,0.0,1.0,1340,1893
1993-04-14,Romania,Cyprus,2,1,1,1.0,0.0,1813,1443
1993-04-15,Egypt,Zimbabwe,0,0,0,0.5,0.5,1765,1688
1993-04-15,Hungary,Sweden,0,2,2,0.0,1.0,1770,1872
1993-04-15,Japan,Sri Lanka,5,0,5,1.0,0.0,1716,1347
1993-04-15,United Arab Emirates,Bangladesh,1,0,1,1.0,0.0,1700,1460
1993-04-16,Algeria,Ivory Coast,1,1,0,0.5,0.5,1788,1763
1993-04-16,Australia,Kuwait,1,0,1,1.0,0.0,1784,1697
1993-04-16,Qatar,Singapore,4,1,3,1.0,0.0,1668,1559
1993-04-16,Vietnam,Indonesia,1,0,1,1.0,0.0,1482,1541
1993-04-17,Malta,Switzerland,0,2,2,0.0,1.0,1488,1805
1993-04-17,United States,Iceland,1,1,0,0.5,0.5,1694,1605
1993-04-18,Cameroon,Guinea,3,1,2,1.0,0.0,1740,1587
1993-04-18,Canada,Honduras,3,1,2,1.0,0.0,1672,1733
1993-04-18,Indonesia,Singapore,0,2,2,0.0,1.0,1534,1567
1993-04-18,Japan,United Arab Emirates,2,0,2,1.0,0.0,1724,1693
1993-04-18,Mexico,El Salvador,3,1,2,1.0,0.0,1855,1630
1993-04-18,Morocco,Senegal,1,0,1,1.0,0.0,1737,1685
1993-04-18,Qatar,North Korea,1,2,1,0.0,1.0,1662,1731
1993-04-18,Saudi Arabia,New Zealand,3,1,2,1.0,0.0,1744,1698
1993-04-18,Thailand,Bangladesh,4,1,3,1.0,0.0,1617,1456
1993-04-19,Australia,Kuwait,1,3,2,0.0,1.0,1775,1707
1993-04-22,Singapore,Saudi Arabia,0,3,3,0.0,1.0,1563,1749
1993-04-23,Hong Kong,Kuwait,2,2,0,0.5,0.5,1569,1704
1993-04-23,Nigeria,Sudan,4,0,4,1.0,0.0,1760,1562
1993-04-23,Egypt,Malawi,2,0,2,1.0,0.0,1771,1662
1993-04-24,Indonesia,Qatar,1,4,3,0.0,1.0,1529,1668
1993-04-24,Kenya,Lesotho,3,0,3,1.0,0.0,1636,1455
1993-04-24,Saudi Arabia,New Zealand,1,0,1,1.0,0.0,1756,1692
1993-04-24,Sierra Leone,Guinea-Bissau,2,0,2,1.0,0.0,1616,1516
1993-04-24,South Africa,Zimbabwe,1,1,0,0.5,0.5,1612,1687
1993-04-24,Vietnam,North Korea,0,1,1,0.0,1.0,1479,1735
1993-04-25,Cameroon,Gabon,0,0,0,0.5,0.5,1737,1594
1993-04-25,Congo,Burundi,0,0,0,0.5,0.5,1561,1523
1993-04-25,Cyprus,Faroe Islands,3,1,2,1.0,0.0,1453,1509
1993-04-25,Ethiopia,Uganda,2,2,0,0.5,0.5,1583,1657
1993-04-25,Grenada,Dominica,1,1,0,0.5,0.5,1531,1437
1993-04-25,Honduras,El Salvador,2,0,2,1.0,0.0,1739,1625
1993-04-25,Hong Kong,Kuwait,0,1,1,0.0,1.0,1564,1710
1993-04-25,South Korea,Iraq,1,1,0,0.5,0.5,1821,1763
1993-04-25,Mauritius,Zambia,0,3,3,0.0,1.0,1519,1742
1993-04-25,Mexico,Canada,4,0,4,1.0,0.0,1860,1668
1993-04-25,Morocco,Mali,1,0,1,1.0,0.0,1743,1615
1993-04-25,Mozambique,DR Congo,0,0,0,0.5,0.5,1528,1662
1993-04-25,Niger,Benin,4,1,3,1.0,0.0,1525,1427
1993-04-25,Saint Vincent and the Grenadines,Saint Lucia,0,1,1,0.0,1.0,1547,1518
1993-04-26,Singapore,North Korea,1,3,2,0.0,1.0,1559,1740
1993-04-26,Vietnam,Qatar,0,4,4,0.0,1.0,1475,1673
1993-04-27,Dominica,Saint Lucia,2,4,2,0.0,1.0,1431,1525
1993-04-27,Ukraine,Israel,1,1,0,0.5,0.5,1521,1657
1993-04-28,Bulgaria,Finland,2,0,2,1.0,0.0,1742,1611
1993-04-28,Czech Republic,Wales,1,1,0,0.5,0.5,1505,1759
1993-04-28,England,Netherlands,2,2,0,0.5,0.5,1942,1903
1993-04-28,France,Sweden,2,1,1,1.0,0.0,1915,1865
1993-04-28,Indonesia,North Korea,1,2,1,0.0,1.0,1526,1744
1993-04-28,Republic of Ireland,Denmark,1,1,0,0.5,0.5,1858,1851
1993-04-28,South Korea,Iraq,2,2,0,0.5,0.5,1820,1765
1993-04-28,Norway,Turkey,3,1,2,1.0,0.0,1769,1624
1993-04-28,Poland,San Marino,1,0,1,1.0,0.0,1811,1472
1993-04-28,Portugal,Scotland,5,0,5,1.0,0.0,1811,1793
1993-04-28,Russia,Hungary,3,0,3,1.0,0.0,1899,1765
1993-04-28,Singapore,Vietnam,1,0,1,1.0,0.0,1566,1469
1993-04-28,Spain,Northern Ireland,3,1,2,1.0,0.0,1865,1714
1993-04-28,Thailand,Japan,0,1,1,0.0,1.0,1612,1730
1993-04-28,United Arab Emirates,Sri Lanka,3,0,3,1.0,0.0,1695,1346
1993-04-29,Dominica,Saint Vincent and the Grenadines,0,2,2,0.0,1.0,1426,1553
1993-04-29,Grenada,Saint Lucia,0,1,1,0.0,1.0,1523,1534
1993-04-30,Bangladesh,Japan,1,4,3,0.0,1.0,1454,1733
1993-04-30,Indonesia,Vietnam,2,1,1,1.0,0.0,1533,1463
1993-04-30,Singapore,Qatar,1,0,1,1.0,0.0,1577,1663
1993-04-30,United Arab Emirates,Thailand,2,1,1,1.0,0.0,1702,1606
1993-05-01,Macau,Saudi Arabia,0,6,6,0.0,1.0,1447,1759
1993-05-01,Malaysia,Kuwait,1,1,0,0.5,0.5,1571,1707
1993-05-01,Switzerland,Italy,1,0,1,1.0,0.0,1817,1952
1993-05-02,El Salvador,Canada,1,2,1,0.0,1.0,1618,1676
1993-05-02,Guinea,Zimbabwe,3,0,3,1.0,0.0,1598,1677
1993-05-02,Honduras,Mexico,1,4,3,0.0,1.0,1734,1866
1993-05-02,Ivory Coast,Nigeria,2,1,1,1.0,0.0,1771,1753
1993-05-02,North Korea,Qatar,2,2,0,0.5,0.5,1743,1665
1993-05-02,Singapore,Indonesia,2,1,1,1.0,0.0,1584,1527
1993-05-03,Macau,Kuwait,1,10,9,0.0,1.0,1445,1710
1993-05-03,Malaysia,Saudi Arabia,1,1,0,0.5,0.5,1575,1756
1993-05-03,Sri Lanka,Thailand,0,3,3,0.0,1.0,1344,1609
1993-05-03,United Arab Emirates,Bangladesh,7,0,7,1.0,0.0,1706,1451
1993-05-03,Guernsey,Jersey,1,2,1,0.0,1.0,1634,1703
1993-05-05,Bangladesh,Thailand,1,4,3,0.0,1.0,1447,1614
1993-05-05,Kuwait,Saudi Arabia,0,0,0,0.5,0.5,1712,1755
1993-05-05,Malaysia,Macau,9,0,9,1.0,0.0,1581,1440
1993-05-05,Sri Lanka,Japan,0,6,6,0.0,1.0,1343,1735
1993-05-07,Bangladesh,Sri Lanka,3,0,3,1.0,0.0,1453,1338
1993-05-07,Hong Kong,Bahrain,2,1,1,1.0,0.0,1573,1563
1993-05-07,Lebanon,India,2,2,0,0.5,0.5,1483,1526
1993-05-07,United Arab Emirates,Japan,1,1,0,0.5,0.5,1707,1735
1993-05-08,United States,Colombia,1,2,1,0.0,1.0,1688,1774
1993-05-09,Bahrain,South Korea,0,0,0,0.5,0.5,1569,1815
1993-05-09,Canada,Mexico,1,2,1,0.0,1.0,1672,1871
1993-05-09,El Salvador,Honduras,2,1,1,1.0,0.0,1629,1724
1993-05-09,Lebanon,Hong Kong,2,2,0,0.5,0.5,1486,1571
1993-05-10,China PR,Mongolia,6,1,5,1.0,0.0,1689,1471
1993-05-11,India,Hong Kong,1,2,1,0.0,1.0,1520,1578
1993-05-11,Lebanon,South Korea,0,1,1,0.0,1.0,1484,1818
1993-05-12,Bulgaria,Israel,2,2,0,0.5,0.5,1741,1659
1993-05-12,Estonia,Malta,0,1,1,0.0,1.0,1370,1494
1993-05-12,North Korea,Mongolia,7,0,7,1.0,0.0,1746,1469
1993-05-12,China PR,Macau,11,0,11,1.0,0.0,1693,1437
1993-05-13,Finland,Austria,3,1,2,1.0,0.0,1623,1737
1993-05-13,India,South Korea,0,3,3,0.0,1.0,1518,1821
1993-05-13,Lebanon,Bahrain,0,0,0,0.5,0.5,1486,1568
1993-05-14,Kuwait,Malaysia,2,0,2,1.0,0.0,1718,1576
1993-05-14,Saudi Arabia,Macau,8,0,8,1.0,0.0,1758,1435
1993-05-14,China PR,North Korea,1,1,0,0.5,0.5,1695,1745
1993-05-15,Bahrain,India,2,1,1,1.0,0.0,1575,1512
1993-05-15,Hong Kong,South Korea,0,3,3,0.0,1.0,1575,1825
1993-05-15,Latvia,Albania,0,0,0,0.5,0.5,1493,1499
1993-05-16,Kuwait,Macau,8,0,8,1.0,0.0,1721,1433
1993-05-16,Saudi Arabia,Malaysia,3,0,3,1.0,0.0,1763,1572
1993-05-16,North Korea,Macau,6,0,6,1.0,0.0,1748,1431
1993-05-18,Lithuania,Ukraine,1,2,1,0.0,1.0,1506,1529
1993-05-18,Macau,Malaysia,0,5,5,0.0,1.0,1427,1577
1993-05-18,Saudi Arabia,Kuwait,2,0,2,1.0,0.0,1771,1714
1993-05-18,Mongolia,Macau,4,3,1,1.0,0.0,1477,1420
1993-05-19,Estonia,Scotland,0,3,3,0.0,1.0,1369,1795
1993-05-19,San Marino,Poland,0,3,3,0.0,1.0,1471,1813
1993-05-19,Sweden,Austria,1,0,1,1.0,0.0,1871,1732
1993-05-20,Guadeloupe,Réunion,0,3,3,0.0,1.0,1509,1511
1993-05-20,Luxembourg,Iceland,1,1,0,0.5,0.5,1346,1600
1993-05-20,Zambia,Malawi,1,1,0,0.5,0.5,1741,1664
1993-05-21,Colombia,Venezuela,1,1,0,0.5,0.5,1769,1469
1993-05-21,Jamaica,Saint Kitts and Nevis,4,1,3,1.0,0.0,1569,1509
1993-05-21,Martinique,Saint Lucia,2,0,2,1.0,0.0,1627,1528
1993-05-21,Puerto Rico,Sint Maarten,3,0,3,1.0,0.0,1413,1500
1993-05-22,Belgium,Faroe Islands,3,0,3,1.0,0.0,1835,1507
1993-05-22,Burkina Faso,Guadeloupe,2,0,2,1.0,0.0,1607,1504
1993-05-22,Jordan,Yemen,1,1,0,0.5,0.5,1536,1416
1993-05-22,New Zealand,Fiji,2,0,2,1.0,0.0,1699,1621
1993-05-22,Pakistan,China PR,0,5,5,0.0,1.0,1461,1699
1993-05-22,Zambia,Malawi,0,1,1,0.0,1.0,1732,1674
1993-05-23,Jamaica,Sint Maarten,2,0,2,1.0,0.0,1576,1494
1993-05-23,Russia,Greece,1,1,0,0.5,0.5,1896,1716
1993-05-23,Saint Kitts and Nevis,Puerto Rico,1,0,1,1.0,0.0,1515,1408
1993-05-23,Trinidad and Tobago,Saint Lucia,1,1,0,0.5,0.5,1643,1531
1993-05-23,United States,Bolivia,0,0,0,0.5,0.5,1686,1596
1993-05-24,Jordan,Iraq,1,1,0,0.5,0.5,1541,1761
1993-05-24,New Zealand,Fiji,5,0,5,1.0,0.0,1706,1615
1993-05-24,Yemen,Pakistan,5,1,4,1.0,0.0,1426,1452
1993-05-24,Zambia,Malawi,4,2,2,1.0,0.0,1739,1668
1993-05-25,Azerbaijan,Georgia,1,0,1,1.0,0.0,1493,1497
1993-05-25,Jamaica,Puerto Rico,1,0,1,1.0,0.0,1581,1404
1993-05-25,Lithuania,Northern Ireland,0,1,1,0.0,1.0,1503,1718
1993-05-25,Martinique,Trinidad and Tobago,3,2,1,1.0,0.0,1636,1635
1993-05-25,Saint Kitts and Nevis,Sint Maarten,2,2,0,0.5,0.5,1515,1495
1993-05-25,Saint Vincent and the Grenadines,Saint Lucia,4,1,3,1.0,0.0,1561,1524
1993-05-26,Albania,Republic of Ireland,1,2,1,0.0,1.0,1498,1860
1993-05-26,Ethiopia,Sudan,1,1,0,0.5,0.5,1583,1563
1993-05-26,Jordan,China PR,0,3,3,0.0,1.0,1537,1704
1993-05-26,United States,Peru,0,0,0,0.5,0.5,1685,1616
1993-05-26,Yemen,Iraq,1,6,5,0.0,1.0,1424,1764
1993-05-27,Bolivia,Paraguay,2,1,1,1.0,0.0,1608,1763
1993-05-28,Jamaica,Trinidad and Tobago,3,0,3,1.0,0.0,1591,1626
1993-05-28,Martinique,Saint Kitts and Nevis,1,1,0,0.5,0.5,1634,1518
1993-05-28,Pakistan,Iraq,0,8,8,0.0,1.0,1450,1767
1993-05-28,Yemen,China PR,1,0,1,1.0,0.0,1438,1691
1993-05-29,Republic of Ireland,Hungary,2,4,2,0.0,1.0,1850,1776
1993-05-29,Poland,England,1,1,0,0.5,0.5,1816,1940
1993-05-30,Chile,Colombia,1,1,0,0.5,0.5,1780,1770
1993-05-30,Ecuador,Peru,1,0,1,1.0,0.0,1636,1609
1993-05-30,Iraq,China PR,1,0,1,1.0,0.0,1774,1685
1993-05-30,Jamaica,Martinique,0,0,0,0.5,0.5,1592,1634
1993-05-30,Jordan,Pakistan,3,1,2,1.0,0.0,1544,1444
1993-05-30,New Zealand,Australia,0,1,1,0.0,1.0,1700,1782
1993-05-30,Trinidad and Tobago,Saint Kitts and Nevis,3,2,1,1.0,0.0,1632,1513
1993-06-02,Czech Republic,Romania,5,2,3,1.0,0.0,1519,1800
1993-06-02,Denmark,Albania,4,0,4,1.0,0.0,1853,1497
1993-06-02,Iceland,Russia,1,1,0,0.5,0.5,1606,1891
1993-06-02,Latvia,Northern Ireland,1,2,1,0.0,1.0,1490,1722
1993-06-02,Lithuania,Spain,0,2,2,0.0,1.0,1502,1867
1993-06-02,Norway,England,2,0,2,1.0,0.0,1781,1929
1993-06-02,Scotland,Estonia,3,1,2,1.0,0.0,1797,1368
1993-06-02,Sweden,Israel,5,0,5,1.0,0.0,1875,1656
1993-06-02,Turkmenistan,Tajikistan,6,0,6,1.0,0.0,1514,1493
1993-06-05,Bahrain,Lebanon,0,0,0,0.5,0.5,1573,1489
1993-06-05,South Korea,Hong Kong,4,1,3,1.0,0.0,1829,1572
1993-06-06,Australia,New Zealand,3,0,3,1.0,0.0,1789,1694
1993-06-06,Azerbaijan,Tajikistan,2,0,2,1.0,0.0,1501,1485
1993-06-06,Colombia,Chile,1,0,1,1.0,0.0,1779,1772
1993-06-06,Faroe Islands,Wales,0,3,3,0.0,1.0,1504,1763
1993-06-06,Iran,Pakistan,5,0,5,1.0,0.0,1771,1442
1993-06-06,Peru,Bolivia,1,0,1,1.0,0.0,1617,1601
1993-06-06,United States,Brazil,0,2,2,0.0,1.0,1683,1960
1993-06-07,Azerbaijan,Kyrgyzstan,3,2,1,1.0,0.0,1509,1460
1993-06-07,India,Bahrain,0,3,3,0.0,1.0,1506,1580
1993-06-07,South Korea,Lebanon,2,0,2,1.0,0.0,1831,1488
1993-06-07,Pakistan,Turkmenistan,0,4,4,0.0,1.0,1436,1521
1993-06-07,Thailand,Myanmar,2,0,2,1.0,0.0,1622,1578
1993-06-07,Laos,Brunei,3,2,1,1.0,0.0,1392,1376
1993-06-08,Iran,Turkmenistan,2,1,1,1.0,0.0,1775,1518
1993-06-08,Kyrgyzstan,Tajikistan,1,1,0,0.5,0.5,1461,1485
1993-06-09,Ecuador,Chile,1,2,1,0.0,1.0,1631,1778
1993-06-09,Hong Kong,Lebanon,1,2,1,0.0,1.0,1563,1498
1993-06-09,South Korea,India,7,0,7,1.0,0.0,1834,1504
1993-06-09,Latvia,Republic of Ireland,0,2,2,0.0,1.0,1489,1852
1993-06-09,Netherlands,Norway,0,0,0,0.5,0.5,1901,1784
1993-06-09,United States,England,2,0,2,1.0,0.0,1696,1917
1993-06-09,Singapore,Philippines,7,0,7,1.0,0.0,1588,1329
1993-06-09,Indonesia,Vietnam,1,0,1,1.0,0.0,1534,1457
1993-06-09,Malaysia,Brunei,3,1,2,1.0,0.0,1581,1373
1993-06-09,Myanmar,Laos,7,1,6,1.0,0.0,1583,1388
1993-06-10,Brazil,Germany,3,3,0,0.5,0.5,1961,1975
1993-06-10,Mexico,Paraguay,3,1,2,1.0,0.0,1877,1758
1993-06-11,Bahrain,Hong Kong,3,0,3,1.0,0.0,1588,1556
1993-06-11,India,Lebanon,1,2,1,0.0,1.0,1496,1507
1993-06-11,South Korea,Romania,2,2,0,0.5,0.5,1834,1801
1993-06-11,Martinique,Trinidad and Tobago,1,1,0,0.5,0.5,1634,1633
1993-06-11,Peru,Venezuela,3,1,2,1.0,0.0,1622,1465
1993-06-11,Singapore,Indonesia,1,1,0,0.5,0.5,1587,1536
1993-06-11,Vietnam,Philippines,1,0,1,1.0,0.0,1463,1324
1993-06-11,Malaysia,Laos,9,0,9,1.0,0.0,1585,1385
1993-06-11,Thailand,Brunei,5,2,3,1.0,0.0,1626,1370
1993-06-12,China PR,Pakistan,3,0,3,1.0,0.0,1689,1433
1993-06-12,Yemen,Jordan,1,1,0,0.5,0.5,1441,1542
1993-06-13,Bolivia,Chile,1,3,2,0.0,1.0,1597,1783
1993-06-13,Brazil,England,1,1,0,0.5,0.5,1960,1919
1993-06-13,Hong Kong,India,1,3,2,0.0,1.0,1547,1506
1993-06-13,Iran,Tajikistan,1,0,1,1.0,0.0,1778,1483
1993-06-13,South Korea,Bahrain,3,0,3,1.0,0.0,1838,1585
1993-06-13,United States,Germany,3,4,1,0.0,1.0,1694,1978
1993-06-13,Myanmar,Malaysia,2,1,1,1.0,0.0,1592,1577
1993-06-13,Thailand,Laos,4,1,3,1.0,0.0,1630,1382
1993-06-14,Iran,Turkmenistan,2,1,1,1.0,0.0,1781,1516
1993-06-14,Iraq,Jordan,4,0,4,1.0,0.0,1778,1539
1993-06-14,South Korea,Czech Republic,1,2,1,0.0,1.0,1825,1533
1993-06-14,Pakistan,Yemen,0,3,3,0.0,1.0,1426,1449
1993-06-15,Ecuador,Venezuela,6,1,5,1.0,0.0,1636,1461
1993-06-15,Singapore,Vietnam,2,0,2,1.0,0.0,1593,1458
1993-06-15,Indonesia,Philippines,3,1,2,1.0,0.0,1540,1321
1993-06-15,Myanmar,Brunei,6,0,6,1.0,0.0,1596,1367
1993-06-15,Thailand,Malaysia,2,0,2,1.0,0.0,1637,1571
1993-06-16,China PR,Jordan,4,1,3,1.0,0.0,1694,1535
1993-06-16,Colombia,Mexico,2,1,1,1.0,0.0,1790,1867
1993-06-16,Faroe Islands,Czech Republic,0,3,3,0.0,1.0,1497,1541
1993-06-16,Finland,Israel,0,0,0,0.5,0.5,1624,1656
1993-06-16,Iceland,Hungary,2,0,2,1.0,0.0,1618,1765
1993-06-16,Iraq,Yemen,3,0,3,1.0,0.0,1781,1447
1993-06-16,Lithuania,Republic of Ireland,0,1,1,0.0,1.0,1501,1854
1993-06-16,Uruguay,United States,1,0,1,1.0,0.0,1838,1690
1993-06-17,Argentina,Bolivia,1,0,1,1.0,0.0,1915,1595
1993-06-17,Singapore,Myanmar,3,3,0,0.5,0.5,1594,1596
1993-06-17,Thailand,Indonesia,1,0,1,1.0,0.0,1643,1535
1993-06-18,Brazil,Peru,0,0,0,0.5,0.5,1955,1628
1993-06-18,China PR,Yemen,1,0,1,1.0,0.0,1698,1444
1993-06-18,Iraq,Pakistan,4,0,4,1.0,0.0,1783,1425
1993-06-18,Paraguay,Chile,1,0,1,1.0,0.0,1767,1775
1993-06-19,Ecuador,United States,2,0,2,1.0,0.0,1646,1681
1993-06-19,England,Germany,1,2,1,0.0,1.0,1913,1985
1993-06-19,South Korea,Egypt,1,2,1,0.0,1.0,1816,1781
1993-06-19,Portugal,Malta,4,0,4,1.0,0.0,1814,1492
1993-06-19,Uruguay,Venezuela,2,2,0,0.5,0.5,1832,1468
1993-06-19,Singapore,Indonesia,3,1,2,1.0,0.0,1601,1529
1993-06-20,Argentina,Mexico,1,1,0,0.5,0.5,1914,1869
1993-06-20,China PR,Iraq,2,1,1,1.0,0.0,1708,1774
1993-06-20,Colombia,Bolivia,1,1,0,0.5,0.5,1786,1600
1993-06-20,Mali,Senegal,0,2,2,0.0,1.0,1609,1692
1993-06-20,Pakistan,Jordan,0,5,5,0.0,1.0,1420,1541
1993-06-20,Thailand,Myanmar,4,3,1,1.0,0.0,1650,1590
1993-06-21,Brazil,Chile,2,3,1,0.0,1.0,1944,1787
1993-06-21,Paraguay,Peru,1,1,0,0.5,0.5,1764,1632
1993-06-22,Ecuador,Uruguay,2,1,1,1.0,0.0,1658,1821
1993-06-22,United States,Venezuela,3,3,0,0.5,0.5,1677,1473
1993-06-23,Taiwan,Syria,0,2,2,0.0,1.0,1477,1586
1993-06-23,Argentina,Colombia,1,1,0,0.5,0.5,1912,1789
1993-06-23,Costa Rica,Panama,3,1,2,1.0,0.0,1693,1490
1993-06-23,Iran,Oman,0,0,0,0.5,0.5,1775,1419
1993-06-23,Mexico,Bolivia,0,0,0,0.5,0.5,1864,1606
1993-06-24,Brazil,Paraguay,3,0,3,1.0,0.0,1949,1760
1993-06-24,Chile,Peru,0,1,1,0.0,1.0,1776,1644
1993-06-25,Croatia,Ukraine,3,1,2,1.0,0.0,1604,1523
1993-06-25,Iran,Taiwan,6,0,6,1.0,0.0,1778,1475
1993-06-25,Oman,Syria,0,0,0,0.5,0.5,1423,1583
1993-06-26,Colombia,Uruguay,1,1,0,0.5,0.5,1790,1821
1993-06-26,Ecuador,Paraguay,3,0,3,1.0,0.0,1669,1750
1993-06-26,Egypt,Romania,3,2,1,1.0,0.0,1790,1793
1993-06-26,South Korea,Czech Republic,1,0,1,1.0,0.0,1819,1539
1993-06-27,Brazil,Argentina,1,1,0,0.5,0.5,1949,1913
1993-06-27,Iran,Syria,1,1,0,0.5,0.5,1774,1588
1993-06-27,Oman,Taiwan,2,1,1,1.0,0.0,1433,1466
1993-06-27,Peru,Mexico,2,4,2,0.0,1.0,1641,1868
1993-06-28,South Korea,Egypt,0,1,1,0.0,1.0,1811,1799
1993-06-29,Costa Rica,Mexico,0,2,2,0.0,1.0,1689,1873
1993-06-30,Ecuador,Mexico,0,2,2,0.0,1.0,1666,1877
1993-07-01,Colombia,Argentina,0,0,0,0.5,0.5,1793,1911
1993-07-02,Estonia,Latvia,0,2,2,0.0,1.0,1363,1495
1993-07-02,Oman,Iran,0,1,1,0.0,1.0,1432,1776
1993-07-02,Syria,Taiwan,8,1,7,1.0,0.0,1594,1461
1993-07-03,Ecuador,Colombia,0,1,1,0.0,1.0,1661,1799
1993-07-03,Latvia,Lithuania,0,0,0,0.5,0.5,1496,1501
1993-07-03,Nigeria,Algeria,4,1,3,1.0,0.0,1762,1780
1993-07-04,Taiwan,Iran,0,6,6,0.0,1.0,1459,1779
1993-07-04,Argentina,Mexico,2,1,1,1.0,0.0,1919,1870
1993-07-04,Estonia,Lithuania,2,1,1,1.0,0.0,1375,1490
1993-07-04,Gabon,Mali,0,2,2,0.0,1.0,1587,1617
1993-07-04,Jamaica,Costa Rica,1,1,0,0.5,0.5,1595,1687
1993-07-04,Syria,Oman,2,1,1,1.0,0.0,1599,1428
1993-07-04,Zambia,Morocco,2,1,1,1.0,0.0,1748,1735
1993-07-04,Zimbabwe,Cameroon,1,0,1,1.0,0.0,1687,1728
1993-07-04,Gibraltar,Jersey,1,2,1,0.0,1.0,1497,1707
1993-07-04,Ynys Môn,Greenland,0,1,1,0.0,1.0,1526,1434
1993-07-04,Isle of Wight,Isle of Man,1,0,1,1.0,0.0,1505,1492
1993-07-04,Åland Islands,Shetland,3,1,2,1.0,0.0,1517,1472
1993-07-05,Jersey,Greenland,4,2,2,1.0,0.0,1710,1432
1993-07-05,Ynys Môn,Gibraltar,1,0,1,1.0,0.0,1534,1490
1993-07-05,Isle of Man,Åland Islands,2,0,2,1.0,0.0,1501,1509
1993-07-05,Isle of Wight,Shetland,2,0,2,1.0,0.0,1513,1465
1993-07-06,Malawi,Eswatini,3,1,2,1.0,0.0,1673,1476
1993-07-06,Greenland,Gibraltar,5,0,5,1.0,0.0,1442,1481
1993-07-06,Jersey,Ynys Môn,2,2,0,0.5,0.5,1707,1538
1993-07-06,Shetland,Isle of Man,1,5,4,0.0,1.0,1458,1509
1993-07-06,Isle of Wight,Åland Islands,0,2,2,0.0,1.0,1505,1518
1993-07-07,Syria,Iran,1,1,0,0.5,0.5,1603,1776
1993-07-07,Taiwan,Oman,1,7,6,0.0,1.0,1451,1437
1993-07-07,Ivory Coast,Niger,3,2,1,1.0,0.0,1775,1522
1993-07-08,Malawi,Eswatini,1,1,0,0.5,0.5,1669,1481
1993-07-08,Shetland,Gibraltar,1,0,1,1.0,0.0,1467,1473
1993-07-08,Isle of Wight,Ynys Môn,1,1,0,0.5,0.5,1506,1538
1993-07-09,Greenland,Åland Islands,1,2,1,0.0,1.0,1436,1525
1993-07-09,Jersey,Isle of Man,5,1,4,1.0,0.0,1711,1506
1993-07-09,Sudan,Ethiopia,1,0,1,1.0,0.0,1572,1575
1993-07-10,Honduras,Panama,5,1,4,1.0,0.0,1728,1487
1993-07-10,Malawi,Eswatini,0,1,1,0.0,1.0,1658,1493
1993-07-10,United States,Jamaica,1,0,1,1.0,0.0,1684,1589
1993-07-11,Benin,Cameroon,0,3,3,0.0,1.0,1425,1731
1993-07-11,Burundi,Guinea,2,2,0,0.5,0.5,1525,1597
1993-07-11,Canada,Costa Rica,1,1,0,0.5,0.5,1673,1687
1993-07-11,DR Congo,Kenya,0,1,1,0.0,1.0,1654,1645
1993-07-11,Egypt,Morocco,1,1,0,0.5,0.5,1798,1737
1993-07-11,Gabon,Niger,3,0,3,1.0,0.0,1594,1516
1993-07-11,Lesotho,Mozambique,1,1,0,0.5,0.5,1457,1527
1993-07-11,Mali,Malawi,2,1,1,1.0,0.0,1626,1650
1993-07-11,Mexico,Martinique,9,0,9,1.0,0.0,1874,1631
1993-07-11,Senegal,Sierra Leone,1,1,0,0.5,0.5,1691,1618
1993-07-11,Zambia,South Africa,3,0,3,1.0,0.0,1754,1607
1993-07-11,Zimbabwe,Mauritius,2,0,2,1.0,0.0,1692,1515
1993-07-13,Peru,Uruguay,1,2,1,0.0,1.0,1637,1826
1993-07-14,Brazil,Paraguay,2,0,2,1.0,0.0,1953,1747
1993-07-14,Honduras,Jamaica,1,3,2,0.0,1.0,1717,1601
1993-07-14,United States,Panama,2,1,1,1.0,0.0,1688,1484
1993-07-15,Canada,Martinique,2,2,0,0.5,0.5,1673,1632
1993-07-15,Mexico,Costa Rica,1,1,0,0.5,0.5,1871,1691
1993-07-17,Jamaica,Panama,1,1,0,0.5,0.5,1599,1487
1993-07-17,Senegal,Morocco,1,3,2,0.0,1.0,1685,1744
1993-07-17,Uganda,Nigeria,0,0,0,0.5,0.5,1660,1760
1993-07-17,Uruguay,Peru,3,0,3,1.0,0.0,1831,1633
1993-07-17,United States,Honduras,1,0,1,1.0,0.0,1697,1709
1993-07-18,Costa Rica,Martinique,3,1,2,1.0,0.0,1698,1626
1993-07-18,Ecuador,Brazil,0,0,0,0.5,0.5,1667,1948
1993-07-18,Guinea,Cameroon,0,1,1,0.0,1.0,1592,1737
1993-07-18,Ivory Coast,Algeria,1,0,1,1.0,0.0,1784,1772
1993-07-18,Mexico,Canada,8,0,8,1.0,0.0,1875,1670
1993-07-18,Venezuela,Bolivia,1,7,6,0.0,1.0,1468,1612
1993-07-22,United States,Costa Rica,1,0,1,1.0,0.0,1706,1690
1993-07-22,Mexico,Jamaica,6,1,5,1.0,0.0,1878,1597
1993-07-24,Nigeria,Ethiopia,6,0,6,1.0,0.0,1765,1571
1993-07-24,Uganda,Sudan,1,0,1,1.0,0.0,1667,1566
1993-07-24,Kenya,Mozambique,4,1,3,1.0,0.0,1651,1522
1993-07-25,Algeria,Senegal,4,0,4,1.0,0.0,1779,1679
1993-07-25,Benin,Gabon,1,2,1,0.0,1.0,1421,1599
1993-07-25,Bolivia,Brazil,2,0,2,1.0,0.0,1626,1935
1993-07-25,Cameroon,Niger,2,0,2,1.0,0.0,1741,1513
1993-07-25,DR Congo,Lesotho,7,0,7,1.0,0.0,1658,1454
1993-07-25,Jamaica,Costa Rica,1,1,0,0.5,0.5,1600,1688
1993-07-25,Liberia,Ghana,0,2,2,0.0,1.0,1545,1726
1993-07-25,Malawi,Morocco,0,2,2,0.0,1.0,1645,1750
1993-07-25,Mali,Egypt,2,1,1,1.0,0.0,1638,1787
1993-07-25,Mauritius,South Africa,1,3,2,0.0,1.0,1510,1613
1993-07-25,Mexico,United States,4,0,4,1.0,0.0,1883,1702
1993-07-25,Venezuela,Uruguay,0,1,1,0.0,1.0,1467,1833
1993-07-25,Zimbabwe,Zambia,1,1,0,0.5,0.5,1694,1753
1993-07-28,France,Russia,3,1,2,1.0,0.0,1923,1884
1993-07-29,Malawi,Eswatini,3,0,3,1.0,0.0,1650,1489
1993-07-31,Canada,Australia,2,1,1,1.0,0.0,1681,1779
1993-08-01,Colombia,Paraguay,0,0,0,0.5,0.5,1798,1749
1993-08-01,Peru,Argentina,0,1,1,0.0,1.0,1631,1922
1993-08-01,Uruguay,Ecuador,0,0,0,0.5,0.5,1830,1671
1993-08-01,Venezuela,Brazil,1,5,4,0.0,1.0,1466,1937
1993-08-07,Senegal,Zambia,0,0,0,0.5,0.5,1681,1752
1993-08-08,Bolivia,Uruguay,3,1,2,1.0,0.0,1639,1818
1993-08-08,Brazil,Mexico,1,1,0,0.5,0.5,1936,1885
1993-08-08,Ecuador,Venezuela,5,0,5,1.0,0.0,1675,1463
1993-08-08,Guinea,Sierra Leone,1,0,1,1.0,0.0,1601,1610
1993-08-08,Paraguay,Argentina,1,3,2,0.0,1.0,1745,1927
1993-08-08,Peru,Colombia,0,1,1,0.0,1.0,1627,1803
1993-08-08,Zimbabwe,Eswatini,2,0,2,1.0,0.0,1698,1486
1993-08-09,Guinea,Sierra Leone,4,0,4,1.0,0.0,1610,1602
1993-08-11,Faroe Islands,Norway,0,7,7,0.0,1.0,1495,1787
1993-08-11,Sweden,Switzerland,1,2,1,0.0,1.0,1866,1827
1993-08-15,Paraguay,Peru,2,1,1,1.0,0.0,1751,1622
1993-08-15,Australia,Canada,2,1,1,1.0,0.0,1785,1676
1993-08-15,Bolivia,Ecuador,1,0,1,1.0,0.0,1648,1667
1993-08-15,Colombia,Argentina,2,1,1,1.0,0.0,1814,1917
1993-08-15,Congo,Guinea,0,0,0,0.5,0.5,1563,1609
1993-08-15,Uruguay,Brazil,1,1,0,0.5,0.5,1821,1934
1993-08-20,Madagascar,Comoros,5,0,5,1.0,0.0,1643,1464
1993-08-22,Argentina,Peru,2,1,1,1.0,0.0,1920,1620
1993-08-22,Bolivia,Venezuela,7,0,7,1.0,0.0,1653,1459
1993-08-22,Brazil,Ecuador,2,0,2,1.0,0.0,1937,1665
1993-08-22,Paraguay,Colombia,1,1,0,0.5,0.5,1753,1813
1993-08-22,Sweden,France,1,1,0,0.5,0.5,1868,1922
1993-08-22,Mauritius,Comoros,3,0,3,1.0,0.0,1517,1458
1993-08-22,Seychelles,Réunion,0,2,2,0.0,1.0,1432,1518
1993-08-24,Mauritius,Madagascar,1,2,1,0.0,1.0,1512,1649
1993-08-24,Seychelles,Réunion,0,2,2,0.0,1.0,1426,1525
1993-08-25,Austria,Finland,3,0,3,1.0,0.0,1738,1619
1993-08-25,Denmark,Lithuania,4,0,4,1.0,0.0,1855,1489
1993-08-26,Seychelles,Madagascar,1,2,1,0.0,1.0,1423,1653
1993-08-26,Réunion,Mauritius,1,0,1,1.0,0.0,1533,1505
1993-08-28,Seychelles,Mauritius,2,6,4,0.0,1.0,1417,1512
1993-08-29,Argentina,Paraguay,0,0,0,0.5,0.5,1917,1757
1993-08-29,Brazil,Bolivia,6,0,6,1.0,0.0,1940,1651
1993-08-29,Colombia,Peru,4,0,4,1.0,0.0,1817,1617
1993-08-29,Uruguay,Venezuela,4,0,4,1.0,0.0,1823,1458
1993-08-29,Madagascar,Réunion,1,0,1,1.0,0.0,1659,1528
1993-08-31,Iceland,United States,0,1,1,0.0,1.0,1612,1709
1993-09-05,Argentina,Colombia,0,5,5,0.0,1.0,1907,1828
1993-09-05,Brazil,Venezuela,4,0,4,1.0,0.0,1941,1458
1993-09-05,Ecuador,Uruguay,0,1,1,0.0,1.0,1661,1828
1993-09-05,Estonia,Portugal,0,2,2,0.0,1.0,1374,1816
1993-09-05,Peru,Paraguay,2,2,0,0.5,0.5,1621,1754
1993-09-06,Eswatini,Zimbabwe,0,1,1,0.0,1.0,1483,1702
1993-09-08,Albania,Denmark,0,1,1,0.0,1.0,1496,1857
1993-09-08,Bulgaria,Sweden,1,1,0,0.5,0.5,1744,1866
1993-09-08,England,Poland,3,0,3,1.0,0.0,1919,1811
1993-09-08,Faroe Islands,Romania,0,4,4,0.0,1.0,1493,1796
1993-09-08,Finland,France,0,2,2,0.0,1.0,1617,1925
1993-09-08,Hungary,Russia,1,3,2,0.0,1.0,1760,1890
1993-09-08,Iceland,Luxembourg,1,0,1,1.0,0.0,1615,1344
1993-09-08,Republic of Ireland,Lithuania,2,0,2,1.0,0.0,1856,1488
1993-09-08,Northern Ireland,Latvia,2,0,2,1.0,0.0,1726,1493
1993-09-08,Norway,United States,1,0,1,1.0,0.0,1794,1703
1993-09-08,Scotland,Switzerland,1,1,0,0.5,0.5,1798,1827
1993-09-08,Spain,Chile,2,0,2,1.0,0.0,1873,1771
1993-09-08,Wales,Czech Republic,2,2,0,0.5,0.5,1759,1544
1993-09-12,Uruguay,Bolivia,2,1,1,1.0,0.0,1833,1647
1993-09-12,Venezuela,Ecuador,2,1,1,1.0,0.0,1471,1649
1993-09-15,Morocco,Mali,3,0,3,1.0,0.0,1756,1633
1993-09-17,Saudi Arabia,Thailand,4,0,4,1.0,0.0,1777,1645
1993-09-19,Brazil,Uruguay,2,0,2,1.0,0.0,1947,1828
1993-09-19,Ecuador,Bolivia,1,1,0,0.5,0.5,1649,1648
1993-09-19,Zimbabwe,Senegal,2,0,2,1.0,0.0,1710,1674
1993-09-20,Saudi Arabia,Thailand,3,0,3,1.0,0.0,1783,1640
1993-09-22,Albania,Spain,1,5,4,0.0,1.0,1495,1875
1993-09-22,Estonia,Italy,0,3,3,0.0,1.0,1374,1953
1993-09-22,Mexico,Cameroon,1,0,1,1.0,0.0,1890,1737
1993-09-22,Norway,Poland,1,0,1,1.0,0.0,1803,1803
1993-09-22,Romania,Israel,1,0,1,1.0,0.0,1801,1652
1993-09-22,San Marino,Netherlands,0,7,7,0.0,1.0,1470,1903
1993-09-22,Tunisia,Germany,1,1,0,0.5,0.5,1699,1980
1993-09-23,Saudi Arabia,Costa Rica,1,2,1,0.0,1.0,1773,1699
1993-09-24,South Korea,Australia,1,1,0,0.5,0.5,1811,1786
1993-09-25,Nigeria,Ivory Coast,4,1,3,1.0,0.0,1774,1776
1993-09-26,South Korea,Australia,1,0,1,1.0,0.0,1819,1779
1993-09-26,Zambia,Senegal,4,0,4,1.0,0.0,1759,1668
1993-09-26,Zimbabwe,Guinea,1,0,1,1.0,0.0,1716,1604
1993-09-27,Saudi Arabia,Costa Rica,3,2,1,1.0,0.0,1780,1693
1993-09-29,Mexico,Poland,0,0,0,0.5,0.5,1889,1805
1993-10-01,Morocco,Gabon,1,0,1,1.0,0.0,1761,1595
1993-10-04,Japan,Ivory Coast,1,0,1,1.0,0.0,1744,1768
1993-10-05,Cyprus,Israel,2,2,0,0.5,0.5,1458,1648
1993-10-06,Belgium,Gabon,2,1,1,1.0,0.0,1839,1592
1993-10-06,Mexico,South Africa,4,0,4,1.0,0.0,1892,1611
1993-10-06,Saudi Arabia,Russia,4,2,2,1.0,0.0,1791,1880
1993-10-08,Algeria,Nigeria,1,1,0,0.5,0.5,1779,1775
1993-10-10,Cameroon,Zimbabwe,3,1,2,1.0,0.0,1745,1709
1993-10-10,Morocco,Zambia,1,0,1,1.0,0.0,1769,1752
1993-10-12,Luxembourg,Greece,1,3,2,0.0,1.0,1343,1718
1993-10-13,Bulgaria,Austria,4,1,3,1.0,0.0,1752,1731
1993-10-13,Denmark,Northern Ireland,1,0,1,1.0,0.0,1863,1721
1993-10-13,France,Israel,2,3,1,0.0,1.0,1912,1662
1993-10-13,Germany,Uruguay,5,0,5,1.0,0.0,1985,1824
1993-10-13,Republic of Ireland,Spain,1,3,2,0.0,1.0,1849,1883
1993-10-13,Italy,Scotland,3,1,2,1.0,0.0,1958,1794
1993-10-13,Netherlands,England,2,0,2,1.0,0.0,1912,1911
1993-10-13,Poland,Norway,0,3,3,0.0,1.0,1797,1812
1993-10-13,Portugal,Switzerland,1,0,1,1.0,0.0,1825,1819
1993-10-13,Romania,Belgium,2,1,1,1.0,0.0,1810,1831
1993-10-13,Slovenia,North Macedonia,1,4,3,0.0,1.0,1490,1508
1993-10-13,Sweden,Finland,3,2,1,1.0,0.0,1870,1614
1993-10-13,United States,Mexico,1,1,0,0.5,0.5,1707,1889
1993-10-13,Wales,Cyprus,2,0,2,1.0,0.0,1762,1456
1993-10-15,North Korea,Iraq,3,2,1,1.0,0.0,1757,1766
1993-10-15,Saudi Arabia,Japan,0,0,0,0.5,0.5,1790,1746
1993-10-16,Iran,South Korea,0,3,3,0.0,1.0,1769,1827
1993-10-16,United States,Ukraine,1,2,1,0.0,1.0,1696,1535
1993-10-17,Tunisia,Iceland,3,1,2,1.0,0.0,1706,1609
1993-10-18,Japan,Iran,1,2,1,0.0,1.0,1739,1777
1993-10-18,North Korea,Saudi Arabia,1,2,1,0.0,1.0,1750,1798
1993-10-19,Iraq,South Korea,2,2,0,0.5,0.5,1768,1826
1993-10-20,Mexico,Ukraine,2,1,1,1.0,0.0,1891,1534
1993-10-21,North Korea,Japan,0,3,3,0.0,1.0,1742,1748
1993-10-22,Iran,Iraq,1,2,1,0.0,1.0,1769,1777
1993-10-22,South Korea,Saudi Arabia,1,1,0,0.5,0.5,1826,1799
1993-10-23,United States,Ukraine,0,1,1,0.0,1.0,1685,1546
1993-10-24,Burundi,Guinea,0,0,0,0.5,0.5,1527,1603
1993-10-24,Iraq,Saudi Arabia,1,1,0,0.5,0.5,1778,1799
1993-10-25,Iran,North Korea,2,1,1,1.0,0.0,1777,1735
1993-10-25,Japan,South Korea,1,0,1,1.0,0.0,1758,1817
1993-10-26,Liechtenstein,Estonia,0,2,2,0.0,1.0,1493,1385
1993-10-26,United Arab Emirates,Jordan,2,1,1,1.0,0.0,1712,1537
1993-10-27,Czech Republic,Cyprus,3,0,3,1.0,0.0,1551,1450
1993-10-27,Hungary,Luxembourg,1,0,1,1.0,0.0,1762,1342
1993-10-27,Israel,Austria,1,1,0,0.5,0.5,1664,1730
1993-10-27,Turkey,Poland,2,1,1,1.0,0.0,1636,1786
1993-10-28,Iraq,Japan,2,2,0,0.5,0.5,1778,1759
1993-10-28,South Korea,North Korea,3,0,3,1.0,0.0,1824,1729
1993-10-28,Saudi Arabia,Iran,4,3,1,1.0,0.0,1807,1770
1993-10-28,United Arab Emirates,Jordan,0,2,2,0.0,1.0,1701,1549
1993-10-31,Australia,Argentina,1,1,0,0.5,0.5,1782,1905
1993-11-03,Mexico,China PR,3,0,3,1.0,0.0,1896,1704
1993-11-05,Egypt,Malta,3,0,3,1.0,0.0,1790,1490
1993-11-05,Tunisia,Gabon,4,0,4,1.0,0.0,1712,1587
1993-11-07,Gabon,Malta,1,2,1,0.0,1.0,1577,1501
1993-11-07,Tunisia,Egypt,2,1,1,1.0,0.0,1722,1781
1993-11-07,United States,Jamaica,1,0,1,1.0,0.0,1692,1594
1993-11-10,Austria,Sweden,1,1,0,0.5,0.5,1734,1867
1993-11-10,Israel,Finland,1,3,2,0.0,1.0,1655,1624
1993-11-10,Portugal,Estonia,3,0,3,1.0,0.0,1827,1384
1993-11-10,Turkey,Norway,2,1,1,1.0,0.0,1648,1801
1993-11-14,Antigua and Barbuda,Saint Kitts and Nevis,3,0,3,1.0,0.0,1488,1505
1993-11-14,United States,Cayman Islands,8,1,7,1.0,0.0,1696,1437
1993-11-16,Slovakia,Slovenia,2,0,2,1.0,0.0,1508,1483
1993-11-17,Argentina,Australia,1,0,1,1.0,0.0,1911,1777
1993-11-17,Belgium,Czech Republic,0,0,0,0.5,0.5,1826,1557
1993-11-17,France,Bulgaria,1,2,1,0.0,1.0,1901,1764
1993-11-17,Germany,Brazil,2,1,1,1.0,0.0,1993,1940
1993-11-17,Greece,Russia,1,0,1,1.0,0.0,1730,1869
1993-11-17,Italy,Portugal,1,0,1,1.0,0.0,1964,1822
1993-11-17,Malta,Scotland,0,2,2,0.0,1.0,1499,1797
1993-11-17,Northern Ireland,Republic of Ireland,1,1,0,0.5,0.5,1724,1847
1993-11-17,Poland,Netherlands,1,3,2,0.0,1.0,1781,1918
1993-11-17,San Marino,England,1,7,6,0.0,1.0,1469,1913
1993-11-17,Spain,Denmark,1,0,1,1.0,0.0,1891,1856
1993-11-17,Switzerland,Estonia,4,0,4,1.0,0.0,1821,1383
1993-11-17,Wales,Romania,1,2,1,0.0,1.0,1756,1817
1993-11-22,Gambia,Mauritania,2,4,2,0.0,1.0,1475,1378
1993-11-26,Gambia,Ghana,3,0,3,1.0,0.0,1488,1714
1993-11-26,Sierra Leone,Guinea,1,1,0,0.5,0.5,1603,1603
1993-11-27,Guinea-Bissau,Mauritania,1,0,1,1.0,0.0,1521,1374
1993-11-27,Senegal,Mali,0,1,1,0.0,1.0,1660,1642
1993-11-28,Guinea,Gambia,1,2,1,0.0,1.0,1593,1499
1993-11-28,Sierra Leone,Ghana,2,3,1,0.0,1.0,1598,1720
1993-11-29,Mali,Guinea-Bissau,3,0,3,1.0,0.0,1648,1516
1993-11-29,Senegal,Mauritania,4,0,4,1.0,0.0,1663,1372
1993-11-30,Ghana,Guinea,1,0,1,1.0,0.0,1726,1588
1993-11-30,Sierra Leone,Gambia,1,1,0,0.5,0.5,1596,1502
1993-11-30,Tahiti,Fiji,3,0,3,1.0,0.0,1715,1610
1993-12-01,Kenya,Uganda,2,1,1,1.0,0.0,1660,1659
1993-12-01,Mali,Mauritania,0,0,0,0.5,0.5,1643,1378
1993-12-01,Senegal,Guinea-Bissau,0,0,0,0.5,0.5,1660,1520
1993-12-03,Gambia,Senegal,0,2,2,0.0,1.0,1498,1665
1993-12-03,Sierra Leone,Mali,2,0,2,1.0,0.0,1606,1634
1993-12-05,Gambia,Mali,2,0,2,1.0,0.0,1509,1624
1993-12-05,Sierra Leone,Senegal,2,0,2,1.0,0.0,1616,1656
1993-12-05,United States,El Salvador,7,0,7,1.0,0.0,1703,1623
1993-12-06,Tanzania,Uganda,1,0,1,1.0,0.0,1524,1648
1993-12-07,Vanuatu,Tonga,3,0,3,1.0,0.0,1437,1480
1993-12-07,Tahiti,Guam,11,0,11,1.0,0.0,1719,1464
1993-12-07,Fiji,Solomon Islands,1,0,1,1.0,0.0,1616,1511
1993-12-08,New Caledonia,Papua New Guinea,1,1,0,0.5,0.5,1617,1496
1993-12-09,Tahiti,Fiji,1,0,1,1.0,0.0,1725,1611
1993-12-10,Bangladesh,Myanmar,3,1,2,1.0,0.0,1465,1579
1993-12-10,Kenya,Tanzania,2,1,1,1.0,0.0,1666,1519
1993-12-10,Tonga,Papua New Guinea,0,5,5,0.0,1.0,1473,1504
1993-12-10,Vanuatu,New Caledonia,1,1,0,0.5,0.5,1441,1614
1993-12-11,Solomon Islands,Guam,12,1,11,1.0,0.0,1518,1458
1993-12-13,New Caledonia,Tonga,11,0,11,1.0,0.0,1619,1469
1993-12-13,Vanuatu,Papua New Guinea,1,0,1,1.0,0.0,1451,1495
1993-12-13,Fiji,Guam,12,0,12,1.0,0.0,1616,1454
1993-12-13,Tahiti,Solomon Islands,3,0,3,1.0,0.0,1729,1515
1993-12-14,Tahiti,New Caledonia,2,1,1,1.0,0.0,1735,1614
1993-12-14,Vanuatu,Fiji,0,2,2,0.0,1.0,1447,1621
1993-12-15,Argentina,Germany,2,1,1,1.0,0.0,1921,1984
1993-12-16,Mexico,Brazil,0,1,1,0.0,1.0,1890,1947
1993-12-16,Vanuatu,New Caledonia,1,2,1,0.0,1.0,1443,1619
1993-12-16,Tahiti,Fiji,3,0,3,1.0,0.0,1741,1616
1993-12-18,United States,Germany,0,3,3,0.0,1.0,1701,1987
1993-12-19,Mali,Ivory Coast,0,1,1,0.0,1.0,1620,1773
1993-12-20,Bangladesh,Maldives,0,0,0,0.5,0.5,1465,1437
1993-12-20,Sri Lanka,Pakistan,2,1,1,1.0,0.0,1348,1411
1993-12-22,Mexico,Germany,0,0,0,0.5,0.5,1893,1985
1993-12-22,Basque Country,Bolivia,3,1,2,1.0,0.0,1620,1640
1993-12-22,Nepal,Maldives,0,0,0,0.5,0.5,1414,1437
1993-12-22,India,Sri Lanka,2,0,2,1.0,0.0,1511,1344
1993-12-24,Bangladesh,Nepal,0,1,1,0.0,1.0,1456,1424
1993-12-24,India,Pakistan,2,2,0,0.5,0.5,1509,1414
1993-12-26,Sri Lanka,Maldives,3,1,2,1.0,0.0,1355,1427
1993-12-26,Nepal,India,2,2,0,0.5,0.5,1426,1508
1993-12-29,Ghana,Egypt,0,0,0,0.5,0.5,1728,1780
1993-12-31,Ghana,Tunisia,1,1,0,0.5,0.5,1728,1723
1994-01-02,Barbados,Grenada,0,0,0,0.5,0.5,1540,1524
1994-01-02,Ghana,Egypt,2,1,1,1.0,0.0,1738,1771
1994-01-05,Mali,Burkina Faso,1,1,0,0.5,0.5,1620,1608
1994-01-09,Mauritania,Mali,1,3,2,0.0,1.0,1375,1624
1994-01-11,Thailand,Nigeria,1,1,0,0.5,0.5,1643,1773
1994-01-15,United States,Norway,2,1,1,1.0,0.0,1712,1791
1994-01-18,Guinea,Ivory Coast,3,0,3,1.0,0.0,1600,1762
1994-01-19,Costa Rica,Norway,0,0,0,0.5,0.5,1696,1789
1994-01-19,Mexico,Bulgaria,1,1,0,0.5,0.5,1891,1767
1994-01-19,Spain,Portugal,2,2,0,0.5,0.5,1890,1824
1994-01-19,Suriname,French Guiana,1,0,1,1.0,0.0,1615,1471
1994-01-19,Tunisia,Netherlands,2,2,0,0.5,0.5,1728,1914
1994-01-21,Guyana,French Guiana,1,1,0,0.5,0.5,1472,1472
1994-01-22,United States,Switzerland,1,1,0,0.5,0.5,1715,1819
1994-01-23,Barbados,Puerto Rico,0,1,1,0.0,1.0,1530,1415
1994-01-23,Mali,Senegal,1,0,1,1.0,0.0,1633,1648
1994-01-23,Saudi Arabia,China PR,1,0,1,1.0,0.0,1813,1699
1994-01-23,Suriname,Guyana,2,0,2,1.0,0.0,1620,1468
1994-01-25,Grenada,Puerto Rico,1,0,1,1.0,0.0,1530,1410
1994-01-25,Qatar,Finland,1,0,1,1.0,0.0,1673,1617
1994-01-26,Mexico,Switzerland,1,5,4,0.0,1.0,1882,1829
1994-01-26,Saudi Arabia,China PR,1,1,0,0.5,0.5,1811,1702
1994-01-27,Barbados,Grenada,3,2,1,1.0,0.0,1538,1522
1994-01-27,Qatar,Finland,0,0,0,0.5,0.5,1672,1619
1994-01-28,Venezuela,Colombia,1,2,1,0.0,1.0,1470,1830
1994-01-29,Burkina Faso,Guinea,1,1,0,0.5,0.5,1608,1601
1994-01-29,Ivory Coast,Niger,5,3,2,1.0,0.0,1766,1510
1994-01-29,United States,Russia,1,1,0,0.5,0.5,1719,1866
1994-01-30,Burkina Faso,Ivory Coast,0,1,1,0.0,1.0,1604,1771
1994-01-30,Guinea,Niger,1,3,2,0.0,1.0,1591,1521
1994-01-30,Oman,Finland,0,2,2,0.0,1.0,1433,1624
1994-01-30,Senegal,Mali,0,0,0,0.5,0.5,1648,1634
1994-02-01,Oman,Finland,1,1,0,0.5,0.5,1438,1620
1994-02-02,Egypt,Morocco,1,1,0,0.5,0.5,1771,1770
1994-02-02,Mexico,Russia,1,4,3,0.0,1.0,1874,1875
1994-02-02,United Arab Emirates,Slovakia,0,1,1,0.0,1.0,1689,1521
1994-02-04,Egypt,Slovakia,1,0,1,1.0,0.0,1775,1518
1994-02-04,Oman,Kenya,1,0,1,1.0,0.0,1451,1654
1994-02-04,United Arab Emirates,Morocco,1,1,0,0.5,0.5,1691,1769
1994-02-06,Morocco,Slovakia,2,1,1,1.0,0.0,1773,1515
1994-02-06,Oman,Kenya,2,0,2,1.0,0.0,1464,1642
1994-02-06,Saudi Arabia,Colombia,1,1,0,0.5,0.5,1812,1830
1994-02-06,United Arab Emirates,Egypt,0,1,1,0.0,1.0,1685,1782
1994-02-07,Gambia,Senegal,0,0,0,0.5,0.5,1513,1645
1994-02-08,Georgia,Slovenia,0,1,1,0.0,1.0,1489,1492
1994-02-08,Malta,Tunisia,1,1,0,0.5,0.5,1504,1724
1994-02-09,Spain,Poland,1,1,0,0.5,0.5,1888,1784
1994-02-10,Malta,Georgia,0,1,1,0.0,1.0,1496,1498
1994-02-10,Slovenia,Tunisia,2,2,0,0.5,0.5,1497,1720
1994-02-12,Georgia,Tunisia,2,0,2,1.0,0.0,1511,1708
1994-02-12,Malawi,Zambia,0,3,3,0.0,1.0,1645,1758
1994-02-12,Malta,Slovenia,0,1,1,0.0,1.0,1489,1505
1994-02-13,Malawi,Zambia,0,2,2,0.0,1.0,1640,1764
1994-02-13,Romania,United States,2,1,1,1.0,0.0,1823,1714
1994-02-16,Italy,France,0,1,1,0.0,1.0,1955,1911
1994-02-16,South Korea,Romania,1,2,1,0.0,1.0,1816,1832
1994-02-16,Malta,Belgium,1,0,1,1.0,0.0,1503,1813
1994-02-18,Colombia,Sweden,0,0,0,0.5,0.5,1831,1867
1994-02-18,United States,Bolivia,1,1,0,0.5,0.5,1713,1642
1994-02-20,Bolivia,Colombia,0,2,2,0.0,1.0,1638,1836
1994-02-20,United States,Sweden,1,3,2,0.0,1.0,1709,1872
1994-02-23,Dominica,Antigua and Barbuda,3,2,1,1.0,0.0,1436,1479
1994-02-23,Israel,Georgia,2,0,2,1.0,0.0,1660,1507
1994-02-23,Mali,Ghana,0,0,0,0.5,0.5,1637,1736
1994-02-23,Morocco,Finland,0,0,0,0.5,0.5,1770,1624
1994-02-23,Saint Kitts and Nevis,Montserrat,9,1,8,1.0,0.0,1513,1470
1994-02-23,Turkey,Czech Republic,1,4,3,0.0,1.0,1638,1568
1994-02-24,Mexico,Sweden,2,1,1,1.0,0.0,1882,1865
1994-02-25,Antigua and Barbuda,Montserrat,8,0,8,1.0,0.0,1487,1463
1994-02-25,Saint Kitts and Nevis,Dominica,2,3,1,0.0,1.0,1504,1446
1994-02-26,Colombia,South Korea,2,2,0,0.5,0.5,1836,1817
1994-02-26,Zimbabwe,Zambia,2,2,0,0.5,0.5,1711,1763
1994-02-27,Gabon,Senegal,0,0,0,0.5,0.5,1579,1644
1994-03-02,Cayman Islands,British Virgin Islands,5,0,5,1.0,0.0,1446,1457
1994-03-02,Jamaica,Sint Maarten,3,2,1,1.0,0.0,1600,1490
1994-03-02,Mexico,Colombia,0,0,0,0.5,0.5,1881,1838
1994-03-04,Cayman Islands,Sint Maarten,5,0,5,1.0,0.0,1456,1481
1994-03-04,Guadeloupe,Anguilla,9,0,9,1.0,0.0,1511,1450
1994-03-04,Jamaica,British Virgin Islands,12,0,12,1.0,0.0,1605,1453
1994-03-05,United States,South Korea,1,0,1,1.0,0.0,1720,1807
1994-03-06,Cayman Islands,Jamaica,3,2,1,1.0,0.0,1468,1594
1994-03-06,Sint Maarten,British Virgin Islands,3,0,3,1.0,0.0,1489,1446
1994-03-06,Saint Vincent and the Grenadines,Anguilla,2,0,2,1.0,0.0,1567,1445
1994-03-09,Cyprus,Estonia,2,0,2,1.0,0.0,1457,1377
1994-03-09,England,Denmark,1,0,1,1.0,0.0,1920,1850
1994-03-09,Hungary,Switzerland,1,2,1,0.0,1.0,1756,1836
1994-03-09,Nigeria,Ghana,0,0,0,0.5,0.5,1773,1737
1994-03-09,Wales,Norway,1,3,2,0.0,1.0,1749,1797
1994-03-10,Dominican Republic,Haiti,0,1,1,0.0,1.0,1463,1557
1994-03-12,Congo,DR Congo,2,1,1,1.0,0.0,1574,1648
1994-03-12,United States,South Korea,1,1,0,0.5,0.5,1722,1806
1994-03-12,Zambia,Zimbabwe,2,1,1,1.0,0.0,1770,1705
1994-03-15,Gabon,DR Congo,2,1,1,1.0,0.0,1589,1639
1994-03-15,Israel,Ukraine,1,0,1,1.0,0.0,1666,1541
1994-03-16,Egypt,Cameroon,0,0,0,0.5,0.5,1782,1746
1994-03-17,Tunisia,Niger,4,2,2,1.0,0.0,1713,1517
1994-03-19,Angola,Gabon,2,1,1,1.0,0.0,1579,1581
1994-03-19,Jersey,Alderney,18,0,18,1.0,0.0,1713,1292
1994-03-22,France,Chile,3,1,2,1.0,0.0,1916,1767
1994-03-23,Austria,Hungary,1,1,0,0.5,0.5,1735,1756
1994-03-23,Brazil,Argentina,2,0,2,1.0,0.0,1955,1914
1994-03-23,Germany,Italy,2,1,1,1.0,0.0,1993,1948
1994-03-23,Greece,Poland,0,0,0,0.5,0.5,1732,1783
1994-03-23,Republic of Ireland,Russia,0,0,0,0.5,0.5,1848,1875
1994-03-23,Luxembourg,Morocco,1,2,1,0.0,1.0,1341,1772
1994-03-23,North Macedonia,Slovenia,2,0,2,1.0,0.0,1516,1498
1994-03-23,Northern Ireland,Romania,2,0,2,1.0,0.0,1735,1822
1994-03-23,Scotland,Netherlands,0,1,1,0.0,1.0,1792,1920
1994-03-23,Spain,Croatia,0,2,2,0.0,1.0,1875,1618
1994-03-26,Nigeria,Gabon,3,0,3,1.0,0.0,1777,1578
1994-03-26,Saudi Arabia,Chile,0,2,2,0.0,1.0,1803,1777
1994-03-26,Tunisia,Mali,0,2,2,0.0,1.0,1704,1647
1994-03-26,United States,Bolivia,2,2,0,0.5,0.5,1721,1640
1994-03-27,Ghana,Guinea,1,0,1,1.0,0.0,1742,1587
1994-03-27,Ivory Coast,Sierra Leone,4,0,4,1.0,0.0,1776,1612
1994-03-28,Egypt,Gabon,4,0,4,1.0,0.0,1786,1575
1994-03-28,Mali,DR Congo,0,1,1,0.0,1.0,1639,1648
1994-03-29,Senegal,Guinea,2,1,1,1.0,0.0,1651,1581
1994-03-29,Zambia,Sierra Leone,0,0,0,0.5,0.5,1767,1616
1994-03-30,Malta,Slovakia,1,2,1,0.0,1.0,1496,1523
1994-03-30,Nigeria,Egypt,0,0,0,0.5,0.5,1778,1786
1994-03-30,Tunisia,DR Congo,1,1,0,0.5,0.5,1703,1650
1994-03-31,Ghana,Senegal,1,0,1,1.0,0.0,1748,1646
1994-03-31,Zambia,Ivory Coast,1,0,1,1.0,0.0,1776,1768
1994-04-02,DR Congo,Nigeria,0,2,2,0.0,1.0,1645,1784
1994-04-02,Egypt,Mali,0,1,1,0.0,1.0,1775,1651
1994-04-03,Ghana,Ivory Coast,1,2,1,0.0,1.0,1741,1776
1994-04-03,Zambia,Senegal,1,0,1,1.0,0.0,1782,1641
1994-04-06,Hungary,Slovenia,0,1,1,0.0,1.0,1743,1512
1994-04-06,Nigeria,Ivory Coast,2,2,0,0.5,0.5,1784,1777
1994-04-06,Zambia,Mali,4,0,4,1.0,0.0,1788,1646
1994-04-07,Cayman Islands,Haiti,2,3,1,0.0,1.0,1463,1563
1994-04-07,Colombia,Bolivia,0,1,1,0.0,1.0,1826,1653
1994-04-07,Martinique,Suriname,2,0,2,1.0,0.0,1634,1613
1994-04-09,Martinique,Haiti,3,0,3,1.0,0.0,1641,1557
1994-04-09,Suriname,Cayman Islands,2,0,2,1.0,0.0,1618,1459
1994-04-10,Ivory Coast,Mali,3,1,2,1.0,0.0,1783,1641
1994-04-10,Nigeria,Zambia,2,1,1,1.0,0.0,1793,1780
1994-04-11,Kazakhstan,Tajikistan,1,0,1,1.0,0.0,1548,1477
1994-04-11,Martinique,Cayman Islands,1,1,0,0.5,0.5,1638,1463
1994-04-11,Suriname,Haiti,1,1,0,0.5,0.5,1617,1559
1994-04-11,Uzbekistan,Turkmenistan,4,0,4,1.0,0.0,1519,1508
1994-04-13,Kyrgyzstan,Turkmenistan,1,5,4,0.0,1.0,1455,1515
1994-04-13,Poland,Saudi Arabia,1,0,1,1.0,0.0,1792,1795
1994-04-13,Uzbekistan,Kazakhstan,1,0,1,1.0,0.0,1528,1540
1994-04-14,Martinique,Guadeloupe,4,2,2,1.0,0.0,1644,1506
1994-04-14,Trinidad and Tobago,Suriname,3,2,1,1.0,0.0,1641,1610
1994-04-15,Kazakhstan,Turkmenistan,0,0,0,0.5,0.5,1540,1516
1994-04-15,Kyrgyzstan,Tajikistan,0,1,1,0.0,1.0,1448,1485
1994-04-15,Oman,Bulgaria,1,1,0,0.5,0.5,1470,1762
1994-04-16,United States,Moldova,1,1,0,0.5,0.5,1717,1523
1994-04-17,Colombia,Nigeria,1,0,1,1.0,0.0,1834,1786
1994-04-17,Guadeloupe,Suriname,2,0,2,1.0,0.0,1517,1600
1994-04-17,Kazakhstan,Kyrgyzstan,0,0,0,0.5,0.5,1538,1451
1994-04-17,Trinidad and Tobago,Martinique,7,2,5,1.0,0.0,1650,1636
1994-04-17,Uzbekistan,Tajikistan,1,1,0,0.5,0.5,1528,1486
1994-04-18,Tunisia,Saudi Arabia,2,0,2,1.0,0.0,1714,1785
1994-04-19,Malta,Azerbaijan,5,0,5,1.0,0.0,1505,1501
1994-04-19,Tajikistan,Turkmenistan,0,2,2,0.0,1.0,1479,1524
1994-04-19,Uzbekistan,Kyrgyzstan,3,0,3,1.0,0.0,1535,1445
1994-04-20,Argentina,Morocco,3,1,2,1.0,0.0,1919,1768
1994-04-20,Austria,Scotland,1,2,1,0.0,1.0,1729,1799
1994-04-20,Denmark,Hungary,3,1,2,1.0,0.0,1856,1738
1994-04-20,Iceland,Saudi Arabia,0,2,2,0.0,1.0,1605,1790
1994-04-20,Lithuania,Israel,1,1,0,0.5,0.5,1492,1663
1994-04-20,Netherlands,Republic of Ireland,0,1,1,0.0,1.0,1911,1858
1994-04-20,Northern Ireland,Liechtenstein,4,1,3,1.0,0.0,1739,1490
1994-04-20,Norway,Portugal,0,0,0,0.5,0.5,1798,1824
1994-04-20,Romania,Bolivia,3,0,3,1.0,0.0,1827,1649
1994-04-20,Slovakia,Croatia,4,1,3,1.0,0.0,1534,1608
1994-04-20,Switzerland,Czech Republic,3,0,3,1.0,0.0,1839,1566
1994-04-20,Turkey,Russia,0,1,1,0.0,1.0,1635,1879
1994-04-20,United States,Moldova,3,0,3,1.0,0.0,1721,1520
1994-04-20,Wales,Sweden,0,2,2,0.0,1.0,1744,1871
1994-04-22,Eswatini,Mozambique,0,1,1,0.0,1.0,1476,1530
1994-04-24,South Africa,Zimbabwe,1,0,1,1.0,0.0,1622,1695
1994-04-24,United States,Iceland,1,2,1,0.0,1.0,1711,1616
1994-04-27,Greece,Saudi Arabia,5,1,4,1.0,0.0,1742,1781
1994-04-27,Slovenia,Cyprus,3,0,3,1.0,0.0,1519,1451
1994-04-27,United Arab Emirates,Germany,0,2,2,0.0,1.0,1683,1996
1994-04-28,Kuwait,Bulgaria,2,2,0,0.5,0.5,1716,1761
1994-04-30,United States,Chile,0,2,2,0.0,1.0,1705,1784
1994-05-01,South Korea,Cameroon,2,2,0,0.5,0.5,1805,1748
1994-05-02,Jersey,Guernsey,3,1,2,1.0,0.0,1720,1628
1994-05-03,Colombia,Peru,1,0,1,1.0,0.0,1838,1618
1994-05-03,El Salvador,Honduras,3,1,2,1.0,0.0,1633,1700
1994-05-03,South Korea,Cameroon,2,1,1,1.0,0.0,1812,1742
1994-05-04,Bolivia,Saudi Arabia,1,0,1,1.0,0.0,1660,1771
1994-05-04,Brazil,Iceland,3,0,3,1.0,0.0,1957,1615
1994-05-04,Poland,Hungary,3,2,1,1.0,0.0,1799,1732
1994-05-05,Colombia,El Salvador,3,0,3,1.0,0.0,1842,1630
1994-05-05,Honduras,Peru,2,1,1,1.0,0.0,1707,1612
1994-05-05,Sweden,Nigeria,3,1,2,1.0,0.0,1878,1780
1994-05-07,United States,Estonia,4,0,4,1.0,0.0,1708,1375
1994-05-09,Greece,Cameroon,0,3,3,0.0,1.0,1734,1750
1994-05-11,Bolivia,Cameroon,1,1,0,0.5,0.5,1663,1748
1994-05-13,Greece,Bolivia,0,0,0,0.5,0.5,1733,1665
1994-05-14,North Macedonia,Albania,5,1,4,1.0,0.0,1524,1488
1994-05-14,Nigeria,Suriname,2,1,1,1.0,0.0,1785,1596
1994-05-15,United States,Armenia,1,0,1,1.0,0.0,1712,1491
1994-05-17,England,Greece,5,0,5,1.0,0.0,1925,1729
1994-05-17,Poland,Austria,3,4,1,0.0,1.0,1790,1739
1994-05-18,Chile,Argentina,3,3,0,0.5,0.5,1787,1917
1994-05-18,Hungary,Croatia,2,2,0,0.5,0.5,1730,1611
1994-05-19,Iceland,Bolivia,1,0,1,1.0,0.0,1625,1656
1994-05-22,England,Norway,0,0,0,0.5,0.5,1923,1801
1994-05-22,Japan,Australia,1,1,0,0.5,0.5,1760,1777
1994-05-23,Estonia,Wales,1,2,1,0.0,1.0,1374,1746
1994-05-23,Fiji,Tahiti,2,2,0,0.5,0.5,1619,1739
1994-05-24,Republic of Ireland,Bolivia,1,0,1,1.0,0.0,1862,1653
1994-05-25,Chile,Peru,2,1,1,1.0,0.0,1792,1608
1994-05-25,Czech Republic,Lithuania,5,3,2,1.0,0.0,1573,1486
1994-05-25,Ecuador,Argentina,1,0,1,1.0,0.0,1663,1904
1994-05-25,Fiji,Tahiti,2,0,2,1.0,0.0,1630,1729
1994-05-25,Ukraine,Belarus,3,1,2,1.0,0.0,1549,1506
1994-05-25,United States,Saudi Arabia,0,0,0,0.5,0.5,1714,1770
1994-05-26,Australia,France,0,1,1,0.0,1.0,1773,1921
1994-05-26,Denmark,Sweden,1,0,1,1.0,0.0,1865,1870
1994-05-27,Italy,Finland,2,0,2,1.0,0.0,1951,1622
1994-05-27,Netherlands,Scotland,3,1,2,1.0,0.0,1917,1794
1994-05-27,Switzerland,Liechtenstein,2,0,2,1.0,0.0,1841,1489
1994-05-28,United States,Greece,1,1,0,0.5,0.5,1715,1729
1994-05-29,Germany,Republic of Ireland,0,2,2,0.0,1.0,1986,1873
1994-05-29,Japan,France,1,4,3,0.0,1.0,1756,1926
1994-05-29,Russia,Slovakia,2,1,1,1.0,0.0,1881,1533
1994-05-31,Israel,Argentina,0,3,3,0.0,1.0,1660,1908
1994-06-01,Canada,Morocco,1,1,0,0.5,0.5,1679,1766
1994-06-01,North Macedonia,Estonia,2,0,2,1.0,0.0,1529,1370
1994-06-01,Netherlands,Hungary,7,1,6,1.0,0.0,1922,1726
1994-06-01,Norway,Denmark,2,1,1,1.0,0.0,1811,1856
1994-06-01,Romania,Slovenia,0,0,0,0.5,0.5,1822,1525
1994-06-02,Austria,Germany,1,5,4,0.0,1.0,1736,1990
1994-06-02,Finland,Spain,1,2,1,0.0,1.0,1619,1879
1994-06-02,Latvia,Malta,2,0,2,1.0,0.0,1502,1497
1994-06-03,Bulgaria,Ukraine,1,1,0,0.5,0.5,1757,1554
1994-06-03,Colombia,Northern Ireland,2,0,2,1.0,0.0,1848,1734
1994-06-03,Italy,Switzerland,1,0,1,1.0,0.0,1957,1836
1994-06-04,Croatia,Argentina,0,0,0,0.5,0.5,1617,1903
1994-06-04,Trinidad and Tobago,Saudi Arabia,2,3,1,0.0,1.0,1645,1776
1994-06-04,United States,Mexico,1,0,1,1.0,0.0,1727,1870
1994-06-05,Canada,Brazil,1,1,0,0.5,0.5,1685,1952
1994-06-05,Colombia,Greece,2,0,2,1.0,0.0,1854,1724
1994-06-05,Ecuador,South Korea,2,1,1,1.0,0.0,1675,1801
1994-06-05,Republic of Ireland,Czech Republic,1,3,2,0.0,1.0,1860,1587
1994-06-05,Ivory Coast,Liberia,4,1,3,1.0,0.0,1787,1542
1994-06-05,Sweden,Norway,2,0,2,1.0,0.0,1877,1805
1994-06-08,Australia,South Africa,1,0,1,1.0,0.0,1778,1618
1994-06-08,Belgium,Hungary,3,1,2,1.0,0.0,1820,1720
1994-06-08,Bolivia,Peru,0,0,0,0.5,0.5,1652,1610
1994-06-08,Canada,Germany,0,2,2,0.0,1.0,1683,1993
1994-06-08,Honduras,Brazil,2,8,6,0.0,1.0,1704,1956
1994-06-10,Canada,Spain,0,2,2,0.0,1.0,1680,1883
1994-06-11,Bolivia,Switzerland,0,0,0,0.5,0.5,1656,1833
1994-06-11,Costa Rica,Italy,0,1,1,0.0,1.0,1694,1960
1994-06-11,Honduras,South Korea,0,3,3,0.0,1.0,1699,1807
1994-06-11,Mexico,Northern Ireland,3,0,3,1.0,0.0,1876,1729
1994-06-11,Nigeria,Georgia,5,1,4,1.0,0.0,1788,1505
1994-06-12,Australia,South Africa,1,0,1,1.0,0.0,1783,1614
1994-06-12,Canada,Netherlands,0,3,3,0.0,1.0,1677,1926
1994-06-12,El Salvador,Brazil,0,4,4,0.0,1.0,1628,1959
1994-06-12,Romania,Sweden,1,1,0,0.5,0.5,1824,1876
1994-06-17,Germany,Bolivia,1,0,1,1.0,0.0,1996,1654
1994-06-17,Spain,South Korea,2,2,0,0.5,0.5,1882,1809
1994-06-18,Colombia,Romania,1,3,2,0.0,1.0,1846,1833
1994-06-18,Italy,Republic of Ireland,0,1,1,0.0,1.0,1950,1871
1994-06-18,United States,Switzerland,1,1,0,0.5,0.5,1730,1831
1994-06-19,Belgium,Morocco,1,0,1,1.0,0.0,1827,1760
1994-06-19,Cameroon,Sweden,2,2,0,0.5,0.5,1751,1874
1994-06-19,Norway,Mexico,1,0,1,1.0,0.0,1815,1867
1994-06-20,Brazil,Russia,2,0,2,1.0,0.0,1966,1875
1994-06-20,Netherlands,Saudi Arabia,2,1,1,1.0,0.0,1931,1772
1994-06-21,Argentina,Greece,4,0,4,1.0,0.0,1908,1720
1994-06-21,Germany,Spain,1,1,0,0.5,0.5,1994,1885
1994-06-21,Nigeria,Bulgaria,3,0,3,1.0,0.0,1796,1750
1994-06-22,Romania,Switzerland,1,4,3,0.0,1.0,1825,1840
1994-06-22,United States,Colombia,2,1,1,1.0,0.0,1741,1836
1994-06-23,Italy,Norway,1,0,1,1.0,0.0,1956,1810
1994-06-23,South Korea,Bolivia,0,0,0,0.5,0.5,1806,1658
1994-06-24,Brazil,Cameroon,3,0,3,1.0,0.0,1970,1748
1994-06-24,Mexico,Republic of Ireland,2,1,1,1.0,0.0,1876,1863
1994-06-24,Sweden,Russia,3,1,2,1.0,0.0,1883,1867
1994-06-25,Argentina,Nigeria,2,1,1,1.0,0.0,1914,1791
1994-06-25,Belgium,Netherlands,1,0,1,1.0,0.0,1838,1921
1994-06-25,Saudi Arabia,Morocco,2,1,1,1.0,0.0,1780,1753
1994-06-26,Bulgaria,Greece,4,0,4,1.0,0.0,1758,1713
1994-06-26,Latvia,Georgia,1,3,2,0.0,1.0,1495,1513
1994-06-26,Switzerland,Colombia,0,2,2,0.0,1.0,1832,1845
1994-06-26,United States,Romania,0,1,1,0.0,1.0,1735,1832
1994-06-27,Bolivia,Spain,1,3,2,0.0,1.0,1655,1889
1994-06-27,Germany,South Korea,3,2,1,1.0,0.0,1999,1802
1994-06-28,Brazil,Sweden,1,1,0,0.5,0.5,1969,1885
1994-06-28,Republic of Ireland,Norway,0,0,0,0.5,0.5,1862,1812
1994-06-28,Italy,Mexico,1,1,0,0.5,0.5,1955,1878
1994-06-28,Russia,Cameroon,6,1,5,1.0,0.0,1873,1743
1994-06-29,Belgium,Saudi Arabia,0,1,1,0.0,1.0,1829,1790
1994-06-29,Morocco,Netherlands,1,2,1,0.0,1.0,1749,1926
1994-06-30,Argentina,Bulgaria,0,2,2,0.0,1.0,1903,1770
1994-06-30,Greece,Nigeria,0,2,2,0.0,1.0,1707,1798
1994-07-01,Botswana,Namibia,0,1,1,0.0,1.0,1442,1468
1994-07-02,Germany,Belgium,3,2,1,1.0,0.0,2004,1825
1994-07-02,Spain,Switzerland,3,0,3,1.0,0.0,1896,1826
1994-07-03,Papua New Guinea,New Caledonia,1,0,1,1.0,0.0,1506,1609
1994-07-03,Romania,Argentina,3,2,1,1.0,0.0,1842,1894
1994-07-03,Saudi Arabia,Sweden,1,3,2,0.0,1.0,1785,1891
1994-07-04,Fiji,New Caledonia,3,1,2,1.0,0.0,1638,1602
1994-07-04,Netherlands,Republic of Ireland,2,0,2,1.0,0.0,1933,1856
1994-07-04,United States,Brazil,0,1,1,0.0,1.0,1732,1973
1994-07-05,Mexico,Bulgaria,1,1,0,0.5,0.5,1876,1773
1994-07-05,Nigeria,Italy,1,2,1,0.0,1.0,1794,1960
1994-07-05,Solomon Islands,Papua New Guinea,2,0,2,1.0,0.0,1523,1499
1994-07-05,Vanuatu,New Caledonia,2,3,1,0.0,1.0,1439,1607
1994-07-06,Papua New Guinea,Fiji,0,1,1,0.0,1.0,1495,1643
1994-07-06,Solomon Islands,Vanuatu,4,0,4,1.0,0.0,1530,1433
1994-07-07,Solomon Islands,Fiji,1,0,1,1.0,0.0,1541,1633
1994-07-07,Vanuatu,Papua New Guinea,1,1,0,0.5,0.5,1435,1494
1994-07-08,Japan,Ghana,3,2,1,1.0,0.0,1764,1734
1994-07-08,Solomon Islands,New Caledonia,3,1,2,1.0,0.0,1551,1598
1994-07-08,Vanuatu,Fiji,2,4,2,0.0,1.0,1432,1637
1994-07-09,Italy,Spain,2,1,1,1.0,0.0,1967,1890
1994-07-09,Netherlands,Brazil,2,3,1,0.0,1.0,1926,1981
1994-07-10,Bulgaria,Germany,2,1,1,1.0,0.0,1786,1992
1994-07-10,Romania,Sweden,2,2,0,0.5,0.5,1844,1890
1994-07-13,Bulgaria,Italy,1,2,1,0.0,1.0,1782,1972
1994-07-13,Sweden,Brazil,0,1,1,0.0,1.0,1885,1987
1994-07-14,Japan,Ghana,2,1,1,1.0,0.0,1772,1727
1994-07-16,Armenia,Malta,1,0,1,1.0,0.0,1500,1489
1994-07-16,Sweden,Bulgaria,4,0,4,1.0,0.0,1891,1777
1994-07-17,Brazil,Italy,0,0,0,0.5,0.5,1987,1973
1994-07-19,Georgia,Malta,1,1,0,0.5,0.5,1513,1490
1994-07-29,Lithuania,Estonia,3,0,3,1.0,0.0,1492,1365
1994-07-30,Estonia,Latvia,0,2,2,0.0,1.0,1360,1501
1994-07-31,Lithuania,Latvia,1,0,1,1.0,0.0,1501,1493
1994-08-08,Ivory Coast,Mali,2,1,1,1.0,0.0,1792,1637
1994-08-12,Myanmar,Thailand,2,2,0,0.5,0.5,1581,1642
1994-08-16,Iceland,Estonia,4,0,4,1.0,0.0,1628,1358
1994-08-16,Niger,Togo,3,2,1,1.0,0.0,1527,1555
1994-08-16,Slovakia,Malta,1,1,0,0.5,0.5,1533,1491
1994-08-17,Austria,Russia,0,3,3,0.0,1.0,1732,1878
1994-08-17,Denmark,Finland,2,1,1,1.0,0.0,1860,1616
1994-08-17,France,Czech Republic,2,2,0,0.5,0.5,1920,1594
1994-08-17,Israel,Croatia,0,4,4,0.0,1.0,1652,1626
1994-08-17,Peru,Ecuador,2,0,2,1.0,0.0,1620,1666
1994-08-17,Poland,Belarus,1,1,0,0.5,0.5,1785,1512
1994-08-17,Sweden,Lithuania,4,2,2,1.0,0.0,1893,1500
1994-08-19,Congo,DR Congo,2,0,2,1.0,0.0,1584,1636
1994-08-19,Egypt,Mali,2,1,1,1.0,0.0,1780,1633
1994-08-21,Egypt,Mali,0,1,1,0.0,1.0,1769,1645
1994-08-23,Burkina Faso,Niger,0,0,0,0.5,0.5,1603,1529
1994-08-23,Egypt,Ghana,2,0,2,1.0,0.0,1777,1720
1994-08-24,DR Congo,Congo,2,0,2,1.0,0.0,1643,1578
1994-08-25,Ghana,Zambia,1,0,1,1.0,0.0,1730,1771
1994-08-25,Namibia,Botswana,2,3,1,0.0,1.0,1460,1451
1994-08-26,DR Congo,Congo,1,1,0,0.5,0.5,1642,1580
1994-08-26,Ukraine,United Arab Emirates,1,1,0,0.5,0.5,1557,1681
1994-08-27,Egypt,Zambia,0,4,4,0.0,1.0,1769,1780
1994-08-30,Iceland,United Arab Emirates,1,0,1,1.0,0.0,1638,1672
1994-08-31,North Macedonia,Turkey,0,2,2,0.0,1.0,1524,1641
1994-09-02,Solomon Islands,Fiji,1,0,1,1.0,0.0,1561,1628
1994-09-03,Senegal,Mauritania,0,0,0,0.5,0.5,1636,1381
1994-09-03,Tanzania,Uganda,4,0,4,1.0,0.0,1530,1638
1994-09-04,Angola,Namibia,2,0,2,1.0,0.0,1585,1455
1994-09-04,Botswana,Guinea,0,1,1,0.0,1.0,1446,1587
1994-09-04,Burkina Faso,Morocco,2,1,1,1.0,0.0,1615,1738
1994-09-04,DR Congo,Malawi,1,1,0,0.5,0.5,1642,1641
1994-09-04,Estonia,Croatia,0,2,2,0.0,1.0,1356,1629
1994-09-04,Ethiopia,Algeria,0,0,0,0.5,0.5,1576,1775
1994-09-04,Ghana,Sierra Leone,4,1,3,1.0,0.0,1736,1611
1994-09-04,Israel,Poland,2,1,1,1.0,0.0,1663,1775
1994-09-04,Liberia,Togo,1,0,1,1.0,0.0,1551,1547
1994-09-04,Mali,Mozambique,2,1,1,1.0,0.0,1651,1525
1994-09-04,Sudan,Egypt,0,0,0,0.5,0.5,1571,1765
1994-09-06,Czech Republic,Malta,6,1,5,1.0,0.0,1600,1486
1994-09-06,Liberia,Togo,1,1,0,0.5,0.5,1551,1548
1994-09-06,Switzerland,United Arab Emirates,1,0,1,1.0,0.0,1831,1668
1994-09-07,Belgium,Armenia,2,0,2,1.0,0.0,1828,1498
1994-09-07,Cyprus,Spain,1,2,1,0.0,1.0,1450,1892
1994-09-07,England,United States,2,0,2,1.0,0.0,1927,1729
1994-09-07,Faroe Islands,Greece,1,5,4,0.0,1.0,1490,1711
1994-09-07,Finland,Scotland,0,2,2,0.0,1.0,1612,1799
1994-09-07,Georgia,Moldova,0,1,1,0.0,1.0,1506,1528
1994-09-07,Hungary,Turkey,2,2,0,0.5,0.5,1719,1643
1994-09-07,Iceland,Sweden,0,1,1,0.0,1.0,1636,1896
1994-09-07,Latvia,Republic of Ireland,0,3,3,0.0,1.0,1492,1858
1994-09-07,Liechtenstein,Austria,0,4,4,0.0,1.0,1486,1736
1994-09-07,Luxembourg,Netherlands,0,4,4,0.0,1.0,1341,1927
1994-09-07,North Macedonia,Denmark,1,1,0,0.5,0.5,1530,1855
1994-09-07,Northern Ireland,Portugal,1,2,1,0.0,1.0,1724,1830
1994-09-07,Norway,Belarus,1,0,1,1.0,0.0,1815,1510
1994-09-07,Romania,Azerbaijan,3,0,3,1.0,0.0,1846,1500
1994-09-07,Russia,Germany,0,1,1,0.0,1.0,1873,1998
1994-09-07,Slovakia,France,0,0,0,0.5,0.5,1540,1914
1994-09-07,Slovenia,Italy,1,1,0,0.5,0.5,1532,1967
1994-09-07,Ukraine,Lithuania,0,2,2,0.0,1.0,1548,1510
1994-09-07,Wales,Albania,2,0,2,1.0,0.0,1749,1486
1994-09-10,Qatar,Oman,0,2,2,0.0,1.0,1660,1483
1994-09-11,South Korea,Ukraine,1,0,1,1.0,0.0,1806,1545
1994-09-12,Bangladesh,India,2,4,2,0.0,1.0,1450,1515
1994-09-13,South Korea,Ukraine,2,0,2,1.0,0.0,1809,1543
1994-09-14,India,Yemen,0,1,1,0.0,1.0,1506,1454
1994-09-14,Oman,Sudan,1,1,0,0.5,0.5,1485,1570
1994-09-16,India,Oman,1,4,3,0.0,1.0,1498,1494
1994-09-16,Qatar,Yemen,2,0,2,1.0,0.0,1664,1451
1994-09-18,India,Yemen,0,2,2,0.0,1.0,1489,1461
1994-09-19,South Korea,United Arab Emirates,0,0,0,0.5,0.5,1806,1672
1994-09-21,Chile,Bolivia,1,2,1,0.0,1.0,1781,1667
1994-09-21,Ecuador,Peru,0,0,0,0.5,0.5,1665,1622
1994-09-22,Malaysia,Kuwait,0,2,2,0.0,1.0,1567,1721
1994-09-24,Australia,Kuwait,0,0,0,0.5,0.5,1782,1723
1994-09-25,Zambia,Ghana,3,0,3,1.0,0.0,1787,1730
1994-09-27,Japan,Australia,0,0,0,0.5,0.5,1773,1782
1994-10-01,Turkmenistan,China PR,2,2,0,0.5,0.5,1528,1699
1994-10-01,Yemen,Bahrain,0,2,2,0.0,1.0,1456,1591
1994-10-01,Saudi Arabia,Uzbekistan,1,4,3,0.0,1.0,1773,1548
1994-10-01,Malaysia,Hong Kong,4,3,1,1.0,0.0,1575,1540
1994-10-01,South Korea,Nepal,11,0,11,1.0,0.0,1808,1425
1994-10-01,Kuwait,Oman,2,2,0,0.5,0.5,1719,1499
1994-10-03,China PR,Yemen,4,0,4,1.0,0.0,1703,1453
1994-10-03,Iran,Bahrain,0,0,0,0.5,0.5,1767,1595
1994-10-03,Uzbekistan,Malaysia,5,0,5,1.0,0.0,1557,1567
1994-10-03,Thailand,Hong Kong,1,2,1,0.0,1.0,1632,1551
1994-10-03,Kuwait,Nepal,8,0,8,1.0,0.0,1722,1423
1994-10-03,Qatar,Myanmar,2,2,0,0.5,0.5,1663,1583
1994-10-03,Japan,United Arab Emirates,1,1,0,0.5,0.5,1771,1675
1994-10-05,Bahrain,China PR,2,3,1,0.0,1.0,1590,1709
1994-10-05,Iran,Turkmenistan,1,1,0,0.5,0.5,1763,1533
1994-10-05,Hong Kong,Uzbekistan,0,1,1,0.0,1.0,1544,1565
1994-10-05,Thailand,Saudi Arabia,2,4,2,0.0,1.0,1628,1778
1994-10-05,South Korea,Oman,2,1,1,1.0,0.0,1811,1497
1994-10-05,Myanmar,United Arab Emirates,0,2,2,0.0,1.0,1578,1681
1994-10-05,Japan,Qatar,1,1,0,0.5,0.5,1769,1666
1994-10-07,Iran,China PR,0,1,1,0.0,1.0,1754,1719
1994-10-07,Yemen,Turkmenistan,0,4,4,0.0,1.0,1447,1540
1994-10-07,Thailand,Uzbekistan,4,5,1,0.0,1.0,1619,1575
1994-10-07,Malaysia,Saudi Arabia,1,2,1,0.0,1.0,1564,1782
1994-10-07,South Korea,Kuwait,0,1,1,0.0,1.0,1801,1733
1994-10-08,Armenia,Cyprus,0,0,0,0.5,0.5,1497,1452
1994-10-08,Estonia,Italy,0,2,2,0.0,1.0,1356,1968
1994-10-08,France,Romania,0,0,0,0.5,0.5,1913,1848
1994-10-09,Croatia,Lithuania,2,0,2,1.0,0.0,1635,1505
1994-10-09,Latvia,Portugal,1,3,2,0.0,1.0,1490,1833
1994-10-09,Senegal,Niger,3,1,2,1.0,0.0,1642,1524
1994-10-09,Zambia,Malawi,2,1,1,1.0,0.0,1792,1637
1994-10-09,Bahrain,Turkmenistan,2,2,0,0.5,0.5,1589,1542
1994-10-09,Iran,Yemen,4,0,4,1.0,0.0,1757,1445
1994-10-09,Hong Kong,Saudi Arabia,1,2,1,0.0,1.0,1541,1786
1994-10-09,Thailand,Malaysia,1,1,0,0.5,0.5,1618,1566
1994-10-09,Oman,Nepal,1,0,1,1.0,0.0,1504,1417
1994-10-09,United Arab Emirates,Qatar,2,2,0,0.5,0.5,1681,1667
1994-10-09,Japan,Myanmar,5,0,5,1.0,0.0,1773,1575
1994-10-11,China PR,Saudi Arabia,2,0,2,1.0,0.0,1729,1777
1994-10-11,Kuwait,United Arab Emirates,2,1,1,1.0,0.0,1740,1675
1994-10-11,Uzbekistan,Turkmenistan,3,0,3,1.0,0.0,1583,1535
1994-10-11,Japan,South Korea,2,3,1,0.0,1.0,1766,1809
1994-10-12,Austria,Northern Ireland,1,2,1,0.0,1.0,1728,1733
1994-10-12,Belarus,Luxembourg,2,0,2,1.0,0.0,1515,1337
1994-10-12,Bulgaria,Georgia,2,0,2,1.0,0.0,1780,1504
1994-10-12,Denmark,Belgium,3,1,2,1.0,0.0,1863,1821
1994-10-12,England,Romania,1,1,0,0.5,0.5,1926,1850
1994-10-12,Greece,Finland,4,0,4,1.0,0.0,1717,1607
1994-10-12,Hungary,Germany,0,0,0,0.5,0.5,1725,1993
1994-10-12,Republic of Ireland,Liechtenstein,4,0,4,1.0,0.0,1860,1485
1994-10-12,Israel,Slovakia,2,2,0,0.5,0.5,1661,1543
1994-10-12,North Macedonia,Spain,0,2,2,0.0,1.0,1529,1894
1994-10-12,Malta,Czech Republic,0,0,0,0.5,0.5,1489,1598
1994-10-12,Moldova,Wales,3,2,1,1.0,0.0,1541,1737
1994-10-12,Norway,Netherlands,1,1,0,0.5,0.5,1818,1925
1994-10-12,Poland,Azerbaijan,1,0,1,1.0,0.0,1778,1498
1994-10-12,Russia,San Marino,4,0,4,1.0,0.0,1875,1468
1994-10-12,Scotland,Faroe Islands,5,1,4,1.0,0.0,1802,1488
1994-10-12,Switzerland,Sweden,4,2,2,1.0,0.0,1841,1887
1994-10-12,Turkey,Iceland,5,0,5,1.0,0.0,1651,1629
1994-10-12,Ukraine,Slovenia,0,0,0,0.5,0.5,1543,1533
1994-10-13,China PR,Kuwait,2,0,2,1.0,0.0,1738,1732
1994-10-13,Uzbekistan,South Korea,1,0,1,1.0,0.0,1596,1797
1994-10-14,Algeria,Sudan,1,1,0,0.5,0.5,1771,1575
1994-10-14,Egypt,Tanzania,5,1,4,1.0,0.0,1769,1527
1994-10-15,Malawi,Zimbabwe,3,1,2,1.0,0.0,1647,1686
1994-10-15,Namibia,Mali,2,1,1,1.0,0.0,1468,1639
1994-10-15,Uganda,Ethiopia,4,1,3,1.0,0.0,1645,1570
1994-10-15,Kuwait,South Korea,2,1,1,1.0,0.0,1742,1788
1994-10-16,Cameroon,DR Congo,1,0,1,1.0,0.0,1749,1637
1994-10-16,Guinea,Angola,3,1,2,1.0,0.0,1595,1578
1994-10-16,Mozambique,Botswana,3,1,2,1.0,0.0,1532,1440
1994-10-16,Sierra Leone,Congo,3,2,1,1.0,0.0,1619,1573
1994-10-16,Togo,Senegal,2,0,2,1.0,0.0,1559,1632
1994-10-16,China PR,Uzbekistan,2,4,2,0.0,1.0,1727,1608
1994-10-19,Peru,Uruguay,0,1,1,0.0,1.0,1619,1828
1994-10-19,Saudi Arabia,United States,2,1,1,1.0,0.0,1784,1723
1994-10-23,Oman,Senegal,0,1,1,0.0,1.0,1499,1638
1994-10-25,Oman,Senegal,2,1,1,1.0,0.0,1511,1627
1994-10-26,Estonia,Finland,0,7,7,0.0,1.0,1353,1611
1994-10-26,Saudi Arabia,Trinidad and Tobago,1,0,1,1.0,0.0,1789,1641
1994-10-28,United Arab Emirates,Senegal,3,2,1,1.0,0.0,1682,1621
1994-10-29,Kuwait,Iceland,0,1,1,0.0,1.0,1732,1640
1994-10-30,Mali,Guinea,2,0,2,1.0,0.0,1646,1589
1994-11-03,United Arab Emirates,Qatar,2,0,2,1.0,0.0,1690,1660
1994-11-04,Bahrain,Kuwait,2,1,1,1.0,0.0,1601,1721
1994-11-04,Oman,Saudi Arabia,1,2,1,0.0,1.0,1509,1792
1994-11-06,Latvia,Estonia,0,0,0,0.5,0.5,1487,1357
1994-11-06,United Arab Emirates,Saudi Arabia,1,1,0,0.5,0.5,1693,1790
1994-11-06,Oman,Bahrain,1,1,0,0.5,0.5,1512,1599
1994-11-07,Kuwait,Qatar,1,0,1,1.0,0.0,1728,1654
1994-11-07,Morocco,Cameroon,1,1,0,0.5,0.5,1739,1749
1994-11-08,Tunisia,Ivory Coast,2,0,2,1.0,0.0,1724,1783
1994-11-09,Qatar,Oman,4,2,2,1.0,0.0,1659,1508
1994-11-09,United Arab Emirates,Kuwait,2,0,2,1.0,0.0,1702,1720
1994-11-10,Saudi Arabia,Bahrain,3,1,2,1.0,0.0,1794,1596
1994-11-11,Egypt,Ethiopia,5,0,5,1.0,0.0,1773,1567
1994-11-11,Mauritania,Liberia,1,1,0,0.5,0.5,1385,1548
1994-11-12,Qatar,Saudi Arabia,1,2,1,0.0,1.0,1654,1800
1994-11-12,Romania,Slovakia,3,2,1,1.0,0.0,1853,1541
1994-11-12,Tanzania,Sudan,2,0,2,1.0,0.0,1537,1566
1994-11-12,Uganda,Algeria,1,1,0,0.5,0.5,1648,1769
1994-11-12,United Arab Emirates,Bahrain,0,0,0,0.5,0.5,1700,1599
1994-11-13,Gabon,Mauritius,3,0,3,1.0,0.0,1582,1506
1994-11-13,Mali,Angola,0,0,0,0.5,0.5,1645,1580
1994-11-13,Morocco,Ivory Coast,1,0,1,1.0,0.0,1749,1774
1994-11-13,Mozambique,Guinea,2,1,1,1.0,0.0,1542,1580
1994-11-13,Namibia,Botswana,1,1,0,0.5,0.5,1468,1441
1994-11-13,Tunisia,Togo,1,1,0,0.5,0.5,1721,1563
1994-11-13,Oman,Kuwait,0,0,0,0.5,0.5,1513,1716
1994-11-13,Portugal,Austria,1,0,1,1.0,0.0,1839,1723
1994-11-13,Ukraine,Estonia,3,0,3,1.0,0.0,1548,1353
1994-11-13,Zimbabwe,DR Congo,2,1,1,1.0,0.0,1693,1631
1994-11-15,Bahrain,Qatar,1,1,0,0.5,0.5,1601,1653
1994-11-15,Grenada,Trinidad and Tobago,1,2,1,0.0,1.0,1517,1647
1994-11-15,Liechtenstein,Latvia,0,1,1,0.0,1.0,1478,1495
1994-11-16,Albania,Germany,1,2,1,0.0,1.0,1486,1994
1994-11-16,Azerbaijan,Israel,0,2,2,0.0,1.0,1494,1666
1994-11-16,Belarus,Norway,0,4,4,0.0,1.0,1513,1821
1994-11-16,Belgium,North Macedonia,1,1,0,0.5,0.5,1816,1535
1994-11-16,Bulgaria,Moldova,4,1,3,1.0,0.0,1784,1538
1994-11-16,Chile,Argentina,0,3,3,0.0,1.0,1776,1900
1994-11-16,Cyprus,Armenia,2,0,2,1.0,0.0,1462,1488
1994-11-16,England,Nigeria,1,0,1,1.0,0.0,1932,1789
1994-11-16,Finland,Faroe Islands,5,0,5,1.0,0.0,1617,1483
1994-11-16,Georgia,Wales,5,0,5,1.0,0.0,1517,1725
1994-11-16,Greece,San Marino,2,0,2,1.0,0.0,1721,1465
1994-11-16,Italy,Croatia,1,2,1,0.0,1.0,1955,1649
1994-11-16,Kuwait,Saudi Arabia,0,2,2,0.0,1.0,1710,1807
1994-11-16,Netherlands,Czech Republic,0,0,0,0.5,0.5,1920,1604
1994-11-16,Northern Ireland,Republic of Ireland,0,4,4,0.0,1.0,1728,1866
1994-11-16,Poland,France,0,0,0,0.5,0.5,1781,1911
1994-11-16,Scotland,Russia,1,1,0,0.5,0.5,1804,1874
1994-11-16,Slovenia,Lithuania,1,2,1,0.0,1.0,1525,1514
1994-11-16,Spain,Denmark,3,0,3,1.0,0.0,1902,1856
1994-11-16,Sweden,Hungary,2,0,2,1.0,0.0,1892,1721
1994-11-16,Switzerland,Iceland,1,0,1,1.0,0.0,1845,1637
1994-11-16,United Arab Emirates,Oman,2,0,2,1.0,0.0,1705,1509
1994-11-19,Trinidad and Tobago,United States,1,0,1,1.0,0.0,1657,1714
1994-11-20,Gabon,Zambia,2,1,1,1.0,0.0,1595,1780
1994-11-22,Jamaica,United States,0,3,3,0.0,1.0,1589,1720
1994-11-24,Samoa,American Samoa,3,1,2,1.0,0.0,1482,1457
1994-11-24,Tahiti,Tonga,1,0,1,1.0,0.0,1732,1467
1994-11-25,Samoa,Tonga,2,2,0,0.5,0.5,1482,1468
1994-11-25,Tahiti,American Samoa,2,1,1,1.0,0.0,1735,1455
1994-11-26,Cameroon,Ivory Coast,1,2,1,0.0,1.0,1742,1782
1994-11-26,Kenya,Somalia,3,1,2,1.0,0.0,1646,1431
1994-11-28,Kenya,Djibouti,4,1,3,1.0,0.0,1650,1425
1994-11-28,Samoa,Tahiti,0,7,7,0.0,1.0,1479,1739
1994-11-28,Tonga,American Samoa,2,1,1,1.0,0.0,1476,1448
1994-11-29,Israel,Cyprus,4,3,1,1.0,0.0,1670,1459
1994-11-29,Tanzania,Somalia,4,0,4,1.0,0.0,1543,1426
1994-11-30,Cameroon,Ghana,0,1,1,0.0,1.0,1734,1739
1994-11-30,South Africa,Ivory Coast,0,0,0,0.5,0.5,1618,1779
1994-11-30,Spain,Finland,2,0,2,1.0,0.0,1905,1615
1994-12-01,Kenya,Tanzania,0,1,1,0.0,1.0,1640,1554
1994-12-01,Somalia,Djibouti,2,1,1,1.0,0.0,1434,1418
1994-12-01,Uganda,Seychelles,2,0,2,1.0,0.0,1652,1414
1994-12-03,Tanzania,Djibouti,3,0,3,1.0,0.0,1560,1413
1994-12-03,Uganda,Eritrea,0,0,0,0.5,0.5,1649,1514
1994-12-04,Ghana,Ivory Coast,1,1,0,0.5,0.5,1740,1779
1994-12-04,South Africa,Cameroon,1,1,0,0.5,0.5,1621,1732
1994-12-04,Togo,Burkina Faso,2,0,2,1.0,0.0,1573,1606
1994-12-05,Kenya,Uganda,0,1,1,0.0,1.0,1633,1657
1994-12-05,Tanzania,Eritrea,1,0,1,1.0,0.0,1567,1508
1994-12-08,Kenya,Eritrea,1,0,1,1.0,0.0,1639,1503
1994-12-08,Saudi Arabia,Poland,0,2,2,0.0,1.0,1799,1790
1994-12-08,Tanzania,Uganda,2,2,0,0.5,0.5,1570,1655
1994-12-10,Namibia,Ivory Coast,2,1,1,1.0,0.0,1482,1766
1994-12-10,Saudi Arabia,Poland,1,2,1,0.0,1.0,1791,1799
1994-12-11,United States,Honduras,1,1,0,0.5,0.5,1720,1700
1994-12-13,Azerbaijan,France,0,2,2,0.0,1.0,1493,1913
1994-12-14,Albania,Georgia,0,1,1,0.0,1.0,1479,1525
1994-12-14,Finland,San Marino,4,1,3,1.0,0.0,1620,1461
1994-12-14,Israel,Romania,1,1,0,0.5,0.5,1674,1850
1994-12-14,Malta,Norway,0,1,1,0.0,1.0,1487,1824
1994-12-14,Mexico,Hungary,5,1,4,1.0,0.0,1881,1717
1994-12-14,Moldova,Germany,0,3,3,0.0,1.0,1537,1996
1994-12-14,Netherlands,Luxembourg,5,0,5,1.0,0.0,1921,1337
1994-12-14,Turkey,Switzerland,1,2,1,0.0,1.0,1648,1849
1994-12-14,Wales,Bulgaria,0,3,3,0.0,1.0,1719,1791
1994-12-16,Tunisia,Algeria,1,0,1,1.0,0.0,1731,1760
1994-12-17,Belgium,Spain,1,4,3,0.0,1.0,1811,1911
1994-12-17,North Macedonia,Cyprus,3,0,3,1.0,0.0,1542,1453
1994-12-17,Saudi Arabia,Costa Rica,1,3,2,0.0,1.0,1781,1705
1994-12-18,Cameroon,Togo,1,1,0,0.5,0.5,1729,1577
1994-12-18,Germany,Albania,2,1,1,1.0,0.0,1997,1479
1994-12-18,Greece,Scotland,1,0,1,1.0,0.0,1731,1795
1994-12-18,Portugal,Liechtenstein,8,0,8,1.0,0.0,1841,1477
1994-12-21,Italy,Turkey,3,1,2,1.0,0.0,1958,1646
1994-12-23,Brazil,Serbia,2,0,2,1.0,0.0,1988,1493
1994-12-23,Basque Country,Russia,1,0,1,1.0,0.0,1633,1862
1994-12-25,Mali,Mauritania,0,0,0,0.5,0.5,1640,1391
1994-12-27,Argentina,Serbia,1,0,1,1.0,0.0,1902,1492
1994-12-29,Liberia,Guinea,0,0,0,0.5,0.5,1549,1580
1994-12-29,Mali,Mauritania,0,0,0,0.5,0.5,1636,1396
1994-12-29,Saudi Arabia,Zambia,1,0,1,1.0,0.0,1789,1773
1995-01-01,Guinea,Sierra Leone,3,1,2,1.0,0.0,1589,1611
1995-01-02,Mali,Mauritania,0,1,1,0.0,1.0,1624,1409
1995-01-02,Tunisia,Egypt,2,0,2,1.0,0.0,1740,1765
1995-01-04,Vietnam,Estonia,1,0,1,1.0,0.0,1464,1348
1995-01-06,Japan,Nigeria,0,3,3,0.0,1.0,1759,1797
1995-01-06,Saudi Arabia,Mexico,0,2,2,0.0,1.0,1784,1887
1995-01-07,Botswana,Mali,1,3,2,0.0,1.0,1437,1629
1995-01-07,Senegal,Tunisia,0,0,0,0.5,0.5,1624,1738
1995-01-08,Algeria,Egypt,1,0,1,1.0,0.0,1769,1757
1995-01-08,Angola,Mozambique,1,0,1,1.0,0.0,1588,1535
1995-01-08,Cameroon,Malawi,0,0,0,0.5,0.5,1728,1649
1995-01-08,Ethiopia,Tanzania,1,0,1,1.0,0.0,1576,1562
1995-01-08,Guinea,Namibia,3,0,3,1.0,0.0,1595,1477
1995-01-08,Japan,Argentina,1,5,4,0.0,1.0,1755,1907
1995-01-08,Saudi Arabia,Denmark,0,2,2,0.0,1.0,1778,1863
1995-01-08,Sudan,Uganda,3,1,2,1.0,0.0,1577,1645
1995-01-08,Togo,Mauritania,0,0,0,0.5,0.5,1574,1413
1995-01-09,Mauritius,Zambia,0,3,3,0.0,1.0,1504,1776
1995-01-10,Denmark,Mexico,1,1,0,0.5,0.5,1864,1887
1995-01-10,Nigeria,Argentina,0,0,0,0.5,0.5,1800,1905
1995-01-13,Denmark,Argentina,2,0,2,1.0,0.0,1873,1897
1995-01-13,Mexico,Nigeria,1,1,0,0.5,0.5,1886,1802
1995-01-15,Ivory Coast,Togo,0,0,0,0.5,0.5,1762,1579
1995-01-18,Netherlands,France,0,1,1,0.0,1.0,1913,1922
1995-01-18,Spain,Uruguay,2,2,0,0.5,0.5,1910,1830
1995-01-21,Tanzania,Algeria,2,1,1,1.0,0.0,1575,1757
1995-01-21,Uganda,Egypt,0,0,0,0.5,0.5,1648,1755
1995-01-22,Botswana,Angola,1,2,1,0.0,1.0,1433,1593
1995-01-22,Ethiopia,Sudan,2,0,2,1.0,0.0,1585,1569
1995-01-22,Ghana,Congo,3,1,2,1.0,0.0,1745,1569
1995-01-22,Ivory Coast,Burkina Faso,2,2,0,0.5,0.5,1759,1610
1995-01-22,Liberia,Senegal,1,1,0,0.5,0.5,1551,1623
1995-01-22,Mozambique,Namibia,4,2,2,1.0,0.0,1542,1471
1995-01-22,Zimbabwe,Cameroon,4,1,3,1.0,0.0,1702,1720
1995-01-25,Cyprus,Greece,2,3,1,0.0,1.0,1451,1734
1995-01-26,Canada,Portugal,1,1,0,0.5,0.5,1681,1838
1995-01-29,Tunisia,Mauritania,1,0,1,1.0,0.0,1741,1411
1995-01-31,South Korea,Colombia,1,0,1,1.0,0.0,1798,1836
1995-02-01,Mexico,Uruguay,1,0,1,1.0,0.0,1893,1824
1995-02-04,South Korea,Serbia,0,1,1,0.0,1.0,1785,1506
1995-02-06,Estonia,Norway,0,7,7,0.0,1.0,1348,1825
1995-02-08,Cyprus,Norway,0,2,2,0.0,1.0,1450,1827
1995-02-08,Greece,Romania,1,0,1,1.0,0.0,1745,1840
1995-02-10,Tunisia,Liberia,0,0,0,0.5,0.5,1738,1555
1995-02-11,Australia,Colombia,0,1,1,0.0,1.0,1776,1843
1995-02-14,Argentina,Bulgaria,4,1,3,1.0,0.0,1903,1786
1995-02-14,Israel,Luxembourg,4,2,2,1.0,0.0,1677,1335
1995-02-15,Australia,Japan,2,1,1,1.0,0.0,1784,1748
1995-02-15,Cyprus,Estonia,3,1,2,1.0,0.0,1456,1343
1995-02-15,Republic of Ireland,England,1,0,1,1.0,0.0,1876,1923
1995-02-15,Trinidad and Tobago,Finland,2,1,1,1.0,0.0,1665,1613
1995-02-15,Turkey,Romania,1,1,0,0.5,0.5,1651,1836
1995-02-17,Trinidad and Tobago,Finland,2,2,0,0.5,0.5,1664,1615
1995-02-19,China PR,South Korea,0,0,0,0.5,0.5,1729,1784
1995-02-19,Hong Kong,Japan,0,3,3,0.0,1.0,1538,1752
1995-02-21,Hong Kong,China PR,0,0,0,0.5,0.5,1543,1725
1995-02-21,Japan,South Korea,1,1,0,0.5,0.5,1753,1784
1995-02-21,New Zealand,Singapore,3,0,3,1.0,0.0,1700,1596
1995-02-22,Brazil,Slovakia,5,0,5,1.0,0.0,1990,1540
1995-02-22,Malta,Luxembourg,0,1,1,0.0,1.0,1476,1347
1995-02-22,Netherlands,Portugal,0,1,1,0.0,1.0,1904,1848
1995-02-22,Spain,Germany,0,0,0,0.5,0.5,1912,1996
1995-02-22,Thailand,Japan,3,2,1,1.0,0.0,1629,1743
1995-02-23,China PR,Japan,1,2,1,0.0,1.0,1718,1751
1995-02-23,Hong Kong,South Korea,2,3,1,0.0,1.0,1540,1788
1995-02-26,Hong Kong,China PR,1,1,0,0.5,0.5,1544,1715
1995-02-26,Japan,South Korea,2,2,0,0.5,0.5,1752,1788
1995-03-01,Morocco,Senegal,2,0,2,1.0,0.0,1755,1618
1995-03-08,Cyprus,Sweden,3,3,0,0.5,0.5,1463,1886
1995-03-08,Czech Republic,Finland,4,1,3,1.0,0.0,1613,1607
1995-03-08,Greece,Switzerland,1,1,0,0.5,0.5,1748,1847
1995-03-08,Hungary,Latvia,3,1,2,1.0,0.0,1721,1492
1995-03-08,Iraq,Uzbekistan,3,1,2,1.0,0.0,1783,1604
1995-03-08,Slovakia,Russia,2,1,1,1.0,0.0,1554,1849
1995-03-08,Turkey,Israel,2,1,1,1.0,0.0,1660,1669
1995-03-10,India,Thailand,0,5,5,0.0,1.0,1485,1634
1995-03-12,Barbados,Saint Kitts and Nevis,0,1,1,0.0,1.0,1530,1513
1995-03-12,India,Iraq,1,1,0,0.5,0.5,1491,1778
1995-03-12,Jamaica,Cuba,0,0,0,0.5,0.5,1588,1516
1995-03-14,India,Uzbekistan,1,0,1,1.0,0.0,1502,1594
1995-03-14,Iraq,Thailand,3,1,2,1.0,0.0,1783,1630
1995-03-15,Poland,Lithuania,4,1,3,1.0,0.0,1802,1512
1995-03-16,Thailand,Uzbekistan,0,1,1,0.0,1.0,1622,1603
1995-03-18,Alderney,Jersey,1,7,6,0.0,1.0,1291,1722
1995-03-19,Sint Maarten,Saint Kitts and Nevis,0,2,2,0.0,1.0,1482,1521
1995-03-21,Grenada,Saint Lucia,2,0,2,1.0,0.0,1526,1516
1995-03-22,Colombia,Uruguay,2,1,1,1.0,0.0,1851,1817
1995-03-23,Morocco,Mali,3,0,3,1.0,0.0,1761,1624
1995-03-24,Tahiti,Fiji,3,3,0,0.5,0.5,1737,1631
1995-03-25,Croatia,Ukraine,4,0,4,1.0,0.0,1655,1543
1995-03-25,Italy,Estonia,4,1,3,1.0,0.0,1959,1343
1995-03-25,Nepal,Bangladesh,0,2,2,0.0,1.0,1410,1458
1995-03-25,Pakistan,Bangladesh,1,0,1,1.0,0.0,1424,1449
1995-03-25,United States,Uruguay,2,2,0,0.5,0.5,1723,1815
1995-03-26,Barbados,Guyana,3,0,3,1.0,0.0,1537,1462
1995-03-26,Lebanon,Egypt,1,1,0,0.5,0.5,1512,1751
1995-03-26,Montserrat,Anguilla,3,2,1,1.0,0.0,1471,1438
1995-03-26,Saint Kitts and Nevis,Sint Maarten,0,1,1,0.0,1.0,1513,1491
1995-03-29,Albania,Moldova,3,0,3,1.0,0.0,1489,1528
1995-03-29,Austria,Latvia,5,0,5,1.0,0.0,1727,1489
1995-03-29,Brazil,Honduras,1,1,0,0.5,0.5,1985,1706
1995-03-29,Bulgaria,Wales,3,1,2,1.0,0.0,1793,1713
1995-03-29,Cyprus,Denmark,1,1,0,0.5,0.5,1470,1867
1995-03-29,Czech Republic,Belarus,4,2,2,1.0,0.0,1619,1508
1995-03-29,England,Uruguay,0,0,0,0.5,0.5,1921,1818
1995-03-29,Georgia,Germany,0,2,2,0.0,1.0,1525,1997
1995-03-29,Hungary,Switzerland,2,2,0,0.5,0.5,1724,1845
1995-03-29,Republic of Ireland,Northern Ireland,1,1,0,0.5,0.5,1873,1732
1995-03-29,Israel,France,0,0,0,0.5,0.5,1674,1918
1995-03-29,Lithuania,Croatia,0,0,0,0.5,0.5,1516,1652
1995-03-29,Luxembourg,Norway,0,2,2,0.0,1.0,1347,1828
1995-03-29,Mexico,Chile,1,2,1,0.0,1.0,1883,1787
1995-03-29,Nepal,Pakistan,2,0,2,1.0,0.0,1419,1416
1995-03-29,Netherlands,Malta,4,0,4,1.0,0.0,1906,1475
1995-03-29,Romania,Poland,2,1,1,1.0,0.0,1844,1795
1995-03-29,Russia,Scotland,0,0,0,0.5,0.5,1848,1797
1995-03-29,San Marino,Finland,0,2,2,0.0,1.0,1457,1612
1995-03-29,Slovakia,Azerbaijan,4,1,3,1.0,0.0,1561,1487
1995-03-29,Slovenia,Estonia,3,0,3,1.0,0.0,1530,1339
1995-03-29,Spain,Belgium,1,1,0,0.5,0.5,1910,1814
1995-03-29,Sri Lanka,India,2,2,0,0.5,0.5,1359,1499
1995-03-29,Turkey,Sweden,2,1,1,1.0,0.0,1673,1874
1995-03-29,Ukraine,Italy,0,2,2,0.0,1.0,1542,1961
1995-03-30,Tahiti,Fiji,3,0,3,1.0,0.0,1743,1626
1995-03-31,India,Bangladesh,0,0,0,0.5,0.5,1498,1451
1995-03-31,Serbia,Uruguay,1,0,1,1.0,0.0,1520,1805
1995-03-31,Sri Lanka,Nepal,2,1,1,1.0,0.0,1369,1410
1995-03-31,Syria,Egypt,1,2,1,0.0,1.0,1599,1756
1995-04-02,Anguilla,Montserrat,0,1,1,0.0,1.0,1431,1479
1995-04-02,Gabon,Benin,7,0,7,1.0,0.0,1600,1417
1995-04-02,Guyana,Barbados,0,4,4,0.0,1.0,1456,1544
1995-04-02,Sri Lanka,India,1,0,1,1.0,0.0,1380,1488
1995-04-03,Bolivia,Venezuela,0,0,0,0.5,0.5,1663,1475
1995-04-05,Uruguay,Peru,1,0,1,1.0,0.0,1810,1615
1995-04-07,Algeria,Ethiopia,2,0,2,1.0,0.0,1762,1581
1995-04-07,Egypt,Sudan,3,1,2,1.0,0.0,1761,1565
1995-04-07,Mauritania,Senegal,0,1,1,0.0,1.0,1408,1622
1995-04-08,Sierra Leone,Ghana,1,0,1,1.0,0.0,1622,1735
1995-04-08,Uganda,Tanzania,2,0,2,1.0,0.0,1655,1569
1995-04-08,Zambia,Gabon,1,0,1,1.0,0.0,1781,1596
1995-04-09,Guinea,Botswana,5,0,5,1.0,0.0,1600,1429
1995-04-09,Malawi,DR Congo,0,1,1,0.0,1.0,1641,1640
1995-04-09,Morocco,Burkina Faso,0,0,0,0.5,0.5,1758,1614
1995-04-09,Mozambique,Mali,1,0,1,1.0,0.0,1552,1615
1995-04-09,Namibia,Angola,2,2,0,0.5,0.5,1474,1591
1995-04-09,Saint Lucia,Grenada,4,0,4,1.0,0.0,1525,1518
1995-04-09,Togo,Liberia,0,0,0,0.5,0.5,1579,1556
1995-04-12,North Macedonia,Bulgaria,0,0,0,0.5,0.5,1547,1789
1995-04-14,Egypt,Tunisia,1,0,1,1.0,0.0,1769,1731
1995-04-19,Peru,Chile,6,0,6,1.0,0.0,1627,1776
1995-04-22,Belgium,United States,1,0,1,1.0,0.0,1820,1718
1995-04-22,Chile,Iceland,1,1,0,0.5,0.5,1773,1641
1995-04-22,Congo,Sierra Leone,0,2,2,0.0,1.0,1563,1629
1995-04-22,Senegal,Togo,5,1,4,1.0,0.0,1630,1572
1995-04-22,Tanzania,Egypt,1,2,1,0.0,1.0,1566,1773
1995-04-23,Angola,Guinea,3,0,3,1.0,0.0,1600,1592
1995-04-23,Botswana,Mozambique,0,3,3,0.0,1.0,1424,1558
1995-04-23,DR Congo,Cameroon,2,1,1,1.0,0.0,1650,1711
1995-04-23,Ethiopia,Uganda,0,0,0,0.5,0.5,1583,1654
1995-04-23,Liberia,Tunisia,1,0,1,1.0,0.0,1568,1720
1995-04-23,Mali,Namibia,2,0,2,1.0,0.0,1620,1470
1995-04-23,Zimbabwe,Malawi,1,1,0,0.5,0.5,1701,1643
1995-04-24,Sudan,Algeria,0,2,2,0.0,1.0,1562,1766
1995-04-25,Poland,Israel,4,3,1,1.0,0.0,1801,1669
1995-04-26,Armenia,Spain,0,2,2,0.0,1.0,1487,1912
1995-04-26,Austria,Liechtenstein,7,0,7,1.0,0.0,1731,1474
1995-04-26,Azerbaijan,Romania,1,4,3,0.0,1.0,1486,1846
1995-04-26,Belarus,Malta,1,1,0,0.5,0.5,1508,1476
1995-04-26,Belgium,Cyprus,2,0,2,1.0,0.0,1822,1469
1995-04-26,Croatia,Slovenia,2,0,2,1.0,0.0,1658,1525
1995-04-26,Czech Republic,Netherlands,3,1,2,1.0,0.0,1633,1893
1995-04-26,Denmark,North Macedonia,1,0,1,1.0,0.0,1870,1545
1995-04-26,Estonia,Ukraine,0,1,1,0.0,1.0,1336,1546
1995-04-26,Faroe Islands,Finland,0,4,4,0.0,1.0,1478,1618
1995-04-26,France,Slovakia,4,0,4,1.0,0.0,1920,1560
1995-04-26,Georgia,Albania,2,0,2,1.0,0.0,1533,1482
1995-04-26,Germany,Wales,1,1,0,0.5,0.5,1992,1719
1995-04-26,Greece,Russia,0,3,3,0.0,1.0,1743,1854
1995-04-26,Hungary,Sweden,1,0,1,1.0,0.0,1736,1863
1995-04-26,Republic of Ireland,Portugal,1,0,1,1.0,0.0,1881,1841
1995-04-26,Ivory Coast,Sierra Leone,4,0,4,1.0,0.0,1765,1624
1995-04-26,Latvia,Northern Ireland,0,1,1,0.0,1.0,1486,1736
1995-04-26,Lithuania,Italy,0,1,1,0.0,1.0,1515,1963
1995-04-26,Moldova,Bulgaria,0,3,3,0.0,1.0,1526,1792
1995-04-26,Norway,Luxembourg,5,0,5,1.0,0.0,1829,1347
1995-04-26,San Marino,Scotland,0,2,2,0.0,1.0,1456,1799
1995-04-26,Switzerland,Turkey,1,2,1,0.0,1.0,1834,1685
1995-04-30,Barbados,Saint Lucia,1,1,0,0.5,0.5,1544,1526
1995-04-30,Saint Kitts and Nevis,Antigua and Barbuda,1,1,0,0.5,0.5,1513,1488
1995-04-30,Guernsey,Jersey,1,2,1,0.0,1.0,1623,1728
1995-05-04,Kuwait,Mali,2,1,1,1.0,0.0,1716,1615
1995-05-06,Russia,Faroe Islands,3,0,3,1.0,0.0,1856,1477
1995-05-07,Aruba,Curaçao,3,4,1,0.0,1.0,1435,1570
1995-05-07,Saint Lucia,Barbados,2,1,1,1.0,0.0,1535,1536
1995-05-08,Slovakia,Czech Republic,1,1,0,0.5,0.5,1562,1632
1995-05-09,French Guiana,Martinique,1,3,2,0.0,1.0,1468,1641
1995-05-09,Guadeloupe,Suriname,1,2,1,0.0,1.0,1511,1603
1995-05-10,Armenia,North Macedonia,2,2,0,0.5,0.5,1489,1544
1995-05-11,French Guiana,Guadeloupe,2,2,0,0.5,0.5,1469,1511
1995-05-11,Martinique,Suriname,1,1,0,0.5,0.5,1641,1604
1995-05-13,French Guiana,Suriname,4,0,4,1.0,0.0,1480,1594
1995-05-13,Guadeloupe,Martinique,2,1,1,1.0,0.0,1522,1631
1995-05-13,Ivory Coast,Mali,0,1,1,0.0,1.0,1754,1627
1995-05-13,South Africa,Argentina,1,1,0,0.5,0.5,1627,1898
1995-05-13,Togo,Benin,3,0,3,1.0,0.0,1577,1413
1995-05-14,Bolivia,Paraguay,1,1,0,0.5,0.5,1666,1752
1995-05-14,Curaçao,Aruba,3,2,1,1.0,0.0,1576,1430
1995-05-17,Israel,Brazil,1,2,1,0.0,1.0,1667,1988
1995-05-17,Lithuania,Greece,2,1,1,1.0,0.0,1528,1731
1995-05-18,Morocco,Egypt,0,0,0,0.5,0.5,1759,1773
1995-05-19,Latvia,Estonia,2,0,2,1.0,0.0,1491,1332
1995-05-20,Estonia,Lithuania,0,7,7,0.0,1.0,1329,1532
1995-05-21,Antigua and Barbuda,Saint Kitts and Nevis,2,2,0,0.5,0.5,1489,1513
1995-05-21,Japan,Scotland,0,0,0,0.5,0.5,1754,1798
1995-05-21,Latvia,Lithuania,2,0,2,1.0,0.0,1500,1524
1995-05-22,Canada,Northern Ireland,2,0,2,1.0,0.0,1691,1727
1995-05-23,Cuba,Curaçao,3,0,3,1.0,0.0,1526,1567
1995-05-23,Dominican Republic,Puerto Rico,3,1,2,1.0,0.0,1470,1404
1995-05-24,Ecuador,Scotland,1,2,1,0.0,1.0,1660,1804
1995-05-25,Chile,Northern Ireland,2,1,1,1.0,0.0,1780,1721
1995-05-25,Curaçao,Puerto Rico,2,2,0,0.5,0.5,1564,1408
1995-05-25,Dominican Republic,Cuba,0,3,3,0.0,1.0,1464,1533
1995-05-25,Faroe Islands,San Marino,3,0,3,1.0,0.0,1485,1449
1995-05-25,Liberia,Mali,3,2,1,1.0,0.0,1578,1618
1995-05-25,Norway,Ghana,3,2,1,1.0,0.0,1835,1730
1995-05-27,Cuba,Puerto Rico,9,0,9,1.0,0.0,1539,1403
1995-05-27,Dominican Republic,Curaçao,1,2,1,0.0,1.0,1459,1570
1995-05-28,Canada,Chile,1,2,1,0.0,1.0,1686,1786
1995-05-28,Ivory Coast,Liberia,1,1,0,0.5,0.5,1751,1582
1995-05-28,Japan,Ecuador,3,0,3,1.0,0.0,1760,1655
1995-05-28,United States,Costa Rica,1,2,1,0.0,1.0,1710,1714
1995-05-31,Argentina,Peru,1,0,1,1.0,0.0,1901,1625
1995-05-31,Finland,Denmark,0,1,1,0.0,1.0,1615,1874
1995-05-31,Serbia,Russia,1,2,1,0.0,1.0,1518,1859
1995-06-01,Sweden,Iceland,1,1,0,0.5,0.5,1859,1646
1995-06-02,Algeria,Uganda,1,1,0,0.5,0.5,1764,1657
1995-06-03,England,Japan,2,1,1,1.0,0.0,1926,1756
1995-06-03,Liechtenstein,Republic of Ireland,0,0,0,0.5,0.5,1481,1875
1995-06-03,Portugal,Latvia,3,2,1,1.0,0.0,1843,1499
1995-06-03,Sudan,Tanzania,2,1,1,1.0,0.0,1571,1558
1995-06-04,Angola,Mali,1,0,1,1.0,0.0,1609,1610
1995-06-04,Botswana,Namibia,1,1,0,0.5,0.5,1426,1469
1995-06-04,Brazil,Sweden,1,0,1,1.0,0.0,1994,1854
1995-06-04,Canada,Turkey,1,3,2,0.0,1.0,1678,1694
1995-06-04,DR Congo,Zimbabwe,5,0,5,1.0,0.0,1660,1692
1995-06-04,Ecuador,Zambia,4,1,3,1.0,0.0,1666,1771
1995-06-04,Ethiopia,Egypt,0,2,2,0.0,1.0,1579,1778
1995-06-04,Guinea,Mozambique,0,0,0,0.5,0.5,1592,1559
1995-06-04,Ivory Coast,Morocco,2,0,2,1.0,0.0,1760,1751
1995-06-04,Liberia,Mauritania,2,0,2,1.0,0.0,1587,1404
1995-06-04,Mauritius,Gabon,0,3,3,0.0,1.0,1499,1602
1995-06-04,Togo,Tunisia,0,1,1,0.0,1.0,1573,1725
1995-06-05,South Korea,Costa Rica,1,0,1,1.0,0.0,1795,1708
1995-06-06,Brazil,Japan,3,0,3,1.0,0.0,1998,1753
1995-06-07,Belarus,Netherlands,1,0,1,1.0,0.0,1523,1879
1995-06-07,Bulgaria,Germany,3,2,1,1.0,0.0,1805,1980
1995-06-07,Canada,Turkey,0,3,3,0.0,1.0,1671,1702
1995-06-07,Denmark,Cyprus,4,0,4,1.0,0.0,1876,1468
1995-06-07,Faroe Islands,Scotland,0,2,2,0.0,1.0,1483,1807
1995-06-07,Lithuania,Slovenia,2,1,1,1.0,0.0,1533,1517
1995-06-07,Luxembourg,Czech Republic,1,0,1,1.0,0.0,1361,1619
1995-06-07,North Macedonia,Belgium,0,5,5,0.0,1.0,1542,1825
1995-06-07,Moldova,Albania,2,3,1,0.0,1.0,1517,1492
1995-06-07,Northern Ireland,Latvia,1,2,1,0.0,1.0,1709,1512
1995-06-07,Norway,Malta,2,0,2,1.0,0.0,1837,1475
1995-06-07,Poland,Slovakia,5,0,5,1.0,0.0,1805,1559
1995-06-07,Romania,Israel,2,1,1,1.0,0.0,1851,1663
1995-06-07,San Marino,Russia,0,7,7,0.0,1.0,1448,1861
1995-06-07,Spain,Armenia,1,0,1,1.0,0.0,1914,1488
1995-06-07,Wales,Georgia,0,1,1,0.0,1.0,1708,1545
1995-06-08,England,Sweden,3,3,0,0.5,0.5,1925,1856
1995-06-09,Paraguay,Bolivia,0,0,0,0.5,0.5,1751,1668
1995-06-09,Tahiti,New Zealand,2,1,1,1.0,0.0,1751,1693
1995-06-10,Costa Rica,Ecuador,1,2,1,0.0,1.0,1700,1675
1995-06-10,South Korea,Zambia,2,3,1,0.0,1.0,1787,1780
1995-06-10,Sweden,Japan,2,2,0,0.5,0.5,1854,1756
1995-06-11,England,Brazil,1,3,2,0.0,1.0,1919,2005
1995-06-11,Estonia,Slovenia,1,3,2,0.0,1.0,1325,1522
1995-06-11,Finland,Greece,2,1,1,1.0,0.0,1626,1721
1995-06-11,Honduras,Turkey,0,1,1,0.0,1.0,1698,1711
1995-06-11,Iceland,Hungary,2,1,1,1.0,0.0,1657,1726
1995-06-11,Republic of Ireland,Austria,1,3,2,0.0,1.0,1864,1743
1995-06-11,Ukraine,Croatia,1,0,1,1.0,0.0,1557,1648
1995-06-11,United States,Nigeria,3,2,1,1.0,0.0,1721,1792
1995-06-12,Ecuador,Zambia,1,0,1,1.0,0.0,1686,1770
1995-06-14,Argentina,Paraguay,2,1,1,1.0,0.0,1906,1747
1995-06-17,Colombia,Nigeria,1,0,1,1.0,0.0,1858,1786
1995-06-18,Australia,Ghana,2,1,1,1.0,0.0,1791,1724
1995-06-18,United States,Mexico,4,0,4,1.0,0.0,1733,1872
1995-06-18,Venezuela,Bolivia,1,3,2,0.0,1.0,1472,1672
1995-06-19,Chile,Paraguay,0,1,1,0.0,1.0,1778,1756
1995-06-19,Switzerland,Italy,0,1,1,0.0,1.0,1829,1969
1995-06-20,New Zealand,Turkey,1,2,1,0.0,1.0,1686,1719
1995-06-21,Australia,Ghana,1,0,1,1.0,0.0,1798,1718
1995-06-21,Germany,Italy,2,0,2,1.0,0.0,1988,1962
1995-06-21,Mexico,Colombia,0,0,0,0.5,0.5,1872,1859
1995-06-22,Chile,Turkey,0,0,0,0.5,0.5,1777,1721
1995-06-22,Paraguay,New Zealand,3,2,1,1.0,0.0,1763,1680
1995-06-23,Switzerland,Germany,1,2,1,0.0,1.0,1825,1993
1995-06-24,Australia,Ghana,0,1,1,0.0,1.0,1789,1728
1995-06-24,Mexico,Nigeria,2,1,1,1.0,0.0,1879,1780
1995-06-25,Mozambique,Zimbabwe,3,1,2,1.0,0.0,1570,1682
1995-06-25,Uruguay,New Zealand,7,0,7,1.0,0.0,1816,1675
1995-06-25,United States,Colombia,0,0,0,0.5,0.5,1736,1857
1995-06-25,Peru,Slovakia,1,0,1,1.0,0.0,1632,1553
1995-06-28,Uruguay,New Zealand,2,2,0,0.5,0.5,1813,1679
1995-06-30,Argentina,Australia,2,0,2,1.0,0.0,1912,1784
1995-06-30,Paraguay,Ecuador,1,0,1,1.0,0.0,1770,1680
1995-07-01,Ivory Coast,Ghana,2,0,2,1.0,0.0,1768,1721
1995-07-01,Peru,Bolivia,4,1,3,1.0,0.0,1641,1664
1995-07-02,Iceland,Faroe Islands,2,0,2,1.0,0.0,1662,1479
1995-07-05,Uruguay,Venezuela,4,1,3,1.0,0.0,1815,1471
1995-07-06,Mexico,Paraguay,1,2,1,0.0,1.0,1869,1781
1995-07-07,Brazil,Ecuador,1,0,1,1.0,0.0,2008,1678
1995-07-07,Colombia,Peru,1,1,0,0.5,0.5,1853,1646
1995-07-08,Argentina,Bolivia,2,1,1,1.0,0.0,1916,1661
1995-07-08,United States,Chile,2,1,1,1.0,0.0,1745,1769
1995-07-09,Mexico,Venezuela,3,1,2,1.0,0.0,1871,1470
1995-07-09,Syria,Egypt,0,0,0,0.5,0.5,1603,1775
1995-07-09,Uruguay,Paraguay,1,0,1,1.0,0.0,1823,1774
1995-07-10,Brazil,Peru,2,0,2,1.0,0.0,2010,1645
1995-07-10,Colombia,Ecuador,1,0,1,1.0,0.0,1858,1674
1995-07-11,Argentina,Chile,4,0,4,1.0,0.0,1921,1765
1995-07-11,United States,Bolivia,0,1,1,0.0,1.0,1736,1671
1995-07-12,Paraguay,Venezuela,3,2,1,1.0,0.0,1777,1468
1995-07-13,Brazil,Colombia,3,0,3,1.0,0.0,2015,1854
1995-07-13,Peru,Ecuador,1,2,1,0.0,1.0,1638,1682
1995-07-13,Uruguay,Mexico,1,1,0,0.5,0.5,1825,1870
1995-07-14,Argentina,United States,0,3,3,0.0,1.0,1910,1748
1995-07-14,Chile,Bolivia,2,2,0,0.5,0.5,1763,1674
1995-07-14,Egypt,Algeria,1,1,0,0.5,0.5,1775,1765
1995-07-14,Mauritania,Togo,2,1,1,1.0,0.0,1416,1562
1995-07-15,Tanzania,Ethiopia,2,0,2,1.0,0.0,1567,1571
1995-07-15,Tunisia,Senegal,4,0,4,1.0,0.0,1731,1625
1995-07-15,Uganda,Sudan,2,0,2,1.0,0.0,1664,1565
1995-07-15,Zambia,Mauritius,2,0,2,1.0,0.0,1773,1497
1995-07-16,Malawi,Cameroon,1,3,2,0.0,1.0,1637,1718
1995-07-16,Mali,Botswana,4,0,4,1.0,0.0,1615,1422
1995-07-16,Mozambique,Angola,2,1,1,1.0,0.0,1579,1601
1995-07-16,Namibia,Guinea,0,0,0,0.5,0.5,1472,1590
1995-07-16,Paraguay,Colombia,1,1,0,0.5,0.5,1779,1853
1995-07-16,Uruguay,Bolivia,2,1,1,1.0,0.0,1830,1670
1995-07-16,Isle of Man,Ynys Môn,0,2,2,0.0,1.0,1499,1546
1995-07-16,Gibraltar,Greenland,0,1,1,0.0,1.0,1465,1445
1995-07-16,Jersey,Isle of Wight,2,0,2,1.0,0.0,1732,1503
1995-07-16,Åland Islands,Guernsey,2,2,0,0.5,0.5,1528,1621
1995-07-17,Brazil,Argentina,2,2,0,0.5,0.5,2013,1913
1995-07-17,United States,Mexico,0,0,0,0.5,0.5,1751,1868
1995-07-17,Gibraltar,Isle of Man,2,1,1,1.0,0.0,1474,1491
1995-07-17,Greenland,Ynys Môn,1,2,1,0.0,1.0,1440,1552
1995-07-17,Åland Islands,Isle of Wight,0,5,5,0.0,1.0,1520,1512
1995-07-17,Jersey,Guernsey,1,0,1,1.0,0.0,1738,1616
1995-07-18,Gibraltar,Ynys Môn,2,0,2,1.0,0.0,1484,1543
1995-07-18,Greenland,Isle of Man,4,0,4,1.0,0.0,1450,1482
1995-07-18,Jersey,Åland Islands,3,1,2,1.0,0.0,1742,1517
1995-07-18,Isle of Wight,Guernsey,1,1,0,0.5,0.5,1515,1614
1995-07-19,Jamaica,Saint Lucia,2,1,1,1.0,0.0,1595,1529
1995-07-19,Trinidad and Tobago,Cuba,2,0,2,1.0,0.0,1670,1534
1995-07-19,Uruguay,Colombia,2,0,2,1.0,0.0,1839,1845
1995-07-20,United States,Brazil,0,1,1,0.0,1.0,1749,2016
1995-07-20,Greenland,Isle of Wight,1,2,1,0.0,1.0,1444,1522
1995-07-20,Gibraltar,Jersey,1,0,1,1.0,0.0,1498,1729
1995-07-21,Cayman Islands,Antigua and Barbuda,2,0,2,1.0,0.0,1472,1481
1995-07-21,French Guiana,Saint Vincent and the Grenadines,1,3,2,0.0,1.0,1474,1574
1995-07-21,Jamaica,Cuba,1,2,1,0.0,1.0,1586,1544
1995-07-21,Malaysia,Iraq,1,2,1,0.0,1.0,1563,1787
1995-07-21,Saint Lucia,Trinidad and Tobago,0,5,5,0.0,1.0,1525,1675
1995-07-21,Åland Islands,Isle of Man,4,1,3,1.0,0.0,1525,1475
1995-07-21,Guernsey,Ynys Môn,4,2,2,1.0,0.0,1621,1537
1995-07-21,Gibraltar,Jersey,1,0,1,1.0,0.0,1511,1717
1995-07-22,Algeria,Tunisia,2,1,1,1.0,0.0,1773,1724
1995-07-22,Colombia,United States,4,1,3,1.0,0.0,1851,1744
1995-07-22,Norway,France,0,0,0,0.5,0.5,1839,1919
1995-07-22,Gibraltar,Isle of Wight,0,1,1,0.0,1.0,1504,1530
1995-07-23,Cayman Islands,French Guiana,1,0,1,1.0,0.0,1481,1466
1995-07-23,Cuba,Saint Lucia,2,0,2,1.0,0.0,1552,1518
1995-07-23,Jamaica,Trinidad and Tobago,1,0,1,1.0,0.0,1597,1665
1995-07-23,Mali,Ivory Coast,2,2,0,0.5,0.5,1619,1765
1995-07-23,Saint Vincent and the Grenadines,Antigua and Barbuda,5,1,4,1.0,0.0,1580,1476
1995-07-23,Uruguay,Brazil,1,1,0,0.5,0.5,1843,2013
1995-07-25,Antigua and Barbuda,French Guiana,2,1,1,1.0,0.0,1484,1459
1995-07-28,Cayman Islands,Trinidad and Tobago,2,9,7,0.0,1.0,1477,1670
1995-07-29,Lithuania,Belarus,1,1,0,0.5,0.5,1533,1524
1995-07-30,Algeria,Tanzania,2,1,1,1.0,0.0,1777,1564
1995-07-30,Angola,Botswana,4,0,4,1.0,0.0,1606,1418
1995-07-30,Burkina Faso,Ivory Coast,1,1,0,0.5,0.5,1618,1762
1995-07-30,Cameroon,Zimbabwe,1,0,1,1.0,0.0,1726,1675
1995-07-30,Cayman Islands,Cuba,0,3,3,0.0,1.0,1471,1559
1995-07-30,Congo,Ghana,0,2,2,0.0,1.0,1559,1726
1995-07-30,Egypt,Uganda,6,0,6,1.0,0.0,1781,1659
1995-07-30,Guinea,Mali,4,1,3,1.0,0.0,1599,1611
1995-07-30,Mauritania,Tunisia,0,0,0,0.5,0.5,1422,1719
1995-07-30,Namibia,Mozambique,0,0,0,0.5,0.5,1475,1577
1995-07-30,Senegal,Liberia,3,0,3,1.0,0.0,1633,1580
1995-07-30,Sudan,Ethiopia,3,0,3,1.0,0.0,1574,1563
1995-08-01,Canada,Jamaica,3,1,2,1.0,0.0,1678,1591
1995-08-01,Indonesia,Singapore,0,0,0,0.5,0.5,1531,1595
1995-08-03,Canada,Trinidad and Tobago,3,1,2,1.0,0.0,1686,1663
1995-08-06,Jamaica,Trinidad and Tobago,1,0,1,1.0,0.0,1601,1654
1995-08-06,Japan,Costa Rica,3,0,3,1.0,0.0,1763,1694
1995-08-09,Japan,Brazil,1,5,4,0.0,1.0,1760,2017
1995-08-12,South Korea,Brazil,0,1,1,0.0,1.0,1784,2021
1995-08-15,Liechtenstein,Portugal,0,7,7,0.0,1.0,1480,1845
1995-08-16,Armenia,Denmark,0,2,2,0.0,1.0,1487,1878
1995-08-16,Azerbaijan,Slovakia,0,1,1,0.0,1.0,1480,1560
1995-08-16,Cook Islands,New Caledonia,0,9,9,0.0,1.0,1472,1604
1995-08-16,Estonia,Lithuania,0,1,1,0.0,1.0,1322,1537
1995-08-16,Fiji,Papua New Guinea,2,2,0,0.5,0.5,1624,1497
1995-08-16,Finland,Russia,0,6,6,0.0,1.0,1623,1865
1995-08-16,France,Poland,1,1,0,0.5,0.5,1917,1808
1995-08-16,Guam,Vanuatu,0,6,6,0.0,1.0,1446,1441
1995-08-16,Hungary,Israel,0,2,2,0.0,1.0,1717,1673
1995-08-16,Iceland,Switzerland,0,2,2,0.0,1.0,1658,1830
1995-08-16,Latvia,Austria,3,2,1,1.0,0.0,1525,1731
1995-08-16,Malta,Albania,2,1,1,1.0,0.0,1484,1484
1995-08-16,Norway,Czech Republic,1,1,0,0.5,0.5,1835,1624
1995-08-16,Scotland,Greece,1,0,1,1.0,0.0,1814,1715
1995-08-16,Solomon Islands,Wallis Islands and Futuna,12,1,11,1.0,0.0,1567,1443
1995-08-16,Sweden,United States,1,0,1,1.0,0.0,1860,1739
1995-08-17,Tahiti,Wallis Islands and Futuna,13,0,13,1.0,0.0,1754,1441
1995-08-18,Jamaica,Zambia,1,1,0,0.5,0.5,1605,1770
1995-08-18,New Caledonia,Solomon Islands,0,1,1,0.0,1.0,1596,1576
1995-08-19,Cook Islands,Wallis Islands and Futuna,2,1,1,1.0,0.0,1480,1434
1995-08-19,Tahiti,Solomon Islands,4,2,2,1.0,0.0,1759,1572
1995-08-20,Fiji,Guam,8,0,8,1.0,0.0,1629,1442
1995-08-20,Jamaica,Zambia,3,1,2,1.0,0.0,1617,1759
1995-08-20,New Caledonia,Wallis Islands and Futuna,10,0,10,1.0,0.0,1601,1430
1995-08-20,Papua New Guinea,Vanuatu,0,3,3,0.0,1.0,1488,1451
1995-08-21,Cook Islands,Solomon Islands,0,16,16,0.0,1.0,1475,1578
1995-08-21,Tahiti,New Caledonia,2,0,2,1.0,0.0,1764,1597
1995-08-22,Fiji,Vanuatu,3,1,2,1.0,0.0,1634,1447
1995-08-22,Guam,Papua New Guinea,0,9,9,0.0,1.0,1436,1495
1995-08-22,Tahiti,Cook Islands,11,0,11,1.0,0.0,1767,1473
1995-08-23,Belgium,Germany,1,2,1,0.0,1.0,1821,1998
1995-08-24,Fiji,Solomon Islands,3,3,0,0.5,0.5,1633,1580
1995-08-24,Tahiti,Vanuatu,3,0,3,1.0,0.0,1770,1445
1995-08-26,Fiji,Vanuatu,3,0,3,1.0,0.0,1638,1441
1995-08-26,Tahiti,Solomon Islands,2,0,2,1.0,0.0,1775,1576
1995-08-30,Turkey,North Macedonia,2,1,1,1.0,0.0,1726,1538
1995-09-03,Croatia,Estonia,7,1,6,1.0,0.0,1651,1320
1995-09-03,Portugal,Northern Ireland,1,1,0,0.5,0.5,1843,1712
1995-09-06,Albania,Bulgaria,1,1,0,0.5,0.5,1490,1800
1995-09-06,Austria,Republic of Ireland,3,1,2,1.0,0.0,1742,1854
1995-09-06,Belgium,Denmark,1,3,2,0.0,1.0,1815,1885
1995-09-06,Czech Republic,Norway,2,0,2,1.0,0.0,1637,1823
1995-09-06,England,Colombia,0,0,0,0.5,0.5,1918,1853
1995-09-06,Faroe Islands,Russia,2,5,3,0.0,1.0,1478,1867
1995-09-06,France,Azerbaijan,10,0,10,1.0,0.0,1919,1479
1995-09-06,Germany,Georgia,4,1,3,1.0,0.0,2000,1544
1995-09-06,Italy,Slovenia,1,0,1,1.0,0.0,1964,1521
1995-09-06,Latvia,Liechtenstein,1,0,1,1.0,0.0,1532,1474
1995-09-06,Lithuania,Ukraine,1,3,2,0.0,1.0,1530,1565
1995-09-06,Luxembourg,Malta,1,0,1,1.0,0.0,1372,1474
1995-09-06,North Macedonia,Armenia,1,2,1,0.0,1.0,1529,1497
1995-09-06,Netherlands,Belarus,1,0,1,1.0,0.0,1881,1523
1995-09-06,Poland,Romania,0,0,0,0.5,0.5,1809,1851
1995-09-06,San Marino,Greece,0,4,4,0.0,1.0,1446,1718
1995-09-06,Scotland,Finland,1,0,1,1.0,0.0,1818,1620
1995-09-06,Slovakia,Israel,1,0,1,1.0,0.0,1571,1663
1995-09-06,Spain,Cyprus,6,0,6,1.0,0.0,1916,1467
1995-09-06,Sweden,Switzerland,0,0,0,0.5,0.5,1860,1831
1995-09-06,Turkey,Hungary,2,0,2,1.0,0.0,1734,1710
1995-09-06,Wales,Moldova,1,0,1,1.0,0.0,1712,1514
1995-09-20,Greece,Serbia,0,2,2,0.0,1.0,1706,1531
1995-09-20,Israel,Uruguay,3,1,2,1.0,0.0,1675,1832
1995-09-20,Japan,Paraguay,1,2,1,0.0,1.0,1753,1787
1995-09-20,Spain,Argentina,2,1,1,1.0,0.0,1924,1906
1995-09-24,Trinidad and Tobago,Jamaica,1,0,1,1.0,0.0,1662,1610
1995-09-27,Jamaica,Costa Rica,2,0,2,1.0,0.0,1620,1685
1995-09-30,South Africa,Mozambique,3,2,1,1.0,0.0,1634,1571
1995-10-04,Finland,Turkey,0,0,0,0.5,0.5,1623,1732
1995-10-07,Armenia,Belgium,0,2,2,0.0,1.0,1495,1818
1995-10-07,Belarus,Czech Republic,0,2,2,0.0,1.0,1518,1643
1995-10-07,Bulgaria,Albania,3,0,3,1.0,0.0,1803,1488
1995-10-08,Croatia,Italy,1,1,0,0.5,0.5,1657,1959
1995-10-08,Germany,Moldova,6,1,5,1.0,0.0,2001,1514
1995-10-08,United States,Saudi Arabia,4,3,1,1.0,0.0,1748,1770
1995-10-11,Argentina,Colombia,0,0,0,0.5,0.5,1905,1855
1995-10-11,Austria,Portugal,1,1,0,0.5,0.5,1745,1841
1995-10-11,Brazil,Uruguay,2,0,2,1.0,0.0,2026,1828
1995-10-11,Chile,Canada,2,0,2,1.0,0.0,1770,1680
1995-10-11,Cyprus,North Macedonia,1,1,0,0.5,0.5,1469,1528
1995-10-11,Denmark,Spain,1,1,0,0.5,0.5,1886,1924
1995-10-11,Georgia,Bulgaria,2,1,1,1.0,0.0,1558,1790
1995-10-11,Iceland,Turkey,0,0,0,0.5,0.5,1660,1731
1995-10-11,Republic of Ireland,Latvia,2,1,1,1.0,0.0,1857,1530
1995-10-11,Israel,Azerbaijan,2,0,2,1.0,0.0,1679,1476
1995-10-11,Liechtenstein,Northern Ireland,0,4,4,0.0,1.0,1471,1716
1995-10-11,Lithuania,Estonia,5,0,5,1.0,0.0,1534,1317
1995-10-11,Luxembourg,Belarus,0,0,0,0.5,0.5,1376,1515
1995-10-11,Malta,Netherlands,0,4,4,0.0,1.0,1473,1883
1995-10-11,Mexico,Saudi Arabia,2,1,1,1.0,0.0,1874,1765
1995-10-11,Norway,England,0,0,0,0.5,0.5,1826,1916
1995-10-11,Romania,France,1,3,2,0.0,1.0,1845,1926
1995-10-11,Russia,Greece,2,1,1,1.0,0.0,1872,1702
1995-10-11,San Marino,Faroe Islands,1,3,2,0.0,1.0,1439,1486
1995-10-11,Slovakia,Poland,4,1,3,1.0,0.0,1584,1797
1995-10-11,Slovenia,Ukraine,3,2,1,1.0,0.0,1531,1556
1995-10-11,Sweden,Scotland,2,0,2,1.0,0.0,1868,1811
1995-10-11,Switzerland,Hungary,3,0,3,1.0,0.0,1837,1705
1995-10-11,Wales,Germany,1,2,1,0.0,1.0,1710,2004
1995-10-18,Jamaica,Honduras,1,0,1,1.0,0.0,1630,1689
1995-10-20,Jamaica,Trinidad and Tobago,1,0,1,1.0,0.0,1639,1654
1995-10-21,Mali,Algeria,0,2,2,0.0,1.0,1607,1782
1995-10-21,Uzbekistan,Nigeria,2,3,1,0.0,1.0,1599,1785
1995-10-22,Burkina Faso,Tunisia,2,2,0,0.5,0.5,1621,1717
1995-10-22,Cayman Islands,Jamaica,1,5,4,0.0,1.0,1467,1644
1995-10-22,Gabon,Sierra Leone,1,0,1,1.0,0.0,1611,1616
1995-10-22,Panama,Nicaragua,2,0,2,1.0,0.0,1492,1337
1995-10-24,Cayman Islands,Trinidad and Tobago,0,7,7,0.0,1.0,1463,1659
1995-10-24,Japan,Saudi Arabia,2,1,1,1.0,0.0,1762,1757
1995-10-25,Bolivia,Ecuador,2,2,0,0.5,0.5,1671,1682
1995-10-26,Myanmar,Bangladesh,4,0,4,1.0,0.0,1581,1446
1995-10-26,China PR,Colombia,2,1,1,1.0,0.0,1727,1844
1995-10-28,Japan,Saudi Arabia,2,1,1,1.0,0.0,1770,1750
1995-10-29,Myanmar,Sri Lanka,2,0,2,1.0,0.0,1585,1377
1995-10-29,Nicaragua,Panama,0,5,5,0.0,1.0,1333,1497
1995-10-31,South Korea,Saudi Arabia,1,1,0,0.5,0.5,1784,1751
1995-11-01,Bangladesh,Sri Lanka,1,0,1,1.0,0.0,1453,1371
1995-11-03,Algeria,Mauritania,4,0,4,1.0,0.0,1784,1421
1995-11-04,Myanmar,Bangladesh,1,2,1,0.0,1.0,1575,1464
1995-11-05,Tunisia,Algeria,2,0,2,1.0,0.0,1727,1775
1995-11-05,Zambia,Jamaica,4,2,2,1.0,0.0,1765,1639
1995-11-07,Tunisia,Mauritania,2,1,1,1.0,0.0,1730,1419
1995-11-08,Argentina,Brazil,0,1,1,0.0,1.0,1900,2032
1995-11-10,New Zealand,Australia,0,0,0,0.5,0.5,1682,1782
1995-11-10,Nigeria,Uzbekistan,1,0,1,1.0,0.0,1790,1595
1995-11-11,Hungary,Iceland,1,0,1,1.0,0.0,1712,1654
1995-11-11,Italy,Ukraine,3,1,2,1.0,0.0,1961,1555
1995-11-12,El Salvador,Serbia,1,4,3,0.0,1.0,1618,1542
1995-11-12,Malta,Belarus,0,2,2,0.0,1.0,1466,1523
1995-11-15,Albania,Wales,1,1,0,0.5,0.5,1493,1706
1995-11-15,Australia,New Zealand,3,0,3,1.0,0.0,1788,1677
1995-11-15,Azerbaijan,Poland,0,0,0,0.5,0.5,1482,1792
1995-11-15,Cyprus,Belgium,1,1,0,0.5,0.5,1476,1812
1995-11-15,Czech Republic,Luxembourg,3,0,3,1.0,0.0,1646,1374
1995-11-15,Denmark,Armenia,3,1,2,1.0,0.0,1888,1494
1995-11-15,England,Switzerland,3,1,2,1.0,0.0,1923,1831
1995-11-15,France,Israel,2,0,2,1.0,0.0,1930,1676
1995-11-15,Germany,Bulgaria,3,1,2,1.0,0.0,2008,1787
1995-11-15,Greece,Faroe Islands,5,0,5,1.0,0.0,1706,1483
1995-11-15,Italy,Lithuania,4,0,4,1.0,0.0,1963,1533
1995-11-15,Moldova,Georgia,3,2,1,1.0,0.0,1524,1549
1995-11-15,Morocco,Mali,2,0,2,1.0,0.0,1756,1603
1995-11-15,Netherlands,Norway,3,0,3,1.0,0.0,1890,1820
1995-11-15,Northern Ireland,Austria,5,3,2,1.0,0.0,1725,1737
1995-11-15,Portugal,Republic of Ireland,3,0,3,1.0,0.0,1850,1849
1995-11-15,Russia,Finland,3,1,2,1.0,0.0,1876,1620
1995-11-15,Scotland,San Marino,5,0,5,1.0,0.0,1813,1438
1995-11-15,Slovakia,Romania,0,2,2,0.0,1.0,1582,1848
1995-11-15,Slovenia,Croatia,1,2,1,0.0,1.0,1526,1663
1995-11-15,Spain,North Macedonia,3,0,3,1.0,0.0,1926,1527
1995-11-15,Sweden,Turkey,2,2,0,0.5,0.5,1865,1735
1995-11-16,Mexico,Serbia,1,4,3,0.0,1.0,1861,1556
1995-11-17,Cape Verde,Mali,1,0,1,1.0,0.0,1502,1593
1995-11-17,Mauritania,Gambia,2,1,1,1.0,0.0,1430,1503
1995-11-17,Solomon Islands,Tahiti,0,1,1,0.0,1.0,1573,1779
1995-11-18,Guinea-Bissau,Senegal,2,1,1,1.0,0.0,1531,1623
1995-11-18,Sierra Leone,Guinea,2,0,2,1.0,0.0,1624,1592
1995-11-19,Dominica,Saint Lucia,2,1,1,1.0,0.0,1456,1509
1995-11-19,Mali,Gambia,1,0,1,1.0,0.0,1599,1498
1995-11-19,Mauritania,Cape Verde,1,1,0,0.5,0.5,1432,1501
1995-11-19,Saint Vincent and the Grenadines,Barbados,2,0,2,1.0,0.0,1587,1530
1995-11-20,Senegal,Guinea,3,0,3,1.0,0.0,1631,1585
1995-11-20,Sierra Leone,Guinea-Bissau,2,0,2,1.0,0.0,1630,1526
1995-11-22,Egypt,Zimbabwe,2,2,0,0.5,0.5,1779,1678
1995-11-22,Guinea-Bissau,Guinea,2,1,1,1.0,0.0,1536,1576
1995-11-22,Senegal,Sierra Leone,1,1,0,0.5,0.5,1631,1631
1995-11-22,South Africa,Zambia,2,2,0,0.5,0.5,1637,1763
1995-11-23,Grenada,Barbados,1,0,1,1.0,0.0,1527,1522
1995-11-23,Saint Lucia,Saint Vincent and the Grenadines,2,1,1,1.0,0.0,1519,1578
1995-11-24,South Africa,Egypt,2,0,2,1.0,0.0,1649,1768
1995-11-24,Zambia,Zimbabwe,1,1,0,0.5,0.5,1762,1680
1995-11-25,Mauritania,Guinea-Bissau,1,0,1,1.0,0.0,1443,1526
1995-11-25,Sierra Leone,Cape Verde,2,0,2,1.0,0.0,1637,1496
1995-11-26,Algeria,Ivory Coast,0,0,0,0.5,0.5,1775,1763
1995-11-26,Egypt,Zambia,3,1,2,1.0,0.0,1776,1755
1995-11-26,Gabon,Cameroon,1,2,1,0.0,1.0,1606,1732
1995-11-26,Jamaica,Norway,1,1,0,0.5,0.5,1643,1817
1995-11-26,South Africa,Zimbabwe,2,0,2,1.0,0.0,1658,1672
1995-11-26,Uganda,Rwanda,0,0,0,0.5,0.5,1656,1501
1995-11-27,Cape Verde,Guinea-Bissau,1,0,1,1.0,0.0,1505,1518
1995-11-27,Kenya,Zanzibar,2,0,2,1.0,0.0,1642,1369
1995-11-27,Tanzania,Ethiopia,2,2,0,0.5,0.5,1564,1564
1995-11-28,Algeria,Cameroon,4,0,4,1.0,0.0,1783,1725
1995-11-28,Dominica,Saint Vincent and the Grenadines,1,0,1,1.0,0.0,1467,1568
1995-11-28,Gabon,Ivory Coast,0,2,2,0.0,1.0,1602,1768
1995-11-28,Mauritania,Sierra Leone,0,0,0,0.5,0.5,1448,1633
1995-11-29,El Salvador,Belize,3,0,3,1.0,0.0,1624,1489
1995-11-29,Honduras,Panama,2,0,2,1.0,0.0,1693,1494
1995-11-29,Mexico,Colombia,2,2,0,0.5,0.5,1861,1845
1995-11-29,Trinidad and Tobago,Norway,3,2,1,1.0,0.0,1671,1806
1995-11-29,Tunisia,Burkina Faso,3,0,3,1.0,0.0,1736,1616
1995-11-29,Zanzibar,Rwanda,2,1,1,1.0,0.0,1380,1491
1995-11-30,Albania,Bosnia and Herzegovina,2,0,2,1.0,0.0,1502,1492
1995-11-30,Gabon,Algeria,2,1,1,1.0,0.0,1614,1772
1995-11-30,Ivory Coast,Cameroon,2,1,1,1.0,0.0,1776,1718
1995-11-30,Kenya,Rwanda,1,0,1,1.0,0.0,1647,1487
1995-11-30,Uganda,Zanzibar,0,1,1,0.0,1.0,1643,1394
1995-12-01,Costa Rica,Belize,2,1,1,1.0,0.0,1689,1486
1995-12-01,Guatemala,Panama,1,0,1,1.0,0.0,1627,1489
1995-12-01,Tanzania,Somalia,7,0,7,1.0,0.0,1570,1429
1995-12-02,Algeria,Ivory Coast,0,0,0,0.5,0.5,1773,1776
1995-12-02,Gabon,Cameroon,0,0,0,0.5,0.5,1617,1716
1995-12-02,Uganda,Kenya,0,0,0,0.5,0.5,1644,1647
1995-12-03,Antigua and Barbuda,Jamaica,1,2,1,0.0,1.0,1480,1648
1995-12-03,El Salvador,Costa Rica,2,1,1,1.0,0.0,1634,1680
1995-12-03,Ethiopia,Somalia,5,0,5,1.0,0.0,1570,1424
1995-12-03,Grenada,Saint Vincent and the Grenadines,1,0,1,1.0,0.0,1536,1560
1995-12-03,Honduras,Guatemala,2,0,2,1.0,0.0,1700,1621
1995-12-04,Thailand,Indonesia,2,1,1,1.0,0.0,1628,1526
1995-12-04,Vietnam,Malaysia,2,0,2,1.0,0.0,1475,1553
1995-12-04,Singapore,Brunei,2,2,0,0.5,0.5,1591,1372
1995-12-04,Myanmar,Philippines,4,1,3,1.0,0.0,1579,1318
1995-12-06,Ethiopia,Zanzibar,1,1,0,0.5,0.5,1567,1398
1995-12-06,Mexico,Slovenia,1,2,1,0.0,1.0,1848,1540
1995-12-06,Saint Kitts and Nevis,Jamaica,0,3,3,0.0,1.0,1508,1654
1995-12-06,Thailand,Malaysia,0,0,0,0.5,0.5,1627,1555
1995-12-06,Indonesia,Cambodia,10,0,10,1.0,0.0,1534,1490
1995-12-06,Singapore,Myanmar,4,2,2,1.0,0.0,1599,1572
1995-12-06,Laos,Philippines,1,0,1,1.0,0.0,1389,1312
1995-12-07,El Salvador,Guatemala,0,1,1,0.0,1.0,1626,1630
1995-12-07,Honduras,Costa Rica,1,1,0,0.5,0.5,1700,1681
1995-12-08,Vietnam,Cambodia,4,0,4,1.0,0.0,1484,1482
1995-12-08,Indonesia,Malaysia,3,0,3,1.0,0.0,1543,1547
1995-12-08,Singapore,Philippines,4,0,4,1.0,0.0,1602,1310
1995-12-08,Laos,Brunei,3,0,3,1.0,0.0,1397,1365
1995-12-09,Ivory Coast,Mali,2,1,1,1.0,0.0,1781,1595
1995-12-09,Kenya,Ethiopia,2,1,1,1.0,0.0,1654,1561
1995-12-10,El Salvador,Costa Rica,2,1,1,1.0,0.0,1636,1672
1995-12-10,Honduras,Guatemala,3,0,3,1.0,0.0,1707,1624
1995-12-10,Thailand,Vietnam,3,1,2,1.0,0.0,1632,1480
1995-12-10,Malaysia,Cambodia,9,0,9,1.0,0.0,1554,1476
1995-12-10,Singapore,Laos,0,0,0,0.5,0.5,1598,1402
1995-12-10,Myanmar,Brunei,2,0,2,1.0,0.0,1576,1362
1995-12-12,DR Congo,Congo,2,2,0,0.5,0.5,1658,1562
1995-12-12,England,Portugal,1,1,0,0.5,0.5,1922,1852
1995-12-12,Thailand,Cambodia,9,0,9,1.0,0.0,1637,1472
1995-12-12,Vietnam,Indonesia,1,0,1,1.0,0.0,1490,1534
1995-12-12,Philippines,Brunei,1,0,1,1.0,0.0,1320,1353
1995-12-12,Myanmar,Laos,1,0,1,1.0,0.0,1581,1398
1995-12-13,Republic of Ireland,Netherlands,0,2,2,0.0,1.0,1842,1898
1995-12-13,Kuwait,Czech Republic,1,2,1,0.0,1.0,1707,1656
1995-12-14,Thailand,Singapore,1,0,1,1.0,0.0,1645,1591
1995-12-14,Vietnam,Myanmar,2,1,1,1.0,0.0,1501,1571
1995-12-15,South Africa,Germany,0,0,0,0.5,0.5,1665,2002
1995-12-16,Singapore,Myanmar,1,0,1,1.0,0.0,1599,1564
1995-12-16,Thailand,Vietnam,4,0,4,1.0,0.0,1650,1497
1995-12-17,Sierra Leone,Liberia,1,0,1,1.0,0.0,1640,1574
1995-12-19,Nepal,Maldives,1,0,1,1.0,0.0,1419,1419
1995-12-20,Brazil,Colombia,3,1,2,1.0,0.0,2037,1841
1995-12-20,Jamaica,Mexico,2,1,1,1.0,0.0,1667,1836
1995-12-21,Argentina,Venezuela,6,0,6,1.0,0.0,1902,1467
1995-12-21,Maldives,Bangladesh,0,0,0,0.5,0.5,1421,1463
1995-12-22,Burkina Faso,Gabon,2,5,3,0.0,1.0,1609,1625
1995-12-22,Basque Country,Paraguay,1,1,0,0.5,0.5,1637,1784
1995-12-23,Zambia,Tunisia,2,0,2,1.0,0.0,1763,1729
1995-12-23,India,Sri Lanka,1,0,1,1.0,0.0,1494,1366
1995-12-23,Bangladesh,Nepal,2,1,1,1.0,0.0,1470,1413
1995-12-24,Cameroon,Liberia,1,0,1,1.0,0.0,1721,1570
1995-12-25,Bangladesh,Sri Lanka,0,0,0,0.5,0.5,1468,1369
1995-12-25,India,Nepal,3,0,3,1.0,0.0,1501,1407
1995-12-27,Kuwait,Kazakhstan,0,0,0,0.5,0.5,1704,1542
1995-12-27,Mali,Gabon,1,2,1,0.0,1.0,1588,1633
1995-12-27,Sri Lanka,Nepal,0,0,0,0.5,0.5,1370,1407
1995-12-27,India,Bangladesh,1,0,1,1.0,0.0,1509,1461
1995-12-29,Egypt,Ghana,1,2,1,0.0,1.0,1767,1736
1995-12-29,Saudi Arabia,Kazakhstan,3,0,3,1.0,0.0,1755,1539
1996-01-03,Lebanon,Kazakhstan,2,1,1,1.0,0.0,1521,1531
1996-01-03,Morocco,Tunisia,3,1,2,1.0,0.0,1764,1722
1996-01-05,Saudi Arabia,Ghana,1,1,0,0.5,0.5,1755,1737
1996-01-05,Trinidad and Tobago,Venezuela,0,0,0,0.5,0.5,1667,1472
1996-01-06,Sierra Leone,Liberia,2,1,1,1.0,0.0,1647,1564
1996-01-07,Trinidad and Tobago,Venezuela,0,0,0,0.5,0.5,1663,1477
1996-01-07,Zimbabwe,Gabon,1,2,1,0.0,1.0,1664,1642
1996-01-08,Egypt,Tunisia,2,1,1,1.0,0.0,1774,1716
1996-01-09,Zimbabwe,Ghana,1,1,0,0.5,0.5,1666,1736
1996-01-10,Canada,Honduras,3,1,2,1.0,0.0,1689,1699
1996-01-10,Trinidad and Tobago,El Salvador,2,3,1,0.0,1.0,1655,1645
1996-01-11,Mexico,Saint Vincent and the Grenadines,5,0,5,1.0,0.0,1839,1558
1996-01-11,Mozambique,Gabon,1,0,1,1.0,0.0,1581,1633
1996-01-12,Brazil,Canada,4,1,3,1.0,0.0,2039,1688
1996-01-13,South Africa,Cameroon,3,0,3,1.0,0.0,1675,1712
1996-01-13,United States,Trinidad and Tobago,3,2,1,1.0,0.0,1754,1650
1996-01-14,Guatemala,Mexico,0,1,1,0.0,1.0,1621,1843
1996-01-14,Honduras,Brazil,0,5,5,0.0,1.0,1698,2041
1996-01-14,Ivory Coast,Ghana,0,2,2,0.0,1.0,1772,1746
1996-01-14,Jamaica,Cuba,1,1,0,0.5,0.5,1665,1562
1996-01-14,Zambia,Algeria,0,0,0,0.5,0.5,1764,1773
1996-01-15,Egypt,Angola,2,1,1,1.0,0.0,1779,1602
1996-01-15,Sierra Leone,Burkina Faso,2,1,1,1.0,0.0,1655,1602
1996-01-16,Gabon,Liberia,1,2,1,0.0,1.0,1624,1574
1996-01-16,Guatemala,Saint Vincent and the Grenadines,3,0,3,1.0,0.0,1628,1552
1996-01-16,Lebanon,Cyprus,1,0,1,1.0,0.0,1528,1470
1996-01-16,Tunisia,Mozambique,1,1,0,0.5,0.5,1714,1584
1996-01-16,United States,El Salvador,2,0,2,1.0,0.0,1760,1640
1996-01-17,Armenia,Morocco,0,6,6,0.0,1.0,1492,1767
1996-01-18,Algeria,Sierra Leone,2,0,2,1.0,0.0,1779,1650
1996-01-18,Cameroon,Egypt,2,1,1,1.0,0.0,1722,1770
1996-01-18,United States,Brazil,0,1,1,0.0,1.0,1758,2044
1996-01-19,DR Congo,Gabon,0,2,2,0.0,1.0,1650,1633
1996-01-19,Ghana,Tunisia,2,1,1,1.0,0.0,1754,1707
1996-01-19,Mexico,Guatemala,1,0,1,1.0,0.0,1847,1625
1996-01-20,Burkina Faso,Zambia,1,5,4,0.0,1.0,1598,1769
1996-01-20,South Africa,Angola,1,0,1,1.0,0.0,1682,1596
1996-01-21,Mexico,Brazil,2,0,2,1.0,0.0,1860,2032
1996-01-21,Mozambique,Ivory Coast,0,1,1,0.0,1.0,1580,1777
1996-01-21,United States,Guatemala,3,0,3,1.0,0.0,1764,1620
1996-01-24,Angola,Cameroon,3,3,0,0.5,0.5,1599,1720
1996-01-24,Burkina Faso,Algeria,1,2,1,0.0,1.0,1594,1784
1996-01-24,Greece,Israel,2,1,1,1.0,0.0,1714,1669
1996-01-24,Saudi Arabia,Kyrgyzstan,3,0,3,1.0,0.0,1758,1443
1996-01-24,Sierra Leone,Zambia,0,4,4,0.0,1.0,1645,1775
1996-01-24,South Africa,Egypt,0,1,1,0.0,1.0,1676,1777
1996-01-25,Liberia,DR Congo,0,2,2,0.0,1.0,1568,1657
1996-01-25,Mozambique,Ghana,0,2,2,0.0,1.0,1576,1759
1996-01-25,Tunisia,Ivory Coast,3,1,2,1.0,0.0,1717,1768
1996-01-26,Yemen,Kyrgyzstan,1,0,1,1.0,0.0,1453,1436
1996-01-27,South Africa,Algeria,2,1,1,1.0,0.0,1687,1774
1996-01-27,Zambia,Egypt,3,1,2,1.0,0.0,1784,1769
1996-01-28,Gabon,Tunisia,1,1,0,0.5,0.5,1635,1716
1996-01-28,Ghana,DR Congo,1,0,1,1.0,0.0,1765,1652
1996-01-28,Saudi Arabia,Yemen,4,0,4,1.0,0.0,1761,1451
1996-01-30,China PR,Macau,7,1,6,1.0,0.0,1730,1418
1996-01-30,Hong Kong,Philippines,8,0,8,1.0,0.0,1548,1317
1996-01-31,Saudi Arabia,Kyrgyzstan,2,0,2,1.0,0.0,1764,1434
1996-01-31,South Africa,Ghana,3,0,3,1.0,0.0,1697,1756
1996-01-31,Zambia,Tunisia,2,4,2,0.0,1.0,1775,1726
1996-02-01,Hong Kong,Macau,4,1,3,1.0,0.0,1554,1413
1996-02-01,Philippines,China PR,0,7,7,0.0,1.0,1316,1732
1996-02-02,Kyrgyzstan,Yemen,3,1,2,1.0,0.0,1443,1443
1996-02-02,Venezuela,Ecuador,0,1,1,0.0,1.0,1474,1686
1996-02-03,South Africa,Tunisia,2,0,2,1.0,0.0,1706,1718
1996-02-03,Zambia,Ghana,1,0,1,1.0,0.0,1783,1749
1996-02-04,Bolivia,Chile,1,1,0,0.5,0.5,1674,1768
1996-02-04,Hong Kong,China PR,0,2,2,0.0,1.0,1550,1737
1996-02-04,Macau,Philippines,5,1,4,1.0,0.0,1419,1311
1996-02-04,Saudi Arabia,Yemen,1,0,1,1.0,0.0,1767,1441
1996-02-06,Canary Islands,Venezuela,5,1,4,1.0,0.0,1508,1467
1996-02-07,Chile,Mexico,2,1,1,1.0,0.0,1779,1850
1996-02-07,Iceland,Slovenia,1,7,6,0.0,1.0,1644,1551
1996-02-07,Malta,Russia,0,2,2,0.0,1.0,1465,1878
1996-02-07,Morocco,Luxembourg,2,0,2,1.0,0.0,1769,1373
1996-02-07,Spain,Norway,1,0,1,1.0,0.0,1932,1801
1996-02-09,Iceland,Russia,0,3,3,0.0,1.0,1641,1882
1996-02-09,Malta,Slovenia,0,0,0,0.5,0.5,1467,1550
1996-02-09,Thailand,Finland,1,0,1,1.0,0.0,1658,1613
1996-02-10,Australia,Japan,1,4,3,0.0,1.0,1780,1779
1996-02-11,Lebanon,Ecuador,1,0,1,1.0,0.0,1540,1675
1996-02-11,Malta,Iceland,1,4,3,0.0,1.0,1463,1646
1996-02-11,Peru,Bolivia,1,3,2,0.0,1.0,1631,1682
1996-02-11,Russia,Slovenia,3,1,2,1.0,0.0,1885,1548
1996-02-14,Australia,Japan,3,0,3,1.0,0.0,1788,1772
1996-02-14,Bolivia,Paraguay,4,1,3,1.0,0.0,1693,1774
1996-02-14,Chile,Peru,4,0,4,1.0,0.0,1784,1627
1996-02-14,Turkey,Belarus,3,2,1,1.0,0.0,1739,1520
1996-02-16,Azerbaijan,Estonia,0,0,0,0.5,0.5,1479,1321
1996-02-16,Oman,Ecuador,0,2,2,0.0,1.0,1505,1680
1996-02-16,Thailand,Finland,5,2,3,1.0,0.0,1665,1607
1996-02-18,Qatar,Ecuador,1,1,0,0.5,0.5,1654,1680
1996-02-19,Japan,Poland,5,0,5,1.0,0.0,1781,1784
1996-02-20,Cyprus,Estonia,1,0,1,1.0,0.0,1475,1317
1996-02-21,France,Greece,3,1,2,1.0,0.0,1934,1711
1996-02-21,Israel,Lithuania,4,2,2,1.0,0.0,1675,1528
1996-02-21,Portugal,Germany,1,2,1,0.0,1.0,1848,2007
1996-02-22,Japan,Sweden,1,1,0,0.5,0.5,1783,1864
1996-02-23,Kuwait,Ecuador,0,3,3,0.0,1.0,1696,1689
1996-02-23,Thailand,Indonesia,4,1,3,1.0,0.0,1671,1529
1996-02-24,Estonia,Faroe Islands,2,2,0,0.5,0.5,1321,1480
1996-02-24,Kuwait,Oman,1,0,1,1.0,0.0,1700,1502
1996-02-25,Australia,Sweden,0,2,2,0.0,1.0,1782,1871
1996-02-25,Qatar,Ecuador,1,2,1,0.0,1.0,1647,1697
1996-02-27,Azerbaijan,Faroe Islands,3,0,3,1.0,0.0,1488,1472
1996-02-28,Australia,Sweden,0,0,0,0.5,0.5,1785,1869
1996-02-28,Croatia,Poland,2,1,1,1.0,0.0,1674,1774
1996-03-02,Malaysia,Indonesia,1,1,0,0.5,0.5,1554,1530
1996-03-02,Oman,Kuwait,0,3,3,0.0,1.0,1499,1704
1996-03-03,Jamaica,Guatemala,2,0,2,1.0,0.0,1672,1614
1996-03-04,Indonesia,India,7,1,6,1.0,0.0,1538,1502
1996-03-05,Syria,Kuwait,0,2,2,0.0,1.0,1598,1710
1996-03-06,Colombia,Honduras,2,1,1,1.0,0.0,1846,1694
1996-03-06,Malaysia,India,5,2,3,1.0,0.0,1561,1496
1996-03-06,Trinidad and Tobago,Haiti,2,0,2,1.0,0.0,1656,1554
1996-03-07,Bolivia,Peru,2,0,2,1.0,0.0,1700,1621
1996-03-10,Dominica,Antigua and Barbuda,3,3,0,0.5,0.5,1468,1480
1996-03-10,Turkmenistan,Kuwait,2,2,0,0.5,0.5,1539,1707
1996-03-12,Cyprus,Latvia,1,0,1,1.0,0.0,1485,1521
1996-03-13,Croatia,South Korea,3,0,3,1.0,0.0,1685,1774
1996-03-13,Luxembourg,Switzerland,1,1,0,0.5,0.5,1380,1825
1996-03-16,Kuwait,Finland,0,1,1,0.0,1.0,1697,1618
1996-03-16,Alderney,Guernsey,0,2,2,0.0,1.0,1289,1624
1996-03-17,Dominica,Saint Lucia,0,1,1,0.0,1.0,1462,1526
1996-03-19,United Arab Emirates,South Korea,3,2,1,1.0,0.0,1715,1765
1996-03-20,Egypt,Morocco,0,2,2,0.0,1.0,1761,1777
1996-03-21,Colombia,Trinidad and Tobago,3,0,3,1.0,0.0,1851,1652
1996-03-22,Kuwait,Turkmenistan,2,0,2,1.0,0.0,1702,1535
1996-03-22,United Arab Emirates,Egypt,0,0,0,0.5,0.5,1717,1760
1996-03-23,Curaçao,Grenada,0,1,1,0.0,1.0,1562,1545
1996-03-23,South Korea,Morocco,2,2,0,0.5,0.5,1766,1777
1996-03-24,Dominican Republic,Aruba,3,2,1,1.0,0.0,1467,1423
1996-03-24,French Guiana,Suriname,1,2,1,0.0,1.0,1454,1600
1996-03-25,Egypt,South Korea,1,1,0,0.5,0.5,1761,1766
1996-03-26,Croatia,Israel,2,0,2,1.0,0.0,1693,1668
1996-03-26,Czech Republic,Turkey,3,0,3,1.0,0.0,1666,1730
1996-03-26,United Arab Emirates,Morocco,1,0,1,1.0,0.0,1727,1768
1996-03-27,England,Bulgaria,1,0,1,1.0,0.0,1928,1782
1996-03-27,Austria,Switzerland,1,0,1,1.0,0.0,1747,1816
1996-03-27,Belgium,France,0,2,2,0.0,1.0,1807,1940
1996-03-27,Brazil,Ghana,8,2,6,1.0,0.0,2035,1747
1996-03-27,Cyprus,Georgia,0,2,2,0.0,1.0,1479,1556
1996-03-27,Germany,Denmark,2,0,2,1.0,0.0,2013,1883
1996-03-27,Guatemala,Venezuela,3,0,3,1.0,0.0,1619,1463
1996-03-27,Honduras,Nicaragua,1,0,1,1.0,0.0,1696,1332
1996-03-27,Republic of Ireland,Russia,0,2,2,0.0,1.0,1835,1893
1996-03-27,North Macedonia,Malta,1,0,1,1.0,0.0,1534,1457
1996-03-27,Northern Ireland,Norway,0,2,2,0.0,1.0,1719,1808
1996-03-27,Poland,Slovenia,0,0,0,0.5,0.5,1770,1553
1996-03-27,Portugal,Greece,1,0,1,1.0,0.0,1853,1707
1996-03-27,Scotland,Australia,1,0,1,1.0,0.0,1821,1778
1996-03-27,Serbia,Romania,1,0,1,1.0,0.0,1570,1835
1996-03-27,Slovakia,Belarus,4,0,4,1.0,0.0,1589,1514
1996-03-27,Saint Kitts and Nevis,Anguilla,8,0,8,1.0,0.0,1515,1425
1996-03-28,Colombia,Bolivia,4,1,3,1.0,0.0,1856,1696
1996-03-29,Guyana,Grenada,1,2,1,0.0,1.0,1451,1551
1996-03-29,Sint Maarten,Anguilla,4,0,4,1.0,0.0,1498,1419
1996-03-31,Antigua and Barbuda,Dominica,1,3,2,0.0,1.0,1472,1471
1996-03-31,Aruba,Dominican Republic,1,3,2,0.0,1.0,1417,1474
1996-03-31,Saint Kitts and Nevis,Sint Maarten,3,0,3,1.0,0.0,1523,1491
1996-03-31,Suriname,Jamaica,0,1,1,0.0,1.0,1594,1679
1996-04-07,Congo,DR Congo,2,1,1,1.0,0.0,1573,1642
1996-04-07,Grenada,Guyana,6,0,6,1.0,0.0,1557,1446
1996-04-09,Azerbaijan,Turkey,0,1,1,0.0,1.0,1485,1734
1996-04-09,Moldova,Ukraine,2,2,0,0.5,0.5,1525,1555
1996-04-10,Croatia,Hungary,4,1,3,1.0,0.0,1702,1704
1996-04-14,Suriname,French Guiana,1,1,0,0.5,0.5,1591,1458
1996-04-21,Ethiopia,Ghana,2,0,2,1.0,0.0,1573,1736
1996-04-21,Gambia,Senegal,1,2,1,0.0,1.0,1493,1637
1996-04-21,Jamaica,Suriname,1,0,1,1.0,0.0,1686,1585
1996-04-21,Paraguay,Bosnia and Herzegovina,3,0,3,1.0,0.0,1777,1490
1996-04-21,Qatar,Kuwait,3,1,2,1.0,0.0,1657,1693
1996-04-21,Saint Lucia,Dominica,1,1,0,0.5,0.5,1525,1473
1996-04-24,Argentina,Bolivia,3,1,2,1.0,0.0,1906,1693
1996-04-24,Belgium,Russia,0,0,0,0.5,0.5,1809,1892
1996-04-24,Bosnia and Herzegovina,Albania,0,0,0,0.5,0.5,1491,1502
1996-04-24,Colombia,Paraguay,1,0,1,1.0,0.0,1863,1771
1996-04-24,Czech Republic,Republic of Ireland,2,0,2,1.0,0.0,1678,1824
1996-04-24,Denmark,Scotland,2,0,2,1.0,0.0,1890,1815
1996-04-24,Ecuador,Peru,4,1,3,1.0,0.0,1704,1615
1996-04-24,England,Croatia,0,0,0,0.5,0.5,1924,1707
1996-04-24,Estonia,Iceland,0,3,3,0.0,1.0,1319,1649
1996-04-24,Greece,Slovenia,2,0,2,1.0,0.0,1712,1549
1996-04-24,Hungary,Austria,0,2,2,0.0,1.0,1697,1755
1996-04-24,Jamaica,Barbados,2,0,2,1.0,0.0,1691,1518
1996-04-24,North Macedonia,Liechtenstein,3,0,3,1.0,0.0,1541,1465
1996-04-24,Martinique,Saint Lucia,1,0,1,1.0,0.0,1637,1520
1996-04-24,Netherlands,Germany,0,1,1,0.0,1.0,1893,2019
1996-04-24,Northern Ireland,Sweden,1,2,1,0.0,1.0,1715,1874
1996-04-24,Norway,Spain,0,0,0,0.5,0.5,1811,1930
1996-04-24,Romania,Georgia,5,0,5,1.0,0.0,1838,1554
1996-04-24,Serbia,Faroe Islands,3,1,2,1.0,0.0,1576,1467
1996-04-24,Slovakia,Bulgaria,0,0,0,0.5,0.5,1594,1778
1996-04-24,South Africa,Brazil,2,3,1,0.0,1.0,1704,2038
1996-04-24,Switzerland,Wales,2,0,2,1.0,0.0,1822,1701
1996-04-24,Venezuela,Uruguay,0,2,2,0.0,1.0,1462,1830
1996-04-26,Cayman Islands,Cuba,0,4,4,0.0,1.0,1458,1568
1996-04-26,Haiti,Dominican Republic,6,0,6,1.0,0.0,1561,1468
1996-04-26,Turkmenistan,Iran,1,1,0,0.5,0.5,1540,1753
1996-04-28,Barbados,Jamaica,2,0,2,1.0,0.0,1530,1680
1996-04-28,DR Congo,Congo,3,1,2,1.0,0.0,1649,1567
1996-04-28,Haiti,Dominican Republic,1,1,0,0.5,0.5,1559,1471
1996-04-28,Saint Lucia,Martinique,0,1,1,0.0,1.0,1515,1643
1996-04-28,Suriname,Guyana,2,1,1,1.0,0.0,1590,1442
1996-04-28,Turkmenistan,Iran,0,1,1,0.0,1.0,1537,1757
1996-04-30,Israel,South Korea,4,5,1,0.0,1.0,1663,1772
1996-05-01,Poland,Belarus,1,1,0,0.5,0.5,1765,1520
1996-05-01,Turkey,Ukraine,3,2,1,1.0,0.0,1739,1551
1996-05-04,Puerto Rico,Saint Vincent and the Grenadines,1,2,1,0.0,1.0,1399,1557
1996-05-04,Dominican Republic,Curaçao,2,1,1,1.0,0.0,1482,1552
1996-05-05,El Salvador,Bolivia,1,1,0,0.5,0.5,1642,1692
1996-05-05,Guyana,Suriname,2,1,1,1.0,0.0,1454,1579
1996-05-05,Nicaragua,Guatemala,0,1,1,0.0,1.0,1330,1622
1996-05-05,Saint Kitts and Nevis,Saint Lucia,5,1,4,1.0,0.0,1531,1508
1996-05-06,Jersey,Guernsey,0,0,0,0.5,0.5,1715,1627
1996-05-08,Greece,Georgia,2,1,1,1.0,0.0,1717,1550
1996-05-08,Tajikistan,Uzbekistan,4,0,4,1.0,0.0,1490,1585
1996-05-09,Sweden,Slovakia,2,1,1,1.0,0.0,1877,1592
1996-05-10,Guatemala,Nicaragua,2,1,1,1.0,0.0,1625,1328
1996-05-11,Curaçao,Dominican Republic,0,0,0,0.5,0.5,1551,1484
1996-05-11,Malawi,Zambia,0,1,1,0.0,1.0,1633,1788
1996-05-11,Tahiti,Solomon Islands,2,1,1,1.0,0.0,1783,1570
1996-05-12,Saint Vincent and the Grenadines,Puerto Rico,7,0,7,1.0,0.0,1562,1395
1996-05-12,Burkina Faso,Niger,0,0,0,0.5,0.5,1593,1526
1996-05-12,Cayman Islands,Cuba,0,1,1,0.0,1.0,1453,1574
1996-05-12,Haiti,Grenada,6,1,5,1.0,0.0,1567,1550
1996-05-12,Lebanon,Turkmenistan,3,1,2,1.0,0.0,1548,1530
1996-05-12,Malawi,Zambia,1,1,0,0.5,0.5,1637,1785
1996-05-12,Eswatini,Mozambique,0,1,1,0.0,1.0,1471,1582
1996-05-14,Cayman Islands,Cuba,0,5,5,0.0,1.0,1448,1580
1996-05-14,Dominica,Barbados,0,1,1,0.0,1.0,1467,1537
1996-05-16,South Korea,Sweden,0,2,2,0.0,1.0,1767,1883
1996-05-17,Iran,Qatar,2,0,2,1.0,0.0,1763,1652
1996-05-17,Mauritania,Senegal,0,0,0,0.5,0.5,1452,1634
1996-05-18,England,Hungary,3,0,3,1.0,0.0,1928,1694
1996-05-18,Grenada,Haiti,0,1,1,0.0,1.0,1543,1575
1996-05-18,Mexico,Slovakia,5,2,3,1.0,0.0,1853,1590
1996-05-19,Barbados,Dominica,1,0,1,1.0,0.0,1544,1461
1996-05-19,Gambia,Guinea,1,1,0,0.5,0.5,1495,1575
1996-05-19,Saint Lucia,Saint Kitts and Nevis,0,1,1,0.0,1.0,1501,1539
1996-05-19,Zambia,Tanzania,1,0,1,1.0,0.0,1789,1567
1996-05-19,Guernsey,Jersey,0,1,1,0.0,1.0,1621,1722
1996-05-21,Slovenia,United Arab Emirates,2,2,0,0.5,0.5,1553,1724
1996-05-21,Zambia,Tanzania,0,0,0,0.5,0.5,1785,1572
1996-05-23,China PR,England,0,3,3,0.0,1.0,1734,1932
1996-05-23,Kuwait,Syria,3,1,2,1.0,0.0,1699,1593
1996-05-23,Mexico,Serbia,0,0,0,0.5,0.5,1848,1582
1996-05-24,Trinidad and Tobago,Jamaica,1,0,1,1.0,0.0,1661,1672
1996-05-25,Cuba,Saint Vincent and the Grenadines,2,0,2,1.0,0.0,1588,1555
1996-05-25,Martinique,Haiti,1,0,1,1.0,0.0,1650,1569
1996-05-25,Mauritius,Madagascar,0,0,0,0.5,0.5,1501,1656
1996-05-25,Qatar,Russia,2,5,3,0.0,1.0,1649,1896
1996-05-25,Uganda,Kenya,1,1,0,0.5,0.5,1645,1654
1996-05-26,Chile,Bolivia,2,0,2,1.0,0.0,1790,1687
1996-05-26,Gabon,Ivory Coast,0,1,1,0.0,1.0,1630,1774
1996-05-26,Ghana,Egypt,0,2,2,0.0,1.0,1729,1769
1996-05-26,Jamaica,Saint Kitts and Nevis,4,1,3,1.0,0.0,1678,1534
1996-05-26,Japan,Serbia,1,0,1,1.0,0.0,1787,1579
1996-05-26,Malawi,Mozambique,1,0,1,1.0,0.0,1644,1576
1996-05-26,Trinidad and Tobago,Suriname,3,0,3,1.0,0.0,1668,1573
1996-05-26,Tunisia,Senegal,2,0,2,1.0,0.0,1725,1628
1996-05-26,Turkmenistan,Lebanon,0,1,1,0.0,1.0,1523,1556
1996-05-26,Uganda,Kenya,1,2,1,0.0,1.0,1638,1662
1996-05-26,United States,Scotland,2,1,1,1.0,0.0,1774,1806
1996-05-27,Belarus,Azerbaijan,2,2,0,0.5,0.5,1520,1486
1996-05-27,Cuba,Martinique,1,0,1,1.0,0.0,1598,1641
1996-05-28,Bulgaria,North Macedonia,3,0,3,1.0,0.0,1782,1538
1996-05-28,Suriname,Jamaica,3,1,2,1.0,0.0,1584,1668
1996-05-28,Trinidad and Tobago,Saint Kitts and Nevis,5,1,4,1.0,0.0,1674,1529
1996-05-29,Austria,Czech Republic,1,0,1,1.0,0.0,1762,1672
1996-05-29,Colombia,Scotland,1,0,1,1.0,0.0,1870,1800
1996-05-29,Cuba,Haiti,0,0,0,0.5,0.5,1598,1570
1996-05-29,Estonia,Turkey,0,0,0,0.5,0.5,1326,1733
1996-05-29,France,Finland,2,0,2,1.0,0.0,1943,1616
1996-05-29,Republic of Ireland,Portugal,0,1,1,0.0,1.0,1817,1861
1996-05-29,Italy,Belgium,2,2,0,0.5,0.5,1960,1813
1996-05-29,Japan,Mexico,3,2,1,1.0,0.0,1797,1839
1996-05-29,Netherlands,China PR,2,0,2,1.0,0.0,1898,1730
1996-05-29,Northern Ireland,Germany,1,1,0,0.5,0.5,1721,2014
1996-05-29,Russia,United Arab Emirates,1,0,1,1.0,0.0,1901,1720
1996-05-30,Saint Kitts and Nevis,Suriname,1,1,0,0.5,0.5,1531,1583
1996-05-31,Mauritania,Burkina Faso,0,0,0,0.5,0.5,1456,1590
1996-06-01,Gambia,Liberia,2,1,1,1.0,0.0,1505,1559
1996-06-01,Germany,France,0,1,1,0.0,1.0,2005,1953
1996-06-01,Guinea-Bissau,Guinea,3,2,1,1.0,0.0,1528,1566
1996-06-01,Hungary,Italy,0,2,2,0.0,1.0,1692,1963
1996-06-01,Iceland,North Macedonia,1,1,0,0.5,0.5,1647,1541
1996-06-01,Malawi,South Africa,0,1,1,0.0,1.0,1638,1711
1996-06-01,Namibia,Mozambique,2,0,2,1.0,0.0,1486,1566
1996-06-01,Qatar,Iran,0,1,1,0.0,1.0,1644,1769
1996-06-01,Romania,Moldova,3,1,2,1.0,0.0,1841,1523
1996-06-01,Sudan,Zambia,2,0,2,1.0,0.0,1587,1773
1996-06-01,Sweden,Belarus,5,1,4,1.0,0.0,1885,1519
1996-06-01,Switzerland,Czech Republic,1,2,1,0.0,1.0,1811,1684
1996-06-01,Uganda,Angola,0,2,2,0.0,1.0,1630,1608
1996-06-02,Belize,Panama,1,2,1,0.0,1.0,1479,1497
1996-06-02,Bulgaria,United Arab Emirates,4,1,3,1.0,0.0,1789,1714
1996-06-02,Burundi,Sierra Leone,1,0,1,1.0,0.0,1538,1635
1996-06-02,Congo,Ivory Coast,2,0,2,1.0,0.0,1580,1762
1996-06-02,Denmark,Ghana,1,0,1,1.0,0.0,1895,1725
1996-06-02,Ecuador,Argentina,2,0,2,1.0,0.0,1717,1894
1996-06-02,Finland,Turkey,1,2,1,0.0,1.0,1611,1739
1996-06-02,Republic of Ireland,Croatia,2,2,0,0.5,0.5,1815,1710
1996-06-02,Kenya,Algeria,3,1,2,1.0,0.0,1673,1764
1996-06-02,Madagascar,Zimbabwe,1,2,1,0.0,1.0,1649,1674
1996-06-02,Mauritius,DR Congo,1,5,4,0.0,1.0,1497,1654
1996-06-02,Norway,Azerbaijan,5,0,5,1.0,0.0,1814,1484
1996-06-02,Peru,Colombia,1,1,0,0.5,0.5,1621,1865
1996-06-02,Russia,Poland,2,0,2,1.0,0.0,1907,1760
1996-06-02,Rwanda,Tunisia,1,3,2,0.0,1.0,1484,1729
1996-06-02,San Marino,Wales,0,5,5,0.0,1.0,1436,1704
1996-06-02,Serbia,Malta,6,0,6,1.0,0.0,1585,1452
1996-06-02,Eswatini,Gabon,0,1,1,0.0,1.0,1467,1635
1996-06-02,Togo,Senegal,2,1,1,1.0,0.0,1572,1619
1996-06-02,Trinidad and Tobago,Martinique,2,1,1,1.0,0.0,1682,1634
1996-06-02,Uruguay,Paraguay,0,2,2,0.0,1.0,1821,1781
1996-06-02,Venezuela,Chile,1,1,0,0.5,0.5,1468,1785
1996-06-03,Cuba,Suriname,4,0,4,1.0,0.0,1606,1576
1996-06-03,Oman,Bahrain,3,0,3,1.0,0.0,1510,1591
1996-06-04,Germany,Liechtenstein,9,1,8,1.0,0.0,2006,1465
1996-06-04,Netherlands,Republic of Ireland,3,1,2,1.0,0.0,1905,1809
1996-06-05,Canada,Costa Rica,0,1,1,0.0,1.0,1680,1681
1996-06-05,France,Armenia,2,0,2,1.0,0.0,1955,1491
1996-06-05,Iceland,Cyprus,2,1,1,1.0,0.0,1652,1475
1996-06-05,Martinique,Suriname,1,1,0,0.5,0.5,1633,1578
1996-06-07,Trinidad and Tobago,Cuba,2,0,2,1.0,0.0,1689,1600
1996-06-08,England,Switzerland,1,1,0,0.5,0.5,1930,1814
1996-06-08,Mexico,Bolivia,1,0,1,1.0,0.0,1844,1683
1996-06-08,Tanzania,Ghana,0,0,0,0.5,0.5,1576,1722
1996-06-09,Denmark,Portugal,1,1,0,0.5,0.5,1895,1862
1996-06-09,Germany,Czech Republic,2,0,2,1.0,0.0,2009,1682
1996-06-09,Ivory Coast,Burkina Faso,1,1,0,0.5,0.5,1759,1594
1996-06-09,Lebanon,Kuwait,3,5,2,0.0,1.0,1552,1704
1996-06-09,Nigeria,Togo,1,3,2,0.0,1.0,1778,1585
1996-06-09,Panama,Belize,4,1,3,1.0,0.0,1505,1472
1996-06-09,Spain,Bulgaria,1,1,0,0.5,0.5,1927,1793
1996-06-09,United States,Republic of Ireland,2,1,1,1.0,0.0,1783,1801
1996-06-10,Iran,Nepal,8,0,8,1.0,0.0,1771,1406
1996-06-10,Netherlands,Scotland,0,0,0,0.5,0.5,1903,1803
1996-06-10,Romania,France,0,1,1,0.0,1.0,1836,1961
1996-06-10,Sri Lanka,Oman,0,3,3,0.0,1.0,1366,1515
1996-06-11,Italy,Russia,2,1,1,1.0,0.0,1970,1901
1996-06-11,Turkey,Croatia,0,1,1,0.0,1.0,1731,1719
1996-06-12,Iran,Sri Lanka,7,0,7,1.0,0.0,1773,1365
1996-06-12,Mexico,Republic of Ireland,2,2,0,0.5,0.5,1844,1802
1996-06-12,Nepal,Oman,0,7,7,0.0,1.0,1401,1521
1996-06-12,Tanzania,Sudan,0,0,0,0.5,0.5,1577,1587
1996-06-12,United States,Bolivia,0,2,2,0.0,1.0,1773,1694
1996-06-13,Barbados,Trinidad and Tobago,0,4,4,0.0,1.0,1540,1694
1996-06-13,Bulgaria,Romania,1,0,1,1.0,0.0,1802,1828
1996-06-13,Switzerland,Netherlands,0,2,2,0.0,1.0,1809,1909
1996-06-14,Algeria,Kenya,1,0,1,1.0,0.0,1770,1668
1996-06-14,Czech Republic,Italy,2,1,1,1.0,0.0,1696,1957
1996-06-14,Iran,Oman,2,0,2,1.0,0.0,1777,1518
1996-06-14,Kazakhstan,Qatar,1,0,1,1.0,0.0,1542,1634
1996-06-14,Portugal,Turkey,1,0,1,1.0,0.0,1868,1726
1996-06-14,Sri Lanka,Nepal,3,1,2,1.0,0.0,1374,1393
1996-06-15,Bolivia,Republic of Ireland,0,3,3,0.0,1.0,1689,1808
1996-06-15,Dominican Republic,Trinidad and Tobago,1,4,3,0.0,1.0,1481,1698
1996-06-15,England,Scotland,2,0,2,1.0,0.0,1936,1798
1996-06-15,France,Spain,1,1,0,0.5,0.5,1961,1928
1996-06-15,South Africa,Malawi,3,0,3,1.0,0.0,1718,1632
1996-06-16,Senegal,Togo,1,1,0,0.5,0.5,1619,1586
1996-06-16,Angola,Uganda,3,1,2,1.0,0.0,1617,1622
1996-06-16,Burkina Faso,Mauritania,2,0,2,1.0,0.0,1599,1452
1996-06-16,DR Congo,Mauritius,2,0,2,1.0,0.0,1659,1493
1996-06-16,Croatia,Denmark,3,0,3,1.0,0.0,1731,1884
1996-06-16,Gabon,Eswatini,2,0,2,1.0,0.0,1640,1463
1996-06-16,Guinea,Guinea-Bissau,3,1,2,1.0,0.0,1574,1521
1996-06-16,Ivory Coast,Congo,1,1,0,0.5,0.5,1756,1584
1996-06-16,Mozambique,Namibia,1,1,0,0.5,0.5,1565,1488
1996-06-16,Russia,Germany,0,3,3,0.0,1.0,1896,2015
1996-06-16,Sierra Leone,Burundi,0,1,1,0.0,1.0,1625,1549
1996-06-16,Tunisia,Rwanda,2,0,2,1.0,0.0,1733,1481
1996-06-16,United States,Mexico,2,2,0,0.5,0.5,1775,1843
1996-06-16,Zambia,Sudan,3,0,3,1.0,0.0,1778,1583
1996-06-16,Zimbabwe,Madagascar,2,2,0,0.5,0.5,1674,1650
1996-06-17,Ghana,Tanzania,2,1,1,1.0,0.0,1727,1573
1996-06-17,Oman,Nepal,2,1,1,1.0,0.0,1524,1388
1996-06-17,Sri Lanka,Iran,0,4,4,0.0,1.0,1373,1779
1996-06-18,England,Netherlands,4,1,3,1.0,0.0,1944,1902
1996-06-18,France,Bulgaria,3,1,2,1.0,0.0,1966,1798
1996-06-18,Romania,Spain,1,2,1,0.0,1.0,1823,1934
1996-06-18,Scotland,Switzerland,1,0,1,1.0,0.0,1807,1801
1996-06-19,Croatia,Portugal,0,3,3,0.0,1.0,1727,1873
1996-06-19,Italy,Germany,0,0,0,0.5,0.5,1959,2014
1996-06-19,Nepal,Iran,0,4,4,0.0,1.0,1387,1781
1996-06-19,Oman,Sri Lanka,10,0,10,1.0,0.0,1529,1369
1996-06-19,Russia,Czech Republic,3,3,0,0.5,0.5,1892,1701
1996-06-19,Turkey,Denmark,0,3,3,0.0,1.0,1722,1889
1996-06-19,Uzbekistan,Tajikistan,5,0,5,1.0,0.0,1591,1485
1996-06-20,Kuwait,Lebanon,0,0,0,0.5,0.5,1701,1556
1996-06-20,Peru,Armenia,4,0,4,1.0,0.0,1627,1486
1996-06-21,Nepal,Sri Lanka,0,2,2,0.0,1.0,1379,1378
1996-06-21,Oman,Iran,1,2,1,0.0,1.0,1526,1785
1996-06-21,Syria,Kazakhstan,2,0,2,1.0,0.0,1600,1536
1996-06-22,England,Spain,0,0,0,0.5,0.5,1944,1935
1996-06-22,France,Netherlands,0,0,0,0.5,0.5,1965,1904
1996-06-22,Honduras,Venezuela,1,0,1,1.0,0.0,1700,1465
1996-06-23,Cuba,Haiti,6,1,5,1.0,0.0,1608,1563
1996-06-23,Barbados,Jamaica,0,1,1,0.0,1.0,1535,1674
1996-06-23,Czech Republic,Portugal,1,0,1,1.0,0.0,1713,1862
1996-06-23,Germany,Croatia,2,1,1,1.0,0.0,2017,1725
1996-06-23,Liberia,Gambia,4,0,4,1.0,0.0,1566,1499
1996-06-23,Saint Kitts and Nevis,Saint Vincent and the Grenadines,2,2,0,0.5,0.5,1532,1555
1996-06-23,Trinidad and Tobago,Dominican Republic,8,0,8,1.0,0.0,1702,1478
1996-06-25,Paraguay,Armenia,1,2,1,0.0,1.0,1768,1500
1996-06-26,England,Germany,1,1,0,0.5,0.5,1946,2016
1996-06-26,France,Czech Republic,0,0,0,0.5,0.5,1961,1718
1996-06-27,Myanmar,Singapore,0,4,4,0.0,1.0,1557,1607
1996-06-27,Thailand,Maldives,8,0,8,1.0,0.0,1675,1418
1996-06-28,China PR,New Zealand,2,0,2,1.0,0.0,1737,1671
1996-06-28,Qatar,Syria,1,0,1,1.0,0.0,1642,1593
1996-06-29,Maldives,Singapore,0,2,2,0.0,1.0,1414,1612
1996-06-29,Thailand,Myanmar,5,1,4,1.0,0.0,1681,1552
1996-06-30,Czech Republic,Germany,1,2,1,0.0,1.0,1716,2019
1996-06-30,Ecuador,Armenia,3,0,3,1.0,0.0,1721,1497
1996-06-30,Haiti,Cuba,1,1,0,0.5,0.5,1565,1607
1996-06-30,Jamaica,Barbados,2,0,2,1.0,0.0,1679,1531
1996-06-30,Saint Vincent and the Grenadines,Saint Kitts and Nevis,0,0,0,0.5,0.5,1555,1533
1996-07-01,Myanmar,Maldives,3,1,2,1.0,0.0,1557,1410
1996-07-01,Thailand,Singapore,1,1,0,0.5,0.5,1680,1614
1996-07-04,Maldives,Thailand,0,8,8,0.0,1.0,1408,1683
1996-07-04,Singapore,Myanmar,2,2,0,0.5,0.5,1613,1559
1996-07-05,Qatar,Kazakhstan,3,0,3,1.0,0.0,1648,1531
1996-07-06,Chile,Ecuador,4,1,3,1.0,0.0,1792,1715
1996-07-06,Malawi,Tanzania,3,2,1,1.0,0.0,1639,1567
1996-07-07,Bolivia,Venezuela,6,1,5,1.0,0.0,1693,1462
1996-07-07,Myanmar,Thailand,1,7,6,0.0,1.0,1554,1689
1996-07-07,Colombia,Uruguay,3,1,2,1.0,0.0,1872,1815
1996-07-07,Estonia,Latvia,1,1,0,0.5,0.5,1331,1517
1996-07-07,Peru,Argentina,0,0,0,0.5,0.5,1633,1889
1996-07-07,Singapore,Maldives,5,2,3,1.0,0.0,1617,1405
1996-07-08,Latvia,Lithuania,1,2,1,0.0,1.0,1510,1536
1996-07-08,Malawi,Tanzania,1,0,1,1.0,0.0,1646,1561
1996-07-09,Myanmar,Maldives,4,1,3,1.0,0.0,1559,1401
1996-07-09,Estonia,Lithuania,1,1,0,0.5,0.5,1336,1532
1996-07-09,Singapore,Thailand,2,2,0,0.5,0.5,1619,1688
1996-07-10,Malawi,Tanzania,1,1,0,0.5,0.5,1645,1563
1996-07-12,Kazakhstan,Syria,0,1,1,0.0,1.0,1525,1600
1996-07-17,China PR,Uruguay,1,1,0,0.5,0.5,1739,1814
1996-07-19,Syria,Qatar,3,1,2,1.0,0.0,1610,1639
1996-07-21,Panama,Venezuela,0,2,2,0.0,1.0,1497,1471
1996-07-24,Honduras,Panama,1,1,0,0.5,0.5,1696,1502
1996-07-26,Paraguay,Bolivia,2,0,2,1.0,0.0,1775,1687
1996-07-28,Honduras,Trinidad and Tobago,0,0,0,0.5,0.5,1697,1702
1996-07-28,Jamaica,Panama,0,0,0,0.5,0.5,1676,1506
1996-07-30,Panama,Trinidad and Tobago,1,0,1,1.0,0.0,1519,1690
1996-07-31,Belarus,Lithuania,2,2,0,0.5,0.5,1520,1532
1996-08-04,Costa Rica,Honduras,1,1,0,0.5,0.5,1682,1697
1996-08-04,Guatemala,Panama,1,0,1,1.0,0.0,1631,1514
1996-08-04,Vietnam,Taiwan,4,1,3,1.0,0.0,1504,1445
1996-08-05,South Korea,Guam,9,0,9,1.0,0.0,1770,1434
1996-08-07,Panama,Honduras,2,1,1,1.0,0.0,1526,1686
1996-08-07,Vietnam,Guam,9,0,9,1.0,0.0,1511,1428
1996-08-08,Benin,Mauritania,4,1,3,1.0,0.0,1422,1444
1996-08-08,China PR,Paraguay,0,2,2,0.0,1.0,1732,1783
1996-08-08,South Korea,Taiwan,4,0,4,1.0,0.0,1773,1443
1996-08-09,Jordan,Pakistan,4,0,4,1.0,0.0,1555,1411
1996-08-11,Botswana,Namibia,0,0,0,0.5,0.5,1420,1487
1996-08-11,Congo,Togo,0,0,0,0.5,0.5,1585,1586
1996-08-11,Honduras,Costa Rica,0,0,0,0.5,0.5,1686,1683
1996-08-11,Iraq,Pakistan,3,0,3,1.0,0.0,1789,1410
1996-08-11,Mauritius,Seychelles,1,0,1,1.0,0.0,1500,1408
1996-08-11,Uganda,Ethiopia,1,1,0,0.5,0.5,1621,1575
1996-08-11,Vietnam,South Korea,0,4,4,0.0,1.0,1509,1776
1996-08-13,Jordan,Iraq,0,1,1,0.0,1.0,1552,1793
1996-08-13,Ukraine,Lithuania,5,2,3,1.0,0.0,1559,1525
1996-08-14,Greece,Albania,2,1,1,1.0,0.0,1721,1499
1996-08-14,Honduras,El Salvador,2,1,1,1.0,0.0,1693,1636
1996-08-14,Hungary,United Arab Emirates,3,1,2,1.0,0.0,1701,1706
1996-08-14,Iceland,Malta,2,1,1,1.0,0.0,1656,1449
1996-08-14,Latvia,Finland,0,0,0,0.5,0.5,1513,1609
1996-08-14,Panama,Guatemala,1,0,1,1.0,0.0,1537,1621
1996-08-14,Peru,Costa Rica,3,0,3,1.0,0.0,1643,1674
1996-08-14,Romania,Israel,2,0,2,1.0,0.0,1828,1659
1996-08-14,Sweden,Denmark,0,1,1,0.0,1.0,1878,1897
1996-08-14,Turkey,Moldova,2,0,2,1.0,0.0,1726,1520
1996-08-16,Ecuador,Costa Rica,1,1,0,0.5,0.5,1715,1675
1996-08-17,Rwanda,Uganda,0,0,0,0.5,0.5,1485,1618
1996-08-18,Guatemala,Honduras,1,1,0,0.5,0.5,1623,1692
1996-08-20,Belarus,United Arab Emirates,0,1,1,0.0,1.0,1516,1711
1996-08-20,Oman,Mali,1,0,1,1.0,0.0,1536,1579
1996-08-20,Togo,Benin,2,0,2,1.0,0.0,1591,1418
1996-08-21,El Salvador,Honduras,1,2,1,0.0,1.0,1630,1699
1996-08-22,Oman,Mali,1,1,0,0.5,0.5,1537,1579
1996-08-24,Panama,Jamaica,2,0,2,1.0,0.0,1549,1665
1996-08-24,Seychelles,Mauritius,1,1,0,0.5,0.5,1411,1498
1996-08-25,Ethiopia,Uganda,1,1,0,0.5,0.5,1576,1618
1996-08-25,Honduras,Cuba,4,0,4,1.0,0.0,1705,1602
1996-08-25,Japan,Uruguay,5,3,2,1.0,0.0,1806,1806
1996-08-25,Namibia,Botswana,6,0,6,1.0,0.0,1494,1414
1996-08-25,Togo,Congo,1,0,1,1.0,0.0,1599,1578
1996-08-27,Guatemala,Jamaica,2,1,1,1.0,0.0,1632,1657
1996-08-27,Poland,Cyprus,2,2,0,0.5,0.5,1755,1481
1996-08-28,Honduras,Cuba,2,2,0,0.5,0.5,1703,1605
1996-08-28,Oman,Sudan,0,0,0,0.5,0.5,1539,1582
1996-08-28,Russia,Brazil,2,2,0,0.5,0.5,1896,2035
1996-08-29,Morocco,DR Congo,7,0,7,1.0,0.0,1774,1654
1996-08-30,Canada,Panama,3,1,2,1.0,0.0,1686,1544
1996-08-30,Guatemala,Cuba,1,1,0,0.5,0.5,1632,1606
1996-08-30,Mauritania,Benin,0,0,0,0.5,0.5,1444,1419
1996-08-30,United States,El Salvador,3,1,2,1.0,0.0,1780,1626
1996-08-31,Armenia,Portugal,0,0,0,0.5,0.5,1504,1856
1996-08-31,Austria,Scotland,0,0,0,0.5,0.5,1764,1806
1996-08-31,Azerbaijan,Switzerland,1,0,1,1.0,0.0,1498,1788
1996-08-31,Belarus,Estonia,1,0,1,1.0,0.0,1521,1332
1996-08-31,Belgium,Turkey,2,1,1,1.0,0.0,1820,1720
1996-08-31,Faroe Islands,Slovakia,1,2,1,0.0,1.0,1462,1596
1996-08-31,France,Mexico,2,0,2,1.0,0.0,1967,1838
1996-08-31,Liechtenstein,Republic of Ireland,0,5,5,0.0,1.0,1464,1810
1996-08-31,Netherlands,Brazil,2,2,0,0.5,0.5,1907,2033
1996-08-31,Northern Ireland,Ukraine,0,1,1,0.0,1.0,1710,1571
1996-08-31,Oman,Sudan,0,1,1,0.0,1.0,1532,1590
1996-08-31,Romania,Lithuania,3,0,3,1.0,0.0,1831,1523
1996-08-31,Wales,San Marino,6,0,6,1.0,0.0,1707,1434
1996-09-01,Argentina,Paraguay,1,1,0,0.5,0.5,1887,1786
1996-09-01,Bolivia,Peru,0,0,0,0.5,0.5,1686,1645
1996-09-01,Colombia,Chile,4,1,3,1.0,0.0,1879,1786
1996-09-01,Ecuador,Venezuela,1,0,1,1.0,0.0,1719,1468
1996-09-01,Greece,Bosnia and Herzegovina,3,0,3,1.0,0.0,1725,1488
1996-09-01,Hungary,Finland,1,0,1,1.0,0.0,1707,1604
1996-09-01,Israel,Bulgaria,2,1,1,1.0,0.0,1671,1787
1996-09-01,Latvia,Sweden,1,2,1,0.0,1.0,1512,1880
1996-09-01,Moldova,England,0,3,3,0.0,1.0,1519,1948
1996-09-01,Norway,Georgia,1,0,1,1.0,0.0,1817,1548
1996-09-01,Russia,Cyprus,4,0,4,1.0,0.0,1898,1480
1996-09-01,Singapore,Malaysia,1,1,0,0.5,0.5,1618,1563
1996-09-01,Slovenia,Denmark,0,2,2,0.0,1.0,1552,1899
1996-09-01,Trinidad and Tobago,Costa Rica,0,1,1,0.0,1.0,1682,1684
1996-09-02,Cambodia,Vietnam,1,3,2,0.0,1.0,1465,1517
1996-09-02,Laos,Indonesia,1,5,4,0.0,1.0,1394,1543
1996-09-02,Philippines,Thailand,0,5,5,0.0,1.0,1310,1690
1996-09-04,Czech Republic,Iceland,2,1,1,1.0,0.0,1723,1650
1996-09-04,Faroe Islands,Spain,2,6,4,0.0,1.0,1462,1936
1996-09-04,Jamaica,Costa Rica,2,0,2,1.0,0.0,1666,1676
1996-09-04,Malaysia,Philippines,7,0,7,1.0,0.0,1567,1307
1996-09-04,Poland,Germany,0,2,2,0.0,1.0,1753,2022
1996-09-04,Singapore,Brunei,3,0,3,1.0,0.0,1621,1351
1996-09-05,Myanmar,Cambodia,5,0,5,1.0,0.0,1565,1460
1996-09-05,Laos,Vietnam,1,1,0,0.5,0.5,1397,1515
1996-09-05,Lebanon,Oman,1,2,1,0.0,1.0,1548,1541
1996-09-06,Singapore,Philippines,3,0,3,1.0,0.0,1624,1305
1996-09-06,Thailand,Brunei,6,0,6,1.0,0.0,1692,1350
1996-09-07,Myanmar,Vietnam,1,4,3,0.0,1.0,1556,1525
1996-09-07,Indonesia,Cambodia,3,0,3,1.0,0.0,1550,1454
1996-09-08,Brunei,Philippines,1,0,1,1.0,0.0,1357,1299
1996-09-08,El Salvador,Cuba,5,0,5,1.0,0.0,1634,1599
1996-09-08,Thailand,Malaysia,1,1,0,0.5,0.5,1690,1570
1996-09-09,Indonesia,Myanmar,6,1,5,1.0,0.0,1559,1548
1996-09-09,Laos,Cambodia,1,0,1,1.0,0.0,1407,1445
1996-09-10,Brunei,Malaysia,0,6,6,0.0,1.0,1354,1574
1996-09-10,Singapore,Thailand,0,1,1,0.0,1.0,1618,1697
1996-09-11,Japan,Uzbekistan,1,0,1,1.0,0.0,1810,1588
1996-09-11,Laos,Myanmar,2,4,2,0.0,1.0,1403,1553
1996-09-11,Vietnam,Indonesia,1,1,0,0.5,0.5,1526,1559
1996-09-13,Malaysia,Indonesia,3,1,2,1.0,0.0,1582,1552
1996-09-13,Thailand,Vietnam,4,2,2,1.0,0.0,1702,1522
1996-09-14,Australia,Ghana,2,0,2,1.0,0.0,1785,1721
1996-09-14,South Africa,Kenya,1,0,1,1.0,0.0,1725,1662
1996-09-15,Saint Vincent and the Grenadines,Mexico,0,3,3,0.0,1.0,1553,1841
1996-09-15,Indonesia,Vietnam,2,3,1,0.0,1.0,1544,1531
1996-09-15,Jamaica,Honduras,3,0,3,1.0,0.0,1675,1695
1996-09-15,Senegal,Mali,1,0,1,1.0,0.0,1627,1572
1996-09-15,Thailand,Malaysia,1,0,1,1.0,0.0,1708,1577
1996-09-16,Papua New Guinea,Solomon Islands,1,1,0,0.5,0.5,1497,1569
1996-09-17,Oman,Zambia,0,0,0,0.5,0.5,1546,1774
1996-09-18,Czech Republic,Malta,6,0,6,1.0,0.0,1726,1447
1996-09-18,Ghana,Kenya,1,0,1,1.0,0.0,1728,1656
1996-09-18,Romania,United Arab Emirates,1,2,1,0.0,1.0,1821,1722
1996-09-18,Solomon Islands,Vanuatu,1,1,0,0.5,0.5,1567,1444
1996-09-18,South Africa,Australia,2,0,2,1.0,0.0,1735,1776
1996-09-19,El Salvador,Venezuela,0,1,1,0.0,1.0,1623,1480
1996-09-20,Papua New Guinea,Vanuatu,2,1,1,1.0,0.0,1504,1438
1996-09-20,Qatar,Sri Lanka,3,0,3,1.0,0.0,1642,1376
1996-09-21,Australia,Kenya,4,0,4,1.0,0.0,1782,1651
1996-09-21,Honduras,Mexico,2,1,1,1.0,0.0,1707,1830
1996-09-21,India,Philippines,2,0,2,1.0,0.0,1500,1296
1996-09-21,South Africa,Ghana,0,0,0,0.5,0.5,1735,1729
1996-09-22,Guinea,Gabon,0,1,1,0.0,1.0,1568,1647
1996-09-22,Panama,Cuba,1,3,2,0.0,1.0,1538,1606
1996-09-22,Saudi Arabia,Zambia,2,1,1,1.0,0.0,1776,1766
1996-09-22,Slovakia,Malta,6,0,6,1.0,0.0,1601,1443
1996-09-23,Saint Vincent and the Grenadines,Jamaica,1,2,1,0.0,1.0,1548,1681
1996-09-23,Mali,Guinea,0,0,0,0.5,0.5,1572,1569
1996-09-23,Qatar,Philippines,5,0,5,1.0,0.0,1644,1295
1996-09-24,Sri Lanka,India,1,1,0,0.5,0.5,1379,1498
1996-09-25,El Salvador,Guatemala,2,1,1,1.0,0.0,1632,1624
1996-09-25,South Korea,China PR,3,1,2,1.0,0.0,1783,1726
1996-09-25,Oman,Mozambique,0,2,2,0.0,1.0,1539,1573
1996-09-25,Poland,United Arab Emirates,1,0,1,1.0,0.0,1761,1715
1996-09-25,Saudi Arabia,Zambia,1,3,2,0.0,1.0,1768,1775
1996-09-25,Syria,Sudan,1,2,1,0.0,1.0,1602,1599
1996-09-26,Philippines,Sri Lanka,0,3,3,0.0,1.0,1289,1386
1996-09-27,Qatar,India,6,0,6,1.0,0.0,1649,1494
1996-09-29,Gabon,Mali,1,1,0,0.5,0.5,1646,1574
1996-09-29,Oman,New Zealand,0,1,1,0.0,1.0,1534,1677
1996-09-29,Syria,Sudan,1,0,1,1.0,0.0,1610,1592
1996-09-29,Zimbabwe,Tanzania,1,0,1,1.0,0.0,1680,1558
1996-10-01,Oman,New Zealand,1,2,1,0.0,1.0,1530,1682
1996-10-03,Lebanon,Bahrain,2,3,1,0.0,1.0,1541,1599
1996-10-03,Saudi Arabia,New Zealand,3,0,3,1.0,0.0,1775,1676
1996-10-04,Ecuador,Jamaica,2,1,1,1.0,0.0,1727,1674
1996-10-04,Kuwait,Iran,0,1,1,0.0,1.0,1695,1792
1996-10-05,Estonia,Belarus,1,0,1,1.0,0.0,1344,1510
1996-10-05,Latvia,Scotland,0,2,2,0.0,1.0,1510,1809
1996-10-05,Lithuania,Iceland,2,0,2,1.0,0.0,1534,1640
1996-10-05,Moldova,Italy,1,3,2,0.0,1.0,1518,1961
1996-10-05,Northern Ireland,Armenia,1,1,0,0.5,0.5,1706,1509
1996-10-05,Qatar,New Zealand,3,2,1,1.0,0.0,1658,1668
1996-10-05,Togo,Tanzania,2,1,1,1.0,0.0,1607,1551
1996-10-05,Ukraine,Portugal,2,1,1,1.0,0.0,1585,1843
1996-10-05,Wales,Netherlands,1,3,2,0.0,1.0,1704,1911
1996-10-06,Algeria,Ivory Coast,4,1,3,1.0,0.0,1778,1749
1996-10-06,Benin,Mali,1,2,1,0.0,1.0,1415,1579
1996-10-06,DR Congo,Liberia,0,0,0,0.5,0.5,1653,1568
1996-10-06,Ethiopia,Senegal,1,2,1,0.0,1.0,1570,1634
1996-10-06,Faroe Islands,Serbia,1,8,7,0.0,1.0,1457,1591
1996-10-06,Finland,Switzerland,2,3,1,0.0,1.0,1600,1793
1996-10-06,Gabon,Cameroon,0,0,0,0.5,0.5,1648,1719
1996-10-06,Ghana,Angola,2,1,1,1.0,0.0,1735,1612
1996-10-06,Mauritius,Malawi,1,2,1,0.0,1.0,1494,1650
1996-10-06,Panama,El Salvador,1,1,0,0.5,0.5,1541,1630
1996-10-06,Trinidad and Tobago,Guatemala,1,1,0,0.5,0.5,1681,1626
1996-10-06,Tunisia,Sierra Leone,2,0,2,1.0,0.0,1739,1620
1996-10-06,Zambia,Mozambique,1,0,1,1.0,0.0,1779,1570
1996-10-07,Oman,Azerbaijan,2,0,2,1.0,0.0,1538,1491
1996-10-08,Bosnia and Herzegovina,Croatia,1,4,3,0.0,1.0,1485,1729
1996-10-08,Kuwait,Cyprus,1,1,0,0.5,0.5,1691,1485
1996-10-08,Luxembourg,Bulgaria,1,2,1,0.0,1.0,1379,1789
1996-10-08,Uruguay,Bolivia,1,0,1,1.0,0.0,1812,1681
1996-10-09,Albania,Portugal,0,3,3,0.0,1.0,1498,1845
1996-10-09,Armenia,Germany,1,5,4,0.0,1.0,1509,2023
1996-10-09,Belarus,Latvia,1,1,0,0.5,0.5,1510,1510
1996-10-09,Costa Rica,Jamaica,0,0,0,0.5,0.5,1676,1675
1996-10-09,Czech Republic,Spain,0,0,0,0.5,0.5,1731,1932
1996-10-09,Denmark,Greece,2,1,1,1.0,0.0,1904,1721
1996-10-09,Ecuador,Colombia,0,1,1,0.0,1.0,1723,1884
1996-10-09,England,Poland,2,1,1,1.0,0.0,1953,1757
1996-10-09,France,Turkey,4,0,4,1.0,0.0,1971,1717
1996-10-09,Iceland,Romania,0,4,4,0.0,1.0,1636,1826
1996-10-09,Republic of Ireland,North Macedonia,3,0,3,1.0,0.0,1813,1539
1996-10-09,Israel,Russia,1,1,0,0.5,0.5,1676,1894
1996-10-09,Italy,Georgia,1,0,1,1.0,0.0,1963,1547
1996-10-09,Lebanon,New Zealand,1,1,0,0.5,0.5,1544,1666
1996-10-09,Lithuania,Liechtenstein,2,1,1,1.0,0.0,1541,1458
1996-10-09,Norway,Hungary,3,0,3,1.0,0.0,1823,1702
1996-10-09,Paraguay,Chile,2,1,1,1.0,0.0,1794,1778
1996-10-09,San Marino,Belgium,0,3,3,0.0,1.0,1433,1822
1996-10-09,Saudi Arabia,Australia,0,0,0,0.5,0.5,1776,1782
1996-10-09,Sweden,Austria,0,1,1,0.0,1.0,1870,1775
1996-10-09,Venezuela,Argentina,2,5,3,0.0,1.0,1479,1889
1996-10-10,Canada,Cuba,2,0,2,1.0,0.0,1693,1600
1996-10-13,Saint Vincent and the Grenadines,Honduras,1,4,3,0.0,1.0,1544,1712
1996-10-13,Canada,Cuba,2,0,2,1.0,0.0,1699,1595
1996-10-13,Japan,Tunisia,1,0,1,1.0,0.0,1817,1733
1996-10-15,Oman,Saudi Arabia,0,1,1,0.0,1.0,1535,1780
1996-10-16,Brazil,Lithuania,3,1,2,1.0,0.0,2034,1541
1996-10-16,Kuwait,Bahrain,1,0,1,1.0,0.0,1697,1594
1996-10-16,Mexico,Jamaica,2,1,1,1.0,0.0,1835,1671
1996-10-16,Peru,United States,4,1,3,1.0,0.0,1656,1770
1996-10-16,United Arab Emirates,Qatar,0,1,1,0.0,1.0,1706,1668
1996-10-18,Oman,Kuwait,1,2,1,0.0,1.0,1531,1702
1996-10-18,United Arab Emirates,Bahrain,1,1,0,0.5,0.5,1704,1597
1996-10-19,Gabon,Burkina Faso,2,0,2,1.0,0.0,1655,1593
1996-10-19,Qatar,Saudi Arabia,2,2,0,0.5,0.5,1671,1778
1996-10-21,Honduras,El Salvador,1,1,0,0.5,0.5,1711,1632
1996-10-21,Oman,Qatar,0,3,3,0.0,1.0,1527,1676
1996-10-21,Saudi Arabia,Bahrain,3,1,2,1.0,0.0,1783,1593
1996-10-22,Kuwait,United Arab Emirates,1,2,1,0.0,1.0,1695,1712
1996-10-23,Mexico,Ecuador,0,1,1,0.0,1.0,1825,1734
1996-10-23,Slovakia,Faroe Islands,3,0,3,1.0,0.0,1606,1453
1996-10-24,Kuwait,Saudi Arabia,1,0,1,1.0,0.0,1705,1774
1996-10-24,Oman,United Arab Emirates,0,0,0,0.5,0.5,1531,1709
1996-10-25,Bahrain,Qatar,1,2,1,0.0,1.0,1587,1683
1996-10-26,Honduras,Jamaica,0,0,0,0.5,0.5,1711,1672
1996-10-27,Panama,Canada,0,0,0,0.5,0.5,1545,1696
1996-10-27,Tahiti,Australia,0,6,6,0.0,1.0,1775,1791
1996-10-27,United Arab Emirates,Saudi Arabia,2,2,0,0.5,0.5,1711,1773
1996-10-28,Oman,Bahrain,1,1,0,0.5,0.5,1533,1586
1996-10-28,Qatar,Kuwait,1,2,1,0.0,1.0,1676,1713
1996-10-30,Mexico,Saint Vincent and the Grenadines,5,1,4,1.0,0.0,1828,1542
1996-10-30,Finland,Estonia,2,2,0,0.5,0.5,1595,1350
1996-10-30,Indonesia,Moldova,1,2,1,0.0,1.0,1536,1527
1996-11-01,Australia,Tahiti,5,0,5,1.0,0.0,1799,1768
1996-11-01,Honduras,Colombia,1,2,1,0.0,1.0,1707,1889
1996-11-03,Canada,El Salvador,1,0,1,1.0,0.0,1703,1626
1996-11-03,Lithuania,Indonesia,4,0,4,1.0,0.0,1549,1529
1996-11-03,Togo,Gabon,0,1,1,0.0,1.0,1601,1662
1996-11-03,United States,Guatemala,2,0,2,1.0,0.0,1775,1622
1996-11-06,Bosnia and Herzegovina,Italy,2,1,1,1.0,0.0,1501,1948
1996-11-06,Mexico,Honduras,3,1,2,1.0,0.0,1834,1702
1996-11-06,Saudi Arabia,Bulgaria,1,0,1,1.0,0.0,1782,1781
1996-11-07,Costa Rica,Panama,2,0,2,1.0,0.0,1682,1540
1996-11-07,Uganda,Rwanda,3,2,1,1.0,0.0,1624,1480
1996-11-08,Egypt,Namibia,7,1,6,1.0,0.0,1772,1492
1996-11-08,Thailand,Bulgaria,0,4,4,0.0,1.0,1702,1788
1996-11-08,Uganda,Rwanda,1,1,0,0.5,0.5,1621,1484
1996-11-09,Albania,Armenia,1,1,0,0.5,0.5,1499,1509
1996-11-09,Austria,Latvia,2,1,1,1.0,0.0,1778,1508
1996-11-09,Denmark,France,1,0,1,1.0,0.0,1914,1962
1996-11-09,Georgia,England,0,2,2,0.0,1.0,1546,1955
1996-11-09,Germany,Northern Ireland,1,1,0,0.5,0.5,2018,1712
1996-11-09,Liechtenstein,North Macedonia,1,11,10,0.0,1.0,1452,1546
1996-11-09,Morocco,Sierra Leone,4,0,4,1.0,0.0,1779,1616
1996-11-09,Netherlands,Wales,7,1,6,1.0,0.0,1915,1701
1996-11-09,Nigeria,Burkina Faso,2,0,2,1.0,0.0,1783,1589
1996-11-09,Portugal,Ukraine,1,0,1,1.0,0.0,1848,1583
1996-11-09,South Africa,DR Congo,1,0,1,1.0,0.0,1742,1647
1996-11-10,Costa Rica,Guatemala,3,0,3,1.0,0.0,1689,1616
1996-11-10,Jamaica,Saint Vincent and the Grenadines,5,0,5,1.0,0.0,1678,1537
1996-11-10,Angola,Zimbabwe,2,1,1,1.0,0.0,1622,1671
1996-11-10,Azerbaijan,Hungary,0,3,3,0.0,1.0,1488,1706
1996-11-10,Bolivia,Colombia,2,2,0,0.5,0.5,1686,1885
1996-11-10,Congo,Zambia,1,0,1,1.0,0.0,1591,1767
1996-11-10,Croatia,Greece,1,1,0,0.5,0.5,1729,1722
1996-11-10,Cyprus,Israel,2,0,2,1.0,0.0,1498,1664
1996-11-10,El Salvador,Panama,3,2,1,1.0,0.0,1633,1534
1996-11-10,Gabon,Ghana,1,1,0,0.5,0.5,1664,1734
1996-11-10,Guinea,Kenya,3,1,2,1.0,0.0,1579,1642
1996-11-10,Republic of Ireland,Iceland,0,0,0,0.5,0.5,1810,1640
1996-11-10,Liberia,Tunisia,0,1,1,0.0,1.0,1564,1738
1996-11-10,Luxembourg,Russia,0,4,4,0.0,1.0,1379,1895
1996-11-10,Paraguay,Ecuador,1,0,1,1.0,0.0,1801,1728
1996-11-10,Peru,Venezuela,4,1,3,1.0,0.0,1661,1475
1996-11-10,Poland,Moldova,2,1,1,1.0,0.0,1761,1524
1996-11-10,Scotland,Sweden,1,0,1,1.0,0.0,1819,1861
1996-11-10,Serbia,Czech Republic,1,0,1,1.0,0.0,1603,1720
1996-11-10,Slovenia,Bosnia and Herzegovina,1,2,1,0.0,1.0,1543,1511
1996-11-10,Switzerland,Norway,0,1,1,0.0,1.0,1786,1831
1996-11-10,Togo,Cameroon,2,4,2,0.0,1.0,1596,1725
1996-11-10,Turkey,San Marino,7,0,7,1.0,0.0,1720,1431
1996-11-10,United States,Trinidad and Tobago,2,0,2,1.0,0.0,1781,1676
1996-11-11,Tonga,Cook Islands,2,0,2,1.0,0.0,1484,1466
1996-11-12,Chile,Uruguay,1,0,1,1.0,0.0,1787,1804
1996-11-13,Samoa,Cook Islands,2,1,1,1.0,0.0,1487,1459
1996-11-13,Andorra,Estonia,1,6,5,0.0,1.0,1489,1362
1996-11-13,Brazil,Cameroon,2,0,2,1.0,0.0,2037,1723
1996-11-13,Lebanon,Iran,0,0,0,0.5,0.5,1549,1788
1996-11-13,Spain,Slovakia,4,1,3,1.0,0.0,1935,1604
1996-11-15,Tonga,Samoa,1,0,1,1.0,0.0,1493,1479
1996-11-15,United Arab Emirates,Malta,0,0,0,0.5,0.5,1706,1449
1996-11-16,Estonia,Indonesia,3,0,3,1.0,0.0,1374,1518
1996-11-16,Saudi Arabia,Syria,3,1,2,1.0,0.0,1787,1606
1996-11-17,Honduras,Saint Vincent and the Grenadines,11,3,8,1.0,0.0,1707,1533
1996-11-17,Jamaica,Mexico,1,0,1,1.0,0.0,1690,1823
1996-11-17,Sudan,Uganda,1,1,0,0.5,0.5,1593,1621
1996-11-19,Kenya,Rwanda,2,1,1,1.0,0.0,1647,1480
1996-11-19,Kuwait,Syria,2,2,0,0.5,0.5,1711,1609
1996-11-19,Saudi Arabia,Mali,1,3,2,0.0,1.0,1775,1592
1996-11-19,United Arab Emirates,Uzbekistan,4,2,2,1.0,0.0,1712,1583
1996-11-20,El Salvador,Mexico,1,3,2,0.0,1.0,1629,1828
1996-11-22,Kuwait,Mali,4,2,2,1.0,0.0,1717,1587
1996-11-22,Rwanda,Zanzibar,1,1,0,0.5,0.5,1479,1400
1996-11-22,Tanzania,Uganda,0,1,1,0.0,1.0,1545,1628
1996-11-22,United Arab Emirates,Uzbekistan,2,0,2,1.0,0.0,1718,1578
1996-11-23,South Korea,Colombia,4,1,3,1.0,0.0,1794,1875
1996-11-24,Guatemala,Costa Rica,1,0,1,1.0,0.0,1626,1680
1996-11-24,Indonesia,Iraq,0,4,4,0.0,1.0,1516,1796
1996-11-24,Kenya,Zanzibar,1,0,1,1.0,0.0,1651,1397
1996-11-24,Mali,Burkina Faso,2,0,2,1.0,0.0,1596,1581
1996-11-24,Sudan,Tanzania,3,2,1,1.0,0.0,1600,1539
1996-11-24,Trinidad and Tobago,United States,0,1,1,0.0,1.0,1671,1787
1996-11-25,Iran,Turkmenistan,0,1,1,0.0,1.0,1775,1537
1996-11-26,China PR,South Korea,2,3,1,0.0,1.0,1720,1801
1996-11-26,United Arab Emirates,Syria,1,1,0,0.5,0.5,1716,1612
1996-11-27,Malta,North Macedonia,0,2,2,0.0,1.0,1444,1552
1996-11-27,Uganda,Kenya,2,0,2,1.0,0.0,1637,1643
1996-11-28,United Arab Emirates,Syria,1,0,1,1.0,0.0,1722,1607
1996-11-29,Saudi Arabia,Indonesia,4,1,3,1.0,0.0,1778,1514
1996-11-29,Sudan,Kenya,1,1,0,0.5,0.5,1601,1643
1996-12-01,Costa Rica,United States,2,1,1,1.0,0.0,1691,1777
1996-12-01,El Salvador,Cuba,3,0,3,1.0,0.0,1637,1588
1996-12-04,Indonesia,Kuwait,2,2,0,0.5,0.5,1519,1713
1996-12-04,United Arab Emirates,South Korea,1,1,0,0.5,0.5,1724,1800
1996-12-05,Iran,Iraq,1,2,1,0.0,1.0,1768,1804
1996-12-05,Lebanon,Georgia,4,2,2,1.0,0.0,1557,1539
1996-12-05,Saudi Arabia,Thailand,6,0,6,1.0,0.0,1785,1696
1996-12-06,China PR,Uzbekistan,0,2,2,0.0,1.0,1709,1590
1996-12-06,Japan,Syria,2,1,1,1.0,0.0,1821,1604
1996-12-07,South Korea,Indonesia,4,2,2,1.0,0.0,1803,1517
1996-12-07,United Arab Emirates,Kuwait,3,2,1,1.0,0.0,1732,1706
1996-12-08,Guatemala,Trinidad and Tobago,2,1,1,1.0,0.0,1636,1662
1996-12-08,Lebanon,Georgia,3,2,1,1.0,0.0,1565,1532
1996-12-08,Saudi Arabia,Iraq,1,0,1,1.0,0.0,1794,1796
1996-12-08,Thailand,Iran,1,3,2,0.0,1.0,1690,1775
1996-12-09,Japan,Uzbekistan,4,0,4,1.0,0.0,1825,1587
1996-12-09,Syria,China PR,0,3,3,0.0,1.0,1599,1715
1996-12-10,Kuwait,South Korea,2,0,2,1.0,0.0,1717,1793
1996-12-10,United Arab Emirates,Indonesia,2,0,2,1.0,0.0,1736,1514
1996-12-11,Czech Republic,Nigeria,2,1,1,1.0,0.0,1730,1774
1996-12-11,Iraq,Thailand,4,1,3,1.0,0.0,1802,1685
1996-12-11,Morocco,Croatia,2,2,0,0.5,0.5,1778,1731
1996-12-11,Saudi Arabia,Iran,0,3,3,0.0,1.0,1786,1784
1996-12-12,Croatia,Czech Republic,1,1,0,0.5,0.5,1731,1731
1996-12-12,Japan,China PR,1,0,1,1.0,0.0,1831,1710
1996-12-12,Morocco,Nigeria,2,0,2,1.0,0.0,1786,1767
1996-12-12,Uzbekistan,Syria,1,2,1,0.0,1.0,1580,1607
1996-12-14,Belgium,Netherlands,0,3,3,0.0,1.0,1817,1921
1996-12-14,Cyprus,Bulgaria,1,3,2,0.0,1.0,1496,1791
1996-12-14,Kenya,Zambia,1,0,1,1.0,0.0,1654,1757
1996-12-14,North Macedonia,Romania,0,3,3,0.0,1.0,1550,1829
1996-12-14,Northern Ireland,Albania,2,0,2,1.0,0.0,1716,1496
1996-12-14,Portugal,Germany,0,0,0,0.5,0.5,1852,2015
1996-12-14,Spain,Serbia,2,0,2,1.0,0.0,1938,1601
1996-12-14,United States,Costa Rica,2,1,1,1.0,0.0,1784,1685
1996-12-14,Wales,Turkey,0,0,0,0.5,0.5,1702,1720
1996-12-15,Argentina,Chile,1,1,0,0.5,0.5,1887,1790
1996-12-15,Bolivia,Paraguay,0,0,0,0.5,0.5,1689,1799
1996-12-15,El Salvador,Canada,0,2,2,0.0,1.0,1631,1710
1996-12-15,Israel,Luxembourg,1,0,1,1.0,0.0,1667,1377
1996-12-15,Kenya,Zambia,0,2,2,0.0,1.0,1649,1763
1996-12-15,Kuwait,Japan,2,0,2,1.0,0.0,1728,1821
1996-12-15,Panama,Cuba,3,1,2,1.0,0.0,1544,1579
1996-12-15,United Arab Emirates,Iraq,1,0,1,1.0,0.0,1746,1793
1996-12-15,Uruguay,Peru,2,0,2,1.0,0.0,1809,1657
1996-12-15,Venezuela,Colombia,0,2,2,0.0,1.0,1474,1877
1996-12-16,South Korea,Iran,2,6,4,0.0,1.0,1785,1793
1996-12-16,Saudi Arabia,China PR,4,3,1,1.0,0.0,1793,1704
1996-12-18,Brazil,Bosnia and Herzegovina,1,0,1,1.0,0.0,2038,1511
1996-12-18,Malta,Spain,0,3,3,0.0,1.0,1444,1939
1996-12-19,Iran,Saudi Arabia,0,0,0,0.5,0.5,1793,1793
1996-12-19,United Arab Emirates,Kuwait,1,0,1,1.0,0.0,1754,1721
1996-12-20,Burkina Faso,Gabon,1,1,0,0.5,0.5,1583,1663
1996-12-21,Costa Rica,Trinidad and Tobago,2,1,1,1.0,0.0,1693,1655
1996-12-21,Guatemala,United States,2,2,0,0.5,0.5,1640,1781
1996-12-21,Iran,Kuwait,1,1,0,0.5,0.5,1792,1723
1996-12-21,United Arab Emirates,Saudi Arabia,0,0,0,0.5,0.5,1755,1793
1996-12-21,Zimbabwe,Tanzania,2,2,0,0.5,0.5,1669,1542
1996-12-22,Benin,Gabon,3,3,0,0.5,0.5,1420,1659
1996-12-22,Burkina Faso,Ghana,2,1,1,1.0,0.0,1595,1723
1996-12-24,Benin,Ghana,1,1,0,0.5,0.5,1426,1718
1996-12-25,Benin,Burkina Faso,1,1,0,0.5,0.5,1430,1592
1996-12-25,Gabon,Ghana,1,1,0,0.5,0.5,1661,1717
1996-12-26,Basque Country,Estonia,3,1,2,1.0,0.0,1640,1372
1996-12-27,Benin,Burkina Faso,0,0,0,0.5,0.5,1434,1589
1996-12-28,Argentina,Serbia,2,3,1,0.0,1.0,1874,1615
1997-01-04,Chile,Armenia,7,0,7,1.0,0.0,1793,1507
1997-01-04,Tunisia,Algeria,0,0,0,0.5,0.5,1739,1778
1997-01-05,Egypt,Belarus,2,0,2,1.0,0.0,1775,1508
1997-01-06,Paraguay,Armenia,2,0,2,1.0,0.0,1802,1505
1997-01-06,Togo,Ghana,4,0,4,1.0,0.0,1607,1707
1997-01-08,Ivory Coast,Guinea,2,1,1,1.0,0.0,1754,1575
1997-01-11,Namibia,Liberia,0,0,0,0.5,0.5,1494,1563
1997-01-11,Sierra Leone,Gabon,1,0,1,1.0,0.0,1626,1652
1997-01-11,Zambia,South Africa,0,0,0,0.5,0.5,1763,1743
1997-01-12,Bolivia,Ecuador,2,0,2,1.0,0.0,1698,1720
1997-01-12,Burkina Faso,Guinea,0,2,2,0.0,1.0,1581,1584
1997-01-12,Cameroon,Angola,0,0,0,0.5,0.5,1721,1625
1997-01-12,DR Congo,Congo,1,1,0,0.5,0.5,1646,1593
1997-01-12,Ghana,Morocco,2,2,0,0.5,0.5,1709,1785
1997-01-12,Kenya,Nigeria,1,1,0,0.5,0.5,1652,1765
1997-01-12,Lebanon,Algeria,2,2,0,0.5,0.5,1570,1774
1997-01-12,Peru,Chile,2,1,1,1.0,0.0,1668,1783
1997-01-12,Tunisia,Egypt,1,0,1,1.0,0.0,1748,1767
1997-01-12,Uruguay,Argentina,0,0,0,0.5,0.5,1811,1873
1997-01-12,Venezuela,Paraguay,0,2,2,0.0,1.0,1472,1805
1997-01-12,Zimbabwe,Togo,3,0,3,1.0,0.0,1676,1601
1997-01-17,United States,Peru,0,1,1,0.0,1.0,1771,1679
1997-01-18,Australia,New Zealand,1,0,1,1.0,0.0,1805,1661
1997-01-18,South Korea,Norway,1,0,1,1.0,0.0,1795,1822
1997-01-19,Benin,Togo,1,1,0,0.5,0.5,1438,1598
1997-01-19,Mozambique,Zimbabwe,1,2,1,0.0,1.0,1565,1682
1997-01-19,United States,Mexico,0,2,2,0.0,1.0,1765,1835
1997-01-22,Australia,South Korea,2,1,1,1.0,0.0,1813,1788
1997-01-22,Israel,Greece,1,1,0,0.5,0.5,1669,1721
1997-01-22,Italy,Northern Ireland,2,0,2,1.0,0.0,1952,1713
1997-01-22,Mexico,Peru,0,0,0,0.5,0.5,1832,1683
1997-01-22,New Zealand,Norway,0,3,3,0.0,1.0,1657,1827
1997-01-22,Portugal,France,0,2,2,0.0,1.0,1847,1968
1997-01-25,Australia,Norway,1,0,1,1.0,0.0,1822,1819
1997-01-25,South Korea,New Zealand,3,1,2,1.0,0.0,1794,1652
1997-01-25,Malawi,Zambia,0,2,2,0.0,1.0,1645,1769
1997-01-26,Cameroon,Namibia,4,0,4,1.0,0.0,1725,1491
1997-01-26,Chile,Honduras,3,2,1,1.0,0.0,1790,1701
1997-01-26,Guinea,Tunisia,1,0,1,1.0,0.0,1596,1737
1997-01-26,Ivory Coast,Benin,1,0,1,1.0,0.0,1757,1436
1997-01-26,Lebanon,Estonia,2,0,2,1.0,0.0,1574,1369
1997-01-26,Liberia,Togo,1,2,1,0.0,1.0,1556,1606
1997-01-26,Mali,Algeria,1,0,1,1.0,0.0,1608,1763
1997-01-26,Mozambique,Mauritius,3,0,3,1.0,0.0,1572,1488
1997-01-26,Eswatini,Lesotho,3,1,2,1.0,0.0,1471,1447
1997-01-26,Tanzania,DR Congo,1,2,1,0.0,1.0,1537,1652
1997-01-26,Zimbabwe,Ghana,0,0,0,0.5,0.5,1683,1709
1997-01-29,China PR,United States,2,1,1,1.0,0.0,1714,1756
1997-02-01,China PR,United States,1,1,0,0.5,0.5,1715,1756
1997-02-02,Bolivia,Slovakia,0,1,1,0.0,1.0,1688,1615
1997-02-02,Lebanon,Jordan,1,0,1,1.0,0.0,1582,1545
1997-02-05,Costa Rica,Slovakia,2,2,0,0.5,0.5,1692,1617
1997-02-05,Mexico,Ecuador,3,1,2,1.0,0.0,1838,1715
1997-02-07,Jordan,Lebanon,0,0,0,0.5,0.5,1546,1582
1997-02-07,Russia,Serbia,1,1,0,0.5,0.5,1890,1621
1997-02-08,Colombia,Slovakia,1,0,1,1.0,0.0,1880,1615
1997-02-09,Lebanon,Jordan,0,0,0,0.5,0.5,1582,1547
1997-02-09,Thailand,Japan,1,1,0,0.5,0.5,1688,1819
1997-02-10,Russia,Switzerland,2,1,1,1.0,0.0,1896,1781
1997-02-11,Ecuador,Uruguay,4,0,4,1.0,0.0,1726,1801
1997-02-11,Estonia,Scotland,0,0,0,0.5,0.5,1376,1813
1997-02-11,Northern Ireland,Belgium,3,0,3,1.0,0.0,1724,1807
1997-02-11,Thailand,Sweden,0,0,0,0.5,0.5,1692,1858
1997-02-11,Wales,Republic of Ireland,0,0,0,0.5,0.5,1705,1808
1997-02-12,Bolivia,Chile,1,1,0,0.5,0.5,1691,1788
1997-02-12,Colombia,Argentina,0,1,1,0.0,1.0,1872,1882
1997-02-12,England,Italy,0,1,1,0.0,1.0,1947,1961
1997-02-12,Jamaica,Venezuela,0,0,0,0.5,0.5,1686,1477
1997-02-12,Paraguay,Peru,2,1,1,1.0,0.0,1811,1678
1997-02-12,Spain,Malta,4,0,4,1.0,0.0,1940,1444
1997-02-12,Turkey,Finland,1,1,0,0.5,0.5,1718,1598
1997-02-13,Japan,Sweden,0,1,1,0.0,1.0,1812,1866
1997-02-14,Cyprus,Latvia,2,0,2,1.0,0.0,1505,1500
1997-02-14,Lithuania,Poland,0,0,0,0.5,0.5,1554,1757
1997-02-15,Cyprus,Poland,2,3,1,0.0,1.0,1502,1761
1997-02-15,Latvia,Lithuania,1,0,1,1.0,0.0,1510,1545
1997-02-15,Tonga,Solomon Islands,0,4,4,0.0,1.0,1487,1574
1997-02-16,Iraq,Jordan,1,0,1,1.0,0.0,1797,1544
1997-02-16,Senegal,Mali,1,1,0,0.5,0.5,1634,1609
1997-02-16,Thailand,Sweden,1,3,2,0.0,1.0,1688,1871
1997-02-17,Cyprus,Lithuania,1,0,1,1.0,0.0,1511,1537
1997-02-17,Fiji,Solomon Islands,1,2,1,0.0,1.0,1629,1584
1997-02-17,Latvia,Poland,2,3,1,0.0,1.0,1507,1765
1997-02-18,Kuwait,Egypt,2,0,2,1.0,0.0,1733,1758
1997-02-19,Costa Rica,Venezuela,5,2,3,1.0,0.0,1696,1474
1997-02-19,Greece,Portugal,0,0,0,0.5,0.5,1724,1845
1997-02-19,Guyana,French Guiana,2,0,2,1.0,0.0,1463,1450
1997-02-21,Botswana,Eswatini,0,0,0,0.5,0.5,1416,1470
1997-02-21,China PR,Singapore,3,1,2,1.0,0.0,1721,1613
1997-02-21,Fiji,Solomon Islands,3,2,1,1.0,0.0,1636,1578
1997-02-21,Jamaica,Bermuda,1,0,1,1.0,0.0,1691,1514
1997-02-21,Malaysia,Finland,2,1,1,1.0,0.0,1586,1590
1997-02-22,Bosnia and Herzegovina,Vietnam,4,0,4,1.0,0.0,1520,1523
1997-02-22,Hong Kong,South Korea,0,2,2,0.0,1.0,1547,1798
1997-02-22,Indonesia,Zimbabwe,0,0,0,0.5,0.5,1518,1680
1997-02-22,Malawi,Mozambique,2,0,2,1.0,0.0,1652,1566
1997-02-23,Benin,Algeria,1,1,0,0.5,0.5,1442,1758
1997-02-23,Botswana,Lesotho,1,4,3,0.0,1.0,1409,1455
1997-02-23,China PR,Finland,2,1,1,1.0,0.0,1727,1585
1997-02-23,Ethiopia,Egypt,1,1,0,0.5,0.5,1574,1755
1997-02-23,Guinea,Sierra Leone,1,0,1,1.0,0.0,1605,1618
1997-02-23,Guyana,French Guiana,2,2,0,0.5,0.5,1463,1451
1997-02-23,Jamaica,Bermuda,3,2,1,1.0,0.0,1696,1510
1997-02-23,Malaysia,Singapore,0,0,0,0.5,0.5,1587,1613
1997-02-23,Mali,Ivory Coast,1,2,1,0.0,1.0,1605,1762
1997-02-23,Mauritius,Zambia,0,0,0,0.5,0.5,1494,1764
1997-02-23,Tanzania,Liberia,1,1,0,0.5,0.5,1538,1556
1997-02-23,Togo,DR Congo,1,1,0,0.5,0.5,1608,1651
1997-02-23,Zimbabwe,Angola,1,0,1,1.0,0.0,1687,1619
1997-02-24,Bosnia and Herzegovina,Zimbabwe,2,2,0,0.5,0.5,1524,1684
1997-02-24,Indonesia,Vietnam,1,0,1,1.0,0.0,1527,1515
1997-02-25,Malaysia,China PR,0,2,2,0.0,1.0,1583,1732
1997-02-25,Singapore,Finland,0,1,1,0.0,1.0,1605,1594
1997-02-26,Bosnia and Herzegovina,Indonesia,2,0,2,1.0,0.0,1533,1519
1997-02-26,Brazil,Poland,4,2,2,1.0,0.0,2041,1763
1997-02-26,France,Netherlands,2,1,1,1.0,0.0,1975,1915
1997-02-26,Israel,Germany,0,1,1,0.0,1.0,1668,2017
1997-02-26,Vietnam,Zimbabwe,0,6,6,0.0,1.0,1511,1689
1997-02-28,China PR,Zimbabwe,3,1,2,1.0,0.0,1740,1682
1997-02-28,Malaysia,Bosnia and Herzegovina,0,1,1,0.0,1.0,1574,1543
1997-03-01,Azerbaijan,Estonia,0,2,2,0.0,1.0,1478,1387
1997-03-01,Botswana,Malawi,1,4,3,0.0,1.0,1406,1656
1997-03-01,Solomon Islands,Tonga,9,0,9,1.0,0.0,1584,1482
1997-03-02,Bosnia and Herzegovina,China PR,0,3,3,0.0,1.0,1540,1744
1997-03-02,Jamaica,United States,0,0,0,0.5,0.5,1698,1755
1997-03-02,Lesotho,Zambia,0,2,2,0.0,1.0,1453,1767
1997-03-02,Mexico,Canada,4,0,4,1.0,0.0,1844,1705
1997-03-02,Saudi Arabia,Syria,3,0,3,1.0,0.0,1798,1603
1997-03-02,Thailand,South Korea,1,3,2,0.0,1.0,1683,1804
1997-03-03,Eswatini,Mozambique,0,4,4,0.0,1.0,1465,1572
1997-03-05,Aruba,Curaçao,2,1,1,1.0,0.0,1428,1541
1997-03-06,Bahrain,Oman,1,0,1,1.0,0.0,1593,1527
1997-03-09,Costa Rica,Cameroon,5,0,5,1.0,0.0,1705,1717
1997-03-09,Saudi Arabia,Indonesia,2,0,2,1.0,0.0,1801,1517
1997-03-09,Thailand,Hong Kong,2,0,2,1.0,0.0,1689,1542
1997-03-12,Cyprus,Greece,0,4,4,0.0,1.0,1508,1728
1997-03-12,Czech Republic,Poland,2,1,1,1.0,0.0,1740,1755
1997-03-12,Israel,Sweden,0,1,1,0.0,1.0,1665,1875
1997-03-12,North Macedonia,Australia,0,1,1,0.0,1.0,1548,1825
1997-03-12,Martinique,Saint Lucia,1,0,1,1.0,0.0,1639,1496
1997-03-12,Saudi Arabia,Indonesia,3,1,2,1.0,0.0,1804,1515
1997-03-12,Serbia,Russia,0,0,0,0.5,0.5,1627,1891
1997-03-13,El Salvador,Guatemala,0,0,0,0.5,0.5,1632,1640
1997-03-14,Saint Lucia,Saint Vincent and the Grenadines,3,2,1,1.0,0.0,1505,1525
1997-03-15,Thailand,Japan,3,1,2,1.0,0.0,1700,1802
1997-03-16,Taiwan,Saudi Arabia,0,2,2,0.0,1.0,1442,1806
1997-03-16,Costa Rica,Mexico,0,0,0,0.5,0.5,1709,1841
1997-03-16,Malaysia,Bangladesh,2,0,2,1.0,0.0,1580,1456
1997-03-16,Namibia,Zimbabwe,2,1,1,1.0,0.0,1504,1670
1997-03-16,United States,Canada,3,0,3,1.0,0.0,1762,1699
1997-03-18,Austria,Slovenia,0,2,2,0.0,1.0,1766,1556
1997-03-18,Bangladesh,Taiwan,1,3,2,0.0,1.0,1448,1451
1997-03-18,Kuwait,Bahrain,3,1,2,1.0,0.0,1738,1589
1997-03-18,Malaysia,Saudi Arabia,0,0,0,0.5,0.5,1585,1802
1997-03-19,Malta,Hungary,1,4,3,0.0,1.0,1442,1709
1997-03-19,United Arab Emirates,Lebanon,2,1,1,1.0,0.0,1760,1578
1997-03-20,Bangladesh,Saudi Arabia,1,4,3,0.0,1.0,1447,1804
1997-03-20,Malaysia,Taiwan,2,0,2,1.0,0.0,1591,1446
1997-03-22,Azerbaijan,Turkmenistan,3,0,3,1.0,0.0,1488,1528
1997-03-22,Alderney,Guernsey,0,6,6,0.0,1.0,1287,1624
1997-03-23,Bolivia,Jamaica,6,0,6,1.0,0.0,1700,1690
1997-03-23,Costa Rica,United States,3,2,1,1.0,0.0,1719,1753
1997-03-23,Nepal,Macau,1,1,0,0.5,0.5,1380,1419
1997-03-23,Oman,Japan,0,1,1,0.0,1.0,1525,1805
1997-03-23,Panama,Belize,1,1,0,0.5,0.5,1543,1474
1997-03-25,Guatemala,Ecuador,0,0,0,0.5,0.5,1642,1725
1997-03-25,Macau,Japan,0,10,10,0.0,1.0,1418,1807
1997-03-25,Oman,Nepal,1,0,1,1.0,0.0,1530,1376
1997-03-27,Nepal,Japan,0,6,6,0.0,1.0,1375,1809
1997-03-27,Oman,Macau,4,0,4,1.0,0.0,1536,1413
1997-03-27,Saudi Arabia,Bangladesh,3,0,3,1.0,0.0,1806,1446
1997-03-29,Taiwan,Bangladesh,1,2,1,0.0,1.0,1438,1454
1997-03-29,Albania,Ukraine,0,1,1,0.0,1.0,1490,1590
1997-03-29,Croatia,Denmark,1,1,0,0.5,0.5,1735,1911
1997-03-29,Cyprus,Russia,1,1,0,0.5,0.5,1515,1885
1997-03-29,England,Mexico,2,0,2,1.0,0.0,1953,1836
1997-03-29,Italy,Moldova,3,0,3,1.0,0.0,1963,1523
1997-03-29,Netherlands,San Marino,4,0,4,1.0,0.0,1916,1431
1997-03-29,Northern Ireland,Portugal,0,0,0,0.5,0.5,1727,1843
1997-03-29,Romania,Liechtenstein,8,0,8,1.0,0.0,1831,1451
1997-03-29,Saudi Arabia,Malaysia,3,0,3,1.0,0.0,1810,1588
1997-03-29,Scotland,Estonia,2,0,2,1.0,0.0,1815,1386
1997-03-29,Sierra Leone,Senegal,2,1,1,1.0,0.0,1627,1626
1997-03-29,Tanzania,Burkina Faso,3,2,1,1.0,0.0,1547,1573
1997-03-29,United Arab Emirates,Norway,1,4,3,0.0,1.0,1754,1826
1997-03-29,Wales,Belgium,1,2,1,0.0,1.0,1700,1813
1997-03-30,Belize,Panama,0,1,1,0.0,1.0,1468,1550
1997-03-30,China PR,Iraq,0,2,2,0.0,1.0,1738,1804
1997-03-30,Gabon,Togo,2,1,1,1.0,0.0,1659,1602
1997-03-30,Georgia,Armenia,7,0,7,1.0,0.0,1540,1498
1997-03-30,Hong Kong,Thailand,3,2,1,1.0,0.0,1554,1689
1997-03-31,Bangladesh,Malaysia,0,1,1,0.0,1.0,1449,1594
1997-03-31,Luxembourg,Israel,0,3,3,0.0,1.0,1375,1668
1997-03-31,Malta,Slovakia,0,2,2,0.0,1.0,1438,1620
1997-03-31,Saudi Arabia,Taiwan,6,0,6,1.0,0.0,1812,1437
1997-04-01,India,China PR,0,0,0,0.5,0.5,1499,1734
1997-04-02,Albania,Germany,2,3,1,0.0,1.0,1490,2018
1997-04-02,Azerbaijan,Finland,1,2,1,0.0,1.0,1483,1600
1997-04-02,Barbados,Grenada,1,1,0,0.5,0.5,1532,1543
1997-04-02,Bolivia,Argentina,2,1,1,1.0,0.0,1712,1871
1997-04-02,Bosnia and Herzegovina,Greece,0,1,1,0.0,1.0,1536,1733
1997-04-02,Brazil,Chile,4,0,4,1.0,0.0,2045,1785
1997-04-02,Bulgaria,Cyprus,4,1,3,1.0,0.0,1794,1513
1997-04-02,Croatia,Slovenia,3,3,0,0.5,0.5,1732,1560
1997-04-02,Czech Republic,Serbia,1,2,1,0.0,1.0,1730,1638
1997-04-02,Dominica,British Virgin Islands,6,1,5,1.0,0.0,1469,1439
1997-04-02,France,Sweden,1,0,1,1.0,0.0,1981,1870
1997-04-02,Hungary,Australia,1,3,2,0.0,1.0,1704,1831
1997-04-02,Lithuania,Romania,0,1,1,0.0,1.0,1535,1834
1997-04-02,North Macedonia,Republic of Ireland,3,2,1,1.0,0.0,1562,1795
1997-04-02,Paraguay,Colombia,2,1,1,1.0,0.0,1821,1863
1997-04-02,Peru,Ecuador,1,1,0,0.5,0.5,1680,1724
1997-04-02,Poland,Italy,0,0,0,0.5,0.5,1760,1959
1997-04-02,Scotland,Austria,2,0,2,1.0,0.0,1822,1760
1997-04-02,Sint Maarten,Anguilla,3,0,3,1.0,0.0,1498,1413
1997-04-02,Switzerland,Latvia,1,0,1,1.0,0.0,1784,1505
1997-04-02,Trinidad and Tobago,Guyana,3,0,3,1.0,0.0,1659,1460
1997-04-02,Turkey,Netherlands,1,0,1,1.0,0.0,1731,1904
1997-04-02,Ukraine,Northern Ireland,2,1,1,1.0,0.0,1602,1716
1997-04-02,Uruguay,Venezuela,3,1,2,1.0,0.0,1804,1472
1997-04-03,China PR,Ghana,0,0,0,0.5,0.5,1734,1710
1997-04-04,British Virgin Islands,Anguilla,4,2,2,1.0,0.0,1447,1406
1997-04-04,Dominica,Sint Maarten,1,0,1,1.0,0.0,1478,1490
1997-04-04,Grenada,Guyana,5,1,4,1.0,0.0,1550,1454
1997-04-04,Trinidad and Tobago,Barbados,0,1,1,0.0,1.0,1649,1543
1997-04-05,Nigeria,Guinea,2,1,1,1.0,0.0,1770,1601
1997-04-05,Sierra Leone,Ghana,1,1,0,0.5,0.5,1629,1709
1997-04-06,Angola,Togo,3,1,2,1.0,0.0,1627,1595
1997-04-06,Cameroon,Zimbabwe,1,0,1,1.0,0.0,1724,1664
1997-04-06,Canada,El Salvador,0,0,0,0.5,0.5,1698,1634
1997-04-06,Congo,South Africa,2,0,2,1.0,0.0,1605,1732
1997-04-06,Dominica,Anguilla,5,0,5,1.0,0.0,1485,1400
1997-04-06,Gabon,Morocco,0,4,4,0.0,1.0,1654,1791
1997-04-06,Guyana,Barbados,0,2,2,0.0,1.0,1449,1549
1997-04-06,India,Iraq,0,1,1,0.0,1.0,1497,1807
1997-04-06,Indonesia,Cambodia,8,0,8,1.0,0.0,1522,1439
1997-04-06,Kenya,Burkina Faso,4,3,1,1.0,0.0,1659,1567
1997-04-06,Liberia,Egypt,1,0,1,1.0,0.0,1569,1743
1997-04-06,Namibia,Tunisia,1,2,1,0.0,1.0,1501,1741
1997-04-06,Sint Maarten,British Virgin Islands,3,2,1,1.0,0.0,1498,1440
1997-04-06,Trinidad and Tobago,Grenada,2,3,1,0.0,1.0,1639,1561
1997-04-08,India,Ghana,2,2,0,0.5,0.5,1502,1705
1997-04-08,Jordan,United Arab Emirates,0,0,0,0.5,0.5,1549,1750
1997-04-09,DR Congo,Zambia,2,2,0,0.5,0.5,1654,1765
1997-04-10,India,Iraq,1,1,0,0.5,0.5,1508,1802
1997-04-11,Bahrain,United Arab Emirates,1,2,1,0.0,1.0,1585,1755
1997-04-11,India,China PR,1,2,1,0.0,1.0,1505,1738
1997-04-11,Kuwait,Iran,0,2,2,0.0,1.0,1732,1799
1997-04-12,Malawi,Mozambique,2,2,0,0.5,0.5,1655,1574
1997-04-13,El Salvador,Guatemala,1,1,0,0.5,0.5,1635,1642
1997-04-13,Indonesia,Yemen,0,0,0,0.5,0.5,1521,1443
1997-04-13,Lebanon,Singapore,1,1,0,0.5,0.5,1579,1605
1997-04-13,Mexico,Jamaica,6,0,6,1.0,0.0,1841,1686
1997-04-14,Bahrain,Jordan,1,0,1,1.0,0.0,1593,1542
1997-04-16,Guatemala,Costa Rica,1,1,0,0.5,0.5,1644,1718
1997-04-16,Honduras,Panama,5,0,5,1.0,0.0,1706,1546
1997-04-17,Thailand,Kuwait,3,1,2,1.0,0.0,1698,1724
1997-04-18,Costa Rica,Nicaragua,5,1,4,1.0,0.0,1720,1327
1997-04-18,Honduras,El Salvador,3,0,3,1.0,0.0,1713,1629
1997-04-19,Zambia,Malawi,4,0,4,1.0,0.0,1771,1650
1997-04-19,Jordan,Bahrain,4,1,3,1.0,0.0,1552,1584
1997-04-20,Cambodia,Yemen,0,1,1,0.0,1.0,1432,1451
1997-04-20,Cameroon,Congo,2,0,2,1.0,0.0,1730,1600
1997-04-20,El Salvador,Panama,2,0,2,1.0,0.0,1636,1540
1997-04-20,Guatemala,Nicaragua,6,1,5,1.0,0.0,1647,1325
1997-04-20,United States,Mexico,2,2,0,0.5,0.5,1755,1840
1997-04-21,China PR,Myanmar,5,0,5,1.0,0.0,1743,1549
1997-04-21,Iran,Kenya,3,0,3,1.0,0.0,1804,1655
1997-04-22,United Arab Emirates,Bahrain,3,0,3,1.0,0.0,1760,1580
1997-04-23,China PR,South Korea,0,2,2,0.0,1.0,1737,1811
1997-04-23,Guatemala,El Salvador,1,0,1,1.0,0.0,1655,1629
1997-04-23,Honduras,Costa Rica,0,4,4,0.0,1.0,1706,1728
1997-04-25,Costa Rica,El Salvador,1,0,1,1.0,0.0,1734,1624
1997-04-25,Guatemala,Honduras,1,0,1,1.0,0.0,1665,1697
1997-04-25,Turkmenistan,Azerbaijan,2,0,2,1.0,0.0,1535,1477
1997-04-26,Namibia,Egypt,2,3,1,0.0,1.0,1498,1747
1997-04-26,Sierra Leone,Morocco,0,1,1,0.0,1.0,1625,1796
1997-04-26,Singapore,Kuwait,0,1,1,0.0,1.0,1600,1730
1997-04-26,United Arab Emirates,Jordan,2,0,2,1.0,0.0,1764,1549
1997-04-27,Burkina Faso,Nigeria,1,2,1,0.0,1.0,1564,1774
1997-04-27,Cambodia,Indonesia,1,1,0,0.5,0.5,1435,1519
1997-04-27,Cameroon,Togo,2,0,2,1.0,0.0,1736,1590
1997-04-27,Canada,Jamaica,0,0,0,0.5,0.5,1698,1687
1997-04-27,China PR,Iran,0,0,0,0.5,0.5,1739,1803
1997-04-27,DR Congo,South Africa,1,2,1,0.0,1.0,1648,1739
1997-04-27,Dominica,Martinique,1,2,1,0.0,1.0,1481,1644
1997-04-27,Ghana,Gabon,3,0,3,1.0,0.0,1712,1648
1997-04-27,Guatemala,Costa Rica,1,1,0,0.5,0.5,1667,1733
1997-04-27,Honduras,El Salvador,0,0,0,0.5,0.5,1696,1626
1997-04-27,Kenya,Guinea,1,0,1,1.0,0.0,1662,1595
1997-04-27,Lebanon,Libya,2,0,2,1.0,0.0,1589,1614
1997-04-27,Tunisia,Liberia,2,0,2,1.0,0.0,1746,1565
1997-04-27,Zambia,Congo,3,0,3,1.0,0.0,1776,1596
1997-04-27,Zimbabwe,Angola,0,0,0,0.5,0.5,1664,1628
1997-04-28,Bermuda,Saint Martin,2,1,1,1.0,0.0,1519,1503
1997-04-29,Chile,Venezuela,6,0,6,1.0,0.0,1788,1470
1997-04-29,Slovakia,Iceland,3,1,2,1.0,0.0,1629,1632
1997-04-30,Argentina,Ecuador,2,1,1,1.0,0.0,1876,1720
1997-04-30,Armenia,Northern Ireland,0,0,0,0.5,0.5,1503,1712
1997-04-30,Austria,Estonia,2,0,2,1.0,0.0,1762,1385
1997-04-30,Brazil,Mexico,4,0,4,1.0,0.0,2049,1837
1997-04-30,Colombia,Peru,0,1,1,0.0,1.0,1852,1692
1997-04-30,Denmark,Slovenia,4,0,4,1.0,0.0,1913,1559
1997-04-30,England,Georgia,2,0,2,1.0,0.0,1955,1539
1997-04-30,Germany,Ukraine,2,0,2,1.0,0.0,2020,1601
1997-04-30,Greece,Croatia,0,1,1,0.0,1.0,1725,1741
1997-04-30,Israel,Cyprus,2,0,2,1.0,0.0,1673,1509
1997-04-30,Italy,Poland,3,0,3,1.0,0.0,1963,1757
1997-04-30,Latvia,Belarus,2,0,2,1.0,0.0,1514,1500
1997-04-30,Liechtenstein,Lithuania,0,2,2,0.0,1.0,1445,1542
1997-04-30,Malta,Faroe Islands,1,2,1,0.0,1.0,1431,1461
1997-04-30,Norway,Finland,1,1,0,0.5,0.5,1822,1605
1997-04-30,Paraguay,Uruguay,3,1,2,1.0,0.0,1829,1797
1997-04-30,Romania,Republic of Ireland,1,0,1,1.0,0.0,1842,1788
1997-04-30,Russia,Luxembourg,3,0,3,1.0,0.0,1886,1375
1997-04-30,San Marino,Netherlands,0,6,6,0.0,1.0,1431,1905
1997-04-30,Serbia,Spain,1,1,0,0.5,0.5,1644,1935
1997-04-30,Sweden,Scotland,2,1,1,1.0,0.0,1877,1816
1997-04-30,Switzerland,Hungary,1,0,1,1.0,0.0,1791,1698
1997-04-30,Syria,Libya,1,1,0,0.5,0.5,1604,1614
1997-04-30,Turkey,Belgium,1,3,2,0.0,1.0,1725,1820
1997-05-01,Fiji,New Caledonia,5,1,4,1.0,0.0,1644,1590
1997-05-01,Trinidad and Tobago,Jamaica,1,1,0,0.5,0.5,1641,1686
1997-05-04,Aruba,Jamaica,0,6,6,0.0,1.0,1426,1689
1997-05-04,El Salvador,Costa Rica,2,1,1,1.0,0.0,1637,1723
1997-05-04,Martinique,Dominica,7,0,7,1.0,0.0,1649,1477
1997-05-04,Tajikistan,Vietnam,4,0,4,1.0,0.0,1494,1503
1997-05-04,Turkmenistan,China PR,1,4,3,0.0,1.0,1532,1743
1997-05-05,Guernsey,Jersey,2,1,1,1.0,0.0,1635,1712
1997-05-07,Ukraine,Armenia,1,1,0,0.5,0.5,1599,1506
1997-05-08,Ivory Coast,Senegal,4,1,3,1.0,0.0,1768,1621
1997-05-08,Kuwait,Lebanon,2,0,2,1.0,0.0,1735,1585
1997-05-09,Yemen,Uzbekistan,0,1,1,0.0,1.0,1446,1586
1997-05-11,Costa Rica,Jamaica,3,1,2,1.0,0.0,1731,1682
1997-05-11,Kazakhstan,Pakistan,3,0,3,1.0,0.0,1531,1405
1997-05-11,Tajikistan,China PR,0,1,1,0.0,1.0,1491,1747
1997-05-11,Turkmenistan,Vietnam,2,1,1,1.0,0.0,1540,1496
1997-05-11,Mongolia,China PR,0,6,6,0.0,1.0,1475,1750
1997-05-11,Guam,Japan,0,12,12,0.0,1.0,1427,1811
1997-05-13,Kazakhstan,Guam,20,1,19,1.0,0.0,1537,1422
1997-05-13,Japan,Mongolia,5,0,5,1.0,0.0,1814,1473
1997-05-15,Guam,China PR,0,7,7,0.0,1.0,1420,1753
1997-05-15,Kazakhstan,Japan,2,2,0,0.5,0.5,1543,1809
1997-05-16,Yemen,Cambodia,7,0,7,1.0,0.0,1454,1428
1997-05-17,Mongolia,Kazakhstan,3,11,8,0.0,1.0,1467,1550
1997-05-17,China PR,Japan,2,0,2,1.0,0.0,1763,1800
1997-05-18,Estonia,Latvia,1,3,2,0.0,1.0,1380,1520
1997-05-18,Jamaica,El Salvador,1,0,1,1.0,0.0,1689,1631
1997-05-19,Guam,Mongolia,0,4,4,0.0,1.0,1414,1474
1997-05-19,China PR,Kazakhstan,0,0,0,0.5,0.5,1759,1555
1997-05-21,Republic of Ireland,Liechtenstein,5,0,5,1.0,0.0,1790,1444
1997-05-21,Japan,South Korea,1,1,0,0.5,0.5,1801,1811
1997-05-21,Thailand,Northern Ireland,0,0,0,0.5,0.5,1699,1712
1997-05-22,Sweden,Poland,2,2,0,0.5,0.5,1875,1760
1997-05-23,Pakistan,Iraq,2,6,4,0.0,1.0,1404,1804
1997-05-24,England,South Africa,2,1,1,1.0,0.0,1959,1736
1997-05-24,Singapore,Lebanon,1,2,1,0.0,1.0,1592,1594
1997-05-25,Turkmenistan,Tajikistan,1,2,1,0.0,1.0,1531,1501
1997-05-25,Uzbekistan,Cambodia,6,0,6,1.0,0.0,1591,1424
1997-05-25,Vietnam,China PR,1,3,2,0.0,1.0,1494,1762
1997-05-27,Kuwait,Zambia,2,1,1,1.0,0.0,1744,1768
1997-05-27,Scotland,Wales,0,1,1,0.0,1.0,1806,1711
1997-05-28,El Salvador,Ecuador,0,2,2,0.0,1.0,1626,1726
1997-05-28,South Korea,Hong Kong,4,0,4,1.0,0.0,1814,1552
1997-05-30,Norway,Brazil,4,2,2,1.0,0.0,1835,2037
1997-05-31,Burkina Faso,Mali,2,0,2,1.0,0.0,1573,1597
1997-05-31,Morocco,Ethiopia,4,0,4,1.0,0.0,1800,1571
1997-05-31,Papua New Guinea,New Zealand,1,0,1,1.0,0.0,1516,1641
1997-05-31,Poland,England,0,2,2,0.0,1.0,1757,1963
1997-05-31,Tanzania,Namibia,0,0,0,0.5,0.5,1546,1500
1997-05-31,Tunisia,Algeria,0,1,1,0.0,1.0,1739,1766
1997-06-01,Canada,Costa Rica,1,0,1,1.0,0.0,1707,1723
1997-06-01,China PR,Turkmenistan,1,0,1,1.0,0.0,1766,1528
1997-06-01,Indonesia,Uzbekistan,1,1,0,0.5,0.5,1521,1590
1997-06-01,South Korea,Thailand,0,0,0,0.5,0.5,1812,1702
1997-06-01,Malta,Scotland,2,3,1,0.0,1.0,1430,1808
1997-06-01,Vietnam,Tajikistan,0,4,4,0.0,1.0,1487,1509
1997-06-01,Zambia,Cameroon,3,0,3,1.0,0.0,1776,1729
1997-06-02,Maldives,Iran,0,17,17,0.0,1.0,1400,1805
1997-06-03,France,Brazil,1,1,0,0.5,0.5,1983,2036
1997-06-04,England,Italy,2,0,2,1.0,0.0,1971,1955
1997-06-04,Estonia,Azerbaijan,1,0,1,1.0,0.0,1391,1467
1997-06-04,Kyrgyzstan,Iran,0,7,7,0.0,1.0,1442,1807
1997-06-04,South Africa,Netherlands,0,2,2,0.0,1.0,1732,1910
1997-06-04,Syria,Maldives,12,0,12,1.0,0.0,1608,1397
1997-06-04,Togo,Burkina Faso,0,0,0,0.5,0.5,1590,1574
1997-06-04,United States,Paraguay,0,0,0,0.5,0.5,1757,1828
1997-06-05,Kuwait,Singapore,4,0,4,1.0,0.0,1749,1588
1997-06-05,Senegal,Algeria,0,0,0,0.5,0.5,1625,1763
1997-06-06,Iraq,Kazakhstan,1,2,1,0.0,1.0,1792,1568
1997-06-06,Kyrgyzstan,Maldives,3,0,3,1.0,0.0,1449,1391
1997-06-06,Palestine,Jordan,0,0,0,0.5,0.5,1481,1548
1997-06-06,Syria,Iran,0,1,1,0.0,1.0,1605,1811
1997-06-07,Belgium,San Marino,6,0,6,1.0,0.0,1822,1430
1997-06-07,Fiji,New Zealand,0,1,1,0.0,1.0,1636,1650
1997-06-07,France,England,0,1,1,0.0,1.0,1975,1980
1997-06-07,Georgia,Moldova,2,0,2,1.0,0.0,1547,1516
1997-06-07,North Macedonia,Iceland,1,0,1,1.0,0.0,1572,1623
1997-06-07,Nigeria,Kenya,3,0,3,1.0,0.0,1780,1657
1997-06-07,Portugal,Albania,2,0,2,1.0,0.0,1845,1489
1997-06-07,Ukraine,Germany,0,0,0,0.5,0.5,1606,2014
1997-06-08,Morocco,Ghana,1,0,1,1.0,0.0,1807,1706
1997-06-08,Angola,Cameroon,1,1,0,0.5,0.5,1631,1727
1997-06-08,Argentina,Peru,2,0,2,1.0,0.0,1881,1688
1997-06-08,Belarus,Scotland,0,1,1,0.0,1.0,1498,1811
1997-06-08,Bulgaria,Luxembourg,4,0,4,1.0,0.0,1796,1374
1997-06-08,China PR,Tajikistan,0,0,0,0.5,0.5,1761,1515
1997-06-08,Congo,DR Congo,1,0,1,1.0,0.0,1606,1639
1997-06-08,Denmark,Bosnia and Herzegovina,2,0,2,1.0,0.0,1915,1535
1997-06-08,Ecuador,Chile,1,1,0,0.5,0.5,1728,1787
1997-06-08,Egypt,Tunisia,0,0,0,0.5,0.5,1747,1740
1997-06-08,El Salvador,Mexico,0,1,1,0.0,1.0,1623,1841
1997-06-08,Estonia,Sweden,2,3,1,0.0,1.0,1391,1876
1997-06-08,Faroe Islands,Malta,2,1,1,1.0,0.0,1469,1423
1997-06-08,Finland,Azerbaijan,3,0,3,1.0,0.0,1610,1463
1997-06-08,Guinea,Burkina Faso,3,1,2,1.0,0.0,1603,1567
1997-06-08,Hungary,Norway,1,1,0,0.5,0.5,1702,1832
1997-06-08,Italy,Brazil,3,3,0,0.5,0.5,1957,2035
1997-06-08,Japan,Croatia,4,3,1,1.0,0.0,1808,1735
1997-06-08,Latvia,Austria,1,3,2,0.0,1.0,1517,1766
1997-06-08,Liberia,Namibia,1,2,1,0.0,1.0,1556,1510
1997-06-08,Russia,Israel,2,0,2,1.0,0.0,1890,1670
1997-06-08,Serbia,Slovakia,2,0,2,1.0,0.0,1652,1622
1997-06-08,South Africa,Zambia,3,0,3,1.0,0.0,1742,1767
1997-06-08,Spain,Czech Republic,1,0,1,1.0,0.0,1939,1727
1997-06-08,Togo,Zimbabwe,2,1,1,1.0,0.0,1600,1655
1997-06-08,Uruguay,Colombia,1,1,0,0.5,0.5,1799,1851
1997-06-08,Venezuela,Bolivia,1,1,0,0.5,0.5,1475,1708
1997-06-08,Vietnam,Turkmenistan,0,4,4,0.0,1.0,1480,1536
1997-06-09,Iran,Kyrgyzstan,3,1,2,1.0,0.0,1813,1448
1997-06-09,Maldives,Syria,0,12,12,0.0,1.0,1388,1609
1997-06-10,England,Brazil,0,1,1,0.0,1.0,1974,2042
1997-06-11,Argentina,Ecuador,0,0,0,0.5,0.5,1878,1732
1997-06-11,Australia,Solomon Islands,13,0,13,1.0,0.0,1835,1581
1997-06-11,Chile,Paraguay,0,1,1,0.0,1.0,1780,1836
1997-06-11,France,Italy,2,2,0,0.5,0.5,1975,1958
1997-06-11,Iceland,Lithuania,0,0,0,0.5,0.5,1622,1544
1997-06-11,Iran,Maldives,9,0,9,1.0,0.0,1815,1387
1997-06-11,Kyrgyzstan,Syria,2,1,1,1.0,0.0,1460,1598
1997-06-11,New Zealand,Papua New Guinea,7,0,7,1.0,0.0,1656,1511
1997-06-11,Pakistan,Kazakhstan,0,7,7,0.0,1.0,1400,1573
1997-06-12,Bolivia,Venezuela,1,0,1,1.0,0.0,1712,1472
1997-06-12,Croatia,Turkey,1,1,0,0.5,0.5,1735,1726
1997-06-12,Ghana,Serbia,1,3,2,0.0,1.0,1697,1662
1997-06-12,South Korea,Egypt,3,1,2,1.0,0.0,1819,1741
1997-06-12,Peru,Uruguay,1,0,1,1.0,0.0,1699,1789
1997-06-13,Australia,Tahiti,5,0,5,1.0,0.0,1842,1762
1997-06-13,Brazil,Costa Rica,5,0,5,1.0,0.0,2045,1721
1997-06-13,Iran,Syria,2,2,0,0.5,0.5,1811,1603
1997-06-13,Maldives,Kyrgyzstan,0,6,6,0.0,1.0,1381,1467
1997-06-13,Mexico,Colombia,2,1,1,1.0,0.0,1850,1843
1997-06-13,Yemen,Indonesia,1,1,0,0.5,0.5,1456,1520
1997-06-14,Argentina,Chile,2,0,2,1.0,0.0,1884,1775
1997-06-14,Egypt,Serbia,0,0,0,0.5,0.5,1740,1664
1997-06-14,South Korea,Ghana,3,0,3,1.0,0.0,1825,1692
1997-06-14,Paraguay,Ecuador,0,2,2,0.0,1.0,1826,1743
1997-06-14,Poland,Georgia,4,1,3,1.0,0.0,1761,1544
1997-06-15,Bolivia,Peru,2,0,2,1.0,0.0,1720,1692
1997-06-15,Fiji,Papua New Guinea,3,1,2,1.0,0.0,1642,1506
1997-06-15,Japan,Turkey,1,0,1,1.0,0.0,1815,1720
1997-06-15,Mozambique,Tanzania,3,0,3,1.0,0.0,1582,1539
1997-06-15,Solomon Islands,Tahiti,4,1,3,1.0,0.0,1593,1751
1997-06-15,Uruguay,Venezuela,2,0,2,1.0,0.0,1792,1470
1997-06-16,Brazil,Mexico,3,2,1,1.0,0.0,2049,1847
1997-06-16,Colombia,Costa Rica,4,1,3,1.0,0.0,1849,1716
1997-06-16,Egypt,Ghana,2,0,2,1.0,0.0,1747,1686
1997-06-16,South Korea,Serbia,1,1,0,0.5,0.5,1822,1668
1997-06-17,Argentina,Paraguay,1,1,0,0.5,0.5,1883,1828
1997-06-17,Australia,Solomon Islands,6,2,4,1.0,0.0,1846,1590
1997-06-17,Chile,Ecuador,1,2,1,0.0,1.0,1767,1752
1997-06-17,United States,Israel,2,1,1,1.0,0.0,1764,1664
1997-06-18,Bolivia,Uruguay,1,0,1,1.0,0.0,1730,1783
1997-06-18,New Zealand,Fiji,5,0,5,1.0,0.0,1664,1635
1997-06-18,Peru,Venezuela,2,0,2,1.0,0.0,1696,1467
1997-06-19,Australia,Tahiti,2,0,2,1.0,0.0,1852,1746
1997-06-19,Brazil,Colombia,2,0,2,1.0,0.0,2053,1846
1997-06-19,Mexico,Costa Rica,1,1,0,0.5,0.5,1845,1719
1997-06-20,Iraq,Pakistan,6,1,5,1.0,0.0,1794,1399
1997-06-20,Uzbekistan,Indonesia,3,0,3,1.0,0.0,1597,1514
1997-06-21,Antigua and Barbuda,Saint Lucia,1,1,0,0.5,0.5,1473,1505
1997-06-21,Bolivia,Colombia,2,1,1,1.0,0.0,1741,1836
1997-06-21,Malawi,Mauritius,3,2,1,1.0,0.0,1655,1490
1997-06-21,Morocco,Egypt,1,0,1,1.0,0.0,1814,1741
1997-06-21,Papua New Guinea,Fiji,0,1,1,0.0,1.0,1501,1641
1997-06-21,Peru,Argentina,2,1,1,1.0,0.0,1708,1872
1997-06-21,Tahiti,Solomon Islands,1,1,0,0.5,0.5,1743,1594
1997-06-22,Angola,Ghana,1,0,1,1.0,0.0,1641,1677
1997-06-22,Antigua and Barbuda,Saint Lucia,1,0,1,1.0,0.0,1482,1497
1997-06-22,Brazil,Paraguay,2,0,2,1.0,0.0,2057,1825
1997-06-22,Cameroon,Gabon,2,2,0,0.5,0.5,1726,1650
1997-06-22,China PR,Vietnam,4,0,4,1.0,0.0,1764,1478
1997-06-22,Ecuador,Mexico,1,1,0,0.5,0.5,1755,1843
1997-06-22,Estonia,Andorra,4,1,3,1.0,0.0,1402,1479
1997-06-22,Ivory Coast,Algeria,2,1,1,1.0,0.0,1776,1756
1997-06-22,Japan,Macau,10,0,10,1.0,0.0,1817,1412
1997-06-22,Lebanon,Kuwait,1,3,2,0.0,1.0,1590,1754
1997-06-22,Liberia,DR Congo,2,1,1,1.0,0.0,1566,1630
1997-06-22,Mali,Benin,3,1,2,1.0,0.0,1602,1438
1997-06-22,Mozambique,Zambia,2,2,0,0.5,0.5,1586,1764
1997-06-22,Nepal,Oman,0,6,6,0.0,1.0,1371,1541
1997-06-22,Senegal,Ethiopia,3,0,3,1.0,0.0,1632,1565
1997-06-22,Tajikistan,Turkmenistan,5,0,5,1.0,0.0,1524,1528
1997-06-22,Tanzania,Togo,1,0,1,1.0,0.0,1549,1591
1997-06-25,Bolivia,Mexico,3,1,2,1.0,0.0,1752,1833
1997-06-25,Japan,Nepal,3,0,3,1.0,0.0,1819,1370
1997-06-25,Latvia,Andorra,4,1,3,1.0,0.0,1525,1472
1997-06-25,Macau,Oman,0,2,2,0.0,1.0,1407,1547
1997-06-26,Brazil,Peru,7,0,7,1.0,0.0,2059,1707
1997-06-28,DR Congo,Uganda,0,0,0,0.5,0.5,1631,1637
1997-06-28,Japan,Oman,1,1,0,0.5,0.5,1814,1553
1997-06-28,Macau,Nepal,2,1,1,1.0,0.0,1415,1363
1997-06-28,Mexico,Peru,1,0,1,1.0,0.0,1839,1702
1997-06-28,Namibia,Malawi,4,1,3,1.0,0.0,1522,1644
1997-06-28,New Zealand,Australia,0,3,3,0.0,1.0,1660,1857
1997-06-29,Bolivia,Brazil,1,3,2,0.0,1.0,1750,2062
1997-06-29,Cambodia,Uzbekistan,1,4,3,0.0,1.0,1420,1602
1997-06-29,El Salvador,United States,1,1,0,0.5,0.5,1627,1761
1997-06-29,Jamaica,Cuba,3,0,3,1.0,0.0,1695,1574
1997-06-29,Kazakhstan,Iraq,3,1,2,1.0,0.0,1586,1782
1997-06-29,Jersey,Frøya,4,1,3,1.0,0.0,1716,1497
1997-06-29,Gibraltar,Guernsey,1,2,1,0.0,1.0,1499,1641
1997-06-29,Ynys Môn,Hitra,8,0,8,1.0,0.0,1545,1493
1997-06-29,Shetland,Isle of Wight,0,0,0,0.5,0.5,1469,1529
1997-06-30,Jersey,Greenland,2,1,1,1.0,0.0,1719,1442
1997-06-30,Frøya,Guernsey,1,2,1,0.0,1.0,1493,1646
1997-07-01,Ynys Môn,Shetland,4,0,4,1.0,0.0,1552,1463
1997-07-01,Hitra,Isle of Wight,0,4,4,0.0,1.0,1486,1537
1997-07-01,Guernsey,Greenland,0,0,0,0.5,0.5,1642,1447
1997-07-01,Frøya,Gibraltar,0,4,4,0.0,1.0,1486,1507
1997-07-02,Barbados,Trinidad and Tobago,1,1,0,0.5,0.5,1552,1639
1997-07-02,Gibraltar,Greenland,5,1,4,1.0,0.0,1514,1441
1997-07-02,Jersey,Guernsey,4,0,4,1.0,0.0,1726,1636
1997-07-03,Frøya,Greenland,2,1,1,1.0,0.0,1493,1435
1997-07-03,Jersey,Gibraltar,3,2,1,1.0,0.0,1730,1511
1997-07-03,Ynys Môn,Isle of Wight,0,0,0,0.5,0.5,1552,1538
1997-07-03,Shetland,Hitra,2,1,1,1.0,0.0,1472,1478
1997-07-03,Frøya,Hitra,4,1,3,1.0,0.0,1501,1471
1997-07-03,Shetland,Gibraltar,2,1,1,1.0,0.0,1481,1503
1997-07-03,Isle of Wight,Guernsey,3,1,2,1.0,0.0,1549,1626
1997-07-04,Jersey,Ynys Môn,2,1,1,1.0,0.0,1735,1548
1997-07-04,Jamaica,Grenada,1,1,0,0.5,0.5,1693,1564
1997-07-04,Martinique,Trinidad and Tobago,2,1,1,1.0,0.0,1657,1632
1997-07-05,Chile,Colombia,4,1,3,1.0,0.0,1777,1827
1997-07-05,Tanzania,Zambia,2,2,0,0.5,0.5,1554,1760
1997-07-05,Tunisia,Mali,1,0,1,1.0,0.0,1745,1598
1997-07-06,Australia,New Zealand,2,0,2,1.0,0.0,1861,1657
1997-07-06,Antigua and Barbuda,Grenada,1,3,2,0.0,1.0,1476,1571
1997-07-06,Malawi,Botswana,0,0,0,0.5,0.5,1640,1411
1997-07-06,Paraguay,Argentina,1,2,1,0.0,1.0,1819,1879
1997-07-06,Peru,Bolivia,2,1,1,1.0,0.0,1712,1741
1997-07-06,Saint Kitts and Nevis,Martinique,2,0,2,1.0,0.0,1544,1647
1997-07-06,Venezuela,Ecuador,1,1,0,0.5,0.5,1473,1750
1997-07-08,Antigua and Barbuda,Jamaica,0,2,2,0.0,1.0,1473,1697
1997-07-08,Saint Kitts and Nevis,Trinidad and Tobago,0,3,3,0.0,1.0,1538,1639
1997-07-09,Lithuania,Estonia,2,1,1,1.0,0.0,1549,1398
1997-07-10,Estonia,Latvia,1,2,1,0.0,1.0,1393,1531
1997-07-10,Saint Kitts and Nevis,Grenada,2,1,1,1.0,0.0,1547,1563
1997-07-10,Trinidad and Tobago,Jamaica,1,1,0,0.5,0.5,1641,1696
1997-07-11,Lithuania,Latvia,1,0,1,1.0,0.0,1557,1524
1997-07-12,Zambia,Malawi,3,1,2,1.0,0.0,1766,1635
1997-07-13,Algeria,Mali,1,0,1,1.0,0.0,1761,1594
1997-07-13,Benin,Ivory Coast,0,0,0,0.5,0.5,1444,1771
1997-07-13,DR Congo,Tanzania,1,1,0,0.5,0.5,1630,1556
1997-07-13,Egypt,Senegal,2,0,2,1.0,0.0,1747,1627
1997-07-13,Ethiopia,Morocco,0,1,1,0.0,1.0,1562,1818
1997-07-13,Gabon,Kenya,1,0,1,1.0,0.0,1659,1649
1997-07-13,Ghana,Zimbabwe,2,1,1,1.0,0.0,1685,1648
1997-07-13,Jamaica,Grenada,4,1,3,1.0,0.0,1702,1558
1997-07-13,Mauritius,Mozambique,1,3,2,0.0,1.0,1485,1592
1997-07-13,Togo,Liberia,4,0,4,1.0,0.0,1599,1559
1997-07-13,Trinidad and Tobago,Saint Kitts and Nevis,4,0,4,1.0,0.0,1647,1542
1997-07-13,Tunisia,Guinea,1,0,1,1.0,0.0,1750,1599
1997-07-20,Argentina,Venezuela,2,0,2,1.0,0.0,1881,1472
1997-07-20,Bolivia,Uruguay,1,0,1,1.0,0.0,1750,1775
1997-07-20,Chile,Paraguay,2,1,1,1.0,0.0,1786,1811
1997-07-20,Colombia,Ecuador,1,0,1,1.0,0.0,1834,1744
1997-07-20,Iceland,Norway,0,1,1,0.0,1.0,1619,1836
1997-07-20,Mozambique,Namibia,1,1,0,0.5,0.5,1591,1524
1997-07-27,Algeria,Benin,2,0,2,1.0,0.0,1764,1442
1997-07-27,Angola,Zimbabwe,2,1,1,1.0,0.0,1650,1640
1997-07-27,Cameroon,Kenya,1,1,0,0.5,0.5,1725,1651
1997-07-27,DR Congo,Togo,1,0,1,1.0,0.0,1638,1592
1997-07-27,Egypt,Ethiopia,8,1,7,1.0,0.0,1752,1558
1997-07-27,Gabon,Namibia,1,1,0,0.5,0.5,1657,1527
1997-07-27,Iceland,Faroe Islands,1,0,1,1.0,0.0,1624,1465
1997-07-27,Ivory Coast,Mali,4,2,2,1.0,0.0,1776,1590
1997-07-27,Liberia,Tanzania,1,0,1,1.0,0.0,1567,1549
1997-07-27,Morocco,Senegal,3,0,3,1.0,0.0,1822,1624
1997-07-27,Mozambique,Malawi,2,1,1,1.0,0.0,1601,1626
1997-07-27,Zambia,Mauritius,1,0,1,1.0,0.0,1769,1483
1997-08-02,Zambia,Mozambique,2,1,1,1.0,0.0,1774,1597
1997-08-05,Belarus,Israel,2,3,1,0.0,1.0,1494,1669
1997-08-06,Estonia,Faroe Islands,0,2,2,0.0,1.0,1387,1472
1997-08-06,Hungary,Malta,3,0,3,1.0,0.0,1705,1421
1997-08-06,Jamaica,Colombia,1,0,1,1.0,0.0,1713,1824
1997-08-06,Slovakia,Switzerland,1,0,1,1.0,0.0,1634,1780
1997-08-06,Sweden,Lithuania,1,0,1,1.0,0.0,1879,1555
1997-08-07,Cameroon,Nigeria,0,1,1,0.0,1.0,1719,1787
1997-08-07,Tunisia,Zambia,3,1,2,1.0,0.0,1759,1766
1997-08-07,United States,Ecuador,0,1,1,0.0,1.0,1753,1753
1997-08-09,Cameroon,Zambia,3,3,0,0.5,0.5,1721,1765
1997-08-09,Malawi,Tanzania,2,2,0,0.5,0.5,1625,1551
1997-08-09,Tunisia,Nigeria,2,0,2,1.0,0.0,1768,1779
1997-08-10,Costa Rica,El Salvador,0,0,0,0.5,0.5,1717,1630
1997-08-10,South Korea,Brazil,1,2,1,0.0,1.0,1819,2066
1997-08-13,Japan,Brazil,0,3,3,0.0,1.0,1811,2070
1997-08-16,Guinea,Nigeria,1,0,1,1.0,0.0,1611,1768
1997-08-16,Burkina Faso,Kenya,2,4,2,0.0,1.0,1561,1658
1997-08-16,Morocco,Gabon,2,0,2,1.0,0.0,1827,1653
1997-08-16,South Africa,Congo,1,0,1,1.0,0.0,1748,1601
1997-08-16,Zambia,DR Congo,2,0,2,1.0,0.0,1771,1633
1997-08-17,Canada,Iran,0,1,1,0.0,1.0,1702,1817
1997-08-17,Egypt,Liberia,5,0,5,1.0,0.0,1757,1563
1997-08-17,Ghana,Sierra Leone,0,2,2,0.0,1.0,1676,1635
1997-08-17,Togo,Angola,1,1,0,0.5,0.5,1594,1649
1997-08-17,Tunisia,Namibia,4,0,4,1.0,0.0,1772,1524
1997-08-17,Zimbabwe,Cameroon,1,2,1,0.0,1.0,1634,1728
1997-08-19,Greece,Cyprus,2,1,1,1.0,0.0,1729,1506
1997-08-19,Latvia,Azerbaijan,0,0,0,0.5,0.5,1523,1465
1997-08-20,Belarus,Sweden,1,2,1,0.0,1.0,1493,1881
1997-08-20,Bosnia and Herzegovina,Denmark,3,0,3,1.0,0.0,1550,1901
1997-08-20,Bulgaria,Israel,1,0,1,1.0,0.0,1802,1664
1997-08-20,Colombia,Bolivia,3,0,3,1.0,0.0,1831,1744
1997-08-20,Czech Republic,Faroe Islands,2,0,2,1.0,0.0,1730,1470
1997-08-20,Ecuador,Paraguay,2,1,1,1.0,0.0,1763,1802
1997-08-20,Estonia,Austria,0,3,3,0.0,1.0,1386,1768
1997-08-20,Finland,Norway,0,4,4,0.0,1.0,1607,1840
1997-08-20,Hungary,Switzerland,1,1,0,0.5,0.5,1707,1779
1997-08-20,Republic of Ireland,Lithuania,0,0,0,0.5,0.5,1786,1560
1997-08-20,Liechtenstein,Iceland,0,4,4,0.0,1.0,1440,1629
1997-08-20,Northern Ireland,Germany,1,3,2,0.0,1.0,1710,2017
1997-08-20,Portugal,Armenia,3,1,2,1.0,0.0,1847,1505
1997-08-20,Romania,North Macedonia,4,2,2,1.0,0.0,1845,1570
1997-08-20,Russia,Serbia,0,1,1,0.0,1.0,1878,1681
1997-08-20,Turkey,Wales,6,4,2,1.0,0.0,1728,1704
1997-08-20,Ukraine,Albania,1,0,1,1.0,0.0,1612,1484
1997-08-20,Uruguay,Chile,1,0,1,1.0,0.0,1784,1778
1997-08-20,Venezuela,Peru,0,3,3,0.0,1.0,1469,1716
1997-08-21,Lebanon,Iraq,0,2,2,0.0,1.0,1587,1786
1997-08-24,South Korea,Tajikistan,4,1,3,1.0,0.0,1822,1522
1997-08-24,Peru,Colombia,2,1,1,1.0,0.0,1727,1821
1997-08-24,Slovakia,Czech Republic,2,1,1,1.0,0.0,1645,1720
1997-08-24,Uzbekistan,Yemen,5,1,4,1.0,0.0,1607,1452
1997-08-30,South Korea,China PR,0,0,0,0.5,0.5,1821,1766
1997-08-31,Jamaica,Trinidad and Tobago,6,1,5,1.0,0.0,1720,1641
1997-08-31,Namibia,Zambia,1,1,0,0.5,0.5,1529,1767
1997-09-02,China PR,Kazakhstan,3,0,3,1.0,0.0,1771,1582
1997-09-02,United Arab Emirates,Iran,3,1,2,1.0,0.0,1774,1808
1997-09-04,Nepal,Pakistan,0,2,2,0.0,1.0,1356,1407
1997-09-05,Maldives,Bangladesh,1,1,0,0.5,0.5,1383,1448
1997-09-06,Armenia,Albania,3,0,3,1.0,0.0,1513,1477
1997-09-06,Austria,Sweden,1,0,1,1.0,0.0,1779,1871
1997-09-06,Azerbaijan,Norway,0,1,1,0.0,1.0,1464,1842
1997-09-06,Croatia,Bosnia and Herzegovina,3,2,1,1.0,0.0,1740,1546
1997-09-06,El Salvador,Colombia,2,2,0,0.5,0.5,1635,1817
1997-09-06,Faroe Islands,Czech Republic,0,2,2,0.0,1.0,1467,1724
1997-09-06,Germany,Portugal,1,1,0,0.5,0.5,2014,1851
1997-09-06,Iceland,Republic of Ireland,2,4,2,0.0,1.0,1625,1791
1997-09-06,South Korea,Kazakhstan,3,0,3,1.0,0.0,1825,1579
1997-09-06,Latvia,Estonia,1,0,1,1.0,0.0,1528,1382
1997-09-06,Liechtenstein,Romania,1,8,7,0.0,1.0,1439,1847
1997-09-06,Lithuania,North Macedonia,2,0,2,1.0,0.0,1569,1562
1997-09-06,Netherlands,Belgium,3,1,2,1.0,0.0,1917,1816
1997-09-06,Poland,Hungary,1,0,1,1.0,0.0,1768,1701
1997-09-06,Slovenia,Greece,0,3,3,0.0,1.0,1555,1734
1997-09-06,Sri Lanka,Pakistan,2,0,2,1.0,0.0,1395,1399
1997-09-06,Switzerland,Finland,1,2,1,0.0,1.0,1768,1619
1997-09-07,India,Bangladesh,3,0,3,1.0,0.0,1512,1442
1997-09-07,Jamaica,Canada,1,0,1,1.0,0.0,1728,1695
1997-09-07,Japan,Uzbekistan,6,3,3,1.0,0.0,1815,1604
1997-09-07,Luxembourg,Cyprus,1,3,2,0.0,1.0,1369,1512
1997-09-07,Scotland,Belarus,4,1,3,1.0,0.0,1814,1491
1997-09-07,United States,Costa Rica,1,0,1,1.0,0.0,1761,1710
1997-09-08,Nepal,Sri Lanka,1,3,2,0.0,1.0,1349,1403
1997-09-09,Maldives,India,2,2,0,0.5,0.5,1386,1510
1997-09-10,Albania,Northern Ireland,1,0,1,1.0,0.0,1490,1698
1997-09-10,Belarus,Austria,0,1,1,0.0,1.0,1489,1782
1997-09-10,Bosnia and Herzegovina,Slovenia,1,0,1,1.0,0.0,1555,1547
1997-09-10,Brazil,Ecuador,4,2,2,1.0,0.0,2073,1761
1997-09-10,Bulgaria,Russia,1,0,1,1.0,0.0,1812,1869
1997-09-10,Chile,Argentina,1,2,1,0.0,1.0,1773,1887
1997-09-10,Colombia,Venezuela,1,0,1,1.0,0.0,1819,1468
1997-09-10,Denmark,Croatia,3,1,2,1.0,0.0,1906,1736
1997-09-10,England,Moldova,4,0,4,1.0,0.0,1976,1515
1997-09-10,Georgia,Italy,0,0,0,0.5,0.5,1551,1952
1997-09-10,Germany,Armenia,4,0,4,1.0,0.0,2015,1513
1997-09-10,Hungary,Azerbaijan,3,1,2,1.0,0.0,1705,1461
1997-09-10,Lithuania,Republic of Ireland,1,2,1,0.0,1.0,1566,1795
1997-09-10,Norway,Switzerland,5,0,5,1.0,0.0,1849,1762
1997-09-10,Paraguay,Bolivia,2,1,1,1.0,0.0,1809,1738
1997-09-10,Peru,Uruguay,2,1,1,1.0,0.0,1737,1775
1997-09-10,Romania,Iceland,4,0,4,1.0,0.0,1851,1622
1997-09-10,San Marino,Turkey,0,5,5,0.0,1.0,1428,1731
1997-09-10,Slovakia,Serbia,1,1,0,0.5,0.5,1646,1681
1997-09-10,Sri Lanka,Maldives,1,2,1,0.0,1.0,1395,1395
1997-09-10,Sweden,Latvia,1,0,1,1.0,0.0,1873,1527
1997-09-11,India,Pakistan,2,0,2,1.0,0.0,1516,1394
1997-09-12,South Korea,Uzbekistan,2,1,1,1.0,0.0,1829,1601
1997-09-12,United Arab Emirates,Kazakhstan,4,0,4,1.0,0.0,1778,1576
1997-09-13,China PR,Iran,2,4,2,0.0,1.0,1764,1816
1997-09-13,India,Maldives,5,1,4,1.0,0.0,1522,1390
1997-09-13,Pakistan,Sri Lanka,1,0,1,1.0,0.0,1403,1387
1997-09-14,El Salvador,Canada,4,1,3,1.0,0.0,1645,1686
1997-09-14,Indonesia,Tanzania,3,1,2,1.0,0.0,1523,1543
1997-09-14,Jamaica,Costa Rica,1,0,1,1.0,0.0,1736,1703
1997-09-14,Saudi Arabia,Kuwait,2,1,1,1.0,0.0,1819,1748
1997-09-19,Iran,Saudi Arabia,1,1,0,0.5,0.5,1817,1819
1997-09-19,Qatar,Kuwait,0,2,2,0.0,1.0,1670,1755
1997-09-19,United Arab Emirates,Japan,0,0,0,0.5,0.5,1779,1815
1997-09-20,Kazakhstan,Uzbekistan,1,1,0,0.5,0.5,1577,1601
1997-09-20,Libya,Bahrain,2,1,1,1.0,0.0,1622,1573
1997-09-21,Indonesia,New Zealand,5,0,5,1.0,0.0,1534,1647
1997-09-24,El Salvador,Guatemala,0,1,1,0.0,1.0,1638,1675
1997-09-24,Malta,Czech Republic,0,1,1,0.0,1.0,1419,1727
1997-09-24,Moldova,Georgia,0,1,1,0.0,1.0,1508,1559
1997-09-24,Poland,Lithuania,2,0,2,1.0,0.0,1772,1563
1997-09-24,Slovakia,Spain,1,2,1,0.0,1.0,1644,1942
1997-09-25,Bahrain,Chad,1,1,0,0.5,0.5,1571,1482
1997-09-25,Libya,Jordan,1,1,0,0.5,0.5,1621,1550
1997-09-25,Saudi Arabia,Mali,5,1,4,1.0,0.0,1823,1587
1997-09-26,Kuwait,Iran,1,1,0,0.5,0.5,1757,1816
1997-09-26,Qatar,China PR,1,1,0,0.5,0.5,1673,1762
1997-09-27,Tanzania,Zambia,0,0,0,0.5,0.5,1548,1763
1997-09-27,Uzbekistan,United Arab Emirates,2,3,1,0.0,1.0,1597,1784
1997-09-28,Algeria,Kenya,0,1,1,0.0,1.0,1754,1669
1997-09-28,Japan,South Korea,1,2,1,0.0,1.0,1808,1837
1997-09-30,Algeria,Zambia,0,1,1,0.0,1.0,1747,1771
1997-10-01,Tanzania,Kenya,0,1,1,0.0,1.0,1543,1675
1997-10-03,China PR,Saudi Arabia,1,0,1,1.0,0.0,1772,1814
1997-10-03,Iran,Qatar,3,0,3,1.0,0.0,1821,1669
1997-10-03,Kenya,Zambia,0,0,0,0.5,0.5,1678,1769
1997-10-03,United States,Jamaica,1,1,0,0.5,0.5,1761,1737
1997-10-04,Kazakhstan,Japan,1,1,0,0.5,0.5,1582,1804
1997-10-04,South Korea,United Arab Emirates,3,0,3,1.0,0.0,1844,1778
1997-10-04,Saint Kitts and Nevis,Cuba,0,2,2,0.0,1.0,1535,1582
1997-10-04,Tanzania,Algeria,0,1,1,0.0,1.0,1540,1751
1997-10-05,Mexico,El Salvador,5,0,5,1.0,0.0,1843,1635
1997-10-05,Vietnam,Malaysia,0,1,1,0.0,1.0,1473,1600
1997-10-05,Indonesia,Laos,5,2,3,1.0,0.0,1540,1398
1997-10-05,Thailand,Myanmar,2,1,1,1.0,0.0,1707,1545
1997-10-05,Brunei,Cambodia,0,4,4,0.0,1.0,1348,1427
1997-10-07,Moldova,Poland,0,3,3,0.0,1.0,1506,1775
1997-10-07,Malaysia,Philippines,4,0,4,1.0,0.0,1603,1287
1997-10-07,Indonesia,Vietnam,2,2,0,0.5,0.5,1539,1475
1997-10-07,Brunei,Thailand,0,6,6,0.0,1.0,1347,1709
1997-10-07,Singapore,Myanmar,2,2,0,0.5,0.5,1588,1546
1997-10-08,Norway,Colombia,0,0,0,0.5,0.5,1849,1820
1997-10-09,Brazil,Morocco,2,0,2,1.0,0.0,2077,1824
1997-10-09,Laos,Philippines,4,1,3,1.0,0.0,1404,1282
1997-10-09,Indonesia,Malaysia,4,0,4,1.0,0.0,1549,1594
1997-10-09,Singapore,Cambodia,2,1,1,1.0,0.0,1593,1423
1997-10-09,Brunei,Myanmar,1,6,5,0.0,1.0,1344,1550
1997-10-10,Kuwait,China PR,1,2,1,0.0,1.0,1750,1780
1997-10-11,Armenia,Ukraine,0,2,2,0.0,1.0,1508,1618
1997-10-11,Austria,Belarus,4,0,4,1.0,0.0,1785,1487
1997-10-11,Belgium,Wales,3,2,1,1.0,0.0,1822,1699
1997-10-11,Cyprus,Luxembourg,2,0,2,1.0,0.0,1517,1365
1997-10-11,Czech Republic,Slovakia,3,0,3,1.0,0.0,1734,1638
1997-10-11,Finland,Hungary,1,1,0,0.5,0.5,1621,1704
1997-10-11,France,South Africa,2,1,1,1.0,0.0,1979,1745
1997-10-11,Georgia,Poland,3,0,3,1.0,0.0,1572,1763
1997-10-11,Germany,Albania,4,3,1,1.0,0.0,2016,1490
1997-10-11,Greece,Denmark,0,0,0,0.5,0.5,1738,1903
1997-10-11,Iceland,Liechtenstein,4,0,4,1.0,0.0,1627,1435
1997-10-11,Republic of Ireland,Romania,1,1,0,0.5,0.5,1797,1850
1997-10-11,Italy,England,0,0,0,0.5,0.5,1953,1976
1997-10-11,Kazakhstan,South Korea,1,1,0,0.5,0.5,1588,1839
1997-10-11,North Macedonia,Lithuania,1,2,1,0.0,1.0,1555,1571
1997-10-11,Malta,Serbia,0,5,5,0.0,1.0,1417,1684
1997-10-11,Netherlands,Turkey,0,0,0,0.5,0.5,1914,1735
1997-10-11,Portugal,Northern Ireland,1,0,1,1.0,0.0,1856,1694
1997-10-11,Russia,Bulgaria,4,2,2,1.0,0.0,1876,1806
1997-10-11,Saudi Arabia,Qatar,1,0,1,1.0,0.0,1819,1665
1997-10-11,Scotland,Latvia,2,0,2,1.0,0.0,1817,1525
1997-10-11,Slovenia,Croatia,1,3,2,0.0,1.0,1543,1741
1997-10-11,Spain,Faroe Islands,3,1,2,1.0,0.0,1943,1467
1997-10-11,Sweden,Estonia,1,0,1,1.0,0.0,1874,1382
1997-10-11,Switzerland,Azerbaijan,5,0,5,1.0,0.0,1765,1459
1997-10-11,Uzbekistan,Japan,1,1,0,0.5,0.5,1602,1800
1997-10-12,Argentina,Uruguay,0,0,0,0.5,0.5,1885,1778
1997-10-12,Canada,Mexico,2,2,0,0.5,0.5,1690,1840
1997-10-12,Ecuador,Bolivia,1,0,1,1.0,0.0,1769,1731
1997-10-12,Paraguay,Venezuela,1,0,1,1.0,0.0,1811,1467
1997-10-12,Peru,Chile,0,4,4,0.0,1.0,1730,1781
1997-10-12,Indonesia,Philippines,2,0,2,1.0,0.0,1552,1280
1997-10-12,Vietnam,Laos,2,1,1,1.0,0.0,1482,1398
1997-10-12,Thailand,Cambodia,4,0,4,1.0,0.0,1712,1421
1997-10-12,Singapore,Brunei,1,0,1,1.0,0.0,1597,1341
1997-10-14,Vietnam,Philippines,3,0,3,1.0,0.0,1486,1277
1997-10-14,Laos,Malaysia,1,0,1,1.0,0.0,1411,1582
1997-10-14,Myanmar,Cambodia,1,3,2,0.0,1.0,1540,1432
1997-10-14,Singapore,Thailand,0,0,0,0.5,0.5,1600,1710
1997-10-16,Thailand,Vietnam,2,1,1,1.0,0.0,1714,1483
1997-10-16,Indonesia,Singapore,2,1,1,1.0,0.0,1562,1591
1997-10-17,Iran,China PR,4,1,3,1.0,0.0,1829,1773
1997-10-17,Kuwait,Saudi Arabia,2,1,1,1.0,0.0,1760,1810
1997-10-18,Haiti,Jamaica,0,1,1,0.0,1.0,1561,1742
1997-10-18,Kazakhstan,United Arab Emirates,3,0,3,1.0,0.0,1600,1767
1997-10-18,Uzbekistan,South Korea,1,5,4,0.0,1.0,1599,1843
1997-10-18,Vietnam,Singapore,1,0,1,1.0,0.0,1494,1581
1997-10-18,Indonesia,Thailand,1,1,0,0.5,0.5,1566,1711
1997-10-20,Haiti,Cuba,2,2,0,0.5,0.5,1562,1582
1997-10-20,Martinique,Cameroon,2,1,1,1.0,0.0,1657,1719
1997-10-22,Cuba,Cameroon,1,1,0,0.5,0.5,1586,1716
1997-10-22,Haiti,Martinique,3,0,3,1.0,0.0,1573,1647
1997-10-24,Kuwait,Qatar,0,1,1,0.0,1.0,1750,1676
1997-10-24,Saudi Arabia,Iran,1,0,1,1.0,0.0,1819,1821
1997-10-24,Saint Lucia,Jamaica,1,3,2,0.0,1.0,1494,1746
1997-10-25,Uzbekistan,Kazakhstan,4,0,4,1.0,0.0,1608,1592
1997-10-26,Antigua and Barbuda,Jamaica,0,3,3,0.0,1.0,1471,1749
1997-10-26,Japan,United Arab Emirates,1,1,0,0.5,0.5,1800,1768
1997-10-29,Croatia,Ukraine,2,0,2,1.0,0.0,1747,1613
1997-10-29,Hungary,Serbia,1,7,6,0.0,1.0,1696,1693
1997-10-29,Republic of Ireland,Belgium,1,1,0,0.5,0.5,1798,1822
1997-10-29,Russia,Italy,1,1,0,0.5,0.5,1878,1952
1997-10-29,Saint Kitts and Nevis,Jamaica,1,1,0,0.5,0.5,1540,1745
1997-10-31,China PR,Qatar,2,3,1,0.0,1.0,1763,1687
1997-10-31,Iran,Kuwait,0,0,0,0.5,0.5,1820,1752
1997-11-01,South Korea,Japan,0,2,2,0.0,1.0,1835,1809
1997-11-02,Ivory Coast,Burkina Faso,0,0,0,0.5,0.5,1772,1566
1997-11-02,Mexico,United States,0,0,0,0.5,0.5,1839,1763
1997-11-02,Eswatini,Mauritius,0,1,1,0.0,1.0,1458,1491
1997-11-02,United Arab Emirates,Uzbekistan,0,0,0,0.5,0.5,1765,1612
1997-11-05,Tunisia,Bosnia and Herzegovina,2,1,1,1.0,0.0,1776,1552
1997-11-06,Saudi Arabia,China PR,1,1,0,0.5,0.5,1818,1765
1997-11-07,Chile,Guatemala,4,1,3,1.0,0.0,1787,1670
1997-11-07,Qatar,Iran,2,0,2,1.0,0.0,1698,1810
1997-11-08,Japan,Kazakhstan,5,1,4,1.0,0.0,1813,1589
1997-11-09,Canada,United States,0,3,3,0.0,1.0,1684,1770
1997-11-09,El Salvador,Jamaica,2,2,0,0.5,0.5,1638,1743
1997-11-09,Mexico,Costa Rica,3,3,0,0.5,0.5,1837,1706
1997-11-09,United Arab Emirates,South Korea,1,3,2,0.0,1.0,1759,1842
1997-11-11,Brazil,Wales,3,0,3,1.0,0.0,2079,1698
1997-11-12,China PR,Kuwait,1,0,1,1.0,0.0,1773,1745
1997-11-12,France,Scotland,2,1,1,1.0,0.0,1984,1813
1997-11-12,Qatar,Saudi Arabia,0,1,1,0.0,1.0,1693,1824
1997-11-13,Mali,Mauritania,3,1,2,1.0,0.0,1592,1440
1997-11-15,Belgium,Republic of Ireland,2,1,1,1.0,0.0,1830,1791
1997-11-15,England,Cameroon,2,0,2,1.0,0.0,1979,1714
1997-11-15,Germany,South Africa,3,0,3,1.0,0.0,2019,1743
1997-11-15,Italy,Russia,1,0,1,1.0,0.0,1959,1872
1997-11-15,Serbia,Hungary,5,0,5,1.0,0.0,1702,1688
1997-11-15,Ukraine,Croatia,1,1,0,0.5,0.5,1616,1745
1997-11-16,Argentina,Colombia,1,1,0,0.5,0.5,1884,1822
1997-11-16,Chile,Bolivia,3,0,3,1.0,0.0,1794,1725
1997-11-16,Costa Rica,Canada,3,1,2,1.0,0.0,1714,1677
1997-11-16,Jamaica,Mexico,0,0,0,0.5,0.5,1746,1835
1997-11-16,Japan,Iran,3,2,1,1.0,0.0,1821,1803
1997-11-16,Peru,Paraguay,1,0,1,1.0,0.0,1740,1802
1997-11-16,Uruguay,Ecuador,5,3,2,1.0,0.0,1786,1762
1997-11-16,United States,El Salvador,4,2,2,1.0,0.0,1776,1633
1997-11-19,Senegal,Mali,1,2,1,0.0,1.0,1616,1601
1997-11-19,Spain,Romania,1,1,0,0.5,0.5,1941,1853
1997-11-22,Iran,Australia,1,1,0,0.5,0.5,1805,1860
1997-11-26,Morocco,Togo,3,0,3,1.0,0.0,1828,1591
1997-11-27,Philippines,Estonia,0,1,1,0.0,1.0,1272,1388
1997-11-28,Gambia,Cape Verde,3,1,2,1.0,0.0,1508,1497
1997-11-28,Mauritania,Senegal,1,1,0,0.5,0.5,1444,1613
1997-11-29,Australia,Iran,2,2,0,0.5,0.5,1859,1807
1997-11-29,Guinea,Mali,0,0,0,0.5,0.5,1611,1602
1997-11-29,Sierra Leone,Guinea-Bissau,2,1,1,1.0,0.0,1641,1516
1997-11-30,Gambia,Mauritania,2,1,1,1.0,0.0,1515,1438
1997-11-30,Senegal,Cape Verde,2,0,2,1.0,0.0,1619,1492
1997-12-01,Guinea,Sierra Leone,3,0,3,1.0,0.0,1620,1633
1997-12-01,Mali,Guinea-Bissau,6,1,5,1.0,0.0,1609,1510
1997-12-02,Cape Verde,Mauritania,2,2,0,0.5,0.5,1491,1440
1997-12-02,Gambia,Senegal,0,0,0,0.5,0.5,1518,1617
1997-12-03,Egypt,Ghana,3,2,1,1.0,0.0,1764,1670
1997-12-03,Guinea,Guinea-Bissau,2,0,2,1.0,0.0,1626,1505
1997-12-03,Mali,Sierra Leone,1,1,0,0.5,0.5,1610,1633
1997-12-05,Gambia,Mali,1,2,1,0.0,1.0,1513,1616
1997-12-05,Guinea,Senegal,1,2,1,0.0,1.0,1618,1626
1997-12-07,Gambia,Guinea,2,2,0,0.5,0.5,1516,1616
1997-12-07,Mali,Senegal,1,0,1,1.0,0.0,1625,1618
1997-12-07,Saudi Arabia,Iceland,0,0,0,0.5,0.5,1820,1632
1997-12-07,South Africa,Brazil,1,2,1,0.0,1.0,1741,2082
1997-12-12,Mexico,Australia,1,3,2,0.0,1.0,1828,1867
1997-12-12,Saudi Arabia,Brazil,0,3,3,0.0,1.0,1818,2085
1997-12-13,South Africa,Czech Republic,2,2,0,0.5,0.5,1741,1735
1997-12-13,United Arab Emirates,Uruguay,0,2,2,0.0,1.0,1752,1794
1997-12-14,Australia,Brazil,0,0,0,0.5,0.5,1872,2081
1997-12-14,Saudi Arabia,Mexico,0,5,5,0.0,1.0,1811,1836
1997-12-15,Czech Republic,Uruguay,1,2,1,0.0,1.0,1729,1801
1997-12-15,United Arab Emirates,South Africa,1,0,1,1.0,0.0,1760,1734
1997-12-16,Brazil,Mexico,3,2,1,1.0,0.0,2085,1833
1997-12-16,Saudi Arabia,Australia,1,0,1,1.0,0.0,1821,1863
1997-12-17,Martinique,Trinidad and Tobago,3,0,3,1.0,0.0,1655,1634
1997-12-17,United Arab Emirates,Czech Republic,1,6,5,0.0,1.0,1752,1738
1997-12-17,Uruguay,South Africa,4,3,1,1.0,0.0,1808,1728
1997-12-17,Zambia,Nigeria,0,0,0,0.5,0.5,1769,1769
1997-12-18,Egypt,Togo,7,2,5,1.0,0.0,1769,1587
1997-12-18,Lesotho,Eswatini,0,0,0,0.5,0.5,1454,1458
1997-12-18,Martinique,Trinidad and Tobago,3,2,1,1.0,0.0,1663,1627
1997-12-19,Brazil,Czech Republic,2,0,2,1.0,0.0,2087,1737
1997-12-19,Uruguay,Australia,0,1,1,0.0,1.0,1802,1870
1997-12-20,Egypt,Algeria,1,2,1,0.0,1.0,1761,1760
1997-12-21,Brazil,Australia,6,0,6,1.0,0.0,2091,1867
1997-12-21,Czech Republic,Uruguay,1,0,1,1.0,0.0,1747,1793
1997-12-21,Mozambique,Lesotho,1,1,0,0.5,0.5,1594,1458
1997-12-22,Algeria,Togo,0,1,1,0.0,1.0,1749,1599
1997-12-22,Egypt,Cameroon,2,0,2,1.0,0.0,1768,1708
1997-12-23,Catalonia,Bulgaria,1,1,0,0.5,0.5,1513,1801
1997-12-24,Cameroon,Togo,3,1,2,1.0,0.0,1714,1594
1997-12-24,Egypt,Algeria,1,2,1,0.0,1.0,1760,1758
1997-12-26,Basque Country,Yugoslavia,3,1,2,1.0,0.0,1653,1842
1997-12-27,Burkina Faso,Ivory Coast,2,0,2,1.0,0.0,1579,1760
1997-12-28,Lesotho,Eswatini,0,0,0,0.5,0.5,1458,1458
1998-01-03,Malawi,Zimbabwe,1,0,1,1.0,0.0,1634,1626
1998-01-04,Barbados,Trinidad and Tobago,0,1,1,0.0,1.0,1546,1634
1998-01-04,Burkina Faso,Mozambique,1,0,1,1.0,0.0,1588,1586
1998-01-04,Guinea,Togo,1,0,1,1.0,0.0,1624,1587
1998-01-04,Malawi,Zimbabwe,0,2,2,0.0,1.0,1626,1635
1998-01-07,Burkina Faso,Mozambique,4,2,2,1.0,0.0,1596,1579
1998-01-07,Trinidad and Tobago,Jamaica,0,0,0,0.5,0.5,1637,1744
1998-01-10,Malawi,Zambia,0,1,1,0.0,1.0,1622,1774
1998-01-10,Eswatini,Botswana,1,1,0,0.5,0.5,1457,1413
1998-01-11,Burkina Faso,Mali,0,0,0,0.5,0.5,1597,1625
1998-01-11,Togo,Mozambique,1,2,1,0.0,1.0,1579,1588
1998-01-12,Lesotho,Botswana,0,0,0,0.5,0.5,1457,1415
1998-01-14,Ghana,Mozambique,0,0,0,0.5,0.5,1669,1590
1998-01-14,Morocco,Angola,2,1,1,1.0,0.0,1833,1645
1998-01-16,Gambia,Zambia,0,2,2,0.0,1.0,1514,1777
1998-01-18,Lesotho,Zimbabwe,0,2,2,0.0,1.0,1453,1640
1998-01-19,Ghana,Mozambique,3,1,2,1.0,0.0,1676,1584
1998-01-21,Costa Rica,Honduras,1,4,3,0.0,1.0,1706,1705
1998-01-21,El Salvador,Trinidad and Tobago,2,0,2,1.0,0.0,1642,1629
1998-01-21,Turkey,Albania,1,4,3,0.0,1.0,1723,1503
1998-01-24,Namibia,South Africa,3,2,1,1.0,0.0,1542,1716
1998-01-24,United States,Sweden,1,0,1,1.0,0.0,1787,1864
1998-01-25,Botswana,Mozambique,1,2,1,0.0,1.0,1411,1589
1998-01-25,Thailand,Egypt,1,1,0,0.5,0.5,1713,1759
1998-01-27,Egypt,South Korea,0,2,2,0.0,1.0,1753,1849
1998-01-27,Liberia,Burkina Faso,1,2,1,0.0,1.0,1556,1605
1998-01-28,Cameroon,Angola,1,0,1,1.0,0.0,1721,1639
1998-01-28,France,Spain,1,0,1,1.0,0.0,1992,1934
1998-01-28,Iran,Nigeria,0,1,1,0.0,1.0,1799,1778
1998-01-28,Italy,Slovakia,3,0,3,1.0,0.0,1962,1636
1998-01-28,Tunisia,Serbia,0,3,3,0.0,1.0,1767,1712
1998-01-29,Ivory Coast,Mozambique,4,1,3,1.0,0.0,1765,1585
1998-01-29,Jamaica,Sweden,0,0,0,0.5,0.5,1747,1862
1998-01-29,Thailand,South Korea,0,2,2,0.0,1.0,1708,1855
1998-01-29,Togo,Mali,2,1,1,1.0,0.0,1589,1616
1998-01-30,Niger,Namibia,2,1,1,1.0,0.0,1535,1534
1998-01-31,Egypt,South Korea,1,1,0,0.5,0.5,1756,1853
1998-01-31,Iran,Chile,1,1,0,0.5,0.5,1799,1795
1998-01-31,Tunisia,Guinea,4,1,3,1.0,0.0,1772,1620
1998-02-01,Burkina Faso,Namibia,3,1,2,1.0,0.0,1612,1528
1998-02-01,Guatemala,El Salvador,0,0,0,0.5,0.5,1670,1643
1998-02-01,Honduras,Trinidad and Tobago,1,3,2,0.0,1.0,1696,1639
1998-02-01,Ivory Coast,Cameroon,1,0,1,1.0,0.0,1772,1715
1998-02-01,Togo,Mali,0,4,4,0.0,1.0,1582,1624
1998-02-01,United States,Cuba,3,0,3,1.0,0.0,1791,1583
1998-02-03,Brazil,Jamaica,0,0,0,0.5,0.5,2085,1754
1998-02-04,Cuba,Costa Rica,2,7,5,0.0,1.0,1578,1712
1998-02-04,Mali,Tunisia,0,1,1,0.0,1.0,1620,1777
1998-02-04,New Zealand,Chile,0,0,0,0.5,0.5,1651,1792
1998-02-04,Trinidad and Tobago,Mexico,2,4,2,0.0,1.0,1636,1837
1998-02-05,Brazil,Guatemala,1,1,0,0.5,0.5,2079,1677
1998-02-05,Cyprus,Finland,1,1,0,0.5,0.5,1520,1619
1998-02-05,Iceland,Slovenia,2,3,1,0.0,1.0,1622,1554
1998-02-05,Morocco,Niger,3,0,3,1.0,0.0,1836,1533
1998-02-06,Georgia,Latvia,2,1,1,1.0,0.0,1579,1519
1998-02-06,Malta,Albania,1,1,0,0.5,0.5,1419,1502
1998-02-06,Slovenia,Slovakia,1,1,0,0.5,0.5,1556,1635
1998-02-07,Australia,Chile,0,1,1,0.0,1.0,1858,1802
1998-02-07,Burkina Faso,Cameroon,0,1,1,0.0,1.0,1607,1721
1998-02-07,Iceland,Slovakia,1,2,1,0.0,1.0,1615,1643
1998-02-07,Mexico,Honduras,2,0,2,1.0,0.0,1842,1692
1998-02-07,New Zealand,South Korea,0,1,1,0.0,1.0,1648,1857
1998-02-07,United States,Costa Rica,2,1,1,1.0,0.0,1798,1706
1998-02-08,Albania,Georgia,0,3,3,0.0,1.0,1496,1586
1998-02-08,Algeria,Guinea,0,1,1,0.0,1.0,1747,1632
1998-02-08,El Salvador,Brazil,0,4,4,0.0,1.0,1642,2081
1998-02-08,Guatemala,Jamaica,2,3,1,0.0,1.0,1671,1761
1998-02-08,Ivory Coast,Namibia,4,3,1,1.0,0.0,1776,1525
1998-02-08,Malta,Latvia,2,1,1,1.0,0.0,1430,1509
1998-02-08,Paraguay,Poland,4,0,4,1.0,0.0,1810,1756
1998-02-08,South Africa,Angola,0,0,0,0.5,0.5,1715,1641
1998-02-09,DR Congo,Togo,2,1,1,1.0,0.0,1640,1576
1998-02-09,Cyprus,Slovenia,1,0,1,1.0,0.0,1529,1548
1998-02-09,Finland,Slovakia,0,2,2,0.0,1.0,1612,1651
1998-02-09,Ghana,Tunisia,2,0,2,1.0,0.0,1687,1767
1998-02-09,Jamaica,El Salvador,2,0,2,1.0,0.0,1767,1637
1998-02-09,Zambia,Morocco,1,1,0,0.5,0.5,1779,1835
1998-02-10,Albania,Latvia,2,2,0,0.5,0.5,1497,1509
1998-02-10,Egypt,Mozambique,2,0,2,1.0,0.0,1761,1581
1998-02-10,Malta,Georgia,1,3,2,0.0,1.0,1426,1591
1998-02-10,United States,Brazil,1,0,1,1.0,0.0,1812,2068
1998-02-11,Australia,South Korea,1,0,1,1.0,0.0,1866,1850
1998-02-11,Burkina Faso,Algeria,2,1,1,1.0,0.0,1619,1736
1998-02-11,Cameroon,Guinea,2,2,0,0.5,0.5,1719,1635
1998-02-11,England,Chile,0,2,2,0.0,1.0,1968,1814
1998-02-11,South Africa,Ivory Coast,1,1,0,0.5,0.5,1717,1775
1998-02-12,Angola,Namibia,3,3,0,0.5,0.5,1639,1528
1998-02-12,Ghana,Togo,1,2,1,0.0,1.0,1677,1587
1998-02-12,Jamaica,Mexico,0,1,1,0.0,1.0,1761,1849
1998-02-12,Tunisia,DR Congo,2,1,1,1.0,0.0,1773,1635
1998-02-13,Morocco,Mozambique,3,0,3,1.0,0.0,1839,1578
1998-02-13,Zambia,Egypt,0,4,4,0.0,1.0,1771,1770
1998-02-15,Australia,Japan,0,3,3,0.0,1.0,1857,1831
1998-02-15,Brazil,Jamaica,1,0,1,1.0,0.0,2071,1759
1998-02-15,Burkina Faso,Guinea,1,0,1,1.0,0.0,1628,1627
1998-02-15,Cameroon,Algeria,2,1,1,1.0,0.0,1728,1728
1998-02-15,United States,Mexico,0,1,1,0.0,1.0,1805,1857
1998-02-16,Ghana,DR Congo,0,1,1,0.0,1.0,1669,1644
1998-02-16,Ivory Coast,Angola,5,2,3,1.0,0.0,1781,1634
1998-02-16,South Africa,Namibia,4,1,3,1.0,0.0,1722,1524
1998-02-16,Tunisia,Togo,3,1,2,1.0,0.0,1778,1583
1998-02-17,Egypt,Morocco,0,1,1,0.0,1.0,1764,1846
1998-02-17,Zambia,Mozambique,3,1,2,1.0,0.0,1775,1575
1998-02-18,Greece,Russia,1,1,0,0.5,0.5,1741,1870
1998-02-18,Israel,Turkey,4,0,4,1.0,0.0,1674,1714
1998-02-18,Oman,Germany,0,2,2,0.0,1.0,1552,2021
1998-02-20,Cameroon,DR Congo,0,1,1,0.0,1.0,1719,1654
1998-02-21,Burkina Faso,Tunisia,1,1,0,0.5,0.5,1632,1775
1998-02-21,Ivory Coast,Egypt,0,0,0,0.5,0.5,1781,1765
1998-02-21,United States,Netherlands,0,2,2,0.0,1.0,1800,1920
1998-02-22,Antigua and Barbuda,Dominica,1,1,0,0.5,0.5,1472,1477
1998-02-22,Jamaica,Nigeria,2,2,0,0.5,0.5,1760,1778
1998-02-22,Morocco,South Africa,1,2,1,0.0,1.0,1836,1733
1998-02-22,Saudi Arabia,Germany,0,3,3,0.0,1.0,1818,2025
1998-02-24,Argentina,Serbia,3,1,2,1.0,0.0,1889,1708
1998-02-24,Mexico,Netherlands,2,3,1,0.0,1.0,1851,1927
1998-02-25,Belgium,United States,2,0,2,1.0,0.0,1838,1793
1998-02-25,Burkina Faso,Egypt,0,2,2,0.0,1.0,1627,1771
1998-02-25,DR Congo,South Africa,1,2,1,0.0,1.0,1648,1740
1998-02-25,France,Norway,3,3,0,0.5,0.5,1989,1853
1998-02-25,Israel,Poland,2,0,2,1.0,0.0,1684,1747
1998-02-27,Burkina Faso,DR Congo,4,4,0,0.5,0.5,1628,1648
1998-02-28,South Africa,Egypt,0,2,2,0.0,1.0,1733,1779
1998-03-01,Barbados,Saint Kitts and Nevis,6,2,4,1.0,0.0,1554,1533
1998-03-01,China PR,Hong Kong,1,0,1,1.0,0.0,1777,1549
1998-03-01,Japan,South Korea,2,1,1,1.0,0.0,1840,1842
1998-03-03,Aruba,French Guiana,1,0,1,1.0,0.0,1435,1443
1998-03-03,Saint Lucia,Saint Kitts and Nevis,2,0,2,1.0,0.0,1503,1525
1998-03-03,Suriname,Curaçao,3,3,0,0.5,0.5,1578,1542
1998-03-04,China PR,South Korea,1,2,1,0.0,1.0,1771,1849
1998-03-04,Japan,Hong Kong,5,1,4,1.0,0.0,1843,1547
1998-03-05,Aruba,Curaçao,0,1,1,0.0,1.0,1430,1548
1998-03-05,Saint Vincent and the Grenadines,Saint Kitts and Nevis,4,2,2,1.0,0.0,1533,1517
1998-03-05,Suriname,French Guiana,2,2,0,0.5,0.5,1576,1446
1998-03-07,Aruba,Suriname,3,3,0,0.5,0.5,1434,1573
1998-03-07,Curaçao,French Guiana,2,1,1,1.0,0.0,1554,1441
1998-03-07,Japan,China PR,0,2,2,0.0,1.0,1834,1781
1998-03-08,Hong Kong,South Korea,0,1,1,0.0,1.0,1545,1852
1998-03-08,Eswatini,Angola,0,1,1,0.0,1.0,1453,1639
1998-03-10,Argentina,Bulgaria,2,0,2,1.0,0.0,1896,1795
1998-03-11,Haiti,Puerto Rico,4,0,4,1.0,0.0,1578,1391
1998-03-13,Dominican Republic,Puerto Rico,3,1,2,1.0,0.0,1485,1385
1998-03-14,Myanmar,Brunei,4,1,3,1.0,0.0,1544,1338
1998-03-14,United States,Paraguay,2,2,0,0.5,0.5,1794,1810
1998-03-14,Alderney,Jersey,0,2,2,0.0,1.0,1286,1737
1998-03-15,Haiti,Dominican Republic,5,0,5,1.0,0.0,1584,1480
1998-03-16,Laos,Brunei,2,1,1,1.0,0.0,1418,1332
1998-03-18,Myanmar,Laos,3,0,3,1.0,0.0,1550,1413
1998-03-18,Mexico,Paraguay,1,1,0,0.5,0.5,1851,1811
1998-03-18,Romania,Israel,0,1,1,0.0,1.0,1842,1696
1998-03-18,Saint Lucia,Barbados,2,1,1,1.0,0.0,1513,1545
1998-03-20,Martinique,Barbados,4,1,3,1.0,0.0,1669,1540
1998-03-20,Saint Lucia,Saint Vincent and the Grenadines,3,2,1,1.0,0.0,1522,1525
1998-03-22,Azerbaijan,Moldova,1,0,1,1.0,0.0,1469,1497
1998-03-22,Saint Lucia,Martinique,1,2,1,0.0,1.0,1518,1674
1998-03-22,United States Virgin Islands,British Virgin Islands,1,0,1,1.0,0.0,1507,1434
1998-03-24,Singapore,Philippines,1,0,1,1.0,0.0,1584,1270
1998-03-25,Austria,Hungary,2,3,1,0.0,1.0,1775,1699
1998-03-25,Belgium,Norway,2,2,0,0.5,0.5,1839,1853
1998-03-25,Colombia,Serbia,0,0,0,0.5,0.5,1820,1711
1998-03-25,Czech Republic,Republic of Ireland,2,1,1,1.0,0.0,1757,1782
1998-03-25,Germany,Brazil,1,2,1,0.0,1.0,2019,2078
1998-03-25,North Macedonia,Bulgaria,1,0,1,1.0,0.0,1568,1783
1998-03-25,Malta,Finland,0,2,2,0.0,1.0,1422,1617
1998-03-25,Northern Ireland,Slovakia,1,0,1,1.0,0.0,1702,1644
1998-03-25,Poland,Slovenia,2,0,2,1.0,0.0,1751,1545
1998-03-25,Russia,France,1,0,1,1.0,0.0,1881,1979
1998-03-25,Scotland,Denmark,0,1,1,0.0,1.0,1808,1909
1998-03-25,Spain,Sweden,4,0,4,1.0,0.0,1941,1856
1998-03-25,Switzerland,England,1,1,0,0.5,0.5,1770,1964
1998-03-25,Wales,Jamaica,0,0,0,0.5,0.5,1700,1759
1998-03-26,Cambodia,Philippines,1,1,0,0.5,0.5,1429,1274
1998-03-28,Singapore,Cambodia,3,0,3,1.0,0.0,1589,1425
1998-03-29,Colombia,Paraguay,1,1,0,0.5,0.5,1820,1812
1998-04-01,Antigua and Barbuda,Saint Lucia,1,1,0,0.5,0.5,1474,1517
1998-04-01,Dominica,Guadeloupe,1,1,0,0.5,0.5,1479,1521
1998-04-01,South Korea,Japan,2,1,1,1.0,0.0,1860,1827
1998-04-01,Saint Kitts and Nevis,British Virgin Islands,4,0,4,1.0,0.0,1524,1428
1998-04-03,Guadeloupe,British Virgin Islands,3,0,3,1.0,0.0,1527,1423
1998-04-03,Saint Kitts and Nevis,Dominica,1,2,1,0.0,1.0,1515,1489
1998-04-05,Dominica,British Virgin Islands,4,1,3,1.0,0.0,1496,1417
1998-04-05,Saint Kitts and Nevis,Guadeloupe,2,1,1,1.0,0.0,1524,1519
1998-04-08,Romania,Greece,2,1,1,1.0,0.0,1848,1736
1998-04-14,Iran,Kuwait,1,1,0,0.5,0.5,1798,1747
1998-04-15,Grenada,Anguilla,14,1,13,1.0,0.0,1563,1396
1998-04-15,Israel,Argentina,2,1,1,1.0,0.0,1709,1884
1998-04-15,Mexico,Peru,1,0,1,1.0,0.0,1857,1735
1998-04-15,Slovakia,South Korea,0,0,0,0.5,0.5,1649,1856
1998-04-18,North Macedonia,South Korea,2,2,0,0.5,0.5,1574,1851
1998-04-19,Antigua and Barbuda,Grenada,2,1,1,1.0,0.0,1485,1553
1998-04-19,Guyana,Anguilla,14,0,14,1.0,0.0,1456,1390
1998-04-19,Zimbabwe,Namibia,5,2,3,1.0,0.0,1646,1519
1998-04-20,Iran,Hungary,0,2,2,0.0,1.0,1788,1710
1998-04-20,Jamaica,North Macedonia,1,2,1,0.0,1.0,1748,1586
1998-04-21,Latvia,Lithuania,1,2,1,0.0,1.0,1503,1578
1998-04-22,Austria,United States,0,3,3,0.0,1.0,1768,1802
1998-04-22,Belgium,Romania,1,1,0,0.5,0.5,1840,1848
1998-04-22,Bulgaria,Morocco,2,1,1,1.0,0.0,1793,1827
1998-04-22,Chile,Colombia,2,2,0,0.5,0.5,1815,1820
1998-04-22,Croatia,Poland,4,1,3,1.0,0.0,1754,1743
1998-04-22,Denmark,Norway,0,2,2,0.0,1.0,1900,1863
1998-04-22,England,Portugal,3,0,3,1.0,0.0,1970,1851
1998-04-22,Germany,Nigeria,1,0,1,1.0,0.0,2023,1775
1998-04-22,Hungary,North Macedonia,0,0,0,0.5,0.5,1708,1589
1998-04-22,Iran,Jamaica,1,0,1,1.0,0.0,1796,1741
1998-04-22,Republic of Ireland,Argentina,0,2,2,0.0,1.0,1777,1890
1998-04-22,Italy,Paraguay,3,1,2,1.0,0.0,1967,1808
1998-04-22,Northern Ireland,Switzerland,1,0,1,1.0,0.0,1712,1761
1998-04-22,Russia,Turkey,1,0,1,1.0,0.0,1886,1710
1998-04-22,Scotland,Finland,1,1,0,0.5,0.5,1804,1622
1998-04-22,Serbia,South Korea,3,1,2,1.0,0.0,1723,1840
1998-04-22,Slovenia,Czech Republic,1,3,2,0.0,1.0,1542,1761
1998-04-22,Sweden,France,0,0,0,0.5,0.5,1859,1977
1998-04-24,Azerbaijan,Uzbekistan,2,1,1,1.0,0.0,1481,1601
1998-04-29,Brazil,Argentina,0,1,1,0.0,1.0,2067,1902
1998-04-29,Chile,Lithuania,1,0,1,1.0,0.0,1819,1575
1998-05-02,Tunisia,Georgia,1,1,0,0.5,0.5,1772,1595
1998-05-03,Angola,Zambia,1,1,0,0.5,0.5,1642,1773
1998-05-04,Jamaica,Saudi Arabia,0,0,0,0.5,0.5,1743,1817
1998-05-04,Jersey,Guernsey,2,0,2,1.0,0.0,1743,1621
1998-05-06,Cayman Islands,Cuba,2,2,0,0.5,0.5,1451,1576
1998-05-08,Cuba,Bermuda,2,1,1,1.0,0.0,1583,1513
1998-05-09,Estonia,Mexico,0,6,6,0.0,1.0,1387,1859
1998-05-09,Saudi Arabia,Trinidad and Tobago,2,1,1,1.0,0.0,1822,1632
1998-05-10,Cayman Islands,Bermuda,2,0,2,1.0,0.0,1461,1504
1998-05-13,Iceland,Saudi Arabia,1,1,0,0.5,0.5,1620,1818
1998-05-14,Argentina,Bosnia and Herzegovina,5,0,5,1.0,0.0,1904,1551
1998-05-14,Corsica,Cameroon,0,1,1,0.0,1.0,1509,1723
1998-05-16,Estonia,Azerbaijan,0,0,0,0.5,0.5,1390,1479
1998-05-16,South Korea,Jamaica,2,1,1,1.0,0.0,1846,1738
1998-05-16,United States,North Macedonia,0,0,0,0.5,0.5,1798,1594
1998-05-16,Zambia,Mozambique,1,0,1,1.0,0.0,1777,1572
1998-05-17,Japan,Paraguay,1,1,0,0.5,0.5,1827,1809
1998-05-17,Latvia,Israel,1,5,4,0.0,1.0,1500,1713
1998-05-17,Saudi Arabia,Namibia,2,1,1,1.0,0.0,1821,1517
1998-05-18,Canada,North Macedonia,1,0,1,1.0,0.0,1684,1588
1998-05-19,Argentina,Chile,1,0,1,1.0,0.0,1911,1813
1998-05-19,Cameroon,Burkina Faso,2,0,2,1.0,0.0,1729,1623
1998-05-19,South Korea,Jamaica,0,0,0,0.5,0.5,1844,1741
1998-05-20,Norway,Mexico,5,2,3,1.0,0.0,1871,1852
1998-05-20,South Africa,Zambia,1,1,0,0.5,0.5,1735,1776
1998-05-21,Czech Republic,Paraguay,1,0,1,1.0,0.0,1771,1800
1998-05-21,Brittany,Cameroon,1,1,0,0.5,0.5,1520,1725
1998-05-23,England,Saudi Arabia,0,0,0,0.5,0.5,1967,1825
1998-05-23,Republic of Ireland,Mexico,0,0,0,0.5,0.5,1779,1851
1998-05-24,Chile,Uruguay,2,2,0,0.5,0.5,1813,1794
1998-05-24,Japan,Czech Republic,0,0,0,0.5,0.5,1826,1773
1998-05-24,Mozambique,Zimbabwe,0,2,2,0.0,1.0,1566,1653
1998-05-24,United States,Kuwait,2,0,2,1.0,0.0,1805,1741
1998-05-25,Argentina,South Africa,2,0,2,1.0,0.0,1916,1731
1998-05-27,Austria,Tunisia,2,1,1,1.0,0.0,1777,1764
1998-05-27,Belgium,France,0,1,1,0.0,1.0,1836,1982
1998-05-27,Finland,Germany,0,0,0,0.5,0.5,1629,2017
1998-05-27,Hungary,Lithuania,1,0,1,1.0,0.0,1714,1570
1998-05-27,South Korea,Czech Republic,2,2,0,0.5,0.5,1843,1775
1998-05-27,Morocco,England,0,1,1,0.0,1.0,1823,1972
1998-05-27,Netherlands,Cameroon,0,0,0,0.5,0.5,1923,1730
1998-05-27,Norway,Saudi Arabia,6,0,6,1.0,0.0,1878,1819
1998-05-27,Poland,Russia,3,1,2,1.0,0.0,1755,1875
1998-05-28,Saint Kitts and Nevis,Trinidad and Tobago,4,1,3,1.0,0.0,1535,1622
1998-05-28,Sweden,Denmark,3,0,3,1.0,0.0,1868,1892
1998-05-29,Belgium,England,0,0,0,0.5,0.5,1839,1970
1998-05-29,Morocco,France,2,2,0,0.5,0.5,1827,1979
1998-05-29,Serbia,Nigeria,3,0,3,1.0,0.0,1733,1766
1998-05-30,Georgia,Russia,1,1,0,0.5,0.5,1601,1870
1998-05-30,Germany,Colombia,3,1,2,1.0,0.0,2021,1817
1998-05-30,Namibia,Angola,1,1,0,0.5,0.5,1520,1640
1998-05-30,United States,Scotland,0,0,0,0.5,0.5,1805,1805
1998-05-31,Chile,Tunisia,3,2,1,1.0,0.0,1820,1758
1998-05-31,Japan,Mexico,1,2,1,0.0,1.0,1819,1859
1998-05-31,Luxembourg,Cameroon,0,2,2,0.0,1.0,1364,1732
1998-06-01,Netherlands,Paraguay,5,1,4,1.0,0.0,1929,1795
1998-06-02,Austria,Liechtenstein,6,0,6,1.0,0.0,1779,1434
1998-06-02,Sweden,Italy,1,0,1,1.0,0.0,1879,1957
1998-06-03,Andorra,Brazil,0,3,3,0.0,1.0,1472,2068
1998-06-03,Belgium,Colombia,2,0,2,1.0,0.0,1847,1810
1998-06-03,Croatia,Iran,2,0,2,1.0,0.0,1763,1788
1998-06-03,North Macedonia,Bosnia and Herzegovina,1,1,0,0.5,0.5,1588,1552
1998-06-03,Malta,Wales,0,3,3,0.0,1.0,1420,1703
1998-06-03,Romania,Paraguay,3,2,1,1.0,0.0,1855,1789
1998-06-03,Saudi Arabia,Mexico,0,0,0,0.5,0.5,1820,1859
1998-06-03,Serbia,Japan,1,0,1,1.0,0.0,1743,1810
1998-06-03,Spain,Northern Ireland,4,1,3,1.0,0.0,1945,1709
1998-06-04,Chile,Morocco,1,1,0,0.5,0.5,1821,1827
1998-06-04,Estonia,Faroe Islands,5,0,5,1.0,0.0,1400,1458
1998-06-04,South Korea,China PR,1,1,0,0.5,0.5,1842,1783
1998-06-05,Bulgaria,Algeria,2,0,2,1.0,0.0,1800,1722
1998-06-05,Denmark,Cameroon,1,2,1,0.0,1.0,1881,1744
1998-06-05,Finland,France,0,1,1,0.0,1.0,1628,1981
1998-06-05,Germany,Luxembourg,7,0,7,1.0,0.0,2022,1364
1998-06-05,Netherlands,Nigeria,5,1,4,1.0,0.0,1934,1762
1998-06-06,Belgium,Paraguay,1,0,1,1.0,0.0,1854,1783
1998-06-06,Croatia,Australia,7,0,7,1.0,0.0,1774,1847
1998-06-06,Iceland,South Africa,1,1,0,0.5,0.5,1623,1729
1998-06-06,Kenya,Seychelles,1,1,0,0.5,0.5,1673,1417
1998-06-06,Romania,Moldova,5,1,4,1.0,0.0,1857,1496
1998-06-06,Switzerland,Serbia,1,1,0,0.5,0.5,1761,1744
1998-06-06,Tunisia,Wales,4,0,4,1.0,0.0,1765,1697
1998-06-07,Belarus,Lithuania,5,0,5,1.0,0.0,1497,1561
1998-06-10,Brazil,Scotland,2,1,1,1.0,0.0,2071,1803
1998-06-10,Morocco,Norway,2,2,0,0.5,0.5,1829,1877
1998-06-11,Cameroon,Austria,1,1,0,0.5,0.5,1745,1779
1998-06-11,Italy,Chile,2,2,0,0.5,0.5,1955,1824
1998-06-12,France,South Africa,3,0,3,1.0,0.0,1985,1726
1998-06-12,Paraguay,Bulgaria,0,0,0,0.5,0.5,1784,1800
1998-06-12,Saudi Arabia,Denmark,0,1,1,0.0,1.0,1814,1888
1998-06-13,South Korea,Mexico,1,3,2,0.0,1.0,1835,1867
1998-06-13,Netherlands,Belgium,0,0,0,0.5,0.5,1933,1856
1998-06-13,Seychelles,Kenya,0,1,1,0.0,1.0,1415,1676
1998-06-13,Spain,Nigeria,2,3,1,0.0,1.0,1934,1774
1998-06-14,Argentina,Japan,1,0,1,1.0,0.0,1922,1805
1998-06-14,Jamaica,Croatia,1,3,2,0.0,1.0,1734,1782
1998-06-14,Serbia,Iran,1,0,1,1.0,0.0,1754,1779
1998-06-15,England,Tunisia,2,0,2,1.0,0.0,1974,1762
1998-06-15,Germany,United States,2,0,2,1.0,0.0,2026,1802
1998-06-15,Romania,Colombia,1,0,1,1.0,0.0,1864,1804
1998-06-16,Brazil,Morocco,3,0,3,1.0,0.0,2075,1826
1998-06-16,Scotland,Norway,1,1,0,0.5,0.5,1805,1876
1998-06-17,Chile,Austria,1,1,0,0.5,0.5,1823,1781
1998-06-17,Italy,Cameroon,3,0,3,1.0,0.0,1959,1742
1998-06-18,France,Saudi Arabia,4,0,4,1.0,0.0,1990,1810
1998-06-18,South Africa,Denmark,1,1,0,0.5,0.5,1730,1885
1998-06-19,Nigeria,Bulgaria,1,0,1,1.0,0.0,1783,1792
1998-06-19,Spain,Paraguay,0,0,0,0.5,0.5,1931,1788
1998-06-20,Belgium,Mexico,2,2,0,0.5,0.5,1857,1867
1998-06-20,Japan,Croatia,0,1,1,0.0,1.0,1797,1791
1998-06-20,Netherlands,South Korea,5,0,5,1.0,0.0,1939,1830
1998-06-21,Argentina,Jamaica,5,0,5,1.0,0.0,1927,1730
1998-06-21,Germany,Serbia,2,2,0,0.5,0.5,2021,1760
1998-06-21,United States,Iran,1,2,1,0.0,1.0,1794,1788
1998-06-22,Colombia,Tunisia,1,0,1,1.0,0.0,1812,1755
1998-06-22,Estonia,Andorra,2,1,1,1.0,0.0,1410,1463
1998-06-22,Romania,England,2,1,1,1.0,0.0,1875,1964
1998-06-23,Brazil,Norway,1,2,1,0.0,1.0,2063,1889
1998-06-23,Chile,Cameroon,1,1,0,0.5,0.5,1822,1744
1998-06-23,Italy,Austria,2,1,1,1.0,0.0,1964,1777
1998-06-23,Scotland,Morocco,0,3,3,0.0,1.0,1798,1834
1998-06-24,Andorra,Azerbaijan,0,0,0,0.5,0.5,1464,1479
1998-06-24,France,Denmark,2,1,1,1.0,0.0,1996,1880
1998-06-24,Nigeria,Paraguay,1,3,2,0.0,1.0,1776,1796
1998-06-24,South Africa,Saudi Arabia,2,2,0,0.5,0.5,1732,1809
1998-06-24,Spain,Bulgaria,6,1,5,1.0,0.0,1936,1788
1998-06-25,Belgium,South Korea,1,1,0,0.5,0.5,1857,1831
1998-06-25,Estonia,Latvia,0,2,2,0.0,1.0,1405,1506
1998-06-25,Germany,Iran,2,0,2,1.0,0.0,2025,1785
1998-06-25,Netherlands,Mexico,2,2,0,0.5,0.5,1938,1869
1998-06-25,United States,Serbia,0,1,1,0.0,1.0,1786,1769
1998-06-26,Argentina,Croatia,1,0,1,1.0,0.0,1933,1786
1998-06-26,Azerbaijan,Lithuania,2,1,1,1.0,0.0,1489,1552
1998-06-26,Colombia,England,0,2,2,0.0,1.0,1808,1969
1998-06-26,Japan,Jamaica,1,2,1,0.0,1.0,1788,1740
1998-06-26,Latvia,Andorra,2,0,2,1.0,0.0,1514,1457
1998-06-26,Romania,Tunisia,1,1,0,0.5,0.5,1873,1758
1998-06-27,Brazil,Chile,4,1,3,1.0,0.0,2067,1819
1998-06-27,Italy,Norway,1,0,1,1.0,0.0,1971,1883
1998-06-27,Thailand,China PR,0,3,3,0.0,1.0,1702,1790
1998-06-28,Estonia,Lithuania,0,0,0,0.5,0.5,1409,1549
1998-06-28,France,Paraguay,1,0,1,1.0,0.0,2000,1793
1998-06-28,Nigeria,Denmark,1,4,3,0.0,1.0,1771,1886
1998-06-29,Germany,Mexico,2,1,1,1.0,0.0,2030,1865
1998-06-29,Lithuania,Andorra,4,0,4,1.0,0.0,1555,1452
1998-06-29,Netherlands,Serbia,2,1,1,1.0,0.0,1943,1765
1998-06-30,Argentina,England,2,2,0,0.5,0.5,1934,1969
1998-06-30,Romania,Croatia,0,1,1,0.0,1.0,1864,1796
1998-07-02,Oman,Syria,1,2,1,0.0,1.0,1546,1610
1998-07-03,Brazil,Denmark,3,2,1,1.0,0.0,2072,1882
1998-07-03,France,Italy,0,0,0,0.5,0.5,2000,1972
1998-07-04,Germany,Croatia,0,3,3,0.0,1.0,2018,1809
1998-07-04,Netherlands,Argentina,2,1,1,1.0,0.0,1951,1927
1998-07-05,Rwanda,Tanzania,2,0,2,1.0,0.0,1489,1531
1998-07-06,Malawi,Mozambique,2,1,1,1.0,0.0,1629,1560
1998-07-06,Rwanda,Tanzania,2,2,0,0.5,0.5,1490,1531
1998-07-07,Brazil,Netherlands,1,1,0,0.5,0.5,2070,1954
1998-07-08,France,Croatia,2,1,1,1.0,0.0,2004,1806
1998-07-08,Malawi,Mozambique,2,2,0,0.5,0.5,1628,1562
1998-07-10,Uganda,Tanzania,3,0,3,1.0,0.0,1643,1526
1998-07-11,Malawi,Mozambique,0,0,0,0.5,0.5,1627,1564
1998-07-11,Netherlands,Croatia,1,2,1,0.0,1.0,1943,1818
1998-07-12,France,Brazil,3,0,3,1.0,0.0,2014,2061
1998-07-15,Ukraine,Poland,1,2,1,0.0,1.0,1612,1760
1998-07-18,Malawi,Zimbabwe,1,0,1,1.0,0.0,1636,1645
1998-07-18,Uganda,Kenya,3,3,0,0.5,0.5,1644,1676
1998-07-19,Mozambique,Angola,1,1,0,0.5,0.5,1566,1639
1998-07-20,Lebanon,Palestine,3,1,2,1.0,0.0,1593,1476
1998-07-20,Malawi,Zimbabwe,0,0,0,0.5,0.5,1637,1645
1998-07-20,Syria,Jordan,3,0,3,1.0,0.0,1617,1544
1998-07-22,Curaçao,Haiti,0,4,4,0.0,1.0,1547,1592
1998-07-22,Jamaica,Cayman Islands,4,0,4,1.0,0.0,1743,1459
1998-07-22,Martinique,Dominica,5,1,4,1.0,0.0,1679,1492
1998-07-22,Senegal,Cape Verde,1,0,1,1.0,0.0,1624,1486
1998-07-22,Trinidad and Tobago,Antigua and Barbuda,3,2,1,1.0,0.0,1627,1481
1998-07-23,Lebanon,Jordan,0,2,2,0.0,1.0,1584,1554
1998-07-23,Palestine,Syria,1,2,1,0.0,1.0,1472,1622
1998-07-24,Antigua and Barbuda,Dominica,2,1,1,1.0,0.0,1490,1484
1998-07-24,Burkina Faso,Niger,1,0,1,1.0,0.0,1629,1528
1998-07-24,Cayman Islands,Haiti,0,1,1,0.0,1.0,1454,1598
1998-07-24,Jamaica,Curaçao,3,2,1,1.0,0.0,1747,1544
1998-07-24,Trinidad and Tobago,Martinique,2,1,1,1.0,0.0,1637,1670
1998-07-25,Benin,Ghana,0,1,1,0.0,1.0,1439,1673
1998-07-26,Antigua and Barbuda,Martinique,5,1,4,1.0,0.0,1502,1659
1998-07-26,Curaçao,Cayman Islands,0,2,2,0.0,1.0,1534,1465
1998-07-26,Jamaica,Haiti,2,1,1,1.0,0.0,1752,1594
1998-07-26,Jordan,Palestine,1,1,0,0.5,0.5,1553,1474
1998-07-26,Lebanon,Syria,0,1,1,0.0,1.0,1577,1630
1998-07-26,Niger,Ivory Coast,1,0,1,1.0,0.0,1541,1769
1998-07-26,Senegal,Mali,3,1,2,1.0,0.0,1632,1613
1998-07-26,Trinidad and Tobago,Dominica,8,0,8,1.0,0.0,1642,1480
1998-07-29,Jamaica,Antigua and Barbuda,1,0,1,1.0,0.0,1756,1499
1998-07-29,Trinidad and Tobago,Haiti,4,1,3,1.0,0.0,1649,1588
1998-07-30,Guam,Northern Mariana Islands,2,1,1,1.0,0.0,1424,1491
1998-07-31,Antigua and Barbuda,Haiti,2,3,1,0.0,1.0,1494,1594
1998-07-31,Kenya,Djibouti,3,0,3,1.0,0.0,1679,1411
1998-07-31,Libya,Algeria,0,2,2,0.0,1.0,1616,1728
1998-07-31,Trinidad and Tobago,Jamaica,1,2,1,0.0,1.0,1644,1762
1998-08-01,Namibia,Malawi,2,1,1,1.0,0.0,1531,1627
1998-08-01,Palau,Guam,2,15,13,0.0,1.0,1482,1434
1998-08-01,Uganda,Rwanda,5,0,5,1.0,0.0,1649,1486
1998-08-02,Benin,Angola,2,1,1,1.0,0.0,1452,1627
1998-08-02,Botswana,Mozambique,0,0,0,0.5,0.5,1415,1563
1998-08-02,Burundi,Tanzania,1,0,1,1.0,0.0,1557,1519
1998-08-02,Chad,Congo,1,1,0,0.5,0.5,1485,1599
1998-08-02,Equatorial Guinea,Gabon,0,2,2,0.0,1.0,1460,1658
1998-08-02,Lesotho,Mauritius,1,1,0,0.5,0.5,1454,1491
1998-08-02,Mali,Cape Verde,3,0,3,1.0,0.0,1619,1481
1998-08-02,Niger,Liberia,2,1,1,1.0,0.0,1550,1548
1998-08-02,São Tomé and Príncipe,Togo,0,4,4,0.0,1.0,1467,1589
1998-08-02,Eswatini,Madagascar,1,2,1,0.0,1.0,1450,1654
1998-08-03,Guam,Northern Mariana Islands,0,3,3,0.0,1.0,1428,1498
1998-08-07,Réunion,Mauritius,4,0,4,1.0,0.0,1536,1484
1998-08-07,Madagascar,Comoros,3,0,3,1.0,0.0,1658,1455
1998-08-08,Zambia,Namibia,1,1,0,0.5,0.5,1772,1536
1998-08-09,Benin,Niger,1,1,0,0.5,0.5,1455,1548
1998-08-09,Seychelles,Comoros,3,0,3,1.0,0.0,1424,1447
1998-08-11,Réunion,Mauritius,1,0,1,1.0,0.0,1543,1478
1998-08-11,Madagascar,Seychelles,5,2,3,1.0,0.0,1662,1421
1998-08-12,Azerbaijan,Georgia,1,0,1,1.0,0.0,1500,1591
1998-08-13,Madagascar,Mauritius,2,0,2,1.0,0.0,1667,1474
1998-08-13,Réunion,Seychelles,2,0,2,1.0,0.0,1549,1416
1998-08-14,Algeria,Libya,3,0,3,1.0,0.0,1734,1611
1998-08-15,Kenya,Djibouti,9,1,8,1.0,0.0,1682,1409
1998-08-15,Malawi,Namibia,0,1,1,0.0,1.0,1617,1547
1998-08-15,Mozambique,Botswana,2,1,1,1.0,0.0,1568,1411
1998-08-15,Tanzania,Burundi,0,1,1,0.0,1.0,1512,1565
1998-08-15,Thailand,Uzbekistan,4,1,3,1.0,0.0,1708,1596
1998-08-15,Mauritius,Seychelles,3,4,1,0.0,1.0,1465,1426
1998-08-15,Réunion,Madagascar,3,3,0,0.5,0.5,1552,1665
1998-08-16,Angola,Benin,2,0,2,1.0,0.0,1632,1451
1998-08-16,Cape Verde,Mali,0,0,0,0.5,0.5,1485,1616
1998-08-16,Congo,Chad,0,0,0,0.5,0.5,1597,1488
1998-08-16,Gabon,Equatorial Guinea,3,0,3,1.0,0.0,1662,1457
1998-08-16,Liberia,Niger,2,0,2,1.0,0.0,1556,1540
1998-08-16,Lithuania,Moldova,1,1,0,0.5,0.5,1554,1498
1998-08-16,Rwanda,Uganda,0,0,0,0.5,0.5,1490,1646
1998-08-18,Armenia,Lebanon,1,0,1,1.0,0.0,1518,1568
1998-08-18,Poland,Israel,2,0,2,1.0,0.0,1767,1707
1998-08-18,Togo,São Tomé and Príncipe,2,0,2,1.0,0.0,1595,1462
1998-08-19,Austria,France,2,2,0,0.5,0.5,1782,2010
1998-08-19,Bosnia and Herzegovina,Faroe Islands,1,0,1,1.0,0.0,1558,1453
1998-08-19,Cyprus,Albania,3,2,1,1.0,0.0,1537,1490
1998-08-19,Czech Republic,Denmark,1,0,1,1.0,0.0,1786,1872
1998-08-19,Hungary,Slovenia,2,1,1,1.0,0.0,1719,1538
1998-08-19,Iceland,Latvia,4,1,3,1.0,0.0,1629,1509
1998-08-19,Lithuania,Belarus,0,3,3,0.0,1.0,1545,1507
1998-08-19,Norway,Romania,0,0,0,0.5,0.5,1883,1865
1998-08-19,Portugal,Mozambique,2,1,1,1.0,0.0,1854,1566
1998-08-19,Slovakia,Finland,0,0,0,0.5,0.5,1649,1629
1998-08-19,Sweden,Russia,1,0,1,1.0,0.0,1887,1863
1998-08-19,Ukraine,Georgia,4,0,4,1.0,0.0,1620,1584
1998-08-20,Estonia,Moldova,0,1,1,0.0,1.0,1404,1504
1998-08-23,Burkina Faso,Togo,1,1,0,0.5,0.5,1629,1596
1998-08-23,Mauritius,Lesotho,3,1,2,1.0,0.0,1473,1447
1998-08-23,Madagascar,Eswatini,1,1,0,0.5,0.5,1661,1455
1998-08-26,Malaysia,Singapore,0,2,2,0.0,1.0,1575,1597
1998-08-26,Vietnam,Laos,4,1,3,1.0,0.0,1501,1407
1998-08-27,Indonesia,Philippines,3,0,3,1.0,0.0,1569,1272
1998-08-27,Thailand,Myanmar,1,1,0,0.5,0.5,1705,1554
1998-08-28,Malaysia,Laos,0,0,0,0.5,0.5,1572,1411
1998-08-28,Vietnam,Singapore,0,0,0,0.5,0.5,1504,1595
1998-08-29,Indonesia,Myanmar,6,2,4,1.0,0.0,1577,1547
1998-08-29,Thailand,Philippines,3,1,2,1.0,0.0,1707,1271
1998-08-30,Angola,Zimbabwe,2,1,1,1.0,0.0,1641,1637
1998-08-30,Burkina Faso,Ivory Coast,1,1,0,0.5,0.5,1633,1766
1998-08-30,Singapore,Laos,4,1,3,1.0,0.0,1600,1407
1998-08-30,Vietnam,Malaysia,1,0,1,1.0,0.0,1514,1563
1998-08-31,Burkina Faso,Senegal,1,1,0,0.5,0.5,1633,1633
1998-08-31,Myanmar,Philippines,5,2,3,1.0,0.0,1550,1269
1998-08-31,Thailand,Indonesia,3,2,1,1.0,0.0,1713,1572
1998-09-02,Cook Islands,Samoa,2,1,1,1.0,0.0,1468,1471
1998-09-02,Malta,Germany,1,2,1,0.0,1.0,1420,2019
1998-09-02,Morocco,Senegal,2,0,2,1.0,0.0,1838,1630
1998-09-02,Romania,Liechtenstein,7,0,7,1.0,0.0,1867,1433
1998-09-02,Serbia,Switzerland,1,1,0,0.5,0.5,1765,1762
1998-09-02,Singapore,Indonesia,2,1,1,1.0,0.0,1608,1565
1998-09-02,Tonga,American Samoa,3,0,3,1.0,0.0,1490,1441
1998-09-03,Cook Islands,American Samoa,4,3,1,1.0,0.0,1476,1434
1998-09-03,Tahiti,Tonga,5,0,5,1.0,0.0,1747,1487
1998-09-03,Vietnam,Thailand,3,0,3,1.0,0.0,1527,1701
1998-09-05,Armenia,Andorra,3,1,2,1.0,0.0,1525,1446
1998-09-05,Austria,Israel,1,1,0,0.5,0.5,1781,1709
1998-09-05,Belarus,Denmark,0,0,0,0.5,0.5,1514,1866
1998-09-05,Bosnia and Herzegovina,Estonia,1,1,0,0.5,0.5,1555,1408
1998-09-05,Cook Islands,Tonga,2,2,0,0.5,0.5,1477,1487
1998-09-05,Cyprus,Spain,3,2,1,1.0,0.0,1552,1922
1998-09-05,Fiji,New Caledonia,3,0,3,1.0,0.0,1648,1584
1998-09-05,Finland,Moldova,3,2,1,1.0,0.0,1635,1499
1998-09-05,Georgia,Albania,1,0,1,1.0,0.0,1590,1485
1998-09-05,Germany,Romania,1,1,0,0.5,0.5,2016,1871
1998-09-05,Iceland,France,1,1,0,0.5,0.5,1636,2004
1998-09-05,Indonesia,Thailand,3,3,0,0.5,0.5,1568,1699
1998-09-05,Republic of Ireland,Croatia,2,0,2,1.0,0.0,1788,1810
1998-09-05,Lithuania,Scotland,0,0,0,0.5,0.5,1550,1794
1998-09-05,Slovakia,Azerbaijan,3,0,3,1.0,0.0,1654,1496
1998-09-05,Solomon Islands,Papua New Guinea,3,1,2,1.0,0.0,1600,1496
1998-09-05,Sweden,England,2,1,1,1.0,0.0,1897,1960
1998-09-05,Tahiti,Samoa,5,1,4,1.0,0.0,1750,1469
1998-09-05,Turkey,Northern Ireland,3,0,3,1.0,0.0,1718,1702
1998-09-05,Ukraine,Russia,3,2,1,1.0,0.0,1633,1851
1998-09-05,Vietnam,Singapore,0,1,1,0.0,1.0,1521,1615
1998-09-05,Wales,Italy,0,2,2,0.0,1.0,1695,1975
1998-09-06,Bulgaria,Poland,0,3,3,0.0,1.0,1780,1776
1998-09-06,Faroe Islands,Czech Republic,0,1,1,0.0,1.0,1451,1789
1998-09-06,Greece,Slovenia,2,2,0,0.5,0.5,1732,1543
1998-09-06,Hungary,Portugal,1,3,2,0.0,1.0,1714,1860
1998-09-06,North Macedonia,Malta,4,0,4,1.0,0.0,1593,1416
1998-09-06,Norway,Latvia,1,3,2,0.0,1.0,1869,1524
1998-09-06,Eswatini,Ghana,0,1,1,0.0,1.0,1452,1677
1998-09-06,Togo,Benin,0,1,1,0.0,1.0,1585,1463
1998-09-07,Papua New Guinea,New Caledonia,1,0,1,1.0,0.0,1506,1575
1998-09-07,Samoa,Tonga,2,0,2,1.0,0.0,1478,1479
1998-09-07,Tahiti,American Samoa,12,0,12,1.0,0.0,1753,1432
1998-09-07,Vanuatu,Fiji,1,2,1,0.0,1.0,1435,1652
1998-09-08,Cook Islands,Tahiti,0,5,5,0.0,1.0,1475,1756
1998-09-08,Samoa,American Samoa,4,0,4,1.0,0.0,1485,1426
1998-09-08,Solomon Islands,New Caledonia,3,2,1,1.0,0.0,1608,1568
1998-09-08,Vanuatu,Papua New Guinea,1,1,0,0.5,0.5,1437,1505
1998-09-09,Kuwait,Lebanon,0,0,0,0.5,0.5,1738,1572
1998-09-10,Fiji,Papua New Guinea,2,0,2,1.0,0.0,1657,1501
1998-09-10,Vanuatu,Solomon Islands,3,1,2,1.0,0.0,1449,1597
1998-09-11,Saudi Arabia,Tanzania,8,0,8,1.0,0.0,1812,1510
1998-09-12,Fiji,Solomon Islands,1,1,0,0.5,0.5,1656,1599
1998-09-12,Namibia,Mozambique,2,1,1,1.0,0.0,1556,1558
1998-09-12,Syria,Oman,3,0,3,1.0,0.0,1637,1540
1998-09-12,Vanuatu,New Caledonia,3,2,1,1.0,0.0,1460,1558
1998-09-13,Bahrain,Libya,2,2,0,0.5,0.5,1572,1611
1998-09-13,Kuwait,North Korea,4,0,4,1.0,0.0,1746,1722
1998-09-14,Saudi Arabia,Sudan,2,1,1,1.0,0.0,1816,1598
1998-09-15,Syria,Oman,0,0,0,0.5,0.5,1635,1543
1998-09-16,Egypt,Ivory Coast,0,0,0,0.5,0.5,1779,1767
1998-09-16,Qatar,Sudan,1,1,0,0.5,0.5,1691,1601
1998-09-16,United Arab Emirates,Libya,5,1,4,1.0,0.0,1757,1607
1998-09-17,Saudi Arabia,Senegal,3,2,1,1.0,0.0,1821,1626
1998-09-18,Bahrain,Syria,2,0,2,1.0,0.0,1582,1626
1998-09-19,Solomon Islands,Papua New Guinea,2,1,1,1.0,0.0,1605,1496
1998-09-20,Togo,Mali,0,1,1,0.0,1.0,1578,1624
1998-09-22,Oman,Zambia,2,0,2,1.0,0.0,1556,1760
1998-09-22,Qatar,Libya,2,1,1,1.0,0.0,1698,1601
1998-09-23,Brazil,Serbia,1,1,0,0.5,0.5,2056,1771
1998-09-23,Estonia,Egypt,2,2,0,0.5,0.5,1415,1773
1998-09-23,Spain,Russia,1,0,1,1.0,0.0,1929,1845
1998-09-24,Libya,Jordan,1,2,1,0.0,1.0,1592,1563
1998-09-24,Oman,Zambia,1,1,0,0.5,0.5,1561,1756
1998-09-25,Australia,Fiji,3,1,2,1.0,0.0,1851,1653
1998-09-25,New Zealand,Tahiti,1,0,1,1.0,0.0,1659,1746
1998-09-26,Kuwait,Syria,4,0,4,1.0,0.0,1752,1621
1998-09-26,Qatar,Jordan,2,0,2,1.0,0.0,1704,1558
1998-09-27,Mali,Burkina Faso,1,0,1,1.0,0.0,1633,1625
1998-09-27,Saudi Arabia,Lebanon,4,1,3,1.0,0.0,1825,1569
1998-09-27,United Arab Emirates,Sudan,4,1,3,1.0,0.0,1762,1597
1998-09-27,Zimbabwe,Zambia,0,1,1,0.0,1.0,1632,1762
1998-09-28,Australia,Cook Islands,16,0,16,1.0,0.0,1853,1474
1998-09-28,New Zealand,Vanuatu,8,1,7,1.0,0.0,1663,1457
1998-09-29,North Macedonia,Egypt,2,2,0,0.5,0.5,1597,1770
1998-09-29,Qatar,United Arab Emirates,2,1,1,1.0,0.0,1714,1753
1998-09-29,Saudi Arabia,Kuwait,2,1,1,1.0,0.0,1832,1746
1998-09-30,Fiji,Cook Islands,3,0,3,1.0,0.0,1658,1470
1998-09-30,Tahiti,Vanuatu,5,1,4,1.0,0.0,1749,1455
1998-10-01,Kuwait,United Arab Emirates,4,1,3,1.0,0.0,1755,1745
1998-10-01,Qatar,Saudi Arabia,1,3,2,0.0,1.0,1709,1838
1998-10-02,Australia,Tahiti,4,1,3,1.0,0.0,1859,1744
1998-10-02,New Zealand,Fiji,1,0,1,1.0,0.0,1671,1651
1998-10-03,Bahrain,Sudan,2,3,1,0.0,1.0,1575,1605
1998-10-03,Kenya,Madagascar,1,1,0,0.5,0.5,1682,1662
1998-10-03,Namibia,Congo,0,1,1,0.0,1.0,1549,1605
1998-10-03,South Africa,Angola,1,0,1,1.0,0.0,1738,1636
1998-10-04,Australia,New Zealand,0,1,1,0.0,1.0,1848,1683
1998-10-04,Gabon,Mauritius,2,0,2,1.0,0.0,1667,1469
1998-10-04,Mali,Ivory Coast,0,1,1,0.0,1.0,1628,1773
1998-10-04,Mozambique,Eritrea,3,1,2,1.0,0.0,1565,1497
1998-10-04,Tahiti,Fiji,2,4,2,0.0,1.0,1734,1662
1998-10-04,Togo,Guinea,2,0,2,1.0,0.0,1588,1618
1998-10-04,Tunisia,Liberia,2,1,1,1.0,0.0,1762,1553
1998-10-04,Zambia,DR Congo,1,1,0,0.5,0.5,1760,1651
1998-10-10,Andorra,Ukraine,0,2,2,0.0,1.0,1442,1638
1998-10-10,Armenia,Iceland,0,0,0,0.5,0.5,1528,1634
1998-10-10,Azerbaijan,Hungary,0,4,4,0.0,1.0,1493,1718
1998-10-10,Bosnia and Herzegovina,Czech Republic,1,3,2,0.0,1.0,1552,1793
1998-10-10,Cyprus,Austria,0,3,3,0.0,1.0,1549,1785
1998-10-10,Denmark,Wales,1,2,1,0.0,1.0,1855,1707
1998-10-10,England,Bulgaria,0,0,0,0.5,0.5,1957,1784
1998-10-10,Italy,Switzerland,2,0,2,1.0,0.0,1979,1759
1998-10-10,Latvia,Georgia,1,0,1,1.0,0.0,1534,1581
1998-10-10,Liechtenstein,Slovakia,0,4,4,0.0,1.0,1430,1658
1998-10-10,Lithuania,Faroe Islands,0,0,0,0.5,0.5,1548,1454
1998-10-10,Malta,Croatia,1,4,3,0.0,1.0,1415,1812
1998-10-10,Netherlands,Peru,2,0,2,1.0,0.0,1947,1732
1998-10-10,Northern Ireland,Finland,1,0,1,1.0,0.0,1709,1629
1998-10-10,Poland,Luxembourg,3,0,3,1.0,0.0,1778,1363
1998-10-10,Portugal,Romania,0,1,1,0.0,1.0,1853,1879
1998-10-10,Russia,France,2,3,1,0.0,1.0,1841,2009
1998-10-10,San Marino,Israel,0,5,5,0.0,1.0,1426,1712
1998-10-10,Scotland,Estonia,3,2,1,1.0,0.0,1796,1414
1998-10-10,Slovenia,Norway,1,2,1,0.0,1.0,1541,1872
1998-10-10,Turkey,Germany,1,0,1,1.0,0.0,1732,2003
1998-10-13,Kuwait,Iran,3,0,3,1.0,0.0,1764,1777
1998-10-13,Netherlands,Ghana,0,0,0,0.5,0.5,1942,1683
1998-10-14,Brazil,Ecuador,5,1,4,1.0,0.0,2059,1760
1998-10-14,Bulgaria,Sweden,0,1,1,0.0,1.0,1779,1903
1998-10-14,Croatia,North Macedonia,3,2,1,1.0,0.0,1816,1594
1998-10-14,Czech Republic,Estonia,4,1,3,1.0,0.0,1795,1413
1998-10-14,France,Andorra,2,0,2,1.0,0.0,2010,1442
1998-10-14,Greece,Georgia,3,0,3,1.0,0.0,1737,1577
1998-10-14,Hungary,Romania,1,1,0,0.5,0.5,1722,1876
1998-10-14,Iceland,Russia,1,0,1,1.0,0.0,1647,1829
1998-10-14,Republic of Ireland,Malta,5,0,5,1.0,0.0,1790,1414
1998-10-14,Israel,Spain,1,2,1,0.0,1.0,1709,1933
1998-10-14,Liechtenstein,Azerbaijan,2,1,1,1.0,0.0,1440,1484
1998-10-14,Lithuania,Bosnia and Herzegovina,4,2,2,1.0,0.0,1557,1544
1998-10-14,Luxembourg,England,0,3,3,0.0,1.0,1363,1958
1998-10-14,Moldova,Germany,1,3,2,0.0,1.0,1499,2004
1998-10-14,Norway,Albania,2,2,0,0.5,0.5,1866,1492
1998-10-14,San Marino,Austria,1,4,3,0.0,1.0,1425,1787
1998-10-14,Scotland,Faroe Islands,2,1,1,1.0,0.0,1798,1453
1998-10-14,Slovakia,Portugal,0,3,3,0.0,1.0,1655,1857
1998-10-14,Slovenia,Latvia,1,0,1,1.0,0.0,1549,1527
1998-10-14,Switzerland,Denmark,1,1,0,0.5,0.5,1762,1853
1998-10-14,Turkey,Finland,1,3,2,0.0,1.0,1722,1640
1998-10-14,Ukraine,Armenia,2,0,2,1.0,0.0,1644,1523
1998-10-14,Wales,Belarus,3,2,1,1.0,0.0,1711,1511
1998-10-17,Lebanon,Syria,3,3,0,0.5,0.5,1571,1620
1998-10-17,Qatar,Burkina Faso,2,2,0,0.5,0.5,1708,1627
1998-10-17,United Arab Emirates,Sudan,2,1,1,1.0,0.0,1750,1601
1998-10-19,Lebanon,Sudan,1,1,0,0.5,0.5,1572,1601
1998-10-19,Oman,Burkina Faso,4,2,2,1.0,0.0,1571,1618
1998-10-19,United Arab Emirates,Syria,1,0,1,1.0,0.0,1756,1615
1998-10-21,Oman,Burkina Faso,0,0,0,0.5,0.5,1573,1617
1998-10-21,Sudan,Syria,2,3,1,0.0,1.0,1594,1623
1998-10-21,United Arab Emirates,Lebanon,1,0,1,1.0,0.0,1761,1568
1998-10-23,Bahrain,Burkina Faso,2,1,1,1.0,0.0,1584,1609
1998-10-28,Japan,Egypt,1,0,1,1.0,0.0,1796,1763
1998-10-30,Bahrain,United Arab Emirates,0,1,1,0.0,1.0,1580,1766
1998-10-31,Kuwait,Saudi Arabia,1,2,1,0.0,1.0,1758,1845
1998-10-31,Oman,Qatar,2,1,1,1.0,0.0,1584,1698
1998-11-02,Bahrain,Saudi Arabia,1,1,0,0.5,0.5,1586,1840
1998-11-02,Kuwait,Qatar,6,2,4,1.0,0.0,1765,1692
1998-11-03,United Arab Emirates,Oman,3,2,1,1.0,0.0,1771,1580
1998-11-04,Bulgaria,Algeria,0,0,0,0.5,0.5,1778,1736
1998-11-05,Oman,Saudi Arabia,0,1,1,0.0,1.0,1578,1843
1998-11-05,Qatar,United Arab Emirates,0,0,0,0.5,0.5,1694,1770
1998-11-06,Bahrain,Kuwait,0,2,2,0.0,1.0,1582,1770
1998-11-06,United States,Australia,0,0,0,0.5,0.5,1788,1847
1998-11-07,Tunisia,Zimbabwe,1,1,0,0.5,0.5,1760,1635
1998-11-08,Bahrain,Qatar,0,0,0,0.5,0.5,1585,1692
1998-11-08,Saudi Arabia,United Arab Emirates,1,0,1,1.0,0.0,1850,1764
1998-11-09,Oman,Kuwait,0,5,5,0.0,1.0,1575,1774
1998-11-10,Slovakia,Poland,1,3,2,0.0,1.0,1650,1784
1998-11-10,Tunisia,Latvia,3,0,3,1.0,0.0,1764,1524
1998-11-11,Qatar,Saudi Arabia,0,0,0,0.5,0.5,1696,1847
1998-11-12,Bahrain,Oman,2,2,0,0.5,0.5,1585,1576
1998-11-12,United Arab Emirates,Kuwait,1,4,3,0.0,1.0,1757,1782
1998-11-15,Sri Lanka,Maldives,2,2,0,0.5,0.5,1388,1390
1998-11-16,India,Uzbekistan,0,0,0,0.5,0.5,1524,1595
1998-11-17,El Salvador,Mexico,0,2,2,0.0,1.0,1634,1869
1998-11-17,Guatemala,Honduras,3,3,0,0.5,0.5,1672,1692
1998-11-18,Albania,Greece,0,0,0,0.5,0.5,1497,1733
1998-11-18,Brazil,Russia,5,1,4,1.0,0.0,2063,1826
1998-11-18,Egypt,Norway,1,1,0,0.5,0.5,1766,1864
1998-11-18,El Salvador,Honduras,1,2,1,0.0,1.0,1628,1699
1998-11-18,England,Czech Republic,2,0,2,1.0,0.0,1963,1791
1998-11-18,Georgia,Estonia,3,1,2,1.0,0.0,1582,1409
1998-11-18,Germany,Netherlands,1,1,0,0.5,0.5,2003,1944
1998-11-18,Guatemala,Mexico,2,2,0,0.5,0.5,1677,1865
1998-11-18,Hungary,Switzerland,2,0,2,1.0,0.0,1731,1754
1998-11-18,Italy,Spain,2,2,0,0.5,0.5,1978,1935
1998-11-18,Luxembourg,Belgium,0,0,0,0.5,0.5,1371,1850
1998-11-18,Malta,North Macedonia,1,2,1,0.0,1.0,1410,1599
1998-11-18,Northern Ireland,Moldova,2,2,0,0.5,0.5,1705,1504
1998-11-18,Portugal,Israel,2,0,2,1.0,0.0,1862,1705
1998-11-18,San Marino,Cyprus,0,1,1,0.0,1.0,1420,1555
1998-11-18,Serbia,Republic of Ireland,1,0,1,1.0,0.0,1780,1782
1998-11-19,Hong Kong,Vietnam,1,1,0,0.5,0.5,1545,1522
1998-11-19,India,Uzbekistan,0,4,4,0.0,1.0,1518,1602
1998-11-21,Armenia,Estonia,2,1,1,1.0,0.0,1529,1404
1998-11-21,Thailand,Turkmenistan,3,3,0,0.5,0.5,1696,1532
1998-11-21,Guernsey,Kernow,1,6,5,0.0,1.0,1611,1505
1998-11-22,China PR,South Korea,0,0,0,0.5,0.5,1791,1831
1998-11-25,Singapore,United Arab Emirates,0,4,4,0.0,1.0,1611,1762
1998-11-27,Thailand,Nepal,2,0,2,1.0,0.0,1698,1348
1998-11-28,Azerbaijan,Estonia,2,1,1,1.0,0.0,1491,1398
1998-11-30,Turkmenistan,Vietnam,2,0,2,1.0,0.0,1540,1515
1998-11-30,China PR,Lebanon,4,1,3,1.0,0.0,1795,1565
1998-11-30,Hong Kong,Oman,0,6,6,0.0,1.0,1538,1584
1998-12-01,Nepal,Japan,0,5,5,0.0,1.0,1347,1798
1998-12-01,Tajikistan,Maldives,3,0,3,1.0,0.0,1528,1385
1998-12-01,Mongolia,Kuwait,0,11,11,0.0,1.0,1472,1785
1998-12-01,Kazakhstan,Iran,0,2,2,0.0,1.0,1585,1782
1998-12-02,South Korea,Turkmenistan,2,3,1,0.0,1.0,1818,1554
1998-12-02,Cambodia,China PR,1,4,3,0.0,1.0,1424,1797
1998-12-02,United Arab Emirates,North Korea,3,3,0,0.5,0.5,1762,1723
1998-12-02,Thailand,Hong Kong,5,0,5,1.0,0.0,1703,1534
1998-12-03,Mali,Ghana,0,2,2,0.0,1.0,1622,1690
1998-12-03,Japan,India,1,0,1,1.0,0.0,1801,1516
1998-12-03,Qatar,Tajikistan,2,1,1,1.0,0.0,1701,1524
1998-12-03,Uzbekistan,Kuwait,3,3,0,0.5,0.5,1606,1782
1998-12-03,Laos,Kazakhstan,0,5,5,0.0,1.0,1403,1590
1998-12-04,Vietnam,South Korea,0,4,4,0.0,1.0,1513,1821
1998-12-04,Lebanon,Cambodia,5,1,4,1.0,0.0,1570,1420
1998-12-04,Thailand,Oman,2,0,2,1.0,0.0,1709,1579
1998-12-05,India,Nepal,1,0,1,1.0,0.0,1521,1343
1998-12-05,Maldives,Qatar,0,4,4,0.0,1.0,1383,1704
1998-12-05,Mongolia,Uzbekistan,0,15,15,0.0,1.0,1467,1612
1998-12-05,Iran,Laos,6,1,5,1.0,0.0,1784,1402
1998-12-06,British Virgin Islands,Saint Vincent and the Grenadines,0,5,5,0.0,1.0,1412,1531
1998-12-07,Turkmenistan,India,3,2,1,1.0,0.0,1562,1514
1998-12-07,North Korea,Uzbekistan,0,4,4,0.0,1.0,1713,1623
1998-12-07,Japan,South Korea,0,2,2,0.0,1.0,1794,1829
1998-12-07,United Arab Emirates,Kuwait,0,5,5,0.0,1.0,1755,1790
1998-12-08,China PR,Tajikistan,3,1,2,1.0,0.0,1800,1522
1998-12-08,Iran,Oman,2,4,2,0.0,1.0,1772,1592
1998-12-08,Qatar,Lebanon,1,0,1,1.0,0.0,1710,1565
1998-12-08,Thailand,Kazakhstan,1,1,0,0.5,0.5,1707,1593
1998-12-09,North Korea,Turkmenistan,1,1,0,0.5,0.5,1710,1566
1998-12-09,India,Uzbekistan,0,2,2,0.0,1.0,1509,1629
1998-12-09,United Arab Emirates,South Korea,1,2,1,0.0,1.0,1749,1836
1998-12-09,Japan,Kuwait,2,1,1,1.0,0.0,1802,1783
1998-12-10,Tajikistan,Iran,0,5,5,0.0,1.0,1519,1776
1998-12-10,Oman,China PR,1,6,5,0.0,1.0,1589,1804
1998-12-10,Qatar,Kazakhstan,0,2,2,0.0,1.0,1700,1604
1998-12-10,Thailand,Lebanon,1,0,1,1.0,0.0,1712,1561
1998-12-11,India,North Korea,0,2,2,0.0,1.0,1506,1714
1998-12-11,Uzbekistan,Turkmenistan,1,1,0,0.5,0.5,1628,1568
1998-12-11,Japan,United Arab Emirates,0,1,1,0.0,1.0,1793,1759
1998-12-11,South Korea,Kuwait,1,0,1,1.0,0.0,1843,1777
1998-12-12,Iran,China PR,2,1,1,1.0,0.0,1785,1796
1998-12-12,Tajikistan,Oman,3,3,0,0.5,0.5,1521,1588
1998-12-12,Kazakhstan,Lebanon,0,3,3,0.0,1.0,1596,1570
1998-12-12,Thailand,Qatar,1,2,1,0.0,1.0,1704,1709
1998-12-13,Burundi,Senegal,1,0,1,1.0,0.0,1575,1617
1998-12-14,Uzbekistan,Iran,0,4,4,0.0,1.0,1624,1790
1998-12-14,Thailand,South Korea,2,1,1,1.0,0.0,1716,1832
1998-12-14,Turkmenistan,China PR,0,3,3,0.0,1.0,1565,1800
1998-12-14,Qatar,Kuwait,0,0,0,0.5,0.5,1711,1776
1998-12-16,South Africa,Egypt,2,1,1,1.0,0.0,1747,1758
1998-12-16,Iran,China PR,1,0,1,1.0,0.0,1799,1792
1998-12-16,Thailand,Kuwait,0,3,3,0.0,1.0,1710,1783
1998-12-19,Thailand,China PR,0,3,3,0.0,1.0,1704,1799
1998-12-19,Iran,Kuwait,2,0,2,1.0,0.0,1807,1776
1998-12-22,Basque Country,Uruguay,5,1,4,1.0,0.0,1665,1783
1998-12-22,Catalonia,Nigeria,5,0,5,1.0,0.0,1527,1758
1998-12-22,Canary Islands,Latvia,4,0,4,1.0,0.0,1517,1516
1998-12-23,Israel,Serbia,2,0,2,1.0,0.0,1715,1771
1998-12-27,Kuwait,Egypt,1,1,0,0.5,0.5,1776,1759
1999-01-03,Ivory Coast,Togo,3,1,2,1.0,0.0,1778,1584
1999-01-04,Burkina Faso,Gabon,2,1,1,1.0,0.0,1619,1658
1999-01-10,Burkina Faso,Mali,1,0,1,1.0,0.0,1628,1614
1999-01-10,Senegal,Guinea,1,0,1,1.0,0.0,1626,1610
1999-01-12,Bermuda,Antigua and Barbuda,1,0,1,1.0,0.0,1512,1487
1999-01-13,Senegal,Guinea,1,0,1,1.0,0.0,1634,1603
1999-01-14,Bermuda,Antigua and Barbuda,0,1,1,0.0,1.0,1504,1496
1999-01-15,Burkina Faso,Mali,4,1,3,1.0,0.0,1636,1607
1999-01-18,Israel,Estonia,7,0,7,1.0,0.0,1718,1396
1999-01-20,France,Morocco,1,0,1,1.0,0.0,2015,1834
1999-01-20,Israel,Norway,0,1,1,0.0,1.0,1714,1869
1999-01-22,Estonia,Norway,3,3,0,0.5,0.5,1404,1862
1999-01-23,Eritrea,Cameroon,0,0,0,0.5,0.5,1502,1740
1999-01-23,Mauritius,South Africa,1,1,0,0.5,0.5,1475,1742
1999-01-23,Senegal,Burkina Faso,1,1,0,0.5,0.5,1635,1636
1999-01-23,Zimbabwe,Malawi,3,0,3,1.0,0.0,1643,1610
1999-01-24,Angola,Gabon,3,1,2,1.0,0.0,1645,1650
1999-01-24,Bolivia,United States,0,0,0,0.5,0.5,1727,1787
1999-01-24,Congo,Mali,0,0,0,0.5,0.5,1606,1607
1999-01-24,DR Congo,Kenya,2,1,1,1.0,0.0,1660,1674
1999-01-24,Guinea,Morocco,1,1,0,0.5,0.5,1608,1830
1999-01-24,Ivory Coast,Namibia,3,0,3,1.0,0.0,1782,1546
1999-01-24,Liberia,Uganda,2,0,2,1.0,0.0,1564,1636
1999-01-24,Madagascar,Zambia,1,2,1,0.0,1.0,1657,1766
1999-01-24,Zimbabwe,Malawi,1,0,1,1.0,0.0,1651,1603
1999-01-27,Malta,Bosnia and Herzegovina,2,1,1,1.0,0.0,1421,1534
1999-01-28,Costa Rica,Ecuador,0,0,0,0.5,0.5,1708,1759
1999-01-29,Vietnam,Singapore,1,0,1,1.0,0.0,1524,1601
1999-01-31,Ethiopia,Kenya,2,2,0,0.5,0.5,1561,1672
1999-02-03,Cyprus,Belgium,0,1,1,0.0,1.0,1553,1853
1999-02-03,Greece,Finland,2,1,1,1.0,0.0,1739,1635
1999-02-03,Malta,Poland,0,1,1,0.0,1.0,1420,1786
1999-02-03,Martinique,French Guiana,3,1,2,1.0,0.0,1663,1438
1999-02-03,Venezuela,Argentina,0,2,2,0.0,1.0,1466,1929
1999-02-05,British Virgin Islands,Montserrat,3,1,2,1.0,0.0,1422,1470
1999-02-05,Cyprus,Finland,2,1,1,1.0,0.0,1563,1626
1999-02-05,Greece,Belgium,1,0,1,1.0,0.0,1750,1843
1999-02-06,Slovenia,Switzerland,0,2,2,0.0,1.0,1546,1758
1999-02-06,United States,Germany,3,0,3,1.0,0.0,1800,1991
1999-02-07,British Virgin Islands,Montserrat,3,0,3,1.0,0.0,1432,1461
1999-02-07,Lesotho,Namibia,1,0,1,1.0,0.0,1458,1536
1999-02-08,Oman,Slovenia,0,7,7,0.0,1.0,1580,1555
1999-02-09,Belgium,Czech Republic,0,1,1,0.0,1.0,1834,1801
1999-02-09,Colombia,Germany,3,3,0,0.5,0.5,1812,1988
1999-02-09,Israel,Belarus,2,1,1,1.0,0.0,1718,1508
1999-02-10,Albania,North Macedonia,2,0,2,1.0,0.0,1508,1589
1999-02-10,Croatia,Denmark,0,1,1,0.0,1.0,1809,1861
1999-02-10,Cyprus,San Marino,4,0,4,1.0,0.0,1568,1416
1999-02-10,England,France,0,2,2,0.0,1.0,1957,2022
1999-02-10,Finland,Poland,1,1,0,0.5,0.5,1630,1783
1999-02-10,Republic of Ireland,Paraguay,2,0,2,1.0,0.0,1791,1785
1999-02-10,Italy,Norway,0,0,0,0.5,0.5,1976,1865
1999-02-10,Jamaica,Costa Rica,1,1,0,0.5,0.5,1761,1710
1999-02-10,Malta,Serbia,0,3,3,0.0,1.0,1419,1773
1999-02-10,Mexico,Argentina,0,1,1,0.0,1.0,1859,1936
1999-02-10,Oman,Switzerland,1,2,1,0.0,1.0,1576,1763
1999-02-10,Peru,Ecuador,1,2,1,0.0,1.0,1725,1767
1999-02-10,Portugal,Netherlands,0,0,0,0.5,0.5,1864,1943
1999-02-10,Tunisia,Sweden,0,1,1,0.0,1.0,1760,1908
1999-02-13,Saint Lucia,Antigua and Barbuda,0,0,0,0.5,0.5,1517,1497
1999-02-15,Kuwait,Iran,1,2,1,0.0,1.0,1769,1815
1999-02-16,Bulgaria,Egypt,1,3,2,0.0,1.0,1770,1768
1999-02-17,Ecuador,Peru,1,2,1,0.0,1.0,1759,1734
1999-02-17,Guatemala,Chile,1,1,0,0.5,0.5,1681,1816
1999-02-19,Egypt,Mexico,0,3,3,0.0,1.0,1763,1865
1999-02-20,Botswana,South Africa,1,2,1,0.0,1.0,1409,1745
1999-02-20,Gabon,Burkina Faso,1,1,0,0.5,0.5,1650,1637
1999-02-20,Zimbabwe,Zambia,1,1,0,0.5,0.5,1654,1764
1999-02-21,United States,Chile,2,1,1,1.0,0.0,1809,1808
1999-02-22,Suriname,Guyana,2,1,1,1.0,0.0,1579,1451
1999-02-23,Thailand,North Korea,2,2,0,0.5,0.5,1705,1714
1999-02-24,Bahamas,Turks and Caicos Islands,3,0,3,1.0,0.0,1503,1492
1999-02-24,Costa Rica,Jamaica,9,0,9,1.0,0.0,1720,1752
1999-02-24,Israel,Latvia,2,0,2,1.0,0.0,1722,1513
1999-02-24,Saint Lucia,Grenada,1,2,1,0.0,1.0,1510,1561
1999-02-26,United States Virgin Islands,Turks and Caicos Islands,2,2,0,0.5,0.5,1507,1493
1999-02-27,South Africa,Gabon,4,1,3,1.0,0.0,1751,1645
1999-02-28,Angola,Mauritius,0,2,2,0.0,1.0,1634,1487
1999-02-28,Bahamas,United States Virgin Islands,0,0,0,0.5,0.5,1504,1507
1999-02-28,British Virgin Islands,Antigua and Barbuda,0,2,2,0.0,1.0,1426,1504
1999-02-28,Burundi,Burkina Faso,1,2,1,0.0,1.0,1569,1644
1999-02-28,Cameroon,Mozambique,1,0,1,1.0,0.0,1745,1561
1999-02-28,Congo,Ivory Coast,1,0,1,1.0,0.0,1618,1771
1999-02-28,Guyana,Barbados,2,2,0,0.5,0.5,1454,1538
1999-02-28,Kenya,Zambia,0,1,1,0.0,1.0,1667,1770
1999-02-28,Liberia,Algeria,1,1,0,0.5,0.5,1568,1733
1999-02-28,Madagascar,DR Congo,3,1,2,1.0,0.0,1666,1652
1999-02-28,Togo,Morocco,2,3,1,0.0,1.0,1581,1834
1999-03-03,Bolivia,Jamaica,0,0,0,0.5,0.5,1728,1752
1999-03-03,Bulgaria,Slovakia,2,0,2,1.0,0.0,1776,1645
1999-03-03,Guatemala,Paraguay,2,3,1,0.0,1.0,1676,1791
1999-03-03,Poland,Armenia,1,0,1,1.0,0.0,1787,1526
1999-03-03,Romania,Estonia,2,0,2,1.0,0.0,1877,1404
1999-03-05,Guatemala,Bolivia,0,3,3,0.0,1.0,1670,1735
1999-03-05,Jamaica,Paraguay,1,3,2,0.0,1.0,1745,1799
1999-03-06,Azerbaijan,Estonia,2,2,0,0.5,0.5,1490,1406
1999-03-06,Barbados,Guyana,2,0,2,1.0,0.0,1545,1448
1999-03-07,Bolivia,Paraguay,0,3,3,0.0,1.0,1729,1806
1999-03-07,Guatemala,Jamaica,2,4,2,0.0,1.0,1664,1752
1999-03-10,Barbados,Antigua and Barbuda,2,0,2,1.0,0.0,1553,1497
1999-03-10,Greece,Croatia,3,2,1,1.0,0.0,1760,1800
1999-03-10,Guadeloupe,Dominica,1,0,1,1.0,0.0,1527,1473
1999-03-10,Hungary,Bosnia and Herzegovina,1,1,0,0.5,0.5,1727,1539
1999-03-10,Luxembourg,Iceland,1,2,1,0.0,1.0,1369,1650
1999-03-10,Malta,Moldova,0,2,2,0.0,1.0,1413,1511
1999-03-10,Romania,Israel,0,2,2,0.0,1.0,1866,1734
1999-03-10,Switzerland,Austria,2,4,2,0.0,1.0,1756,1795
1999-03-11,Mexico,Bolivia,2,1,1,1.0,0.0,1871,1724
1999-03-11,United States,Guatemala,3,1,2,1.0,0.0,1814,1660
1999-03-12,Barbados,Dominica,3,1,2,1.0,0.0,1560,1467
1999-03-12,Guadeloupe,Antigua and Barbuda,2,1,1,1.0,0.0,1535,1490
1999-03-13,Guatemala,Bolivia,2,1,1,1.0,0.0,1670,1715
1999-03-13,United States,Mexico,1,2,1,0.0,1.0,1808,1878
1999-03-14,Antigua and Barbuda,Dominica,1,1,0,0.5,0.5,1490,1468
1999-03-14,Guadeloupe,Barbados,1,0,1,1.0,0.0,1544,1552
1999-03-16,Cyprus,Estonia,1,2,1,0.0,1.0,1557,1418
1999-03-17,British Virgin Islands,Dominican Republic,0,0,0,0.5,0.5,1428,1479
1999-03-17,Costa Rica,Belize,7,0,7,1.0,0.0,1724,1465
1999-03-17,Guatemala,Nicaragua,1,0,1,1.0,0.0,1672,1324
1999-03-17,Haiti,Puerto Rico,2,0,2,1.0,0.0,1598,1382
1999-03-19,British Virgin Islands,Puerto Rico,5,0,5,1.0,0.0,1435,1376
1999-03-19,Guatemala,El Salvador,1,1,0,0.5,0.5,1671,1630
1999-03-19,Haiti,Dominican Republic,4,0,4,1.0,0.0,1604,1474
1999-03-19,Honduras,Belize,5,1,4,1.0,0.0,1703,1462
1999-03-20,Georgia,Ukraine,0,1,1,0.0,1.0,1576,1651
1999-03-21,Costa Rica,Honduras,0,1,1,0.0,1.0,1716,1712
1999-03-21,Dominican Republic,Puerto Rico,2,0,2,1.0,0.0,1480,1371
1999-03-21,El Salvador,Nicaragua,1,0,1,1.0,0.0,1633,1322
1999-03-21,Haiti,British Virgin Islands,6,0,6,1.0,0.0,1609,1431
1999-03-24,Costa Rica,Guatemala,1,0,1,1.0,0.0,1723,1665
1999-03-24,Honduras,El Salvador,3,1,2,1.0,0.0,1719,1627
1999-03-26,Costa Rica,Honduras,1,2,1,0.0,1.0,1715,1728
1999-03-26,Guatemala,El Salvador,1,0,1,1.0,0.0,1673,1620
1999-03-26,Portugal,Azerbaijan,7,0,7,1.0,0.0,1866,1489
1999-03-27,Andorra,Iceland,0,2,2,0.0,1.0,1439,1654
1999-03-27,Armenia,Russia,0,3,3,0.0,1.0,1524,1829
1999-03-27,Belarus,Switzerland,0,1,1,0.0,1.0,1505,1760
1999-03-27,Belgium,Bulgaria,0,1,1,0.0,1.0,1825,1786
1999-03-27,Czech Republic,Lithuania,2,0,2,1.0,0.0,1805,1554
1999-03-27,Denmark,Italy,1,2,1,0.0,1.0,1856,1982
1999-03-27,England,Poland,3,1,2,1.0,0.0,1962,1783
1999-03-27,France,Ukraine,0,0,0,0.5,0.5,2016,1658
1999-03-27,Georgia,Slovenia,1,1,0,0.5,0.5,1576,1556
1999-03-27,Greece,Norway,0,2,2,0.0,1.0,1755,1871
1999-03-27,Hungary,Liechtenstein,5,0,5,1.0,0.0,1730,1438
1999-03-27,Northern Ireland,Germany,0,3,3,0.0,1.0,1703,1991
1999-03-27,Romania,Slovakia,0,0,0,0.5,0.5,1862,1650
1999-03-27,Spain,Austria,9,0,9,1.0,0.0,1940,1791
1999-03-27,Sweden,Luxembourg,2,0,2,1.0,0.0,1909,1369
1999-03-27,Turkey,Moldova,2,0,2,1.0,0.0,1726,1508
1999-03-27,Alderney,Guernsey,0,1,1,0.0,1.0,1284,1614
1999-03-28,Costa Rica,El Salvador,4,0,4,1.0,0.0,1721,1615
1999-03-28,Honduras,Guatemala,0,2,2,0.0,1.0,1719,1683
1999-03-28,Israel,Cyprus,3,0,3,1.0,0.0,1739,1553
1999-03-28,South Korea,Brazil,1,0,1,1.0,0.0,1845,2051
1999-03-28,Trinidad and Tobago,Jamaica,2,0,2,1.0,0.0,1655,1742
1999-03-30,Belgium,Egypt,0,1,1,0.0,1.0,1816,1773
1999-03-30,Venezuela,Colombia,0,0,0,0.5,0.5,1473,1806
1999-03-31,Azerbaijan,Romania,0,1,1,0.0,1.0,1488,1864
1999-03-31,France,Armenia,2,0,2,1.0,0.0,2017,1524
1999-03-31,Germany,Finland,2,0,2,1.0,0.0,1993,1629
1999-03-31,Italy,Belarus,1,1,0,0.5,0.5,1975,1513
1999-03-31,Jamaica,Paraguay,3,0,3,1.0,0.0,1752,1797
1999-03-31,Japan,Brazil,0,2,2,0.0,1.0,1791,2054
1999-03-31,Latvia,Greece,0,0,0,0.5,0.5,1518,1751
1999-03-31,Liechtenstein,Portugal,0,5,5,0.0,1.0,1437,1868
1999-03-31,Lithuania,Estonia,1,2,1,0.0,1.0,1544,1429
1999-03-31,Luxembourg,Bulgaria,0,2,2,0.0,1.0,1368,1788
1999-03-31,Moldova,Northern Ireland,0,0,0,0.5,0.5,1513,1699
1999-03-31,Netherlands,Argentina,1,1,0,0.5,0.5,1943,1937
1999-03-31,Poland,Sweden,0,1,1,0.0,1.0,1778,1915
1999-03-31,Russia,Andorra,6,1,5,1.0,0.0,1831,1438
1999-03-31,San Marino,Spain,0,6,6,0.0,1.0,1416,1941
1999-03-31,Scotland,Czech Republic,1,2,1,0.0,1.0,1791,1813
1999-03-31,Slovakia,Hungary,0,0,0,0.5,0.5,1652,1729
1999-03-31,Switzerland,Wales,2,0,2,1.0,0.0,1767,1705
1999-03-31,Ukraine,Iceland,1,1,0,0.5,0.5,1658,1655
1999-04-03,Mali,Burkina Faso,5,2,3,1.0,0.0,1616,1636
1999-04-03,Eswatini,Namibia,1,1,0,0.5,0.5,1454,1535
1999-04-09,Algeria,Liberia,4,1,3,1.0,0.0,1738,1564
1999-04-10,Gabon,South Africa,1,0,1,1.0,0.0,1656,1741
1999-04-10,Mauritius,Angola,1,1,0,0.5,0.5,1491,1631
1999-04-10,Uganda,Tunisia,0,2,2,0.0,1.0,1631,1766
1999-04-10,Zambia,Kenya,1,0,1,1.0,0.0,1776,1662
1999-04-11,Burkina Faso,Burundi,3,1,2,1.0,0.0,1643,1563
1999-04-11,DR Congo,Madagascar,2,0,2,1.0,0.0,1661,1658
1999-04-11,Ivory Coast,Congo,2,0,2,1.0,0.0,1776,1614
1999-04-11,Mali,Namibia,2,1,1,1.0,0.0,1623,1529
1999-04-11,Morocco,Togo,1,1,0,0.5,0.5,1830,1586
1999-04-11,Mozambique,Cameroon,1,6,5,0.0,1.0,1557,1750
1999-04-13,Saint Vincent and the Grenadines,Grenada,2,1,1,1.0,0.0,1540,1553
1999-04-14,Mexico,Ecuador,0,0,0,0.5,0.5,1876,1762
1999-04-15,Venezuela,Colombia,1,1,0,0.5,0.5,1479,1801
1999-04-17,Saint Lucia,Martinique,3,1,2,1.0,0.0,1522,1652
1999-04-17,Saint Vincent and the Grenadines,Saint Kitts and Nevis,3,4,1,0.0,1.0,1532,1544
1999-04-18,Martinique,Saint Kitts and Nevis,2,1,1,1.0,0.0,1658,1539
1999-04-18,Saint Vincent and the Grenadines,Saint Lucia,2,2,0,0.5,0.5,1532,1523
1999-04-20,Saint Kitts and Nevis,Saint Lucia,4,3,1,1.0,0.0,1547,1516
1999-04-22,India,Bangladesh,0,0,0,0.5,0.5,1505,1444
1999-04-22,Paraguay,Colombia,0,2,2,0.0,1.0,1790,1809
1999-04-23,Sri Lanka,Maldives,0,0,0,0.5,0.5,1388,1384
1999-04-24,Malawi,Angola,1,2,1,0.0,1.0,1596,1639
1999-04-24,Pakistan,Bangladesh,0,4,4,0.0,1.0,1396,1452
1999-04-25,Sri Lanka,Nepal,2,3,1,0.0,1.0,1379,1353
1999-04-25,Eswatini,Lesotho,4,1,3,1.0,0.0,1463,1450
1999-04-26,India,Pakistan,2,0,2,1.0,0.0,1511,1391
1999-04-27,Nepal,Maldives,2,3,1,0.0,1.0,1346,1392
1999-04-27,Northern Ireland,Canada,1,1,0,0.5,0.5,1699,1685
1999-04-28,Austria,San Marino,7,0,7,1.0,0.0,1793,1415
1999-04-28,Bolivia,Chile,1,1,0,0.5,0.5,1718,1806
1999-04-28,Croatia,Italy,0,0,0,0.5,0.5,1804,1972
1999-04-28,Denmark,South Africa,1,1,0,0.5,0.5,1854,1744
1999-04-28,Georgia,Norway,1,4,3,0.0,1.0,1574,1874
1999-04-28,Germany,Scotland,0,1,1,0.0,1.0,1981,1804
1999-04-28,Greece,Switzerland,1,1,0,0.5,0.5,1752,1767
1999-04-28,Hungary,England,1,1,0,0.5,0.5,1734,1958
1999-04-28,Republic of Ireland,Sweden,2,0,2,1.0,0.0,1802,1905
1999-04-28,Latvia,Albania,0,0,0,0.5,0.5,1518,1509
1999-04-28,Malta,Iceland,1,2,1,0.0,1.0,1410,1659
1999-04-28,Netherlands,Morocco,1,2,1,0.0,1.0,1933,1841
1999-04-28,Paraguay,Mexico,2,1,1,1.0,0.0,1800,1867
1999-04-28,Poland,Czech Republic,2,1,1,1.0,0.0,1787,1805
1999-04-28,Romania,Belgium,1,0,1,1.0,0.0,1871,1810
1999-04-28,Slovenia,Finland,1,1,0,0.5,0.5,1558,1628
1999-04-29,Bangladesh,Nepal,2,1,1,1.0,0.0,1458,1341
1999-04-29,India,Maldives,2,1,1,1.0,0.0,1517,1387
1999-05-01,India,Bangladesh,2,0,2,1.0,0.0,1524,1452
1999-05-01,Maldives,Nepal,2,0,2,1.0,0.0,1394,1335
1999-05-03,Guernsey,Jersey,2,0,2,1.0,0.0,1625,1733
1999-05-04,Curaçao,Grenada,1,3,2,0.0,1.0,1527,1561
1999-05-05,Bermuda,Bahamas,6,0,6,1.0,0.0,1512,1496
1999-05-05,Cuba,Cayman Islands,4,1,3,1.0,0.0,1589,1460
1999-05-05,Spain,Croatia,3,1,2,1.0,0.0,1946,1800
1999-05-06,Grenada,Suriname,0,0,0,0.5,0.5,1562,1579
1999-05-06,Trinidad and Tobago,South Africa,2,0,2,1.0,0.0,1666,1734
1999-05-07,Bermuda,Cayman Islands,4,1,3,1.0,0.0,1519,1454
1999-05-07,Cuba,Bahamas,7,0,7,1.0,0.0,1595,1491
1999-05-08,Curaçao,Suriname,1,1,0,0.5,0.5,1529,1578
1999-05-08,Namibia,Mali,0,0,0,0.5,0.5,1532,1621
1999-05-09,Bermuda,Cuba,1,2,1,0.0,1.0,1513,1602
1999-05-09,Cayman Islands,Bahamas,4,1,3,1.0,0.0,1463,1483
1999-05-09,Jamaica,South Africa,1,1,0,0.5,0.5,1752,1735
1999-05-09,Eswatini,Mozambique,3,1,2,1.0,0.0,1474,1547
1999-05-16,Libya,Senegal,2,1,1,1.0,0.0,1601,1627
1999-05-16,Eswatini,Botswana,2,1,1,1.0,0.0,1481,1403
1999-05-19,Russia,Belarus,1,1,0,0.5,0.5,1826,1519
1999-05-19,Slovakia,Bulgaria,2,0,2,1.0,0.0,1663,1778
1999-05-20,Norway,Jamaica,6,0,6,1.0,0.0,1880,1747
1999-05-21,Haiti,Honduras,0,2,2,0.0,1.0,1604,1725
1999-05-22,Malawi,Namibia,1,1,0,0.5,0.5,1595,1534
1999-05-22,Uganda,Zambia,0,1,1,0.0,1.0,1627,1781
1999-05-27,Sweden,Jamaica,2,1,1,1.0,0.0,1910,1743
1999-05-28,Botswana,Mozambique,0,2,2,0.0,1.0,1399,1552
1999-05-29,Canada,Guatemala,1,0,1,1.0,0.0,1693,1676
1999-05-29,Chile,Costa Rica,3,0,3,1.0,0.0,1813,1715
1999-05-29,El Salvador,Colombia,2,1,1,1.0,0.0,1628,1797
1999-05-29,Republic of Ireland,Northern Ireland,0,1,1,0.0,1.0,1792,1710
1999-05-29,Saint Kitts and Nevis,Antigua and Barbuda,4,1,3,1.0,0.0,1554,1484
1999-05-30,Belgium,Peru,1,1,0,0.5,0.5,1809,1736
1999-05-30,Lesotho,Mauritius,1,2,1,0.0,1.0,1443,1499
1999-05-30,Norway,Georgia,1,0,1,1.0,0.0,1883,1572
1999-06-01,Mali,Senegal,1,1,0,0.5,0.5,1622,1627
1999-06-02,Canada,Guatemala,2,0,2,1.0,0.0,1701,1669
1999-06-02,Ecuador,Iran,1,1,0,0.5,0.5,1764,1814
1999-06-03,Grenada,Guadeloupe,2,1,1,1.0,0.0,1570,1537
1999-06-03,Japan,Belgium,0,0,0,0.5,0.5,1792,1809
1999-06-03,Trinidad and Tobago,Jamaica,1,0,1,1.0,0.0,1676,1734
1999-06-04,Canada,Iran,0,1,1,0.0,1.0,1696,1820
1999-06-04,Cuba,Haiti,3,1,2,1.0,0.0,1611,1596
1999-06-04,Ecuador,Guatemala,3,1,2,1.0,0.0,1770,1664
1999-06-04,Germany,Moldova,6,1,5,1.0,0.0,1983,1512
1999-06-04,Poland,Bulgaria,2,0,2,1.0,0.0,1795,1771
1999-06-05,Albania,Norway,1,2,1,0.0,1.0,1508,1885
1999-06-05,Azerbaijan,Liechtenstein,4,0,4,1.0,0.0,1495,1431
1999-06-05,Bosnia and Herzegovina,Lithuania,2,0,2,1.0,0.0,1548,1536
1999-06-05,Brazil,Netherlands,2,2,0,0.5,0.5,2052,1936
1999-06-05,Denmark,Belarus,1,0,1,1.0,0.0,1857,1517
1999-06-05,England,Sweden,0,0,0,0.5,0.5,1957,1912
1999-06-05,Estonia,Czech Republic,0,2,2,0.0,1.0,1428,1807
1999-06-05,Faroe Islands,Scotland,1,1,0,0.5,0.5,1460,1798
1999-06-05,Finland,Turkey,2,4,2,0.0,1.0,1623,1732
1999-06-05,France,Russia,2,3,1,0.0,1.0,2005,1839
1999-06-05,Georgia,Greece,1,2,1,0.0,1.0,1568,1757
1999-06-05,Guam,Micronesia,3,0,3,1.0,0.0,1438,1491
1999-06-05,Iceland,Armenia,2,0,2,1.0,0.0,1665,1519
1999-06-05,Italy,Wales,4,0,4,1.0,0.0,1975,1703
1999-06-05,Jamaica,Guadeloupe,5,1,4,1.0,0.0,1738,1534
1999-06-05,South Korea,Belgium,1,2,1,0.0,1.0,1837,1818
1999-06-05,Latvia,Slovenia,1,2,1,0.0,1.0,1511,1566
1999-06-05,North Macedonia,Croatia,1,1,0,0.5,0.5,1594,1796
1999-06-05,Namibia,Ivory Coast,1,1,0,0.5,0.5,1539,1772
1999-06-05,Portugal,Slovakia,1,0,1,1.0,0.0,1872,1660
1999-06-05,Romania,Hungary,2,0,2,1.0,0.0,1876,1730
1999-06-05,South Africa,Mauritius,2,0,2,1.0,0.0,1739,1496
1999-06-05,Spain,San Marino,9,0,9,1.0,0.0,1947,1415
1999-06-05,Trinidad and Tobago,Grenada,7,0,7,1.0,0.0,1682,1565
1999-06-05,Uganda,Liberia,1,0,1,1.0,0.0,1634,1558
1999-06-05,Ukraine,Andorra,4,0,4,1.0,0.0,1662,1435
1999-06-06,Burkina Faso,Senegal,2,2,0,0.5,0.5,1643,1628
1999-06-06,Cameroon,Eritrea,1,0,1,1.0,0.0,1754,1499
1999-06-06,Canada,Ecuador,1,2,1,0.0,1.0,1690,1777
1999-06-06,Gabon,Angola,3,1,2,1.0,0.0,1664,1632
1999-06-06,Guatemala,Iran,2,2,0,0.5,0.5,1668,1817
1999-06-06,Haiti,Saint Kitts and Nevis,2,0,2,1.0,0.0,1604,1547
1999-06-06,Israel,Austria,5,0,5,1.0,0.0,1749,1784
1999-06-06,Japan,Peru,0,0,0,0.5,0.5,1791,1738
1999-06-06,Kenya,DR Congo,0,1,1,0.0,1.0,1654,1670
1999-06-06,Mali,Congo,3,1,2,1.0,0.0,1630,1607
1999-06-06,Morocco,Guinea,1,0,1,1.0,0.0,1845,1605
1999-06-06,Tunisia,Algeria,2,0,2,1.0,0.0,1774,1731
1999-06-06,Zambia,Madagascar,1,1,0,0.5,0.5,1779,1661
1999-06-07,Jamaica,Grenada,2,1,1,1.0,0.0,1743,1561
1999-06-07,Trinidad and Tobago,Guadeloupe,3,2,1,1.0,0.0,1687,1530
1999-06-08,Brazil,Netherlands,3,1,2,1.0,0.0,2058,1931
1999-06-08,Cuba,Saint Kitts and Nevis,2,0,2,1.0,0.0,1618,1541
1999-06-08,Serbia,Malta,4,1,3,1.0,0.0,1775,1409
1999-06-09,Albania,Slovenia,0,1,1,0.0,1.0,1502,1573
1999-06-09,Andorra,France,0,1,1,0.0,1.0,1435,2006
1999-06-09,Armenia,Ukraine,0,0,0,0.5,0.5,1523,1659
1999-06-09,Bulgaria,England,1,1,0,0.5,0.5,1775,1954
1999-06-09,Czech Republic,Scotland,3,2,1,1.0,0.0,1815,1791
1999-06-09,Estonia,Lithuania,1,2,1,0.0,1.0,1423,1542
1999-06-09,Faroe Islands,Bosnia and Herzegovina,2,2,0,0.5,0.5,1462,1547
1999-06-09,Greece,Latvia,1,2,1,0.0,1.0,1745,1524
1999-06-09,Hungary,Slovakia,0,1,1,0.0,1.0,1721,1670
1999-06-09,Republic of Ireland,North Macedonia,1,0,1,1.0,0.0,1796,1591
1999-06-09,Luxembourg,Poland,2,3,1,0.0,1.0,1367,1797
1999-06-09,Mexico,Argentina,2,2,0,0.5,0.5,1869,1936
1999-06-09,Moldova,Finland,0,0,0,0.5,0.5,1515,1621
1999-06-09,Portugal,Liechtenstein,8,0,8,1.0,0.0,1874,1430
1999-06-09,Romania,Azerbaijan,4,0,4,1.0,0.0,1878,1494
1999-06-09,Russia,Iceland,1,0,1,1.0,0.0,1844,1661
1999-06-09,Switzerland,Italy,0,0,0,0.5,0.5,1772,1971
1999-06-09,Wales,Denmark,0,2,2,0.0,1.0,1699,1862
1999-06-10,Cuba,Jamaica,2,0,2,1.0,0.0,1629,1733
1999-06-10,Guam,Micronesia,4,1,3,1.0,0.0,1448,1482
1999-06-11,Trinidad and Tobago,Haiti,6,1,5,1.0,0.0,1694,1598
1999-06-12,South Korea,Mexico,1,1,0,0.5,0.5,1838,1869
1999-06-13,Croatia,Egypt,2,2,0,0.5,0.5,1796,1774
1999-06-13,Kenya,Zanzibar,0,1,1,0.0,1.0,1641,1411
1999-06-13,Trinidad and Tobago,Cuba,2,1,1,1.0,0.0,1701,1623
1999-06-13,United States,Argentina,1,0,1,1.0,0.0,1819,1926
1999-06-15,Venezuela,Ecuador,3,2,1,1.0,0.0,1493,1764
1999-06-16,Brazil,Poland,2,0,2,1.0,0.0,2061,1795
1999-06-16,Croatia,Mexico,2,1,1,1.0,0.0,1806,1860
1999-06-16,South Korea,Egypt,0,0,0,0.5,0.5,1837,1776
1999-06-16,South Africa,Zimbabwe,0,1,1,0.0,1.0,1730,1664
1999-06-16,Thailand,New Zealand,2,2,0,0.5,0.5,1705,1684
1999-06-17,Colombia,Peru,3,3,0,0.5,0.5,1796,1740
1999-06-17,Paraguay,Uruguay,2,3,1,0.0,1.0,1792,1792
1999-06-18,Egypt,Mexico,0,2,2,0.0,1.0,1770,1867
1999-06-18,Saudi Arabia,Jordan,2,1,1,1.0,0.0,1850,1556
1999-06-19,Eritrea,Mozambique,1,0,1,1.0,0.0,1509,1543
1999-06-19,South Korea,Croatia,1,1,0,0.5,0.5,1837,1807
1999-06-19,New Zealand,Poland,0,0,0,0.5,0.5,1687,1793
1999-06-19,Senegal,Burundi,1,0,1,1.0,0.0,1635,1557
1999-06-19,Thailand,Brazil,0,2,2,0.0,1.0,1704,2063
1999-06-20,Algeria,Uganda,2,0,2,1.0,0.0,1737,1629
1999-06-20,Angola,South Africa,2,2,0,0.5,0.5,1635,1728
1999-06-20,Chile,Bolivia,1,0,1,1.0,0.0,1819,1713
1999-06-20,Congo,Namibia,3,0,3,1.0,0.0,1614,1533
1999-06-20,DR Congo,Zambia,0,1,1,0.0,1.0,1665,1785
1999-06-20,Guinea,Togo,2,1,1,1.0,0.0,1613,1579
1999-06-20,Ivory Coast,Mali,0,0,0,0.5,0.5,1769,1634
1999-06-20,Liberia,Tunisia,2,0,2,1.0,0.0,1571,1762
1999-06-20,Madagascar,Kenya,1,1,0,0.5,0.5,1661,1642
1999-06-20,Mauritius,Gabon,2,2,0,0.5,0.5,1500,1661
1999-06-20,Venezuela,Peru,3,0,3,1.0,0.0,1506,1728
1999-06-22,Oman,New Zealand,1,0,1,1.0,0.0,1587,1677
1999-06-22,Saudi Arabia,Jordan,2,0,2,1.0,0.0,1853,1554
1999-06-22,Uganda,Zambia,0,1,1,0.0,1.0,1625,1790
1999-06-23,Peru,Venezuela,3,0,3,1.0,0.0,1732,1503
1999-06-24,Oman,New Zealand,2,2,0,0.5,0.5,1590,1675
1999-06-24,Paraguay,Colombia,2,1,1,1.0,0.0,1801,1788
1999-06-26,Argentina,Lithuania,0,0,0,0.5,0.5,1920,1549
1999-06-26,Brazil,Latvia,3,0,3,1.0,0.0,2064,1524
1999-06-27,Jersey,Åland Islands,1,0,1,1.0,0.0,1737,1522
1999-06-27,Gotland,Hitra,12,1,11,1.0,0.0,1508,1464
1999-06-27,Isle of Man,Shetland,2,1,1,1.0,0.0,1484,1473
1999-06-27,Isle of Wight,Frøya,6,2,4,1.0,0.0,1556,1495
1999-06-27,Greenland,Saare County,4,1,3,1.0,0.0,1445,1491
1999-06-27,Ynys Môn,Rhodes,1,1,0,0.5,0.5,1547,1502
1999-06-28,Jordan,Iraq,0,1,1,0.0,1.0,1551,1790
1999-06-28,Åland Islands,Gibraltar,2,1,1,1.0,0.0,1530,1496
1999-06-28,Gotland,Shetland,3,1,2,1.0,0.0,1516,1466
1999-06-28,Hitra,Isle of Man,0,13,13,0.0,1.0,1457,1492
1999-06-28,Frøya,Greenland,1,3,2,0.0,1.0,1486,1455
1999-06-28,Saare County,Isle of Wight,1,6,5,0.0,1.0,1485,1563
1999-06-28,Rhodes,Guernsey,0,0,0,0.5,0.5,1505,1623
1999-06-29,Paraguay,Bolivia,0,0,0,0.5,0.5,1800,1715
1999-06-29,Peru,Japan,3,2,1,1.0,0.0,1742,1782
1999-06-29,Singapore,New Zealand,0,1,1,0.0,1.0,1595,1682
1999-06-29,Zimbabwe,Egypt,1,1,0,0.5,0.5,1667,1768
1999-06-29,Gibraltar,Jersey,1,5,4,0.0,1.0,1493,1741
1999-06-29,Gotland,Isle of Man,4,4,0,0.5,0.5,1516,1493
1999-06-29,Shetland,Hitra,4,1,3,1.0,0.0,1474,1450
1999-06-29,Isle of Wight,Greenland,7,2,5,1.0,0.0,1569,1450
1999-06-29,Saare County,Frøya,1,4,3,0.0,1.0,1478,1494
1999-06-29,Guernsey,Ynys Môn,1,1,0,0.5,0.5,1622,1549
1999-06-30,Brazil,Venezuela,7,0,7,1.0,0.0,2065,1503
1999-06-30,Chile,Mexico,0,1,1,0.0,1.0,1813,1874
1999-06-30,Jordan,Iraq,1,1,0,0.5,0.5,1556,1786
1999-07-01,Argentina,Ecuador,3,1,2,1.0,0.0,1925,1760
1999-07-01,Malaysia,New Zealand,2,1,1,1.0,0.0,1574,1672
1999-07-01,Uruguay,Colombia,0,1,1,0.0,1.0,1784,1797
1999-07-01,Hitra,Saare County,2,1,1,1.0,0.0,1459,1470
1999-07-01,Guernsey,Frøya,4,2,2,1.0,0.0,1628,1489
1999-07-01,Shetland,Gibraltar,3,2,1,1.0,0.0,1483,1485
1999-07-01,Greenland,Rhodes,0,2,2,0.0,1.0,1444,1512
1999-07-01,Gotland,Åland Islands,1,4,3,0.0,1.0,1509,1538
1999-07-01,Gotland,Greenland,7,2,5,1.0,0.0,1516,1438
1999-07-01,Isle of Wight,Ynys Môn,1,3,2,0.0,1.0,1561,1558
1999-07-01,Isle of Man,Jersey,1,0,1,1.0,0.0,1506,1729
1999-07-02,Lithuania,Indonesia,2,2,0,0.5,0.5,1550,1568
1999-07-02,Paraguay,Japan,4,0,4,1.0,0.0,1808,1775
1999-07-02,Peru,Bolivia,1,0,1,1.0,0.0,1750,1708
1999-07-02,Gibraltar,Frøya,5,1,4,1.0,0.0,1494,1481
1999-07-02,Guernsey,Shetland,6,5,1,1.0,0.0,1633,1479
1999-07-02,Rhodes,Åland Islands,3,2,1,1.0,0.0,1521,1530
1999-07-02,Isle of Wight,Jersey,2,0,2,1.0,0.0,1573,1718
1999-07-02,Ynys Môn,Isle of Man,1,0,1,1.0,0.0,1565,1500
1999-07-03,Brazil,Mexico,2,1,1,1.0,0.0,2069,1871
1999-07-03,Chile,Venezuela,3,0,3,1.0,0.0,1816,1501
1999-07-03,Malaysia,New Zealand,1,5,4,0.0,1.0,1569,1678
1999-07-04,Argentina,Colombia,0,3,3,0.0,1.0,1915,1808
1999-07-04,Lesotho,Angola,0,1,1,0.0,1.0,1440,1639
1999-07-04,Uruguay,Ecuador,2,1,1,1.0,0.0,1792,1753
1999-07-05,Bolivia,Japan,1,1,0,0.5,0.5,1710,1774
1999-07-05,Paraguay,Peru,1,0,1,1.0,0.0,1815,1744
1999-07-06,Brazil,Chile,1,0,1,1.0,0.0,2073,1813
1999-07-06,Malawi,Uganda,0,2,2,0.0,1.0,1588,1633
1999-07-06,Mexico,Venezuela,3,1,2,1.0,0.0,1873,1500
1999-07-07,Colombia,Ecuador,2,1,1,1.0,0.0,1815,1747
1999-07-07,Uruguay,Argentina,0,2,2,0.0,1.0,1787,1921
1999-07-09,Canada,Saudi Arabia,0,2,2,0.0,1.0,1686,1858
1999-07-10,Egypt,New Zealand,1,1,0,0.5,0.5,1766,1681
1999-07-10,Mexico,Peru,3,3,0,0.5,0.5,1871,1747
1999-07-10,Paraguay,Uruguay,1,1,0,0.5,0.5,1815,1788
1999-07-11,Brazil,Argentina,2,1,1,1.0,0.0,2078,1917
1999-07-11,Chile,Colombia,3,2,1,1.0,0.0,1822,1807
1999-07-11,Uzbekistan,Malaysia,3,0,3,1.0,0.0,1631,1563
1999-07-12,Micronesia,Northern Mariana Islands,7,0,7,1.0,0.0,1491,1490
1999-07-13,Jamaica,Saudi Arabia,2,1,1,1.0,0.0,1744,1848
1999-07-13,Uruguay,Chile,1,1,0,0.5,0.5,1789,1822
1999-07-14,Mexico,Brazil,0,2,2,0.0,1.0,1868,2082
1999-07-15,Egypt,New Zealand,1,0,1,1.0,0.0,1773,1675
1999-07-15,Jamaica,Saudi Arabia,0,4,4,0.0,1.0,1739,1854
1999-07-16,Jordan,Syria,1,0,1,1.0,0.0,1566,1614
1999-07-17,Chile,Mexico,1,2,1,0.0,1.0,1816,1875
1999-07-17,Costa Rica,Saudi Arabia,1,0,1,1.0,0.0,1727,1843
1999-07-18,Brazil,Uruguay,3,0,3,1.0,0.0,2085,1787
1999-07-18,Jordan,Syria,4,0,4,1.0,0.0,1576,1605
1999-07-18,Senegal,Eritrea,6,2,4,1.0,0.0,1641,1504
1999-07-18,Eswatini,Zimbabwe,1,1,0,0.5,0.5,1485,1664
1999-07-21,Oman,Kenya,2,2,0,0.5,0.5,1592,1641
1999-07-24,Brazil,Germany,4,0,4,1.0,0.0,2091,1978
1999-07-24,New Zealand,United States,1,2,1,0.0,1.0,1671,1824
1999-07-24,Rwanda,Djibouti,4,1,3,1.0,0.0,1497,1403
1999-07-24,Thailand,Uzbekistan,1,0,1,1.0,0.0,1711,1625
1999-07-25,Bolivia,Egypt,2,2,0,0.5,0.5,1712,1772
1999-07-25,Burundi,Uganda,0,0,0,0.5,0.5,1559,1632
1999-07-25,Ethiopia,Zanzibar,2,0,2,1.0,0.0,1566,1407
1999-07-25,Mexico,Saudi Arabia,5,1,4,1.0,0.0,1883,1836
1999-07-26,Tanzania,Djibouti,2,1,1,1.0,0.0,1516,1398
1999-07-27,Burundi,Somalia,3,0,3,1.0,0.0,1565,1419
1999-07-27,Ethiopia,Sudan,0,0,0,0.5,0.5,1567,1594
1999-07-27,Mexico,Egypt,2,2,0,0.5,0.5,1881,1775
1999-07-27,Saudi Arabia,Bolivia,0,0,0,0.5,0.5,1834,1715
1999-07-28,Brazil,United States,1,0,1,1.0,0.0,2094,1822
1999-07-28,El Salvador,Guatemala,0,2,2,0.0,1.0,1621,1676
1999-07-28,Germany,New Zealand,2,0,2,1.0,0.0,1981,1669
1999-07-28,Kenya,Eritrea,1,0,1,1.0,0.0,1646,1500
1999-07-28,Rwanda,Tanzania,0,0,0,0.5,0.5,1498,1516
1999-07-29,Egypt,Saudi Arabia,1,5,4,0.0,1.0,1769,1841
1999-07-29,Mexico,Bolivia,1,0,1,1.0,0.0,1886,1711
1999-07-29,Somalia,Uganda,0,2,2,0.0,1.0,1416,1636
1999-07-29,Sudan,Zanzibar,1,1,0,0.5,0.5,1591,1411
1999-07-30,New Zealand,Brazil,0,2,2,0.0,1.0,1668,2096
1999-07-30,United States,Germany,2,0,2,1.0,0.0,1834,1970
1999-07-30,Thailand,Philippines,9,0,9,1.0,0.0,1713,1268
1999-07-30,Vietnam,Laos,9,0,9,1.0,0.0,1530,1397
1999-07-31,Burundi,Tanzania,1,0,1,1.0,0.0,1572,1510
1999-07-31,Namibia,South Africa,1,1,0,0.5,0.5,1538,1724
1999-07-31,Rwanda,Uganda,1,0,1,1.0,0.0,1510,1625
1999-07-31,Indonesia,Cambodia,1,0,1,1.0,0.0,1573,1416
1999-07-31,Singapore,Malaysia,2,1,1,1.0,0.0,1603,1556
1999-08-01,Brazil,Saudi Arabia,8,2,6,1.0,0.0,2099,1839
1999-08-01,Kenya,Sudan,3,0,3,1.0,0.0,1653,1585
1999-08-01,Mexico,United States,1,0,1,1.0,0.0,1893,1828
1999-08-01,Laos,Thailand,1,4,3,0.0,1.0,1395,1716
1999-08-01,Myanmar,Philippines,4,1,3,1.0,0.0,1553,1266
1999-08-02,Indonesia,Malaysia,6,0,6,1.0,0.0,1581,1549
1999-08-02,Brunei,Cambodia,3,3,0,0.5,0.5,1334,1415
1999-08-03,Oman,Kyrgyzstan,3,0,3,1.0,0.0,1598,1462
1999-08-03,Rwanda,Kenya,0,0,0,0.5,0.5,1514,1650
1999-08-03,Tajikistan,Iraq,1,2,1,0.0,1.0,1519,1789
1999-08-03,United States,Saudi Arabia,2,0,2,1.0,0.0,1837,1831
1999-08-03,Myanmar,Vietnam,0,2,2,0.0,1.0,1545,1539
1999-08-03,Philippines,Laos,2,3,1,0.0,1.0,1261,1401
1999-08-04,Mexico,Brazil,4,3,1,1.0,0.0,1906,2087
1999-08-04,Brunei,Singapore,1,3,2,0.0,1.0,1332,1606
1999-08-04,Cambodia,Malaysia,2,7,5,0.0,1.0,1410,1555
1999-08-05,Iraq,Oman,2,0,2,1.0,0.0,1793,1595
1999-08-05,Tajikistan,Kyrgyzstan,3,2,1,1.0,0.0,1526,1456
1999-08-05,Laos,Myanmar,0,0,0,0.5,0.5,1405,1542
1999-08-05,Vietnam,Thailand,0,0,0,0.5,0.5,1543,1713
1999-08-06,Brunei,Malaysia,0,2,2,0.0,1.0,1329,1559
1999-08-06,Indonesia,Singapore,1,1,0,0.5,0.5,1582,1606
1999-08-07,Ghana,Jamaica,2,1,1,1.0,0.0,1700,1730
1999-08-07,Iraq,Kyrgyzstan,5,1,4,1.0,0.0,1796,1454
1999-08-07,Rwanda,Burundi,0,0,0,0.5,0.5,1516,1571
1999-08-07,Tajikistan,Oman,2,1,1,1.0,0.0,1536,1586
1999-08-07,Zambia,Mozambique,1,1,0,0.5,0.5,1786,1548
1999-08-08,Senegal,Zimbabwe,2,0,2,1.0,0.0,1650,1656
1999-08-08,Philippines,Vietnam,0,2,2,0.0,1.0,1259,1546
1999-08-08,Thailand,Myanmar,7,0,7,1.0,0.0,1718,1538
1999-08-09,Cambodia,Singapore,0,2,2,0.0,1.0,1407,1610
1999-08-09,Brunei,Indonesia,0,3,3,0.0,1.0,1326,1586
1999-08-12,Thailand,Singapore,2,0,2,1.0,0.0,1724,1605
1999-08-12,Indonesia,Vietnam,0,1,1,0.0,1.0,1578,1555
1999-08-14,Zambia,Angola,0,1,1,0.0,1.0,1775,1651
1999-08-14,Indonesia,Singapore,0,0,0,0.5,0.5,1579,1605
1999-08-14,Thailand,Vietnam,2,0,2,1.0,0.0,1729,1551
1999-08-15,Lesotho,Eswatini,0,3,3,0.0,1.0,1434,1492
1999-08-15,Zimbabwe,Eritrea,4,0,4,1.0,0.0,1661,1496
1999-08-17,Mozambique,Nigeria,0,1,1,0.0,1.0,1545,1762
1999-08-18,Belarus,Russia,0,2,2,0.0,1.0,1515,1847
1999-08-18,Belgium,Finland,3,4,1,0.0,1.0,1806,1634
1999-08-18,Cyprus,Romania,2,2,0,0.5,0.5,1559,1873
1999-08-18,Czech Republic,Switzerland,3,0,3,1.0,0.0,1823,1765
1999-08-18,Denmark,Netherlands,0,0,0,0.5,0.5,1864,1930
1999-08-18,Estonia,Armenia,2,0,2,1.0,0.0,1434,1513
1999-08-18,Faroe Islands,Iceland,0,1,1,0.0,1.0,1459,1665
1999-08-18,Greece,El Salvador,3,1,2,1.0,0.0,1751,1616
1999-08-18,Hungary,Moldova,1,1,0,0.5,0.5,1717,1520
1999-08-18,Liechtenstein,Bosnia and Herzegovina,0,0,0,0.5,0.5,1433,1545
1999-08-18,Northern Ireland,France,0,1,1,0.0,1.0,1708,2009
1999-08-18,Norway,Lithuania,1,0,1,1.0,0.0,1888,1548
1999-08-18,Poland,Spain,1,2,1,0.0,1.0,1789,1952
1999-08-18,Portugal,Andorra,4,0,4,1.0,0.0,1876,1434
1999-08-18,Serbia,Croatia,0,0,0,0.5,0.5,1776,1807
1999-08-18,Slovakia,Israel,1,0,1,1.0,0.0,1680,1740
1999-08-18,Slovenia,Albania,2,0,2,1.0,0.0,1580,1496
1999-08-18,Sweden,Austria,0,0,0,0.5,0.5,1910,1787
1999-08-18,Ukraine,Bulgaria,1,1,0,0.5,0.5,1662,1773
1999-08-18,Uruguay,Costa Rica,5,4,1,1.0,0.0,1794,1721
1999-08-18,Uzbekistan,Azerbaijan,5,1,4,1.0,0.0,1631,1489
1999-08-20,Greece,El Salvador,3,0,3,1.0,0.0,1757,1611
1999-08-21,Croatia,Malta,2,1,1,1.0,0.0,1809,1408
1999-08-25,Bolivia,Venezuela,0,0,0,0.5,0.5,1707,1505
1999-08-28,Namibia,Eswatini,1,1,0,0.5,0.5,1537,1494
1999-08-28,Nigeria,Ghana,0,0,0,0.5,0.5,1761,1702
1999-09-01,Republic of Ireland,Serbia,2,1,1,1.0,0.0,1804,1769
1999-09-02,Canada,Jamaica,1,0,1,1.0,0.0,1696,1721
1999-09-04,Albania,Latvia,3,3,0,0.5,0.5,1497,1524
1999-09-04,Argentina,Brazil,2,0,2,1.0,0.0,1929,2076
1999-09-04,Austria,Spain,1,3,2,0.0,1.0,1783,1957
1999-09-04,Azerbaijan,Portugal,1,1,0,0.5,0.5,1496,1870
1999-09-04,Belarus,Wales,1,2,1,0.0,1.0,1511,1704
1999-09-04,Bosnia and Herzegovina,Scotland,1,2,1,0.0,1.0,1542,1795
1999-09-04,Croatia,Republic of Ireland,1,0,1,1.0,0.0,1817,1797
1999-09-04,Denmark,Switzerland,2,1,1,1.0,0.0,1870,1760
1999-09-04,England,Luxembourg,6,0,6,1.0,0.0,1955,1367
1999-09-04,Faroe Islands,Estonia,0,2,2,0.0,1.0,1451,1443
1999-09-04,Finland,Germany,1,2,1,0.0,1.0,1632,1973
1999-09-04,Iceland,Andorra,3,0,3,1.0,0.0,1669,1431
1999-09-04,Liechtenstein,Hungary,0,0,0,0.5,0.5,1439,1712
1999-09-04,Lithuania,Czech Republic,0,4,4,0.0,1.0,1546,1826
1999-09-04,Netherlands,Belgium,5,5,0,0.5,0.5,1928,1809
1999-09-04,Northern Ireland,Turkey,0,3,3,0.0,1.0,1701,1740
1999-09-04,Norway,Greece,1,0,1,1.0,0.0,1894,1752
1999-09-04,Russia,Armenia,2,0,2,1.0,0.0,1850,1511
1999-09-04,Slovakia,Romania,1,5,4,0.0,1.0,1677,1877
1999-09-04,Slovenia,Georgia,2,1,1,1.0,0.0,1588,1561
1999-09-04,Sweden,Bulgaria,1,0,1,1.0,0.0,1915,1769
1999-09-04,Ukraine,France,0,0,0,0.5,0.5,1669,2003
1999-09-05,Cyprus,Israel,3,2,1,1.0,0.0,1571,1729
1999-09-05,Serbia,North Macedonia,3,1,2,1.0,0.0,1774,1587
1999-09-07,Belgium,Morocco,4,0,4,1.0,0.0,1818,1837
1999-09-07,Brazil,Argentina,4,2,2,1.0,0.0,2081,1925
1999-09-08,Andorra,Russia,1,2,1,0.0,1.0,1430,1852
1999-09-08,Armenia,France,2,3,1,0.0,1.0,1511,2004
1999-09-08,Czech Republic,Bosnia and Herzegovina,3,0,3,1.0,0.0,1829,1540
1999-09-08,Estonia,Scotland,0,0,0,0.5,0.5,1450,1789
1999-09-08,Faroe Islands,Lithuania,0,1,1,0.0,1.0,1446,1552
1999-09-08,Georgia,Latvia,2,2,0,0.5,0.5,1561,1525
1999-09-08,Germany,Northern Ireland,4,0,4,1.0,0.0,1976,1699
1999-09-08,Hungary,Azerbaijan,3,0,3,1.0,0.0,1716,1493
1999-09-08,Iceland,Ukraine,0,1,1,0.0,1.0,1661,1677
1999-09-08,Israel,San Marino,8,0,8,1.0,0.0,1732,1413
1999-09-08,Italy,Denmark,2,3,1,0.0,1.0,1961,1881
1999-09-08,Jamaica,United States,2,2,0,0.5,0.5,1724,1835
1999-09-08,Japan,Iran,1,1,0,0.5,0.5,1775,1817
1999-09-08,Luxembourg,Sweden,0,1,1,0.0,1.0,1367,1916
1999-09-08,North Macedonia,Serbia,2,4,2,0.0,1.0,1583,1779
1999-09-08,Malta,Republic of Ireland,2,3,1,0.0,1.0,1407,1799
1999-09-08,Moldova,Turkey,1,1,0,0.5,0.5,1525,1736
1999-09-08,Norway,Slovenia,4,0,4,1.0,0.0,1897,1586
1999-09-08,Poland,England,0,0,0,0.5,0.5,1793,1952
1999-09-08,Romania,Portugal,1,1,0,0.5,0.5,1877,1871
1999-09-08,Slovakia,Liechtenstein,2,0,2,1.0,0.0,1681,1436
1999-09-08,Spain,Cyprus,8,0,8,1.0,0.0,1959,1570
1999-09-08,Switzerland,Belarus,2,0,2,1.0,0.0,1764,1508
1999-09-08,Trinidad and Tobago,Colombia,4,3,1,1.0,0.0,1712,1797
1999-09-08,Uruguay,Venezuela,2,0,2,1.0,0.0,1797,1503
1999-09-08,Zambia,Saudi Arabia,0,0,0,0.5,0.5,1777,1830
1999-09-09,Bermuda,Cayman Islands,3,1,2,1.0,0.0,1520,1457
1999-09-09,Dominica,Saint Lucia,0,2,2,0.0,1.0,1462,1523
1999-09-11,Bermuda,Cayman Islands,1,0,1,1.0,0.0,1527,1451
1999-09-11,Zambia,Saudi Arabia,1,2,1,0.0,1.0,1771,1837
1999-09-19,South Africa,Saudi Arabia,1,0,1,1.0,0.0,1735,1827
1999-09-22,Cayman Islands,Bahamas,4,0,4,1.0,0.0,1460,1475
1999-09-24,Sri Lanka,Maldives,0,4,4,0.0,1.0,1372,1402
1999-09-26,Angola,Namibia,1,0,1,1.0,0.0,1657,1532
1999-09-26,India,Pakistan,5,2,3,1.0,0.0,1530,1386
1999-09-26,Nepal,Bhutan,7,0,7,1.0,0.0,1346,1421
1999-09-27,Bangladesh,Maldives,1,2,1,0.0,1.0,1443,1412
1999-09-28,Haiti,Venezuela,3,2,1,1.0,0.0,1604,1498
1999-09-28,India,Bhutan,3,0,3,1.0,0.0,1536,1416
1999-09-28,Nepal,Pakistan,3,1,2,1.0,0.0,1355,1378
1999-09-29,Bangladesh,Sri Lanka,1,0,1,1.0,0.0,1450,1366
1999-09-30,Saudi Arabia,South Africa,0,0,0,0.5,0.5,1825,1738
1999-09-30,Nepal,India,0,4,4,0.0,1.0,1351,1541
1999-09-30,Pakistan,Bhutan,2,1,1,1.0,0.0,1387,1408
1999-10-02,Namibia,Angola,1,1,0,0.5,0.5,1535,1655
1999-10-02,Nepal,Maldives,2,1,1,1.0,0.0,1361,1403
1999-10-02,India,Bangladesh,0,1,1,0.0,1.0,1531,1461
1999-10-04,India,Maldives,3,1,2,1.0,0.0,1537,1398
1999-10-04,Nepal,Bangladesh,0,1,1,0.0,1.0,1356,1467
1999-10-05,Scotland,Bosnia and Herzegovina,1,0,1,1.0,0.0,1793,1537
1999-10-06,Canada,Cuba,0,0,0,0.5,0.5,1695,1625
1999-10-06,El Salvador,Haiti,1,1,0,0.5,0.5,1611,1605
1999-10-06,Greece,Albania,2,0,2,1.0,0.0,1755,1495
1999-10-08,Canada,El Salvador,2,1,1,1.0,0.0,1702,1605
1999-10-08,Cuba,Haiti,0,1,1,0.0,1.0,1617,1614
1999-10-09,Albania,Georgia,2,1,1,1.0,0.0,1505,1552
1999-10-09,Andorra,Armenia,0,3,3,0.0,1.0,1424,1518
1999-10-09,Azerbaijan,Slovakia,0,1,1,0.0,1.0,1489,1686
1999-10-09,Belarus,Italy,0,0,0,0.5,0.5,1515,1955
1999-10-09,Croatia,Serbia,2,2,0,0.5,0.5,1817,1780
1999-10-09,Czech Republic,Faroe Islands,2,0,2,1.0,0.0,1831,1445
1999-10-09,Estonia,Bosnia and Herzegovina,1,4,3,0.0,1.0,1444,1544
1999-10-09,Finland,Northern Ireland,4,1,3,1.0,0.0,1642,1690
1999-10-09,France,Iceland,3,2,1,1.0,0.0,2006,1660
1999-10-09,Germany,Turkey,0,0,0,0.5,0.5,1972,1741
1999-10-09,Latvia,Norway,1,2,1,0.0,1.0,1524,1899
1999-10-09,Liechtenstein,Romania,0,3,3,0.0,1.0,1435,1879
1999-10-09,North Macedonia,Republic of Ireland,1,1,0,0.5,0.5,1588,1795
1999-10-09,Netherlands,Brazil,2,2,0,0.5,0.5,1932,2078
1999-10-09,Portugal,Hungary,3,0,3,1.0,0.0,1876,1712
1999-10-09,Russia,Ukraine,1,1,0,0.5,0.5,1849,1681
1999-10-09,Scotland,Lithuania,3,0,3,1.0,0.0,1797,1549
1999-10-09,Slovenia,Greece,0,3,3,0.0,1.0,1582,1760
1999-10-09,Sweden,Poland,2,0,2,1.0,0.0,1922,1788
1999-10-09,Wales,Switzerland,0,2,2,0.0,1.0,1698,1771
1999-10-09,Austria,Cyprus,3,1,2,1.0,0.0,1787,1567
1999-10-09,Bulgaria,Luxembourg,3,0,3,1.0,0.0,1771,1366
1999-10-10,Canada,Haiti,2,1,1,1.0,0.0,1709,1608
1999-10-10,Cuba,El Salvador,3,1,2,1.0,0.0,1625,1598
1999-10-10,Denmark,Iran,0,0,0,0.5,0.5,1880,1819
1999-10-10,England,Belgium,2,1,1,1.0,0.0,1958,1813
1999-10-10,Spain,Israel,3,0,3,1.0,0.0,1963,1729
1999-10-12,Hong Kong,Mauritius,4,3,1,1.0,0.0,1542,1493
1999-10-12,Panama,Trinidad and Tobago,2,2,0,0.5,0.5,1544,1709
1999-10-12,Uruguay,Ecuador,0,0,0,0.5,0.5,1796,1749
1999-10-13,Argentina,Colombia,2,1,1,1.0,0.0,1931,1792
1999-10-13,Mexico,Paraguay,0,1,1,0.0,1.0,1896,1826
1999-10-15,Guatemala,Paraguay,0,0,0,0.5,0.5,1680,1823
1999-10-16,Tunisia,United Arab Emirates,1,0,1,1.0,0.0,1770,1752
1999-10-18,Hong Kong,Cambodia,4,1,3,1.0,0.0,1548,1402
1999-10-20,Mexico,Colombia,0,0,0,0.5,0.5,1894,1795
1999-10-24,Cayman Islands,Jamaica,1,4,3,0.0,1.0,1458,1727
1999-10-24,Hong Kong,Indonesia,1,1,0,0.5,0.5,1549,1579
1999-10-27,Mexico,Ecuador,0,0,0,0.5,0.5,1891,1753
1999-10-30,Cambodia,Indonesia,1,5,4,0.0,1.0,1398,1584
1999-10-30,DR Congo,Congo,1,1,0,0.5,0.5,1664,1616
1999-10-30,Iraq,Estonia,1,1,0,0.5,0.5,1790,1451
1999-10-30,Ivory Coast,Gabon,0,1,1,0.0,1.0,1759,1672
1999-10-30,United Arab Emirates,Turkmenistan,3,1,2,1.0,0.0,1757,1561
1999-10-31,Tunisia,Zambia,2,1,1,1.0,0.0,1779,1763
1999-11-01,Iraq,Turkmenistan,3,0,3,1.0,0.0,1794,1558
1999-11-01,United Arab Emirates,Estonia,2,2,0,0.5,0.5,1752,1457
1999-11-02,Tunisia,Zambia,0,0,0,0.5,0.5,1779,1764
1999-11-03,Bolivia,Paraguay,0,0,0,0.5,0.5,1710,1821
1999-11-03,Turkmenistan,Estonia,1,1,0,0.5,0.5,1556,1460
1999-11-03,United Arab Emirates,Iraq,2,2,0,0.5,0.5,1753,1794
1999-11-07,Burkina Faso,Togo,1,0,1,1.0,0.0,1650,1573
1999-11-07,Cambodia,Hong Kong,0,1,1,0.0,1.0,1394,1554
1999-11-07,Gabon,Equatorial Guinea,4,0,4,1.0,0.0,1676,1454
1999-11-08,Central African Republic,Chad,4,1,3,1.0,0.0,1440,1479
1999-11-10,Burkina Faso,Togo,1,1,0,0.5,0.5,1649,1575
1999-11-10,Chad,São Tomé and Príncipe,5,0,5,1.0,0.0,1487,1455
1999-11-10,Congo,Equatorial Guinea,2,1,1,1.0,0.0,1621,1450
1999-11-10,Gabon,Central African Republic,1,0,1,1.0,0.0,1680,1437
1999-11-11,Congo,Chad,0,2,2,0.0,1.0,1611,1498
1999-11-11,Equatorial Guinea,Central African Republic,4,2,2,1.0,0.0,1458,1430
1999-11-11,Gabon,São Tomé and Príncipe,1,0,1,1.0,0.0,1684,1452
1999-11-12,Congo,São Tomé and Príncipe,1,0,1,1.0,0.0,1616,1448
1999-11-12,Egypt,Ghana,1,2,1,0.0,1.0,1760,1712
1999-11-13,Central African Republic,São Tomé and Príncipe,3,0,3,1.0,0.0,1439,1440
1999-11-13,Chad,Equatorial Guinea,1,0,1,1.0,0.0,1506,1451
1999-11-13,France,Croatia,3,0,3,1.0,0.0,2011,1813
1999-11-13,Gabon,Congo,0,0,0,0.5,0.5,1683,1618
1999-11-13,Greece,Nigeria,2,0,2,1.0,0.0,1769,1753
1999-11-13,Republic of Ireland,Turkey,1,1,0,0.5,0.5,1794,1743
1999-11-13,Israel,Denmark,0,5,5,0.0,1.0,1725,1885
1999-11-13,Italy,Belgium,1,3,2,0.0,1.0,1944,1825
1999-11-13,Netherlands,Czech Republic,1,1,0,0.5,0.5,1930,1834
1999-11-13,Scotland,England,0,2,2,0.0,1.0,1793,1963
1999-11-13,Slovenia,Ukraine,2,1,1,1.0,0.0,1593,1671
1999-11-13,Spain,Brazil,0,0,0,0.5,0.5,1966,2076
1999-11-14,Central African Republic,Congo,4,2,2,1.0,0.0,1451,1607
1999-11-14,Gabon,Chad,2,0,2,1.0,0.0,1688,1502
1999-11-14,Indonesia,Hong Kong,3,1,2,1.0,0.0,1592,1547
1999-11-14,Norway,Germany,0,1,1,0.0,1.0,1893,1979
1999-11-14,São Tomé and Príncipe,Equatorial Guinea,2,0,2,1.0,0.0,1449,1443
1999-11-15,Namibia,Egypt,0,1,1,0.0,1.0,1532,1764
1999-11-17,Denmark,Israel,3,0,3,1.0,0.0,1890,1721
1999-11-17,England,Scotland,0,1,1,0.0,1.0,1952,1805
1999-11-17,Greece,Bulgaria,1,0,1,1.0,0.0,1778,1763
1999-11-17,Honduras,Trinidad and Tobago,3,2,1,1.0,0.0,1733,1702
1999-11-17,Morocco,United States,2,1,1,1.0,0.0,1845,1828
1999-11-17,Peru,Slovakia,2,1,1,1.0,0.0,1754,1680
1999-11-17,Spain,Argentina,0,2,2,0.0,1.0,1958,1940
1999-11-17,Turkey,Republic of Ireland,0,0,0,0.5,0.5,1745,1793
1999-11-17,Ukraine,Slovenia,1,1,0,0.5,0.5,1670,1595
1999-11-17,Uruguay,Paraguay,0,1,1,0.0,1.0,1789,1829
1999-11-19,Libya,Togo,2,1,1,1.0,0.0,1609,1568
1999-11-20,Indonesia,Cambodia,9,2,7,1.0,0.0,1596,1391
1999-11-20,Senegal,Ivory Coast,3,0,3,1.0,0.0,1661,1749
1999-11-21,Bangladesh,Uzbekistan,0,6,6,0.0,1.0,1463,1636
1999-11-21,Gabon,Nigeria,0,2,2,0.0,1.0,1682,1760
1999-11-21,United Arab Emirates,India,3,1,2,1.0,0.0,1757,1534
1999-11-23,Guatemala,Slovakia,0,1,1,0.0,1.0,1672,1688
1999-11-23,Sri Lanka,Uzbekistan,0,6,6,0.0,1.0,1364,1639
1999-11-23,United Arab Emirates,Bangladesh,3,0,3,1.0,0.0,1760,1461
1999-11-24,Lebanon,Malta,0,0,0,0.5,0.5,1567,1411
1999-11-25,Costa Rica,Slovakia,4,0,4,1.0,0.0,1729,1681
1999-11-25,India,Uzbekistan,2,3,1,0.0,1.0,1529,1645
1999-11-25,Sri Lanka,Bangladesh,1,3,2,0.0,1.0,1359,1467
1999-11-26,Gabon,Togo,0,0,0,0.5,0.5,1680,1571
1999-11-27,Congo,Burkina Faso,2,1,1,1.0,0.0,1616,1641
1999-11-27,South Africa,Sweden,1,0,1,1.0,0.0,1750,1911
1999-11-27,Sri Lanka,India,1,3,2,0.0,1.0,1355,1534
1999-11-27,United Arab Emirates,Uzbekistan,0,1,1,0.0,1.0,1750,1656
1999-11-27,Zimbabwe,Libya,2,1,1,1.0,0.0,1668,1603
1999-11-28,Congo,Togo,2,1,1,1.0,0.0,1623,1565
1999-11-28,Gabon,Burkina Faso,3,2,1,1.0,0.0,1688,1634
1999-11-29,India,Bangladesh,2,2,0,0.5,0.5,1533,1469
1999-11-29,United Arab Emirates,Sri Lanka,6,0,6,1.0,0.0,1752,1354
1999-12-01,Congo,DR Congo,0,1,1,0.0,1.0,1616,1672
1999-12-01,Peru,Honduras,0,0,0,0.5,0.5,1754,1734
1999-12-04,Gambia,Sierra Leone,0,0,0,0.5,0.5,1517,1631
1999-12-04,Malawi,Libya,1,2,1,0.0,1.0,1581,1611
1999-12-05,Panama,Cuba,1,0,1,1.0,0.0,1554,1616
1999-12-11,Malawi,Rwanda,1,1,0,0.5,0.5,1580,1518
1999-12-12,Senegal,Gambia,3,0,3,1.0,0.0,1666,1513
1999-12-12,Saint Lucia,Dominica,3,1,2,1.0,0.0,1530,1456
1999-12-13,Malawi,Rwanda,1,1,0,0.5,0.5,1579,1520
1999-12-13,Saint Lucia,Dominica,2,1,1,1.0,0.0,1537,1450
1999-12-14,Greece,Ghana,1,1,0,0.5,0.5,1777,1714
1999-12-15,Malawi,Rwanda,1,2,1,0.0,1.0,1570,1530
1999-12-16,Greece,Moldova,2,0,2,1.0,0.0,1781,1522
1999-12-16,Honduras,Zambia,7,1,6,1.0,0.0,1743,1756
1999-12-18,Dominica,Saint Lucia,2,1,1,1.0,0.0,1460,1528
1999-12-18,Greece,Estonia,2,2,0,0.5,0.5,1776,1466
1999-12-19,Dominica,Saint Lucia,2,1,1,1.0,0.0,1470,1519
1999-12-21,Morocco,Senegal,0,0,0,0.5,0.5,1842,1670
1999-12-22,Tunisia,Ghana,2,0,2,1.0,0.0,1786,1708
1999-12-23,Libya,Gabon,2,0,2,1.0,0.0,1621,1679
1999-12-23,Catalonia,Yugoslavia,1,0,1,1.0,0.0,1541,1829
1999-12-27,Gabon,Togo,3,2,1,1.0,0.0,1685,1560
1999-12-28,Malaysia,Singapore,1,0,1,1.0,0.0,1569,1596
1999-12-28,Andalusia,Estonia,1,0,1,1.0,0.0,1514,1459
1999-12-29,Costa Rica,Honduras,1,1,0,0.5,0.5,1730,1743
1999-12-29,Ivory Coast,Burkina Faso,3,1,2,1.0,0.0,1755,1629
1999-12-29,Libya,Togo,2,0,2,1.0,0.0,1628,1554
1999-12-29,Basque Country,Nigeria,5,1,4,1.0,0.0,1676,1750
2000-01-04,Egypt,Togo,2,1,1,1.0,0.0,1768,1551
2000-01-07,Tunisia,Togo,7,0,7,1.0,0.0,1790,1548
2000-01-08,Trinidad and Tobago,Canada,0,0,0,0.5,0.5,1703,1709
2000-01-09,Burkina Faso,Gabon,1,1,0,0.5,0.5,1631,1684
2000-01-09,Guatemala,Armenia,1,1,0,0.5,0.5,1669,1522
2000-01-09,Ivory Coast,Egypt,2,0,2,1.0,0.0,1764,1760
2000-01-09,Mexico,Iran,2,1,1,1.0,0.0,1898,1813
2000-01-11,Bermuda,Canada,0,2,2,0.0,1.0,1523,1714
2000-01-11,Burkina Faso,Cameroon,2,2,0,0.5,0.5,1634,1752
2000-01-13,Senegal,Cameroon,0,0,0,0.5,0.5,1672,1751
2000-01-14,China PR,New Zealand,1,0,1,1.0,0.0,1805,1663
2000-01-16,Jamaica,New Zealand,2,1,1,1.0,0.0,1734,1657
2000-01-16,United States,Iran,1,1,0,0.5,0.5,1828,1814
2000-01-18,Ghana,Tunisia,2,0,2,1.0,0.0,1718,1781
2000-01-18,Morocco,Trinidad and Tobago,1,0,1,1.0,0.0,1847,1699
2000-01-19,Panama,Guatemala,2,0,2,1.0,0.0,1565,1659
2000-01-19,Togo,Egypt,1,0,1,1.0,0.0,1561,1748
2000-01-20,Burkina Faso,Algeria,1,0,1,1.0,0.0,1645,1727
2000-01-20,Malta,Qatar,2,0,2,1.0,0.0,1425,1698
2000-01-21,New Zealand,South Korea,0,1,1,0.0,1.0,1653,1842
2000-01-22,Ghana,Cameroon,1,1,0,0.5,0.5,1719,1751
2000-01-23,China PR,Philippines,8,0,8,1.0,0.0,1806,1259
2000-01-23,Egypt,Zambia,2,0,2,1.0,0.0,1757,1748
2000-01-23,New Zealand,South Korea,0,0,0,0.5,0.5,1657,1839
2000-01-23,Nigeria,Tunisia,4,2,2,1.0,0.0,1759,1773
2000-01-23,South Africa,Gabon,3,1,2,1.0,0.0,1757,1678
2000-01-23,Vietnam,Guam,11,0,11,1.0,0.0,1557,1443
2000-01-24,DR Congo,Algeria,0,0,0,0.5,0.5,1674,1726
2000-01-24,Ivory Coast,Togo,1,1,0,0.5,0.5,1760,1566
2000-01-24,Qatar,Bosnia and Herzegovina,2,0,2,1.0,0.0,1703,1540
2000-01-25,Burkina Faso,Senegal,1,3,2,0.0,1.0,1638,1680
2000-01-25,Morocco,Congo,1,0,1,1.0,0.0,1851,1613
2000-01-26,China PR,Guam,19,0,19,1.0,0.0,1808,1442
2000-01-26,Costa Rica,Trinidad and Tobago,2,1,1,1.0,0.0,1738,1692
2000-01-26,Guatemala,Panama,1,1,0,0.5,0.5,1657,1568
2000-01-26,Spain,Poland,3,0,3,1.0,0.0,1963,1784
2000-01-26,Uganda,Libya,3,2,1,1.0,0.0,1634,1620
2000-01-26,Vietnam,Philippines,3,0,3,1.0,0.0,1560,1257
2000-01-27,Ghana,Togo,2,0,2,1.0,0.0,1724,1562
2000-01-27,South Africa,DR Congo,1,0,1,1.0,0.0,1764,1668
2000-01-28,Cameroon,Ivory Coast,3,0,3,1.0,0.0,1760,1752
2000-01-28,Egypt,Senegal,1,0,1,1.0,0.0,1764,1674
2000-01-28,Nigeria,Congo,0,0,0,0.5,0.5,1756,1617
2000-01-28,United States Virgin Islands,Saint Lucia,0,9,9,0.0,1.0,1500,1527
2000-01-29,Algeria,Gabon,3,1,2,1.0,0.0,1733,1672
2000-01-29,Chile,United States,1,2,1,0.0,1.0,1809,1836
2000-01-29,Philippines,Guam,2,0,2,1.0,0.0,1269,1431
2000-01-29,Tunisia,Morocco,0,0,0,0.5,0.5,1775,1850
2000-01-29,Vietnam,China PR,0,2,2,0.0,1.0,1557,1812
2000-01-29,Zambia,Burkina Faso,1,1,0,0.5,0.5,1746,1641
2000-01-30,United States Virgin Islands,Saint Lucia,0,2,2,0.0,1.0,1493,1535
2000-01-31,Cameroon,Togo,0,1,1,0.0,1.0,1748,1575
2000-01-31,Faroe Islands,Finland,0,1,1,0.0,1.0,1442,1646
2000-01-31,Ghana,Ivory Coast,0,2,2,0.0,1.0,1717,1760
2000-01-31,Iceland,Norway,0,0,0,0.5,0.5,1665,1889
2000-01-31,Kuwait,Syria,4,0,4,1.0,0.0,1774,1601
2000-02-01,British Virgin Islands,Saint Lucia,2,3,1,0.0,1.0,1426,1541
2000-02-01,Egypt,Burkina Faso,4,2,2,1.0,0.0,1770,1636
2000-02-01,Zambia,Senegal,2,2,0,0.5,0.5,1745,1676
2000-02-02,Armenia,Moldova,2,1,1,1.0,0.0,1530,1514
2000-02-02,DR Congo,Gabon,0,0,0,0.5,0.5,1669,1672
2000-02-02,Costa Rica,Chile,1,0,1,1.0,0.0,1748,1800
2000-02-02,Cyprus,Lithuania,2,1,1,1.0,0.0,1575,1542
2000-02-02,Finland,Iceland,0,1,1,0.0,1.0,1639,1673
2000-02-02,Romania,Latvia,2,0,2,1.0,0.0,1881,1523
2000-02-02,South Africa,Algeria,1,1,0,0.5,0.5,1764,1734
2000-02-02,Saint Kitts and Nevis,Saint Lucia,0,1,1,0.0,1.0,1533,1549
2000-02-03,Nigeria,Morocco,2,0,2,1.0,0.0,1767,1840
2000-02-03,Tunisia,Congo,1,0,1,1.0,0.0,1780,1613
2000-02-04,Cyprus,Armenia,3,2,1,1.0,0.0,1582,1524
2000-02-04,Faroe Islands,Iceland,2,3,1,0.0,1.0,1439,1677
2000-02-04,Kuwait,Iran,1,1,0,0.5,0.5,1775,1814
2000-02-04,Moldova,Lithuania,2,1,1,1.0,0.0,1523,1534
2000-02-04,Norway,Sweden,1,1,0,0.5,0.5,1890,1911
2000-02-04,Romania,Georgia,1,1,0,0.5,0.5,1876,1558
2000-02-05,Guatemala,Chile,2,1,1,1.0,0.0,1669,1789
2000-02-05,Japan,Mexico,0,1,1,0.0,1.0,1770,1904
2000-02-06,Albania,Andorra,3,0,3,1.0,0.0,1512,1418
2000-02-06,Cameroon,Algeria,2,1,1,1.0,0.0,1756,1727
2000-02-06,Cayman Islands,Jamaica,0,0,0,0.5,0.5,1464,1729
2000-02-06,Cyprus,Romania,3,2,1,1.0,0.0,1596,1863
2000-02-06,Georgia,Armenia,2,1,1,1.0,0.0,1566,1517
2000-02-06,Ghana,South Africa,0,1,1,0.0,1.0,1711,1771
2000-02-06,Latvia,Lithuania,1,2,1,0.0,1.0,1516,1542
2000-02-06,Malta,Azerbaijan,3,0,3,1.0,0.0,1435,1480
2000-02-07,Egypt,Tunisia,0,1,1,0.0,1.0,1763,1788
2000-02-07,Nigeria,Senegal,2,1,1,1.0,0.0,1773,1671
2000-02-07,Singapore,Malaysia,3,1,2,1.0,0.0,1604,1562
2000-02-08,Albania,Azerbaijan,1,0,1,1.0,0.0,1520,1473
2000-02-08,Malta,Andorra,1,1,0,0.5,0.5,1435,1419
2000-02-08,Mexico,Czech Republic,1,2,1,0.0,1.0,1895,1844
2000-02-08,Syria,North Korea,5,1,4,1.0,0.0,1612,1704
2000-02-09,Bulgaria,Slovakia,1,0,1,1.0,0.0,1770,1675
2000-02-09,Cayman Islands,Jamaica,0,1,1,0.0,1.0,1462,1732
2000-02-09,Chile,Australia,2,1,1,1.0,0.0,1799,1838
2000-02-09,Honduras,El Salvador,5,1,4,1.0,0.0,1748,1594
2000-02-10,Andorra,Azerbaijan,0,0,0,0.5,0.5,1421,1472
2000-02-10,Cameroon,Tunisia,3,0,3,1.0,0.0,1765,1780
2000-02-10,Hong Kong,Singapore,0,0,0,0.5,0.5,1549,1603
2000-02-10,Kuwait,Turkmenistan,6,1,5,1.0,0.0,1779,1553
2000-02-10,Malta,Albania,0,1,1,0.0,1.0,1429,1527
2000-02-10,Nepal,Yemen,0,3,3,0.0,1.0,1351,1458
2000-02-10,Nigeria,South Africa,2,0,2,1.0,0.0,1781,1764
2000-02-12,Australia,Slovakia,0,0,0,0.5,0.5,1835,1679
2000-02-12,Chile,Bulgaria,3,2,1,1.0,0.0,1807,1763
2000-02-12,Colombia,Jamaica,1,0,1,1.0,0.0,1802,1726
2000-02-12,Nepal,Bhutan,3,0,3,1.0,0.0,1361,1399
2000-02-12,South Africa,Tunisia,2,2,0,0.5,0.5,1765,1780
2000-02-12,United States,Haiti,3,0,3,1.0,0.0,1840,1605
2000-02-12,Yemen,Turkmenistan,0,1,1,0.0,1.0,1453,1559
2000-02-13,Costa Rica,Canada,2,2,0,0.5,0.5,1748,1715
2000-02-13,Dominican Republic,British Virgin Islands,1,0,1,1.0,0.0,1487,1420
2000-02-13,Macau,Brunei,1,0,1,1.0,0.0,1421,1321
2000-02-13,Mexico,Trinidad and Tobago,4,0,4,1.0,0.0,1899,1689
2000-02-13,Nigeria,Cameroon,2,2,0,0.5,0.5,1781,1766
2000-02-13,Singapore,Japan,0,3,3,0.0,1.0,1599,1775
2000-02-13,Syria,North Korea,0,0,0,0.5,0.5,1615,1702
2000-02-14,Haiti,Peru,1,1,0,0.5,0.5,1609,1751
2000-02-14,Jamaica,Honduras,0,2,2,0.0,1.0,1719,1756
2000-02-14,Kuwait,Bhutan,20,0,20,1.0,0.0,1781,1398
2000-02-14,Turkmenistan,Nepal,5,0,5,1.0,0.0,1563,1358
2000-02-15,Australia,Bulgaria,1,1,0,0.5,0.5,1834,1765
2000-02-15,Canada,South Korea,0,0,0,0.5,0.5,1718,1837
2000-02-15,Chile,Slovakia,0,2,2,0.0,1.0,1797,1690
2000-02-15,Malaysia,Maldives,2,0,2,1.0,0.0,1567,1394
2000-02-15,Trinidad and Tobago,Guatemala,4,2,2,1.0,0.0,1697,1662
2000-02-16,Bhutan,Turkmenistan,0,8,8,0.0,1.0,1394,1568
2000-02-16,Honduras,Colombia,2,0,2,1.0,0.0,1766,1793
2000-02-16,Japan,Brunei,9,0,9,1.0,0.0,1777,1320
2000-02-16,Kuwait,Yemen,2,0,2,1.0,0.0,1784,1451
2000-02-16,Lebanon,North Korea,1,0,1,1.0,0.0,1578,1692
2000-02-16,Macau,Singapore,0,1,1,0.0,1.0,1417,1604
2000-02-16,Panama,El Salvador,4,1,3,1.0,0.0,1577,1586
2000-02-16,United States,Peru,1,0,1,1.0,0.0,1846,1746
2000-02-17,Barbados,Saint Kitts and Nevis,1,0,1,1.0,0.0,1560,1526
2000-02-17,South Korea,Costa Rica,2,2,0,0.5,0.5,1835,1751
2000-02-17,Malaysia,Maldives,3,0,3,1.0,0.0,1572,1390
2000-02-17,Mexico,Guatemala,1,1,0,0.5,0.5,1895,1667
2000-02-18,Kuwait,Nepal,5,0,5,1.0,0.0,1786,1357
2000-02-18,Yemen,Bhutan,11,2,9,1.0,0.0,1458,1388
2000-02-19,Dominica,Antigua and Barbuda,2,0,2,1.0,0.0,1479,1476
2000-02-19,Honduras,Peru,3,5,2,0.0,1.0,1758,1755
2000-02-19,Oman,Switzerland,1,4,3,0.0,1.0,1582,1776
2000-02-19,United Arab Emirates,Slovenia,1,1,0,0.5,0.5,1749,1599
2000-02-19,United States,Colombia,2,2,0,0.5,0.5,1845,1795
2000-02-20,Costa Rica,Trinidad and Tobago,1,2,1,0.0,1.0,1742,1707
2000-02-20,Lesotho,Eswatini,1,0,1,1.0,0.0,1444,1485
2000-02-20,Macau,Japan,0,3,3,0.0,1.0,1416,1779
2000-02-20,Mexico,Canada,1,2,1,0.0,1.0,1884,1730
2000-02-20,Singapore,Brunei,1,0,1,1.0,0.0,1607,1318
2000-02-20,Thailand,Finland,0,0,0,0.5,0.5,1727,1642
2000-02-20,Kernow,Guernsey,1,2,1,0.0,1.0,1500,1639
2000-02-21,Oman,United Arab Emirates,0,1,1,0.0,1.0,1578,1754
2000-02-23,Belgium,Portugal,1,1,0,0.5,0.5,1827,1875
2000-02-23,Colombia,Peru,2,1,1,1.0,0.0,1803,1748
2000-02-23,Croatia,Spain,0,0,0,0.5,0.5,1817,1960
2000-02-23,England,Argentina,0,0,0,0.5,0.5,1952,1941
2000-02-23,Estonia,Finland,2,4,2,0.0,1.0,1455,1647
2000-02-23,France,Poland,1,0,1,1.0,0.0,2015,1781
2000-02-23,Greece,Austria,4,1,3,1.0,0.0,1785,1779
2000-02-23,Hungary,Australia,0,3,3,0.0,1.0,1707,1840
2000-02-23,Republic of Ireland,Czech Republic,3,2,1,1.0,0.0,1803,1835
2000-02-23,Israel,Russia,4,1,3,1.0,0.0,1732,1839
2000-02-23,Italy,Sweden,1,0,1,1.0,0.0,1952,1904
2000-02-23,Lebanon,Jordan,1,1,0,0.5,0.5,1578,1577
2000-02-23,Luxembourg,Northern Ireland,1,3,2,0.0,1.0,1364,1693
2000-02-23,North Macedonia,Serbia,1,2,1,0.0,1.0,1585,1784
2000-02-23,Netherlands,Germany,2,1,1,1.0,0.0,1940,1970
2000-02-23,Oman,Slovenia,0,4,4,0.0,1.0,1571,1607
2000-02-23,Qatar,Wales,0,1,1,0.0,1.0,1695,1707
2000-02-23,Thailand,Brazil,0,7,7,0.0,1.0,1726,2078
2000-02-23,Turkey,Norway,0,2,2,0.0,1.0,1741,1895
2000-02-23,United Arab Emirates,Switzerland,1,0,1,1.0,0.0,1763,1768
2000-02-24,Trinidad and Tobago,Canada,0,1,1,0.0,1.0,1700,1738
2000-02-25,British Virgin Islands,Anguilla,3,4,1,0.0,1.0,1412,1399
2000-02-25,Thailand,Estonia,2,1,1,1.0,0.0,1729,1453
2000-02-27,Botswana,Lesotho,1,0,1,1.0,0.0,1409,1435
2000-02-27,British Virgin Islands,Anguilla,5,0,5,1.0,0.0,1420,1392
2000-02-27,Canada,Colombia,2,0,2,1.0,0.0,1748,1794
2000-02-27,Thailand,Finland,5,1,4,1.0,0.0,1736,1641
2000-02-29,Barbados,Antigua and Barbuda,2,2,0,0.5,0.5,1559,1478
2000-02-29,El Salvador,Panama,3,1,2,1.0,0.0,1594,1570
2000-02-29,Uzbekistan,Mongolia,8,1,7,1.0,0.0,1661,1463
2000-03-01,Zambia,Lesotho,2,0,2,1.0,0.0,1748,1433
2000-03-04,Honduras,Nicaragua,3,0,3,1.0,0.0,1760,1321
2000-03-04,Trinidad and Tobago,Curaçao,5,0,5,1.0,0.0,1705,1525
2000-03-05,Anguilla,Bahamas,1,3,2,0.0,1.0,1386,1482
2000-03-05,Barbados,Grenada,2,2,0,0.5,0.5,1560,1561
2000-03-05,Bolivia,Haiti,9,2,7,1.0,0.0,1716,1604
2000-03-05,British Virgin Islands,Bermuda,1,5,4,0.0,1.0,1415,1529
2000-03-05,Cuba,Cayman Islands,4,0,4,1.0,0.0,1621,1458
2000-03-05,Dominican Republic,Montserrat,3,0,3,1.0,0.0,1495,1454
2000-03-05,El Salvador,Belize,5,0,5,1.0,0.0,1600,1457
2000-03-05,Ethiopia,Sudan,1,0,1,1.0,0.0,1576,1577
2000-03-05,Saint Lucia,Suriname,1,0,1,1.0,0.0,1558,1570
2000-03-05,Saint Vincent and the Grenadines,United States Virgin Islands,9,0,9,1.0,0.0,1540,1486
2000-03-05,Zimbabwe,Lesotho,2,1,1,1.0,0.0,1672,1430
2000-03-06,Syria,Jordan,0,0,0,0.5,0.5,1615,1578
2000-03-08,Ecuador,Honduras,1,3,2,0.0,1.0,1746,1768
2000-03-08,Jordan,Lebanon,1,1,0,0.5,0.5,1578,1578
2000-03-09,Cuba,Nicaragua,4,0,4,1.0,0.0,1624,1319
2000-03-10,Qatar,Sudan,3,0,3,1.0,0.0,1701,1572
2000-03-11,Aruba,Puerto Rico,4,2,2,1.0,0.0,1441,1365
2000-03-11,Haiti,Dominica,4,0,4,1.0,0.0,1610,1474
2000-03-11,Jordan,Bosnia and Herzegovina,0,0,0,0.5,0.5,1578,1541
2000-03-12,United States,Tunisia,1,1,0,0.5,0.5,1844,1782
2000-03-12,Zambia,Malawi,1,1,0,0.5,0.5,1745,1574
2000-03-13,Jordan,Syria,0,0,0,0.5,0.5,1579,1615
2000-03-13,Zambia,Malawi,0,1,1,0.0,1.0,1734,1586
2000-03-15,Japan,China PR,0,0,0,0.5,0.5,1780,1812
2000-03-15,Jordan,Bosnia and Herzegovina,1,2,1,0.0,1.0,1571,1550
2000-03-16,Venezuela,Bolivia,0,0,0,0.5,0.5,1503,1712
2000-03-17,Jordan,Syria,0,0,0,0.5,0.5,1573,1614
2000-03-18,Curaçao,Trinidad and Tobago,1,1,0,0.5,0.5,1529,1702
2000-03-18,Grenada,Barbados,2,3,1,0.0,1.0,1553,1569
2000-03-18,Puerto Rico,Aruba,2,2,0,0.5,0.5,1367,1440
2000-03-18,Saint Kitts and Nevis,Turks and Caicos Islands,8,0,8,1.0,0.0,1534,1486
2000-03-19,Bahamas,Anguilla,2,1,1,1.0,0.0,1488,1381
2000-03-19,Belize,Guatemala,1,2,1,0.0,1.0,1454,1671
2000-03-19,Bermuda,British Virgin Islands,9,0,9,1.0,0.0,1535,1410
2000-03-19,Botswana,Eswatini,3,0,3,1.0,0.0,1419,1476
2000-03-19,Cayman Islands,Cuba,0,0,0,0.5,0.5,1462,1621
2000-03-19,Dominica,Haiti,1,3,2,0.0,1.0,1469,1616
2000-03-19,Montserrat,Dominican Republic,1,3,2,0.0,1.0,1447,1503
2000-03-19,Nicaragua,Panama,0,2,2,0.0,1.0,1316,1574
2000-03-19,Suriname,Saint Lucia,1,0,1,1.0,0.0,1578,1551
2000-03-19,United States Virgin Islands,Saint Vincent and the Grenadines,1,5,4,0.0,1.0,1480,1547
2000-03-20,Bahrain,Kazakhstan,0,1,1,0.0,1.0,1578,1604
2000-03-21,Namibia,Zimbabwe,2,1,1,1.0,0.0,1544,1661
2000-03-21,Saint Kitts and Nevis,Turks and Caicos Islands,6,0,6,1.0,0.0,1541,1480
2000-03-22,Bahrain,Qatar,1,0,1,1.0,0.0,1589,1691
2000-03-22,Chile,Honduras,5,2,3,1.0,0.0,1805,1761
2000-03-22,Cyprus,Iran,0,0,0,0.5,0.5,1601,1810
2000-03-24,Gambia,Mauritania,0,0,0,0.5,0.5,1512,1442
2000-03-25,Bahrain,Jordan,1,1,0,0.5,0.5,1589,1574
2000-03-25,Malaysia,Taiwan,3,0,3,1.0,0.0,1578,1432
2000-03-25,Tanzania,Malawi,1,1,0,0.5,0.5,1512,1585
2000-03-25,Thailand,North Korea,0,0,0,0.5,0.5,1735,1694
2000-03-25,Zambia,Botswana,3,0,3,1.0,0.0,1737,1417
2000-03-25,Alderney,Jersey,0,10,10,0.0,1.0,1283,1720
2000-03-26,Tanzania,Malawi,4,3,1,1.0,0.0,1522,1576
2000-03-27,Malaysia,North Korea,1,1,0,0.5,0.5,1581,1692
2000-03-27,Thailand,Taiwan,2,0,2,1.0,0.0,1738,1430
2000-03-28,Colombia,Brazil,0,0,0,0.5,0.5,1800,2073
2000-03-28,El Salvador,Haiti,3,1,2,1.0,0.0,1609,1608
2000-03-28,Malta,Northern Ireland,0,3,3,0.0,1.0,1427,1696
2000-03-28,Serbia,China PR,1,0,1,1.0,0.0,1793,1804
2000-03-29,Argentina,Chile,4,1,3,1.0,0.0,1947,1800
2000-03-29,Austria,Sweden,1,1,0,0.5,0.5,1782,1902
2000-03-29,Belgium,Netherlands,2,2,0,0.5,0.5,1830,1938
2000-03-29,Bosnia and Herzegovina,North Macedonia,1,0,1,1.0,0.0,1559,1577
2000-03-29,Bulgaria,Belarus,4,1,3,1.0,0.0,1769,1512
2000-03-29,Croatia,Germany,1,1,0,0.5,0.5,1821,1967
2000-03-29,Czech Republic,Australia,3,1,2,1.0,0.0,1844,1832
2000-03-29,Ecuador,Venezuela,2,0,2,1.0,0.0,1750,1500
2000-03-29,Greece,Romania,2,0,2,1.0,0.0,1795,1854
2000-03-29,Hungary,Poland,0,0,0,0.5,0.5,1709,1780
2000-03-29,Israel,Georgia,1,1,0,0.5,0.5,1729,1570
2000-03-29,Malaysia,Thailand,3,2,1,1.0,0.0,1593,1727
2000-03-29,Peru,Paraguay,2,0,2,1.0,0.0,1758,1820
2000-03-29,Portugal,Denmark,2,1,1,1.0,0.0,1884,1882
2000-03-29,Scotland,France,0,2,2,0.0,1.0,1802,2019
2000-03-29,Spain,Italy,2,0,2,1.0,0.0,1968,1945
2000-03-29,Switzerland,Norway,2,2,0,0.5,0.5,1771,1893
2000-03-29,Uruguay,Bolivia,1,0,1,1.0,0.0,1796,1706
2000-03-29,Wales,Finland,1,2,1,0.0,1.0,1698,1651
2000-03-31,Gambia,Mauritania,0,0,0,0.5,0.5,1511,1444
2000-03-31,Jordan,Kazakhstan,0,1,1,0.0,1.0,1567,1612
2000-03-31,Maldives,Iran,0,8,8,0.0,1.0,1389,1812
2000-03-31,Qatar,Palestine,1,0,1,1.0,0.0,1695,1471
2000-03-31,Syria,Bahrain,1,0,1,1.0,0.0,1622,1582
2000-04-01,Aruba,Barbados,1,3,2,0.0,1.0,1435,1575
2000-04-01,Haiti,Bahamas,9,0,9,1.0,0.0,1614,1483
2000-04-01,Zambia,Kenya,1,0,1,1.0,0.0,1744,1644
2000-04-02,Bahrain,Maldives,4,1,3,1.0,0.0,1586,1386
2000-04-02,Cuba,Suriname,1,0,1,1.0,0.0,1629,1571
2000-04-02,Guatemala,El Salvador,0,1,1,0.0,1.0,1662,1619
2000-04-02,Palestine,Pakistan,2,0,2,1.0,0.0,1478,1381
2000-04-02,Panama,Honduras,1,0,1,1.0,0.0,1586,1750
2000-04-02,Qatar,Kazakhstan,3,1,2,1.0,0.0,1702,1606
2000-04-02,Syria,Iran,0,1,1,0.0,1.0,1618,1817
2000-04-02,Trinidad and Tobago,Dominican Republic,3,0,3,1.0,0.0,1706,1500
2000-04-04,Bahrain,Iran,1,0,1,1.0,0.0,1599,1805
2000-04-04,Malaysia,Taiwan,2,3,1,0.0,1.0,1582,1442
2000-04-04,Palestine,Jordan,1,5,4,0.0,1.0,1473,1573
2000-04-04,Qatar,Pakistan,5,0,5,1.0,0.0,1705,1379
2000-04-04,Syria,Maldives,6,0,6,1.0,0.0,1622,1383
2000-04-04,Thailand,North Korea,5,3,2,1.0,0.0,1735,1685
2000-04-05,Myanmar,Mongolia,2,0,2,1.0,0.0,1545,1457
2000-04-05,South Korea,Laos,9,0,9,1.0,0.0,1837,1404
2000-04-06,Kazakhstan,Palestine,2,0,2,1.0,0.0,1612,1468
2000-04-06,Malaysia,North Korea,1,4,3,0.0,1.0,1577,1691
2000-04-06,Pakistan,Jordan,0,5,5,0.0,1.0,1376,1577
2000-04-06,Thailand,Taiwan,1,0,1,1.0,0.0,1738,1440
2000-04-07,Myanmar,Laos,4,0,4,1.0,0.0,1550,1400
2000-04-07,Djibouti,DR Congo,1,1,0,0.5,0.5,1404,1664
2000-04-07,South Korea,Mongolia,6,0,6,1.0,0.0,1839,1456
2000-04-07,Mauritania,Tunisia,1,2,1,0.0,1.0,1442,1785
2000-04-08,Central African Republic,Zimbabwe,0,1,1,0.0,1.0,1448,1665
2000-04-08,Botswana,Zambia,0,1,1,0.0,1.0,1415,1747
2000-04-08,Fiji,Papua New Guinea,5,0,5,1.0,0.0,1667,1492
2000-04-08,Guinea-Bissau,Togo,0,0,0,0.5,0.5,1507,1574
2000-04-08,Madagascar,Gabon,2,0,2,1.0,0.0,1670,1664
2000-04-08,Malawi,Kenya,2,0,2,1.0,0.0,1586,1635
2000-04-08,New Caledonia,Solomon Islands,4,2,2,1.0,0.0,1568,1596
2000-04-08,Pakistan,Kazakhstan,0,4,4,0.0,1.0,1373,1616
2000-04-08,Qatar,Jordan,2,2,0,0.5,0.5,1703,1580
2000-04-08,São Tomé and Príncipe,Sierra Leone,2,0,2,1.0,0.0,1461,1620
2000-04-08,Seychelles,Namibia,1,1,0,0.5,0.5,1429,1542
2000-04-08,Tanzania,Ghana,0,1,1,0.0,1.0,1518,1716
2000-04-08,Thailand,Malaysia,3,2,1,1.0,0.0,1743,1573
2000-04-08,Uganda,Guinea,4,4,0,0.5,0.5,1634,1614
2000-04-09,Benin,Senegal,1,1,0,0.5,0.5,1468,1667
2000-04-09,Cape Verde,Algeria,0,0,0,0.5,0.5,1490,1723
2000-04-09,Chad,Liberia,0,1,1,0.0,1.0,1496,1578
2000-04-09,Equatorial Guinea,Congo,1,3,2,0.0,1.0,1439,1618
2000-04-09,Eritrea,Nigeria,0,0,0,0.5,0.5,1502,1776
2000-04-09,Ethiopia,Burkina Faso,2,1,1,1.0,0.0,1586,1627
2000-04-09,Gambia,Morocco,0,1,1,0.0,1.0,1509,1843
2000-04-09,Iran,Bahrain,3,0,3,1.0,0.0,1809,1596
2000-04-09,South Korea,Myanmar,4,0,4,1.0,0.0,1842,1548
2000-04-09,Laos,Mongolia,2,1,1,1.0,0.0,1410,1447
2000-04-09,Lesotho,South Africa,0,2,2,0.0,1.0,1428,1768
2000-04-09,Libya,Mali,3,0,3,1.0,0.0,1629,1626
2000-04-09,Rwanda,Ivory Coast,2,2,0,0.5,0.5,1535,1756
2000-04-09,Sudan,Mozambique,1,0,1,1.0,0.0,1580,1538
2000-04-09,Eswatini,Angola,0,1,1,0.0,1.0,1472,1660
2000-04-09,Syria,Maldives,2,1,1,1.0,0.0,1626,1380
2000-04-09,Egypt,Mauritius,2,0,2,1.0,0.0,1766,1491
2000-04-10,Fiji,New Caledonia,2,1,1,1.0,0.0,1673,1563
2000-04-10,Solomon Islands,Vanuatu,2,1,1,1.0,0.0,1601,1451
2000-04-11,Bahrain,Maldives,1,0,1,1.0,0.0,1600,1377
2000-04-11,Fiji,Vanuatu,4,1,3,1.0,0.0,1677,1448
2000-04-11,Iran,Syria,1,1,0,0.5,0.5,1806,1630
2000-04-11,New Caledonia,Papua New Guinea,6,1,5,1.0,0.0,1570,1486
2000-04-12,Ethiopia,DR Congo,1,2,1,0.0,1.0,1580,1671
2000-04-13,Bahrain,Syria,0,1,1,0.0,1.0,1593,1638
2000-04-13,Iran,Maldives,3,0,3,1.0,0.0,1808,1376
2000-04-13,Solomon Islands,Papua New Guinea,4,2,2,1.0,0.0,1607,1481
2000-04-13,Vanuatu,New Caledonia,6,0,6,1.0,0.0,1459,1560
2000-04-15,Fiji,Solomon Islands,2,2,0,0.5,0.5,1676,1609
2000-04-15,Malawi,Mozambique,2,1,1,1.0,0.0,1593,1532
2000-04-15,Papua New Guinea,Vanuatu,1,4,3,0.0,1.0,1473,1468
2000-04-16,Antigua and Barbuda,Bermuda,0,0,0,0.5,0.5,1480,1534
2000-04-16,Bahamas,Haiti,0,4,4,0.0,1.0,1478,1620
2000-04-16,Barbados,Aruba,4,0,4,1.0,0.0,1580,1431
2000-04-16,Belize,El Salvador,1,3,2,0.0,1.0,1450,1624
2000-04-16,Dominican Republic,Trinidad and Tobago,0,1,1,0.0,1.0,1497,1710
2000-04-16,Nicaragua,Honduras,0,1,1,0.0,1.0,1315,1752
2000-04-16,Saint Vincent and the Grenadines,Saint Kitts and Nevis,1,0,1,1.0,0.0,1555,1534
2000-04-16,Suriname,Cuba,0,0,0,0.5,0.5,1573,1628
2000-04-16,Uganda,Kenya,2,2,0,0.5,0.5,1635,1635
2000-04-19,Cameroon,Somalia,3,0,3,1.0,0.0,1768,1415
2000-04-19,Mali,Burkina Faso,2,1,1,1.0,0.0,1635,1619
2000-04-21,Algeria,Cape Verde,2,0,2,1.0,0.0,1727,1487
2000-04-22,Gabon,Madagascar,1,0,1,1.0,0.0,1673,1662
2000-04-22,Kenya,Malawi,0,0,0,0.5,0.5,1635,1594
2000-04-22,Morocco,Gambia,2,0,2,1.0,0.0,1846,1507
2000-04-22,Namibia,Seychelles,3,0,3,1.0,0.0,1548,1424
2000-04-22,Nigeria,Eritrea,4,0,4,1.0,0.0,1779,1500
2000-04-22,Sierra Leone,São Tomé and Príncipe,4,0,4,1.0,0.0,1625,1457
2000-04-22,South Africa,Lesotho,1,0,1,1.0,0.0,1770,1427
2000-04-22,Saint Kitts and Nevis,Saint Vincent and the Grenadines,1,2,1,0.0,1.0,1527,1563
2000-04-22,Tunisia,Mauritania,3,0,3,1.0,0.0,1787,1441
2000-04-22,Zambia,Botswana,1,0,1,1.0,0.0,1750,1413
2000-04-23,Angola,Eswatini,7,1,6,1.0,0.0,1665,1468
2000-04-23,Bermuda,Antigua and Barbuda,1,1,0,0.5,0.5,1533,1482
2000-04-23,Burkina Faso,Ethiopia,3,0,3,1.0,0.0,1627,1573
2000-04-23,Cameroon,Somalia,3,0,3,1.0,0.0,1770,1414
2000-04-23,Congo,Equatorial Guinea,2,1,1,1.0,0.0,1623,1435
2000-04-23,DR Congo,Djibouti,9,1,8,1.0,0.0,1674,1402
2000-04-23,Egypt,Mauritius,4,2,2,1.0,0.0,1769,1489
2000-04-23,Ghana,Tanzania,3,2,1,1.0,0.0,1720,1515
2000-04-23,Guinea,Uganda,3,0,3,1.0,0.0,1623,1627
2000-04-23,Ivory Coast,Rwanda,2,0,2,1.0,0.0,1760,1532
2000-04-23,Liberia,Chad,0,0,0,0.5,0.5,1577,1498
2000-04-23,Mali,Libya,3,1,2,1.0,0.0,1643,1622
2000-04-23,Mozambique,Sudan,2,1,1,1.0,0.0,1542,1571
2000-04-23,Senegal,Benin,1,0,1,1.0,0.0,1671,1465
2000-04-23,Togo,Guinea-Bissau,3,0,3,1.0,0.0,1581,1501
2000-04-23,Zimbabwe,Central African Republic,3,1,2,1.0,0.0,1669,1445
2000-04-25,Hong Kong,China PR,0,1,1,0.0,1.0,1547,1807
2000-04-26,Andorra,Belarus,2,0,2,1.0,0.0,1432,1502
2000-04-26,Armenia,Georgia,0,0,0,0.5,0.5,1519,1569
2000-04-26,Austria,Croatia,1,2,1,0.0,1.0,1775,1829
2000-04-26,Bolivia,Colombia,1,1,0,0.5,0.5,1709,1798
2000-04-26,Brazil,Ecuador,3,2,1,1.0,0.0,2076,1748
2000-04-26,Bulgaria,Ukraine,0,1,1,0.0,1.0,1759,1681
2000-04-26,Chile,Peru,1,1,0,0.5,0.5,1800,1759
2000-04-26,Czech Republic,Israel,4,1,3,1.0,0.0,1850,1724
2000-04-26,Denmark,Sweden,0,1,1,0.0,1.0,1875,1910
2000-04-26,France,Slovenia,3,2,1,1.0,0.0,2021,1606
2000-04-26,Germany,Switzerland,1,1,0,0.5,0.5,1963,1776
2000-04-26,Republic of Ireland,Greece,0,1,1,0.0,1.0,1795,1804
2000-04-26,Italy,Portugal,2,0,2,1.0,0.0,1952,1878
2000-04-26,South Korea,Japan,1,0,1,1.0,0.0,1849,1774
2000-04-26,Liechtenstein,Faroe Islands,0,1,1,0.0,1.0,1428,1447
2000-04-26,Lithuania,Latvia,2,1,1,1.0,0.0,1550,1509
2000-04-26,Luxembourg,Estonia,1,1,0,0.5,0.5,1367,1451
2000-04-26,North Macedonia,Albania,1,0,1,1.0,0.0,1584,1521
2000-04-26,Netherlands,Scotland,0,0,0,0.5,0.5,1936,1805
2000-04-26,Northern Ireland,Hungary,0,1,1,0.0,1.0,1689,1717
2000-04-26,Norway,Belgium,0,2,2,0.0,1.0,1884,1840
2000-04-26,Paraguay,Uruguay,1,0,1,1.0,0.0,1828,1789
2000-04-26,Poland,Finland,0,0,0,0.5,0.5,1778,1654
2000-04-26,Romania,Cyprus,2,0,2,1.0,0.0,1858,1598
2000-04-26,Russia,United States,2,0,2,1.0,0.0,1848,1836
2000-04-26,San Marino,Moldova,0,1,1,0.0,1.0,1408,1529
2000-04-26,Venezuela,Argentina,0,4,4,0.0,1.0,1499,1949
2000-04-29,Antigua and Barbuda,Dominica,3,2,1,1.0,0.0,1490,1462
2000-04-29,British Virgin Islands,Sint Maarten,0,0,0,0.5,0.5,1412,1497
2000-04-29,South Africa,Mauritius,3,0,3,1.0,0.0,1773,1487
2000-04-30,British Virgin Islands,Antigua and Barbuda,1,1,0,0.5,0.5,1414,1489
2000-04-30,Dominica,Sint Maarten,3,1,2,1.0,0.0,1471,1489
2000-05-01,Maldives,Sri Lanka,1,1,0,0.5,0.5,1376,1355
2000-05-01,Jersey,Guernsey,1,0,1,1.0,0.0,1727,1633
2000-05-02,Bangladesh,India,1,1,0,0.5,0.5,1471,1532
2000-05-04,Cape Verde,Gambia,1,1,0,0.5,0.5,1488,1507
2000-05-04,Maldives,Bangladesh,1,1,0,0.5,0.5,1379,1469
2000-05-05,Guinea,Mali,3,1,2,1.0,0.0,1632,1635
2000-05-05,Guinea-Bissau,Mauritania,1,0,1,1.0,0.0,1508,1435
2000-05-05,India,Sri Lanka,0,1,1,0.0,1.0,1521,1367
2000-05-06,Cape Verde,Sierra Leone,1,0,1,1.0,0.0,1500,1614
2000-05-06,Gambia,Senegal,1,1,0,0.5,0.5,1511,1668
2000-05-07,Antigua and Barbuda,Saint Vincent and the Grenadines,2,1,1,1.0,0.0,1499,1554
2000-05-07,Bangladesh,Sri Lanka,0,1,1,0.0,1.0,1459,1378
2000-05-07,Cuba,Barbados,1,1,0,0.5,0.5,1627,1582
2000-05-07,El Salvador,Guatemala,1,1,0,0.5,0.5,1625,1662
2000-05-07,Guinea,Mauritania,1,1,0,0.5,0.5,1628,1440
2000-05-07,Honduras,Panama,3,1,2,1.0,0.0,1757,1582
2000-05-07,Mali,Guinea-Bissau,3,2,1,1.0,0.0,1641,1503
2000-05-07,Trinidad and Tobago,Haiti,3,1,2,1.0,0.0,1716,1615
2000-05-08,Cape Verde,Senegal,2,2,0,0.5,0.5,1504,1665
2000-05-08,Gambia,Sierra Leone,2,2,0,0.5,0.5,1514,1612
2000-05-08,Maldives,India,1,0,1,1.0,0.0,1391,1510
2000-05-09,Guinea,Guinea-Bissau,2,1,1,1.0,0.0,1634,1498
2000-05-09,Mali,Mauritania,2,2,0,0.5,0.5,1637,1445
2000-05-10,Maldives,Sri Lanka,1,1,0,0.5,0.5,1391,1379
2000-05-11,Cape Verde,Guinea,2,0,2,1.0,0.0,1515,1624
2000-05-11,Senegal,Mali,2,2,0,0.5,0.5,1665,1638
2000-05-13,Jordan,Lebanon,1,1,0,0.5,0.5,1580,1579
2000-05-14,Cape Verde,Senegal,1,0,1,1.0,0.0,1527,1654
2000-05-14,Guinea,Mali,2,0,2,1.0,0.0,1633,1630
2000-05-14,Jamaica,Panama,0,1,1,0.0,1.0,1708,1594
2000-05-14,Zimbabwe,Namibia,3,2,1,1.0,0.0,1675,1543
2000-05-18,Thailand,Uzbekistan,2,0,2,1.0,0.0,1750,1655
2000-05-19,Guatemala,Belize,0,0,0,0.5,0.5,1658,1455
2000-05-19,Haiti,Trinidad and Tobago,1,1,0,0.5,0.5,1618,1714
2000-05-20,Malawi,Angola,0,0,0,0.5,0.5,1596,1664
2000-05-21,Saint Vincent and the Grenadines,Antigua and Barbuda,4,0,4,1.0,0.0,1561,1493
2000-05-21,Barbados,Cuba,1,1,0,0.5,0.5,1584,1626
2000-05-21,Lebanon,Saudi Arabia,0,0,0,0.5,0.5,1584,1821
2000-05-21,Panama,Nicaragua,4,0,4,1.0,0.0,1597,1313
2000-05-23,Jordan,Kyrgyzstan,2,0,2,1.0,0.0,1586,1449
2000-05-23,Lebanon,Iraq,1,2,1,0.0,1.0,1581,1798
2000-05-23,Wales,Brazil,0,3,3,0.0,1.0,1697,2078
2000-05-24,Iran,Kazakhstan,3,0,3,1.0,0.0,1812,1613
2000-05-24,Slovakia,Saudi Arabia,1,1,0,0.5,0.5,1693,1819
2000-05-24,Syria,Palestine,1,0,1,1.0,0.0,1643,1464
2000-05-25,China PR,Serbia,0,2,2,0.0,1.0,1799,1802
2000-05-25,Jordan,Iraq,0,0,0,0.5,0.5,1591,1794
2000-05-25,Kyrgyzstan,Lebanon,0,2,2,0.0,1.0,1444,1587
2000-05-26,Algeria,Burkina Faso,2,0,2,1.0,0.0,1733,1622
2000-05-26,Kazakhstan,Syria,0,4,4,0.0,1.0,1606,1651
2000-05-26,Palestine,Iran,1,1,0,0.5,0.5,1471,1806
2000-05-27,Canada,Trinidad and Tobago,1,0,1,1.0,0.0,1756,1707
2000-05-27,Cuba,Haiti,0,1,1,0.0,1.0,1618,1627
2000-05-27,England,Brazil,1,1,0,0.5,0.5,1955,2076
2000-05-27,Iraq,Kyrgyzstan,4,0,4,1.0,0.0,1796,1443
2000-05-27,Jamaica,Colombia,0,3,3,0.0,1.0,1703,1804
2000-05-27,Jordan,Lebanon,0,0,0,0.5,0.5,1591,1588
2000-05-27,Netherlands,Romania,2,1,1,1.0,0.0,1943,1852
2000-05-27,Norway,Slovakia,2,0,2,1.0,0.0,1888,1690
2000-05-28,Croatia,France,0,2,2,0.0,1.0,1826,2025
2000-05-28,Iran,Syria,1,0,1,1.0,0.0,1811,1647
2000-05-28,Kazakhstan,Palestine,3,2,1,1.0,0.0,1612,1466
2000-05-28,South Korea,Serbia,0,0,0,0.5,0.5,1848,1804
2000-05-28,Macau,Hong Kong,0,1,1,0.0,1.0,1411,1553
2000-05-28,Malta,South Africa,0,1,1,0.0,1.0,1426,1775
2000-05-29,Cuba,Haiti,1,1,0,0.5,0.5,1619,1627
2000-05-30,Canada,Honduras,2,1,1,1.0,0.0,1765,1749
2000-05-30,Republic of Ireland,Scotland,1,2,1,0.0,1.0,1788,1813
2000-05-30,South Korea,Serbia,0,0,0,0.5,0.5,1847,1806
2000-05-31,England,Ukraine,2,0,2,1.0,0.0,1958,1679
2000-05-31,Hungary,Saudi Arabia,2,2,0,0.5,0.5,1720,1817
2000-05-31,Iraq,Syria,0,0,0,0.5,0.5,1793,1651
2000-05-31,Jordan,Iran,0,1,1,0.0,1.0,1588,1815
2000-05-31,Russia,Slovakia,1,1,0,0.5,0.5,1845,1694
2000-05-31,Venezuela,Panama,3,1,2,1.0,0.0,1510,1587
2000-06-01,Botswana,Mozambique,2,0,2,1.0,0.0,1424,1532
2000-06-01,Eswatini,Lesotho,0,1,1,0.0,1.0,1460,1436
2000-06-02,Iran,Syria,1,0,1,1.0,0.0,1820,1647
2000-06-02,Jordan,Iraq,1,4,3,0.0,1.0,1585,1797
2000-06-02,Lesotho,Mozambique,0,0,0,0.5,0.5,1439,1530
2000-06-02,Portugal,Wales,3,0,3,1.0,0.0,1883,1693
2000-06-02,Singapore,Qatar,1,5,4,0.0,1.0,1602,1709
2000-06-02,Eswatini,Botswana,0,0,0,0.5,0.5,1460,1425
2000-06-03,Algeria,Guinea,4,0,4,1.0,0.0,1739,1628
2000-06-03,Denmark,Belgium,2,2,0,0.5,0.5,1875,1841
2000-06-03,Germany,Czech Republic,3,2,1,1.0,0.0,1969,1845
2000-06-03,Honduras,Haiti,4,0,4,1.0,0.0,1755,1622
2000-06-03,Hungary,Israel,2,1,1,1.0,0.0,1729,1716
2000-06-03,Latvia,Finland,1,0,1,1.0,0.0,1521,1643
2000-06-03,Malta,England,1,2,1,0.0,1.0,1426,1959
2000-06-03,Norway,Italy,1,0,1,1.0,0.0,1898,1943
2000-06-03,Paraguay,Ecuador,3,1,2,1.0,0.0,1835,1742
2000-06-03,Romania,Greece,2,1,1,1.0,0.0,1859,1798
2000-06-03,Slovenia,Saudi Arabia,2,0,2,1.0,0.0,1619,1805
2000-06-03,Sweden,Spain,1,1,0,0.5,0.5,1912,1967
2000-06-03,Uruguay,Chile,2,1,1,1.0,0.0,1798,1792
2000-06-03,United States,South Africa,4,0,4,1.0,0.0,1843,1769
2000-06-04,Argentina,Bolivia,1,0,1,1.0,0.0,1953,1706
2000-06-04,Azerbaijan,Georgia,0,0,0,0.5,0.5,1475,1567
2000-06-04,Benin,Togo,1,2,1,0.0,1.0,1460,1587
2000-06-04,Botswana,Lesotho,1,1,0,0.5,0.5,1426,1439
2000-06-04,Colombia,Venezuela,3,0,3,1.0,0.0,1807,1508
2000-06-04,Cuba,Canada,0,1,1,0.0,1.0,1615,1770
2000-06-04,Estonia,Belarus,2,0,2,1.0,0.0,1461,1493
2000-06-04,France,Japan,2,2,0,0.5,0.5,2021,1779
2000-06-04,Mexico,Republic of Ireland,2,2,0,0.5,0.5,1882,1791
2000-06-04,Moldova,Russia,0,1,1,0.0,1.0,1527,1848
2000-06-04,Morocco,Jamaica,1,0,1,1.0,0.0,1851,1699
2000-06-04,Netherlands,Poland,3,1,2,1.0,0.0,1948,1774
2000-06-04,Nigeria,Malawi,3,2,1,1.0,0.0,1784,1592
2000-06-04,Peru,Brazil,0,1,1,0.0,1.0,1757,2079
2000-06-04,Senegal,Zambia,0,0,0,0.5,0.5,1657,1748
2000-06-04,Eswatini,Mozambique,1,1,0,0.5,0.5,1462,1529
2000-06-06,Jamaica,Japan,0,4,4,0.0,1.0,1693,1786
2000-06-06,Morocco,France,1,5,4,0.0,1.0,1847,2026
2000-06-06,Nigeria,Malawi,4,1,3,1.0,0.0,1788,1589
2000-06-06,Senegal,Zambia,0,0,0,0.5,0.5,1660,1746
2000-06-06,United States,Republic of Ireland,1,1,0,0.5,0.5,1842,1793
2000-06-07,Germany,Liechtenstein,8,2,6,1.0,0.0,1970,1428
2000-06-07,Iran,Egypt,1,1,0,0.5,0.5,1819,1771
2000-06-07,South Korea,North Macedonia,2,1,1,1.0,0.0,1850,1582
2000-06-07,Luxembourg,Spain,0,1,1,0.0,1.0,1367,1968
2000-06-07,Mexico,South Africa,4,2,2,1.0,0.0,1888,1764
2000-06-08,Tonga,Cook Islands,1,2,1,0.0,1.0,1471,1479
2000-06-09,Australia,Paraguay,0,0,0,0.5,0.5,1833,1835
2000-06-09,Egypt,South Korea,0,1,1,0.0,1.0,1765,1857
2000-06-09,Iran,North Macedonia,3,1,2,1.0,0.0,1823,1579
2000-06-10,Belgium,Sweden,2,1,1,1.0,0.0,1851,1903
2000-06-10,Saint Vincent and the Grenadines,Barbados,1,0,1,1.0,0.0,1570,1576
2000-06-10,Thailand,Qatar,2,3,1,0.0,1.0,1742,1718
2000-06-11,Antigua and Barbuda,Guatemala,0,1,1,0.0,1.0,1489,1663
2000-06-11,Canada,Cuba,0,0,0,0.5,0.5,1767,1619
2000-06-11,Estonia,Georgia,1,0,1,1.0,0.0,1472,1557
2000-06-11,France,Denmark,3,0,3,1.0,0.0,2031,1871
2000-06-11,Republic of Ireland,South Africa,2,1,1,1.0,0.0,1801,1757
2000-06-11,Japan,Slovakia,1,1,0,0.5,0.5,1784,1697
2000-06-11,Lesotho,Zambia,0,0,0,0.5,0.5,1445,1741
2000-06-11,Netherlands,Czech Republic,1,0,1,1.0,0.0,1954,1840
2000-06-11,Tunisia,Senegal,4,1,3,1.0,0.0,1793,1655
2000-06-11,Turkey,Italy,1,2,1,0.0,1.0,1738,1947
2000-06-11,United States,Mexico,3,0,3,1.0,0.0,1852,1879
2000-06-11,Gibraltar,Monaco,5,0,5,1.0,0.0,1503,1492
2000-06-12,Australia,Paraguay,0,0,0,0.5,0.5,1834,1835
2000-06-12,Germany,Romania,1,1,0,0.5,0.5,1968,1862
2000-06-12,New Caledonia,Vanuatu,3,1,2,1.0,0.0,1566,1463
2000-06-12,Portugal,England,3,2,1,1.0,0.0,1893,1950
2000-06-13,Serbia,Slovenia,3,3,0,0.5,0.5,1803,1623
2000-06-13,Spain,Norway,0,1,1,0.0,1.0,1959,1908
2000-06-14,American Samoa,Tonga,1,2,1,0.0,1.0,1420,1478
2000-06-14,Belgium,Italy,0,2,2,0.0,1.0,1846,1953
2000-06-14,Bolivia,Slovakia,0,2,2,0.0,1.0,1698,1706
2000-06-14,Kenya,Burkina Faso,0,1,1,0.0,1.0,1627,1631
2000-06-15,Australia,Paraguay,2,1,1,1.0,0.0,1843,1827
2000-06-15,New Caledonia,Vanuatu,1,0,1,1.0,0.0,1572,1458
2000-06-15,Sweden,Turkey,0,0,0,0.5,0.5,1900,1742
2000-06-16,Algeria,Senegal,1,1,0,0.5,0.5,1738,1657
2000-06-16,Czech Republic,France,1,2,1,0.0,1.0,1837,2035
2000-06-16,Netherlands,Denmark,3,0,3,1.0,0.0,1961,1865
2000-06-17,Egypt,Ghana,2,0,2,1.0,0.0,1772,1714
2000-06-17,England,Germany,1,0,1,1.0,0.0,1959,1960
2000-06-17,Haiti,Honduras,1,3,2,0.0,1.0,1617,1761
2000-06-17,Madagascar,DR Congo,3,0,3,1.0,0.0,1671,1666
2000-06-17,Malawi,Burkina Faso,1,1,0,0.5,0.5,1590,1631
2000-06-17,Namibia,Morocco,0,0,0,0.5,0.5,1549,1842
2000-06-17,Nigeria,Sierra Leone,2,0,2,1.0,0.0,1793,1608
2000-06-17,Romania,Portugal,0,1,1,0.0,1.0,1855,1901
2000-06-18,Angola,Zambia,2,1,1,1.0,0.0,1674,1732
2000-06-18,Guatemala,Antigua and Barbuda,8,1,7,1.0,0.0,1668,1485
2000-06-18,Ivory Coast,Tunisia,2,2,0,0.5,0.5,1761,1793
2000-06-18,Japan,Bolivia,2,0,2,1.0,0.0,1791,1692
2000-06-18,Libya,Cameroon,0,3,3,0.0,1.0,1618,1775
2000-06-18,Norway,Serbia,0,1,1,0.0,1.0,1898,1814
2000-06-18,Slovenia,Spain,1,2,1,0.0,1.0,1621,1962
2000-06-18,South Africa,Eswatini,2,0,2,1.0,0.0,1760,1460
2000-06-18,Sudan,Liberia,2,0,2,1.0,0.0,1580,1569
2000-06-19,Australia,Cook Islands,17,0,17,1.0,0.0,1845,1478
2000-06-19,Belgium,Turkey,0,2,2,0.0,1.0,1836,1753
2000-06-19,Italy,Sweden,2,1,1,1.0,0.0,1960,1894
2000-06-19,Tahiti,New Zealand,0,2,2,0.0,1.0,1725,1667
2000-06-20,England,Romania,2,3,1,0.0,1.0,1949,1866
2000-06-20,Madagascar,Mauritius,1,1,0,0.5,0.5,1668,1491
2000-06-20,Portugal,Germany,3,0,3,1.0,0.0,1911,1951
2000-06-21,Denmark,Czech Republic,0,2,2,0.0,1.0,1857,1846
2000-06-21,Netherlands,France,3,2,1,1.0,0.0,1971,2026
2000-06-21,New Zealand,Vanuatu,3,1,2,1.0,0.0,1671,1455
2000-06-21,Paraguay,Costa Rica,1,0,1,1.0,0.0,1834,1736
2000-06-21,Serbia,Spain,3,4,1,0.0,1.0,1810,1967
2000-06-21,Slovenia,Norway,0,0,0,0.5,0.5,1627,1893
2000-06-21,Solomon Islands,Cook Islands,5,1,4,1.0,0.0,1615,1473
2000-06-22,Tahiti,Vanuatu,2,3,1,0.0,1.0,1712,1469
2000-06-23,Gabon,Congo,0,2,2,0.0,1.0,1664,1633
2000-06-23,Solomon Islands,Australia,0,6,6,0.0,1.0,1612,1849
2000-06-24,Italy,Romania,2,0,2,1.0,0.0,1966,1861
2000-06-24,Madagascar,Mauritius,1,0,1,1.0,0.0,1673,1487
2000-06-24,Turkey,Portugal,0,2,2,0.0,1.0,1749,1916
2000-06-24,Uganda,Rwanda,2,1,1,1.0,0.0,1633,1527
2000-06-25,Australia,Vanuatu,1,0,1,1.0,0.0,1851,1468
2000-06-25,Ecuador,Panama,5,0,5,1.0,0.0,1747,1583
2000-06-25,Gabon,Congo,2,3,1,0.0,1.0,1656,1642
2000-06-25,Lebanon,Kuwait,3,1,2,1.0,0.0,1601,1774
2000-06-25,Netherlands,Serbia,6,1,5,1.0,0.0,1976,1806
2000-06-25,New Zealand,Solomon Islands,2,0,2,1.0,0.0,1678,1606
2000-06-25,Spain,France,1,2,1,0.0,1.0,1961,2033
2000-06-28,Australia,New Zealand,2,0,2,1.0,0.0,1856,1674
2000-06-28,Brazil,Uruguay,1,1,0,0.5,0.5,2074,1804
2000-06-28,France,Portugal,2,1,1,1.0,0.0,2039,1911
2000-06-28,Tunisia,Algeria,2,2,0,0.5,0.5,1792,1740
2000-06-28,Vanuatu,Solomon Islands,1,2,1,0.0,1.0,1464,1611
2000-06-28,Venezuela,Bolivia,4,2,2,1.0,0.0,1520,1681
2000-06-29,Barbados,Trinidad and Tobago,0,0,0,0.5,0.5,1579,1705
2000-06-29,Chile,Paraguay,3,1,2,1.0,0.0,1801,1826
2000-06-29,Colombia,Argentina,1,3,2,0.0,1.0,1803,1958
2000-06-29,Ecuador,Peru,2,1,1,1.0,0.0,1756,1749
2000-06-29,Netherlands,Italy,0,0,0,0.5,0.5,1976,1967
2000-06-30,Chad,Libya,3,1,2,1.0,0.0,1509,1608
2000-06-30,Djibouti,Burundi,1,3,2,0.0,1.0,1398,1576
2000-07-01,Botswana,Madagascar,1,0,1,1.0,0.0,1439,1661
2000-07-01,Costa Rica,Panama,5,1,4,1.0,0.0,1741,1579
2000-07-01,El Salvador,Mexico,0,3,3,0.0,1.0,1622,1883
2000-07-01,Gambia,Guinea,2,2,0,0.5,0.5,1517,1626
2000-07-01,São Tomé and Príncipe,Gabon,1,1,0,0.5,0.5,1462,1652
2000-07-01,Seychelles,Zimbabwe,0,1,1,0.0,1.0,1421,1679
2000-07-01,Tanzania,Mauritius,0,1,1,0.0,1.0,1507,1496
2000-07-01,Uganda,Malawi,3,1,2,1.0,0.0,1641,1583
2000-07-02,Benin,Namibia,2,0,2,1.0,0.0,1471,1539
2000-07-02,Central African Republic,DR Congo,1,1,0,0.5,0.5,1450,1662
2000-07-02,Equatorial Guinea,Angola,0,1,1,0.0,1.0,1432,1678
2000-07-02,Ethiopia,Zambia,1,0,1,1.0,0.0,1585,1721
2000-07-02,France,Italy,2,1,1,1.0,0.0,2046,1961
2000-07-02,Jamaica,Cuba,1,1,0,0.5,0.5,1692,1621
2000-07-02,Lesotho,Mozambique,1,0,1,1.0,0.0,1455,1520
2000-07-02,Niger,Ivory Coast,0,1,1,0.0,1.0,1537,1765
2000-07-02,Rwanda,Congo,2,1,1,1.0,0.0,1538,1632
2000-07-02,Saint Vincent and the Grenadines,Trinidad and Tobago,2,1,1,1.0,0.0,1581,1695
2000-07-02,Sudan,Eritrea,5,1,4,1.0,0.0,1587,1494
2000-07-02,Eswatini,Kenya,3,2,1,1.0,0.0,1472,1616
2000-07-03,Guatemala,Haiti,4,1,3,1.0,0.0,1675,1611
2000-07-04,Rwanda,Uganda,2,0,2,1.0,0.0,1549,1631
2000-07-04,Trinidad and Tobago,Cuba,4,1,3,1.0,0.0,1702,1615
2000-07-05,Jamaica,Barbados,5,0,5,1.0,0.0,1698,1574
2000-07-05,Mexico,Venezuela,2,1,1,1.0,0.0,1885,1519
2000-07-06,Cape Verde,Angola,1,1,0,0.5,0.5,1531,1675
2000-07-06,Malawi,Namibia,1,2,1,0.0,1.0,1574,1549
2000-07-07,El Salvador,Guatemala,0,1,1,0.0,1.0,1616,1682
2000-07-08,Trinidad and Tobago,Jamaica,2,4,2,0.0,1.0,1694,1707
2000-07-08,Tunisia,Madagascar,1,0,1,1.0,0.0,1798,1656
2000-07-08,Zambia,Togo,2,0,2,1.0,0.0,1727,1582
2000-07-09,Cameroon,Angola,3,0,3,1.0,0.0,1781,1670
2000-07-09,DR Congo,Congo,2,0,2,1.0,0.0,1670,1625
2000-07-09,Ghana,Sierra Leone,5,0,5,1.0,0.0,1720,1603
2000-07-09,Liberia,Nigeria,2,1,1,1.0,0.0,1582,1781
2000-07-09,Morocco,Algeria,2,1,1,1.0,0.0,1848,1735
2000-07-09,Senegal,Egypt,0,0,0,0.5,0.5,1660,1770
2000-07-09,Zimbabwe,South Africa,0,2,2,0.0,1.0,1673,1767
2000-07-14,Libya,Chad,3,1,2,1.0,0.0,1614,1504
2000-07-15,Burundi,Djibouti,1,0,1,1.0,0.0,1581,1394
2000-07-15,Eritrea,Sudan,2,1,1,1.0,0.0,1505,1577
2000-07-15,Gabon,São Tomé and Príncipe,4,1,3,1.0,0.0,1657,1458
2000-07-15,Kenya,Eswatini,3,0,3,1.0,0.0,1621,1468
2000-07-15,Madagascar,Botswana,2,0,2,1.0,0.0,1660,1436
2000-07-15,Malawi,Uganda,1,2,1,0.0,1.0,1568,1638
2000-07-15,Namibia,Benin,8,2,6,1.0,0.0,1556,1465
2000-07-15,Zambia,Ethiopia,2,0,2,1.0,0.0,1732,1581
2000-07-16,Saint Vincent and the Grenadines,Jamaica,0,1,1,0.0,1.0,1576,1713
2000-07-16,Angola,Equatorial Guinea,4,1,3,1.0,0.0,1674,1429
2000-07-16,Barbados,Costa Rica,2,1,1,1.0,0.0,1586,1730
2000-07-16,Canada,Trinidad and Tobago,0,2,2,0.0,1.0,1758,1704
2000-07-16,Congo,Rwanda,5,1,4,1.0,0.0,1632,1543
2000-07-16,DR Congo,Central African Republic,2,0,2,1.0,0.0,1674,1447
2000-07-16,El Salvador,Honduras,2,5,3,0.0,1.0,1612,1766
2000-07-16,Guatemala,United States,1,1,0,0.5,0.5,1686,1849
2000-07-16,Guinea,Gambia,2,0,2,1.0,0.0,1632,1512
2000-07-16,Ivory Coast,Niger,6,0,6,1.0,0.0,1769,1534
2000-07-16,Mauritius,Tanzania,3,2,1,1.0,0.0,1505,1499
2000-07-16,Mozambique,Lesotho,1,0,1,1.0,0.0,1527,1449
2000-07-16,Zimbabwe,Seychelles,5,0,5,1.0,0.0,1677,1418
2000-07-16,Panama,Mexico,0,1,1,0.0,1.0,1577,1888
2000-07-18,Paraguay,Brazil,2,1,1,1.0,0.0,1839,2062
2000-07-18,Uruguay,Venezuela,3,1,2,1.0,0.0,1807,1517
2000-07-19,Argentina,Ecuador,2,0,2,1.0,0.0,1962,1753
2000-07-19,Bolivia,Chile,1,0,1,1.0,0.0,1692,1791
2000-07-19,Peru,Colombia,0,1,1,0.0,1.0,1743,1810
2000-07-22,Guatemala,Barbados,2,0,2,1.0,0.0,1692,1581
2000-07-23,El Salvador,Saint Vincent and the Grenadines,7,1,6,1.0,0.0,1620,1569
2000-07-23,Costa Rica,United States,2,1,1,1.0,0.0,1741,1839
2000-07-23,Jamaica,Honduras,3,1,2,1.0,0.0,1723,1757
2000-07-23,Lesotho,Angola,2,1,1,1.0,0.0,1462,1662
2000-07-23,Panama,Canada,0,0,0,0.5,0.5,1581,1755
2000-07-23,Trinidad and Tobago,Mexico,1,0,1,1.0,0.0,1716,1877
2000-07-25,Ecuador,Colombia,0,0,0,0.5,0.5,1755,1809
2000-07-25,Venezuela,Chile,0,2,2,0.0,1.0,1515,1794
2000-07-26,Brazil,Argentina,3,1,2,1.0,0.0,2068,1957
2000-07-26,Bulgaria,Azerbaijan,2,1,1,1.0,0.0,1762,1473
2000-07-26,Uruguay,Peru,0,0,0,0.5,0.5,1806,1745
2000-07-27,Azerbaijan,North Macedonia,1,2,1,0.0,1.0,1468,1585
2000-07-27,Bolivia,Paraguay,0,0,0,0.5,0.5,1696,1836
2000-07-27,Iceland,Malta,5,0,5,1.0,0.0,1681,1423
2000-07-28,China PR,South Korea,0,1,1,0.0,1.0,1793,1864
2000-07-29,Bangladesh,India,0,1,1,0.0,1.0,1453,1517
2000-07-29,South Africa,Zimbabwe,0,1,1,0.0,1.0,1757,1688
2000-08-05,El Salvador,Haiti,1,2,1,0.0,1.0,1612,1620
2000-08-05,Lebanon,Oman,3,1,2,1.0,0.0,1609,1564
2000-08-06,Guyana,Trinidad and Tobago,0,0,0,0.5,0.5,1454,1711
2000-08-06,Malaysia,Myanmar,6,0,6,1.0,0.0,1581,1541
2000-08-08,Lebanon,Oman,1,2,1,0.0,1.0,1600,1574
2000-08-09,Malaysia,Myanmar,1,2,1,0.0,1.0,1573,1550
2000-08-09,Syria,Bahrain,1,0,1,1.0,0.0,1654,1587
2000-08-10,Costa Rica,Venezuela,1,5,4,0.0,1.0,1729,1528
2000-08-11,Bahrain,Jordan,0,2,2,0.0,1.0,1579,1594
2000-08-11,Panama,Ecuador,0,0,0,0.5,0.5,1585,1752
2000-08-13,Lesotho,Zimbabwe,0,3,3,0.0,1.0,1459,1692
2000-08-13,Malaysia,New Zealand,0,0,0,0.5,0.5,1576,1672
2000-08-13,Syria,Jordan,1,0,1,1.0,0.0,1661,1588
2000-08-15,Albania,Cyprus,0,0,0,0.5,0.5,1523,1597
2000-08-15,Chile,Brazil,3,0,3,1.0,0.0,1808,2055
2000-08-15,Colombia,Uruguay,1,0,1,1.0,0.0,1817,1799
2000-08-15,Costa Rica,Guatemala,2,1,1,1.0,0.0,1737,1685
2000-08-15,Malaysia,Oman,2,0,2,1.0,0.0,1584,1567
2000-08-15,Mexico,Canada,2,0,2,1.0,0.0,1883,1750
2000-08-16,Honduras,Saint Vincent and the Grenadines,6,0,6,1.0,0.0,1762,1565
2000-08-16,Argentina,Paraguay,1,1,0,0.5,0.5,1955,1839
2000-08-16,Bosnia and Herzegovina,Turkey,2,0,2,1.0,0.0,1571,1738
2000-08-16,Bulgaria,Belgium,1,3,2,0.0,1.0,1756,1843
2000-08-16,Czech Republic,Slovenia,0,1,1,0.0,1.0,1834,1640
2000-08-16,Ecuador,Bolivia,2,0,2,1.0,0.0,1759,1690
2000-08-16,Estonia,Andorra,1,0,1,1.0,0.0,1480,1425
2000-08-16,Faroe Islands,Denmark,0,2,2,0.0,1.0,1446,1859
2000-08-16,Finland,Norway,3,1,2,1.0,0.0,1656,1881
2000-08-16,Germany,Spain,4,1,3,1.0,0.0,1960,1953
2000-08-16,Hungary,Austria,1,1,0,0.5,0.5,1731,1774
2000-08-16,Iceland,Sweden,2,1,1,1.0,0.0,1694,1882
2000-08-16,Iran,Georgia,2,1,1,1.0,0.0,1826,1555
2000-08-16,Jamaica,El Salvador,1,0,1,1.0,0.0,1729,1607
2000-08-16,Japan,United Arab Emirates,3,1,2,1.0,0.0,1799,1756
2000-08-16,Latvia,Belarus,0,1,1,0.0,1.0,1513,1502
2000-08-16,Moldova,Malta,1,0,1,1.0,0.0,1533,1418
2000-08-16,Northern Ireland,Serbia,1,2,1,0.0,1.0,1684,1812
2000-08-16,Peru,Venezuela,1,0,1,1.0,0.0,1749,1525
2000-08-16,Portugal,Lithuania,5,1,4,1.0,0.0,1913,1549
2000-08-16,Romania,Poland,1,1,0,0.5,0.5,1860,1776
2000-08-16,Russia,Israel,1,0,1,1.0,0.0,1854,1711
2000-08-16,Slovakia,Croatia,1,1,0,0.5,0.5,1709,1824
2000-08-16,Switzerland,Greece,2,2,0,0.5,0.5,1777,1798
2000-08-16,Trinidad and Tobago,Panama,6,0,6,1.0,0.0,1717,1580
2000-08-16,United States,Barbados,7,0,7,1.0,0.0,1842,1579
2000-08-17,New Zealand,Oman,1,0,1,1.0,0.0,1678,1562
2000-08-19,Malaysia,New Zealand,0,2,2,0.0,1.0,1579,1684
2000-08-20,Haiti,Honduras,0,4,4,0.0,1.0,1616,1767
2000-08-20,Sierra Leone,Togo,2,0,2,1.0,0.0,1611,1575
2000-08-25,Egypt,Kenya,2,1,1,1.0,0.0,1775,1617
2000-08-25,Vietnam,Sri Lanka,2,2,0,0.5,0.5,1554,1383
2000-08-27,Cayman Islands,Jamaica,0,6,6,0.0,1.0,1460,1732
2000-08-27,Zimbabwe,Lesotho,3,0,3,1.0,0.0,1696,1456
2000-08-28,Indonesia,Myanmar,4,1,3,1.0,0.0,1603,1544
2000-08-28,Iraq,Taiwan,3,0,3,1.0,0.0,1799,1439
2000-08-30,Myanmar,Iraq,0,1,1,0.0,1.0,1542,1802
2000-08-30,Indonesia,Taiwan,1,0,1,1.0,0.0,1608,1435
2000-09-01,Austria,Iran,5,1,4,1.0,0.0,1784,1817
2000-09-01,Indonesia,Iraq,0,0,0,0.5,0.5,1613,1798
2000-09-02,Andorra,Cyprus,2,3,1,0.0,1.0,1421,1602
2000-09-02,Azerbaijan,Sweden,0,1,1,0.0,1.0,1467,1884
2000-09-02,Belarus,Wales,2,1,1,1.0,0.0,1515,1681
2000-09-02,Belgium,Croatia,0,0,0,0.5,0.5,1843,1825
2000-09-02,Bosnia and Herzegovina,Spain,1,2,1,0.0,1.0,1570,1955
2000-09-02,Bulgaria,Czech Republic,0,1,1,0.0,1.0,1750,1841
2000-09-02,Chile,Colombia,0,1,1,0.0,1.0,1801,1825
2000-09-02,China PR,Thailand,3,1,2,1.0,0.0,1800,1736
2000-09-02,Egypt,Ivory Coast,1,0,1,1.0,0.0,1783,1762
2000-09-02,Finland,Albania,2,1,1,1.0,0.0,1662,1518
2000-09-02,France,England,1,1,0,0.5,0.5,2044,1952
2000-09-02,Gabon,Morocco,2,0,2,1.0,0.0,1670,1836
2000-09-02,Germany,Greece,2,0,2,1.0,0.0,1965,1794
2000-09-02,Honduras,El Salvador,5,0,5,1.0,0.0,1772,1603
2000-09-02,Iceland,Denmark,1,2,1,0.0,1.0,1690,1864
2000-09-02,Iraq,Uzbekistan,2,0,2,1.0,0.0,1803,1651
2000-09-02,Netherlands,Republic of Ireland,2,2,0,0.5,0.5,1973,1805
2000-09-02,Nigeria,Namibia,4,0,4,1.0,0.0,1785,1553
2000-09-02,Northern Ireland,Malta,1,0,1,1.0,0.0,1687,1416
2000-09-02,Norway,Armenia,0,0,0,0.5,0.5,1875,1526
2000-09-02,Paraguay,Venezuela,3,0,3,1.0,0.0,1842,1523
2000-09-02,Switzerland,Russia,0,1,1,0.0,1.0,1771,1861
2000-09-02,Turkey,Moldova,2,0,2,1.0,0.0,1742,1530
2000-09-02,Ukraine,Poland,1,3,2,0.0,1.0,1674,1782
2000-09-02,Zambia,Madagascar,1,2,1,0.0,1.0,1723,1670
2000-09-03,Jamaica,Saint Vincent and the Grenadines,2,0,2,1.0,0.0,1737,1561
2000-09-03,Latvia,Scotland,0,1,1,0.0,1.0,1511,1816
2000-09-03,Algeria,Burkina Faso,1,1,0,0.5,0.5,1733,1634
2000-09-03,Brazil,Bolivia,5,0,5,1.0,0.0,2057,1689
2000-09-03,Burundi,Angola,0,0,0,0.5,0.5,1583,1661
2000-09-03,China PR,Iraq,4,1,3,1.0,0.0,1809,1795
2000-09-03,Congo,South Africa,1,2,1,0.0,1.0,1627,1763
2000-09-03,Costa Rica,Barbados,3,0,3,1.0,0.0,1742,1575
2000-09-03,Estonia,Portugal,1,3,2,0.0,1.0,1479,1915
2000-09-03,Faroe Islands,Slovenia,2,2,0,0.5,0.5,1451,1636
2000-09-03,Hungary,Italy,2,2,0,0.5,0.5,1736,1957
2000-09-03,Indonesia,Iraq,3,0,3,1.0,0.0,1625,1784
2000-09-03,Israel,Liechtenstein,2,0,2,1.0,0.0,1714,1426
2000-09-03,Kenya,Tunisia,0,0,0,0.5,0.5,1621,1795
2000-09-03,Lesotho,Ghana,3,3,0,0.5,0.5,1462,1715
2000-09-03,Liberia,Mauritius,4,0,4,1.0,0.0,1589,1499
2000-09-03,Luxembourg,Serbia,0,2,2,0.0,1.0,1366,1814
2000-09-03,Mexico,Panama,7,1,6,1.0,0.0,1886,1578
2000-09-03,Peru,Argentina,1,2,1,0.0,1.0,1746,1959
2000-09-03,Romania,Lithuania,1,0,1,1.0,0.0,1863,1547
2000-09-03,Slovakia,North Macedonia,2,0,2,1.0,0.0,1715,1580
2000-09-03,Thailand,Uzbekistan,4,2,2,1.0,0.0,1743,1645
2000-09-03,Togo,Sierra Leone,2,0,2,1.0,0.0,1584,1603
2000-09-03,Trinidad and Tobago,Canada,4,0,4,1.0,0.0,1726,1742
2000-09-03,Uruguay,Ecuador,4,0,4,1.0,0.0,1807,1752
2000-09-03,United States,Guatemala,1,0,1,1.0,0.0,1847,1681
2000-09-03,Zimbabwe,DR Congo,3,2,1,1.0,0.0,1704,1667
2000-09-07,Lebanon,United Arab Emirates,0,1,1,0.0,1.0,1596,1761
2000-09-10,Lebanon,United Arab Emirates,2,2,0,0.5,0.5,1600,1758
2000-09-10,Libya,Sudan,1,0,1,1.0,0.0,1622,1570
2000-09-20,Mexico,Ecuador,2,0,2,1.0,0.0,1892,1747
2000-09-24,Qatar,Kuwait,0,0,0,0.5,0.5,1720,1773
2000-09-24,Saudi Arabia,Syria,2,1,1,1.0,0.0,1810,1657
2000-09-24,Senegal,Togo,0,0,0,0.5,0.5,1659,1586
2000-09-24,Zanzibar,Tanzania,0,1,1,0.0,1.0,1405,1506
2000-09-26,Saudi Arabia,Syria,3,0,3,1.0,0.0,1815,1653
2000-09-27,Cayman Islands,Turks and Caicos Islands,3,0,3,1.0,0.0,1469,1472
2000-09-27,Mexico,Bolivia,1,0,1,1.0,0.0,1896,1686
2000-09-27,Qatar,Iran,1,2,1,0.0,1.0,1715,1823
2000-09-28,Saudi Arabia,United Arab Emirates,6,1,5,1.0,0.0,1822,1752
2000-09-30,Kenya,Burundi,1,0,1,1.0,0.0,1629,1576
2000-09-30,Kuwait,Thailand,3,2,1,1.0,0.0,1781,1736
2000-10-01,Kenya,Lesotho,1,1,0,0.5,0.5,1626,1466
2000-10-02,Jordan,Saudi Arabia,1,0,1,1.0,0.0,1601,1810
2000-10-02,Qatar,Egypt,0,1,1,0.0,1.0,1709,1790
2000-10-03,Kenya,Burundi,2,3,1,0.0,1.0,1617,1586
2000-10-04,Australia,Kuwait,1,0,1,1.0,0.0,1863,1775
2000-10-04,France,Cameroon,1,1,0,0.5,0.5,2039,1787
2000-10-04,United Arab Emirates,South Korea,1,1,0,0.5,0.5,1755,1862
2000-10-05,China PR,Saudi Arabia,0,2,2,0.0,1.0,1802,1818
2000-10-06,North Macedonia,Azerbaijan,3,0,3,1.0,0.0,1586,1462
2000-10-06,Qatar,Thailand,1,1,0,0.5,0.5,1710,1736
2000-10-07,Andorra,Estonia,1,2,1,0.0,1.0,1415,1486
2000-10-07,Armenia,Ukraine,2,3,1,0.0,1.0,1522,1679
2000-10-07,Australia,South Korea,2,4,2,0.0,1.0,1855,1871
2000-10-07,Bulgaria,Malta,3,0,3,1.0,0.0,1753,1414
2000-10-07,Burkina Faso,Burundi,1,0,1,1.0,0.0,1641,1580
2000-10-07,Colombia,Paraguay,0,2,2,0.0,1.0,1818,1850
2000-10-07,Cyprus,Netherlands,0,4,4,0.0,1.0,1601,1975
2000-10-07,Czech Republic,Iceland,4,0,4,1.0,0.0,1846,1686
2000-10-07,England,Germany,0,1,1,0.0,1.0,1945,1973
2000-10-07,Greece,Finland,1,0,1,1.0,0.0,1800,1657
2000-10-07,Italy,Romania,3,0,3,1.0,0.0,1963,1858
2000-10-07,Jordan,China PR,1,1,0,0.5,0.5,1606,1798
2000-10-07,Latvia,Belgium,0,4,4,0.0,1.0,1509,1846
2000-10-07,Liechtenstein,Austria,0,1,1,0.0,1.0,1425,1786
2000-10-07,Lithuania,Georgia,0,4,4,0.0,1.0,1540,1563
2000-10-07,Luxembourg,Slovenia,1,2,1,0.0,1.0,1364,1639
2000-10-07,Madagascar,Nigeria,0,0,0,0.5,0.5,1673,1783
2000-10-07,Moldova,Slovakia,0,1,1,0.0,1.0,1526,1720
2000-10-07,Northern Ireland,Denmark,1,1,0,0.5,0.5,1691,1861
2000-10-07,Poland,Belarus,3,1,2,1.0,0.0,1785,1513
2000-10-07,Portugal,Republic of Ireland,1,1,0,0.5,0.5,1913,1808
2000-10-07,San Marino,Scotland,0,2,2,0.0,1.0,1407,1818
2000-10-07,Saudi Arabia,Kazakhstan,1,0,1,1.0,0.0,1822,1609
2000-10-07,South Africa,France,0,0,0,0.5,0.5,1769,2034
2000-10-07,Spain,Israel,2,0,2,1.0,0.0,1959,1711
2000-10-07,Sweden,Turkey,1,1,0,0.5,0.5,1881,1746
2000-10-07,Switzerland,Faroe Islands,5,1,4,1.0,0.0,1774,1449
2000-10-07,Tunisia,Gabon,4,2,2,1.0,0.0,1801,1665
2000-10-07,United Arab Emirates,Kuwait,1,0,1,1.0,0.0,1764,1767
2000-10-07,Wales,Norway,1,1,0,0.5,0.5,1686,1871
2000-10-08,Saint Vincent and the Grenadines,El Salvador,1,2,1,0.0,1.0,1554,1611
2000-10-08,Angola,Algeria,2,2,0,0.5,0.5,1663,1732
2000-10-08,Argentina,Uruguay,2,1,1,1.0,0.0,1964,1803
2000-10-08,Barbados,Guatemala,1,3,2,0.0,1.0,1570,1687
2000-10-08,Bolivia,Peru,1,0,1,1.0,0.0,1696,1737
2000-10-08,Ecuador,Chile,1,0,1,1.0,0.0,1757,1792
2000-10-08,Honduras,Jamaica,1,0,1,1.0,0.0,1780,1730
2000-10-08,Hong Kong,Singapore,1,0,1,1.0,0.0,1563,1593
2000-10-08,Ghana,Zimbabwe,4,1,3,1.0,0.0,1723,1697
2000-10-08,Mauritius,Congo,1,2,1,0.0,1.0,1494,1633
2000-10-08,Mexico,Trinidad and Tobago,7,0,7,1.0,0.0,1901,1722
2000-10-08,Morocco,Kenya,1,0,1,1.0,0.0,1840,1614
2000-10-08,Namibia,Zambia,1,2,1,0.0,1.0,1549,1728
2000-10-08,Qatar,Thailand,3,1,2,1.0,0.0,1719,1728
2000-10-08,Sudan,Egypt,0,1,1,0.0,1.0,1567,1794
2000-10-08,Togo,Uganda,3,0,3,1.0,0.0,1596,1629
2000-10-08,Uzbekistan,Turkmenistan,3,0,3,1.0,0.0,1652,1562
2000-10-08,Venezuela,Brazil,0,6,6,0.0,1.0,1523,2058
2000-10-09,Canada,Panama,1,0,1,1.0,0.0,1747,1574
2000-10-10,DR Congo,Lesotho,1,1,0,0.5,0.5,1663,1471
2000-10-11,Albania,Greece,2,0,2,1.0,0.0,1532,1787
2000-10-11,Austria,Spain,1,1,0,0.5,0.5,1790,1956
2000-10-11,Azerbaijan,Turkey,0,1,1,0.0,1.0,1460,1749
2000-10-11,Belarus,Armenia,2,1,1,1.0,0.0,1522,1514
2000-10-11,Croatia,Scotland,1,1,0,0.5,0.5,1825,1819
2000-10-11,Denmark,Bulgaria,1,1,0,0.5,0.5,1859,1756
2000-10-11,Finland,England,0,0,0,0.5,0.5,1663,1940
2000-10-11,Iceland,Northern Ireland,1,0,1,1.0,0.0,1695,1683
2000-10-11,Republic of Ireland,Estonia,2,0,2,1.0,0.0,1811,1484
2000-10-11,Israel,Bosnia and Herzegovina,3,1,2,1.0,0.0,1716,1566
2000-10-11,Italy,Georgia,2,0,2,1.0,0.0,1965,1562
2000-10-11,Lithuania,Hungary,1,6,5,0.0,1.0,1537,1740
2000-10-11,Malta,Czech Republic,0,0,0,0.5,0.5,1421,1840
2000-10-11,Moldova,North Macedonia,0,0,0,0.5,0.5,1528,1585
2000-10-11,Netherlands,Portugal,0,2,2,0.0,1.0,1966,1923
2000-10-11,Norway,Ukraine,0,1,1,0.0,1.0,1859,1692
2000-10-11,Poland,Wales,0,0,0,0.5,0.5,1783,1689
2000-10-11,Russia,Luxembourg,3,0,3,1.0,0.0,1862,1364
2000-10-11,Slovakia,Sweden,0,0,0,0.5,0.5,1724,1878
2000-10-11,Slovenia,Switzerland,2,2,0,0.5,0.5,1642,1772
2000-10-11,United States,Costa Rica,0,0,0,0.5,0.5,1845,1745
2000-10-12,Iraq,Thailand,2,0,2,1.0,0.0,1791,1722
2000-10-12,Lebanon,Iran,0,4,4,0.0,1.0,1597,1827
2000-10-13,South Korea,China PR,2,2,0,0.5,0.5,1870,1800
2000-10-13,Kuwait,Indonesia,0,0,0,0.5,0.5,1764,1629
2000-10-14,Malaysia,Cambodia,2,0,2,1.0,0.0,1584,1387
2000-10-14,Qatar,Uzbekistan,1,1,0,0.5,0.5,1718,1654
2000-10-14,Saudi Arabia,Japan,1,4,3,0.0,1.0,1814,1808
2000-10-15,Iran,Thailand,1,1,0,0.5,0.5,1825,1725
2000-10-15,Kenya,Tanzania,3,0,3,1.0,0.0,1620,1501
2000-10-15,Lebanon,Iraq,2,2,0,0.5,0.5,1602,1787
2000-10-16,China PR,Indonesia,4,0,4,1.0,0.0,1805,1625
2000-10-16,South Korea,Kuwait,0,1,1,0.0,1.0,1860,1775
2000-10-17,Japan,Uzbekistan,8,1,7,1.0,0.0,1813,1650
2000-10-17,Malaysia,Cambodia,1,1,0,0.5,0.5,1580,1392
2000-10-17,Saudi Arabia,Qatar,0,0,0,0.5,0.5,1812,1721
2000-10-18,Iran,Iraq,1,0,1,1.0,0.0,1833,1780
2000-10-18,Lebanon,Thailand,1,1,0,0.5,0.5,1605,1723
2000-10-19,China PR,Kuwait,0,0,0,0.5,0.5,1805,1776
2000-10-19,South Korea,Indonesia,3,0,3,1.0,0.0,1864,1622
2000-10-20,Japan,Qatar,1,1,0,0.5,0.5,1811,1724
2000-10-20,Saudi Arabia,Uzbekistan,5,0,5,1.0,0.0,1817,1646
2000-10-23,China PR,Qatar,3,1,2,1.0,0.0,1812,1718
2000-10-23,Iran,South Korea,1,2,1,0.0,1.0,1826,1872
2000-10-23,Malaysia,Sri Lanka,2,0,2,1.0,0.0,1584,1380
2000-10-24,Japan,Iraq,4,1,3,1.0,0.0,1819,1773
2000-10-24,Kuwait,Saudi Arabia,2,3,1,0.0,1.0,1769,1825
2000-10-25,Ghana,Uganda,1,2,1,0.0,1.0,1713,1640
2000-10-25,Malaysia,Sri Lanka,3,1,2,1.0,0.0,1588,1377
2000-10-25,United States,Mexico,2,0,2,1.0,0.0,1855,1892
2000-10-26,China PR,Japan,2,3,1,0.0,1.0,1805,1827
2000-10-26,South Korea,Saudi Arabia,1,2,1,0.0,1.0,1863,1835
2000-10-28,Eritrea,Rwanda,0,1,1,0.0,1.0,1498,1551
2000-10-28,Kenya,Uganda,1,1,0,0.5,0.5,1621,1640
2000-10-28,Singapore,Sri Lanka,4,0,4,1.0,0.0,1597,1374
2000-10-29,China PR,South Korea,0,1,1,0.0,1.0,1799,1870
2000-10-29,Japan,Saudi Arabia,1,0,1,1.0,0.0,1836,1827
2000-10-29,Oman,Yemen,4,0,4,1.0,0.0,1568,1453
2000-10-29,Zambia,Rwanda,0,2,2,0.0,1.0,1717,1563
2000-10-30,Rwanda,Zimbabwe,1,0,1,1.0,0.0,1574,1687
2000-10-31,Oman,Yemen,4,0,4,1.0,0.0,1574,1448
2000-11-01,Singapore,Indonesia,1,0,1,1.0,0.0,1606,1614
2000-11-05,Singapore,Cambodia,1,0,1,1.0,0.0,1610,1389
2000-11-05,Vietnam,Malaysia,0,0,0,0.5,0.5,1555,1588
2000-11-06,Indonesia,Philippines,3,0,3,1.0,0.0,1616,1268
2000-11-06,Thailand,Myanmar,3,1,2,1.0,0.0,1728,1538
2000-11-07,Cambodia,Vietnam,0,6,6,0.0,1.0,1385,1560
2000-11-07,Laos,Malaysia,0,5,5,0.0,1.0,1406,1593
2000-11-08,Myanmar,Philippines,3,0,3,1.0,0.0,1541,1266
2000-11-09,Malaysia,Cambodia,3,2,1,1.0,0.0,1597,1382
2000-11-09,Singapore,Laos,3,0,3,1.0,0.0,1614,1403
2000-11-10,Thailand,Indonesia,4,1,3,1.0,0.0,1734,1611
2000-11-11,Cambodia,Laos,3,0,3,1.0,0.0,1391,1395
2000-11-11,Vietnam,Singapore,1,0,1,1.0,0.0,1570,1605
2000-11-12,Myanmar,Indonesia,0,5,5,0.0,1.0,1535,1618
2000-11-12,Thailand,Philippines,2,0,2,1.0,0.0,1736,1265
2000-11-12,United Arab Emirates,Hong Kong,1,1,0,0.5,0.5,1760,1568
2000-11-13,Laos,Vietnam,0,5,5,0.0,1.0,1391,1575
2000-11-13,Malaysia,Singapore,1,0,1,1.0,0.0,1606,1597
2000-11-14,Saint Vincent and the Grenadines,Honduras,0,7,7,0.0,1.0,1551,1784
2000-11-14,Algeria,Bulgaria,1,2,1,0.0,1.0,1725,1764
2000-11-15,Albania,Malta,3,0,3,1.0,0.0,1538,1416
2000-11-15,Barbados,United States,0,4,4,0.0,1.0,1568,1858
2000-11-15,Bolivia,Uruguay,0,0,0,0.5,0.5,1699,1801
2000-11-15,Brazil,Colombia,1,0,1,1.0,0.0,2062,1815
2000-11-15,Canada,Mexico,0,0,0,0.5,0.5,1751,1889
2000-11-15,Chile,Argentina,0,2,2,0.0,1.0,1788,1969
2000-11-15,Cyprus,Andorra,5,0,5,1.0,0.0,1606,1411
2000-11-15,Denmark,Germany,2,1,1,1.0,0.0,1870,1963
2000-11-15,El Salvador,Jamaica,2,0,2,1.0,0.0,1622,1720
2000-11-15,Estonia,Kyrgyzstan,1,0,1,1.0,0.0,1492,1436
2000-11-15,Greece,Slovakia,0,2,2,0.0,1.0,1778,1734
2000-11-15,Guatemala,Costa Rica,2,1,1,1.0,0.0,1697,1736
2000-11-15,Republic of Ireland,Finland,3,0,3,1.0,0.0,1816,1659
2000-11-15,Italy,England,1,0,1,1.0,0.0,1973,1933
2000-11-15,North Macedonia,Hungary,0,1,1,0.0,1.0,1581,1745
2000-11-15,Paraguay,Peru,5,1,4,1.0,0.0,1856,1732
2000-11-15,Poland,Iceland,1,0,1,1.0,0.0,1790,1689
2000-11-15,Portugal,Israel,2,1,1,1.0,0.0,1927,1713
2000-11-15,Romania,Serbia,2,1,1,1.0,0.0,1865,1808
2000-11-15,San Marino,Latvia,0,1,1,0.0,1.0,1402,1515
2000-11-15,Scotland,Australia,0,2,2,0.0,1.0,1812,1863
2000-11-15,Spain,Netherlands,1,2,1,0.0,1.0,1949,1974
2000-11-15,Trinidad and Tobago,Panama,1,0,1,1.0,0.0,1727,1570
2000-11-15,Tunisia,Switzerland,1,1,0,0.5,0.5,1801,1773
2000-11-15,Turkey,France,0,4,4,0.0,1.0,1747,2037
2000-11-15,Venezuela,Ecuador,1,2,1,0.0,1.0,1520,1761
2000-11-16,Thailand,Malaysia,2,0,2,1.0,0.0,1742,1601
2000-11-16,Vietnam,Indonesia,2,3,1,0.0,1.0,1568,1626
2000-11-18,Thailand,Indonesia,4,1,3,1.0,0.0,1748,1621
2000-11-18,Uganda,Ethiopia,2,2,0,0.5,0.5,1639,1583
2000-11-18,Vietnam,Malaysia,0,3,3,0.0,1.0,1561,1609
2000-11-19,Djibouti,Somalia,0,0,0,0.5,0.5,1395,1414
2000-11-19,Ivory Coast,Libya,2,1,1,1.0,0.0,1767,1618
2000-11-20,Uganda,Burundi,2,1,1,1.0,0.0,1646,1574
2000-11-21,Oman,Bahrain,2,1,1,1.0,0.0,1583,1571
2000-11-21,Somalia,Ethiopia,1,2,1,0.0,1.0,1410,1588
2000-11-22,Kenya,Rwanda,1,2,1,0.0,1.0,1612,1584
2000-11-22,Morocco,Libya,0,0,0,0.5,0.5,1836,1623
2000-11-23,Djibouti,Burundi,2,4,2,0.0,1.0,1391,1579
2000-11-23,Uganda,Somalia,6,0,6,1.0,0.0,1650,1407
2000-11-24,Iran,Guam,19,0,19,1.0,0.0,1828,1430
2000-11-25,Eritrea,Rwanda,1,1,0,0.5,0.5,1500,1583
2000-11-25,Ethiopia,Djibouti,4,2,2,1.0,0.0,1592,1388
2000-11-26,Tajikistan,Guam,16,0,16,1.0,0.0,1542,1425
2000-11-27,Ethiopia,Burundi,1,0,1,1.0,0.0,1600,1572
2000-11-27,Uganda,Djibouti,7,0,7,1.0,0.0,1653,1386
2000-11-28,Iran,Tajikistan,2,0,2,1.0,0.0,1831,1540
2000-11-29,Uganda,Rwanda,3,1,2,1.0,0.0,1660,1577
2000-12-02,Ethiopia,Rwanda,1,1,0,0.5,0.5,1600,1578
2000-12-05,Algeria,Romania,3,2,1,1.0,0.0,1737,1854
2000-12-08,Algeria,Romania,2,3,1,0.0,1.0,1732,1860
2000-12-10,Hong Kong,Estonia,1,2,1,0.0,1.0,1559,1502
2000-12-13,Greece,Serbia,1,1,0,0.5,0.5,1779,1808
2000-12-16,South Africa,Liberia,2,1,1,1.0,0.0,1774,1585
2000-12-20,Japan,South Korea,1,1,0,0.5,0.5,1837,1870
2000-12-20,Mexico,Argentina,0,2,2,0.0,1.0,1883,1976
2000-12-22,Catalonia,Lithuania,5,0,5,1.0,0.0,1549,1530
2000-12-22,Andalusia,Morocco,2,0,2,1.0,0.0,1528,1823
2000-12-29,Basque Country,Morocco,3,2,1,1.0,0.0,1688,1812
2001-01-04,Kenya,Zambia,2,1,1,1.0,0.0,1623,1707
2001-01-06,Costa Rica,Guatemala,5,2,3,1.0,0.0,1744,1690
2001-01-06,Egypt,United Arab Emirates,2,1,1,1.0,0.0,1802,1753
2001-01-06,Eswatini,Angola,1,0,1,1.0,0.0,1481,1651
2001-01-07,Angola,Lesotho,2,0,2,1.0,0.0,1656,1467
2001-01-07,Eswatini,Namibia,2,1,1,1.0,0.0,1491,1540
2001-01-07,Togo,Burkina Faso,1,1,0,0.5,0.5,1598,1640
2001-01-09,Egypt,Zambia,3,1,2,1.0,0.0,1808,1702
2001-01-09,Eswatini,Lesotho,2,2,0,0.5,0.5,1491,1468
2001-01-11,Romania,Jordan,0,1,1,0.0,1.0,1848,1619
2001-01-12,Algeria,Burundi,2,1,1,1.0,0.0,1737,1568
2001-01-12,Bosnia and Herzegovina,Bangladesh,2,0,2,1.0,0.0,1572,1448
2001-01-12,Qatar,Kuwait,1,0,1,1.0,0.0,1728,1760
2001-01-12,Uzbekistan,Bahrain,5,0,5,1.0,0.0,1653,1565
2001-01-13,Burkina Faso,Angola,1,0,1,1.0,0.0,1649,1648
2001-01-13,India,Iceland,0,3,3,0.0,1.0,1513,1694
2001-01-13,Kenya,Gabon,2,1,1,1.0,0.0,1632,1657
2001-01-13,Mauritius,South Africa,1,1,0,0.5,0.5,1500,1769
2001-01-13,Namibia,Madagascar,2,2,0,0.5,0.5,1543,1671
2001-01-13,Nigeria,Zambia,1,0,1,1.0,0.0,1790,1696
2001-01-13,Tunisia,Morocco,0,1,1,0.0,1.0,1794,1820
2001-01-13,Uganda,Senegal,1,1,0,0.5,0.5,1660,1660
2001-01-14,DR Congo,Ghana,2,1,1,1.0,0.0,1673,1704
2001-01-14,Egypt,Libya,4,0,4,1.0,0.0,1813,1619
2001-01-14,Liberia,Congo,5,1,4,1.0,0.0,1595,1624
2001-01-14,Romania,Hong Kong,4,2,2,1.0,0.0,1851,1557
2001-01-14,Serbia,Bosnia and Herzegovina,1,1,0,0.5,0.5,1804,1577
2001-01-14,Zimbabwe,Lesotho,1,2,1,0.0,1.0,1675,1481
2001-01-15,Chile,Bahrain,2,0,2,1.0,0.0,1792,1562
2001-01-16,Bangladesh,Serbia,1,4,3,0.0,1.0,1447,1806
2001-01-16,Hong Kong,Jordan,0,2,2,0.0,1.0,1551,1626
2001-01-17,Chile,Uzbekistan,2,0,2,1.0,0.0,1797,1649
2001-01-17,China PR,Egypt,0,0,0,0.5,0.5,1800,1813
2001-01-17,Israel,Uzbekistan,2,0,2,1.0,0.0,1720,1643
2001-01-17,Kuwait,Syria,2,0,2,1.0,0.0,1766,1648
2001-01-19,Iran,China PR,4,0,4,1.0,0.0,1839,1793
2001-01-20,Chile,Iceland,2,0,2,1.0,0.0,1803,1689
2001-01-20,Ivory Coast,Sudan,2,0,2,1.0,0.0,1771,1564
2001-01-20,Mali,Guinea,0,1,1,0.0,1.0,1623,1640
2001-01-20,Serbia,Romania,2,0,2,1.0,0.0,1816,1842
2001-01-22,Bosnia and Herzegovina,Chile,1,0,1,1.0,0.0,1590,1791
2001-01-23,Burkina Faso,Mali,0,2,2,0.0,1.0,1641,1632
2001-01-23,Egypt,North Korea,1,0,1,1.0,0.0,1819,1686
2001-01-23,Serbia,Japan,1,0,1,1.0,0.0,1825,1829
2001-01-23,Thailand,Kuwait,5,4,1,1.0,0.0,1757,1758
2001-01-24,South Korea,Norway,2,3,1,0.0,1.0,1862,1868
2001-01-24,Mexico,Bulgaria,0,2,2,0.0,1.0,1873,1775
2001-01-25,Benin,Cameroon,1,3,2,0.0,1.0,1463,1790
2001-01-25,Bosnia and Herzegovina,Serbia,0,2,2,0.0,1.0,1587,1829
2001-01-26,Algeria,Namibia,1,0,1,1.0,0.0,1741,1540
2001-01-27,Botswana,Eswatini,1,2,1,0.0,1.0,1430,1498
2001-01-27,Grenada,Trinidad and Tobago,1,2,1,0.0,1.0,1549,1732
2001-01-27,South Korea,Paraguay,1,1,0,0.5,0.5,1862,1857
2001-01-27,Nigeria,Sudan,3,0,3,1.0,0.0,1794,1561
2001-01-27,Singapore,Thailand,1,1,0,0.5,0.5,1601,1754
2001-01-27,South Africa,Burkina Faso,1,0,1,1.0,0.0,1775,1636
2001-01-27,United States,China PR,2,1,1,1.0,0.0,1865,1787
2001-01-28,Angola,Libya,3,1,2,1.0,0.0,1656,1612
2001-01-28,Antigua and Barbuda,British Virgin Islands,1,1,0,0.5,0.5,1484,1416
2001-01-28,Botswana,Lesotho,2,1,1,1.0,0.0,1440,1472
2001-01-28,Congo,Tunisia,1,2,1,0.0,1.0,1620,1799
2001-01-28,Egypt,Morocco,0,0,0,0.5,0.5,1820,1820
2001-01-28,Ghana,Liberia,1,3,2,0.0,1.0,1694,1606
2001-01-28,Jamaica,Bulgaria,0,0,0,0.5,0.5,1722,1774
2001-01-28,Jordan,North Korea,1,0,1,1.0,0.0,1636,1677
2001-01-28,Madagascar,Ivory Coast,1,3,2,0.0,1.0,1666,1777
2001-01-28,Togo,Cameroon,0,2,2,0.0,1.0,1595,1794
2001-01-29,Grenada,Trinidad and Tobago,0,2,2,0.0,1.0,1545,1737
2001-01-30,Jordan,North Korea,0,2,2,0.0,1.0,1629,1685
2001-01-30,Saudi Arabia,Syria,1,0,1,1.0,0.0,1832,1644
2001-01-30,Thailand,Kyrgyzstan,3,1,2,1.0,0.0,1757,1434
2001-01-31,Lebanon,Iraq,0,0,0,0.5,0.5,1609,1770
2001-01-31,Mexico,Colombia,2,3,1,0.0,1.0,1864,1825
2001-01-31,Sweden,Faroe Islands,0,0,0,0.5,0.5,1872,1456
2001-02-01,Sweden,Finland,0,1,1,0.0,1.0,1860,1672
2001-02-03,Bahrain,Kuwait,1,2,1,0.0,1.0,1559,1762
2001-02-03,Puerto Rico,British Virgin Islands,1,2,1,0.0,1.0,1361,1423
2001-02-03,Saudi Arabia,Uganda,3,1,2,1.0,0.0,1837,1656
2001-02-03,Singapore,Kyrgyzstan,0,1,1,0.0,1.0,1590,1446
2001-02-03,United States,Colombia,0,1,1,0.0,1.0,1857,1834
2001-02-04,Senegal,Mali,1,0,1,1.0,0.0,1668,1625
2001-02-05,Fiji,Malaysia,4,1,3,1.0,0.0,1683,1603
2001-02-06,Bahrain,Kyrgyzstan,1,0,1,1.0,0.0,1565,1441
2001-02-06,Singapore,Kuwait,1,1,0,0.5,0.5,1594,1759
2001-02-06,Saint Martin,Montserrat,3,1,2,1.0,0.0,1510,1441
2001-02-07,Fiji,Malaysia,2,0,2,1.0,0.0,1690,1597
2001-02-08,Anguilla,Montserrat,4,1,3,1.0,0.0,1391,1432
2001-02-08,Morocco,South Korea,1,1,0,0.5,0.5,1821,1862
2001-02-08,Saudi Arabia,Mongolia,6,0,6,1.0,0.0,1839,1446
2001-02-08,Vietnam,Bangladesh,0,0,0,0.5,0.5,1559,1450
2001-02-09,Fiji,Malaysia,1,2,1,0.0,1.0,1680,1608
2001-02-09,Kyrgyzstan,Kuwait,0,3,3,0.0,1.0,1439,1762
2001-02-09,Singapore,Bahrain,1,2,1,0.0,1.0,1586,1574
2001-02-10,China PR,Qatar,1,1,0,0.5,0.5,1786,1730
2001-02-10,Mongolia,Vietnam,0,1,1,0.0,1.0,1441,1565
2001-02-10,Saudi Arabia,Bangladesh,3,0,3,1.0,0.0,1841,1449
2001-02-10,Saint Martin,Anguilla,3,1,2,1.0,0.0,1516,1386
2001-02-10,Thailand,Sweden,1,4,3,0.0,1.0,1752,1866
2001-02-11,British Virgin Islands,Puerto Rico,0,0,0,0.5,0.5,1422,1363
2001-02-11,Eswatini,Zambia,0,0,0,0.5,0.5,1503,1692
2001-02-11,United Arab Emirates,South Korea,1,4,3,0.0,1.0,1748,1868
2001-02-12,Armenia,Uzbekistan,2,0,2,1.0,0.0,1525,1633
2001-02-12,China PR,Sweden,2,2,0,0.5,0.5,1788,1865
2001-02-12,Mongolia,Bangladesh,0,3,3,0.0,1.0,1434,1457
2001-02-12,Saudi Arabia,Vietnam,5,0,5,1.0,0.0,1844,1563
2001-02-12,Thailand,Qatar,1,3,2,0.0,1.0,1744,1739
2001-02-14,Georgia,Ukraine,0,0,0,0.5,0.5,1565,1690
2001-02-14,Israel,Moldova,1,0,1,1.0,0.0,1724,1525
2001-02-14,Sweden,Qatar,0,0,0,0.5,0.5,1863,1742
2001-02-14,Thailand,China PR,1,5,4,0.0,1.0,1738,1795
2001-02-14,United Arab Emirates,Morocco,1,1,0,0.5,0.5,1750,1820
2001-02-15,Azerbaijan,Uzbekistan,1,2,1,0.0,1.0,1456,1638
2001-02-15,Bangladesh,Vietnam,0,4,4,0.0,1.0,1452,1569
2001-02-15,Kuwait,Finland,4,3,1,1.0,0.0,1768,1667
2001-02-15,Saudi Arabia,Mongolia,6,0,6,1.0,0.0,1846,1433
2001-02-17,China PR,Sweden,0,3,3,0.0,1.0,1789,1870
2001-02-17,Saudi Arabia,Bangladesh,6,0,6,1.0,0.0,1848,1451
2001-02-17,Thailand,Qatar,2,0,2,1.0,0.0,1747,1734
2001-02-17,Vietnam,Mongolia,4,0,4,1.0,0.0,1575,1428
2001-02-18,Oman,Finland,1,2,1,0.0,1.0,1577,1674
2001-02-19,Bangladesh,Mongolia,2,2,0,0.5,0.5,1451,1429
2001-02-19,Saudi Arabia,Vietnam,4,0,4,1.0,0.0,1851,1573
2001-02-19,Saint Kitts and Nevis,Saint Lucia,2,0,2,1.0,0.0,1536,1543
2001-02-20,Oman,Finland,0,2,2,0.0,1.0,1572,1680
2001-02-21,Kuwait,Singapore,1,0,1,1.0,0.0,1773,1582
2001-02-21,Kyrgyzstan,Bahrain,1,2,1,0.0,1.0,1434,1580
2001-02-21,Martinique,Saint Lucia,4,2,2,1.0,0.0,1664,1538
2001-02-21,Panama,Guatemala,2,2,0,0.5,0.5,1573,1688
2001-02-23,Libya,Togo,3,3,0,0.5,0.5,1612,1596
2001-02-24,Bahrain,Singapore,2,0,2,1.0,0.0,1589,1574
2001-02-24,Burkina Faso,Zimbabwe,1,2,1,0.0,1.0,1629,1683
2001-02-24,Kuwait,Kyrgyzstan,2,0,2,1.0,0.0,1775,1433
2001-02-24,Morocco,Senegal,0,0,0,0.5,0.5,1817,1672
2001-02-24,Namibia,Egypt,1,1,0,0.5,0.5,1546,1815
2001-02-25,Antigua and Barbuda,Saint Lucia,0,1,1,0.0,1.0,1478,1545
2001-02-25,Cameroon,Zambia,1,0,1,1.0,0.0,1800,1687
2001-02-25,Cayman Islands,Trinidad and Tobago,0,3,3,0.0,1.0,1467,1740
2001-02-25,Liberia,Sierra Leone,1,0,1,1.0,0.0,1614,1596
2001-02-25,Malawi,South Africa,1,2,1,0.0,1.0,1565,1779
2001-02-25,Oman,Maldives,5,0,5,1.0,0.0,1577,1387
2001-02-25,Sudan,Ghana,1,0,1,1.0,0.0,1572,1684
2001-02-25,Tunisia,DR Congo,6,0,6,1.0,0.0,1805,1668
2001-02-26,Cyprus,Lithuania,1,2,1,0.0,1.0,1597,1540
2001-02-26,Romania,Ukraine,1,0,1,1.0,0.0,1847,1686
2001-02-27,Algeria,Slovakia,1,1,0,0.5,0.5,1741,1735
2001-02-27,France,Germany,1,0,1,1.0,0.0,2044,1957
2001-02-27,Kuwait,Bahrain,0,1,1,0.0,1.0,1764,1601
2001-02-27,Kyrgyzstan,Singapore,1,1,0,0.5,0.5,1437,1571
2001-02-27,Oman,Maldives,2,0,2,1.0,0.0,1582,1383
2001-02-28,Belgium,San Marino,10,1,9,1.0,0.0,1848,1401
2001-02-28,Bosnia and Herzegovina,Hungary,1,1,0,0.5,0.5,1591,1742
2001-02-28,Colombia,Australia,3,2,1,1.0,0.0,1843,1855
2001-02-28,Costa Rica,Honduras,2,2,0,0.5,0.5,1745,1784
2001-02-28,Croatia,Austria,1,0,1,1.0,0.0,1833,1783
2001-02-28,Cyprus,Ukraine,4,3,1,1.0,0.0,1608,1676
2001-02-28,England,Spain,3,0,3,1.0,0.0,1942,1941
2001-02-28,Greece,Russia,3,3,0,0.5,0.5,1781,1861
2001-02-28,Italy,Argentina,1,2,1,0.0,1.0,1966,1984
2001-02-28,Jamaica,Trinidad and Tobago,1,0,1,1.0,0.0,1731,1732
2001-02-28,Jordan,Bulgaria,0,2,2,0.0,1.0,1625,1779
2001-02-28,Liechtenstein,Latvia,0,2,2,0.0,1.0,1420,1521
2001-02-28,Lithuania,Romania,0,3,3,0.0,1.0,1538,1850
2001-02-28,Luxembourg,Finland,0,1,1,0.0,1.0,1362,1683
2001-02-28,North Macedonia,Czech Republic,1,1,0,0.5,0.5,1587,1835
2001-02-28,Malta,Sweden,0,3,3,0.0,1.0,1415,1872
2001-02-28,Netherlands,Turkey,0,0,0,0.5,0.5,1970,1752
2001-02-28,Northern Ireland,Norway,0,4,4,0.0,1.0,1679,1873
2001-02-28,Portugal,Andorra,3,0,3,1.0,0.0,1928,1411
2001-02-28,Slovenia,Uruguay,0,2,2,0.0,1.0,1638,1806
2001-02-28,Switzerland,Poland,0,4,4,0.0,1.0,1766,1798
2001-02-28,United States,Mexico,2,0,2,1.0,0.0,1866,1856
2001-03-01,Saint Kitts and Nevis,Dominican Republic,2,1,1,1.0,0.0,1544,1490
2001-03-03,Antigua and Barbuda,Dominican Republic,2,3,1,0.0,1.0,1471,1498
2001-03-03,United States,Brazil,1,2,1,0.0,1.0,1863,2066
2001-03-04,Antigua and Barbuda,Saint Kitts and Nevis,2,2,0,0.5,0.5,1473,1543
2001-03-04,Hong Kong,Palestine,1,1,0,0.5,0.5,1550,1468
2001-03-04,Qatar,Malaysia,5,1,4,1.0,0.0,1740,1603
2001-03-06,Guatemala,El Salvador,1,1,0,0.5,0.5,1687,1624
2001-03-07,Honduras,Peru,0,0,0,0.5,0.5,1783,1734
2001-03-07,Jordan,Hungary,1,1,0,0.5,0.5,1628,1740
2001-03-07,Lebanon,Syria,2,2,0,0.5,0.5,1610,1644
2001-03-07,Mexico,Brazil,3,3,0,0.5,0.5,1861,2062
2001-03-08,Hong Kong,Malaysia,0,2,2,0.0,1.0,1544,1610
2001-03-08,Palestine,Qatar,1,2,1,0.0,1.0,1466,1743
2001-03-10,Botswana,Eswatini,1,0,1,1.0,0.0,1450,1494
2001-03-10,DR Congo,Ivory Coast,1,2,1,0.0,1.0,1663,1783
2001-03-10,Kenya,Uganda,1,0,1,1.0,0.0,1641,1648
2001-03-10,Lesotho,Mozambique,0,0,0,0.5,0.5,1474,1526
2001-03-10,Senegal,Namibia,4,0,4,1.0,0.0,1678,1541
2001-03-10,Sierra Leone,Sudan,0,2,2,0.0,1.0,1588,1581
2001-03-10,Zambia,Libya,2,0,2,1.0,0.0,1694,1606
2001-03-11,Botswana,Mozambique,1,3,2,0.0,1.0,1444,1533
2001-03-11,Egypt,Algeria,5,2,3,1.0,0.0,1822,1735
2001-03-11,Ghana,Nigeria,0,0,0,0.5,0.5,1687,1792
2001-03-11,Hong Kong,Qatar,0,2,2,0.0,1.0,1541,1747
2001-03-11,Lesotho,Eswatini,2,1,1,1.0,0.0,1483,1486
2001-03-11,Palestine,Malaysia,1,0,1,1.0,0.0,1478,1599
2001-03-11,Togo,Angola,1,1,0,0.5,0.5,1598,1655
2001-03-11,Zimbabwe,Malawi,2,0,2,1.0,0.0,1689,1560
2001-03-12,Grenada,Dominica,8,3,5,1.0,0.0,1552,1465
2001-03-12,Saint Lucia,Saint Vincent and the Grenadines,0,2,2,0.0,1.0,1538,1559
2001-03-14,Dominica,Saint Vincent and the Grenadines,0,2,2,0.0,1.0,1460,1565
2001-03-14,Grenada,Saint Lucia,4,3,1,1.0,0.0,1560,1531
2001-03-14,Panama,El Salvador,1,0,1,1.0,0.0,1583,1615
2001-03-16,Dominica,Saint Lucia,1,1,0,0.5,0.5,1462,1530
2001-03-17,Botswana,Malawi,0,1,1,0.0,1.0,1439,1566
2001-03-18,Dominica,Saint Lucia,0,1,1,0.0,1.0,1456,1537
2001-03-18,Gabon,Mali,2,0,2,1.0,0.0,1665,1618
2001-03-19,Egypt,Estonia,3,3,0,0.5,0.5,1817,1508
2001-03-20,Palestine,Hong Kong,1,0,1,1.0,0.0,1488,1532
2001-03-20,Qatar,Malaysia,0,0,0,0.5,0.5,1744,1603
2001-03-21,Honduras,Chile,3,1,2,1.0,0.0,1792,1783
2001-03-21,Saint Lucia,Martinique,1,1,0,0.5,0.5,1540,1662
2001-03-23,Hong Kong,Malaysia,2,1,1,1.0,0.0,1542,1594
2001-03-23,Libya,Egypt,2,0,2,1.0,0.0,1619,1805
2001-03-23,Qatar,Palestine,2,1,1,1.0,0.0,1747,1486
2001-03-24,Andorra,Netherlands,0,5,5,0.0,1.0,1411,1971
2001-03-24,Armenia,Wales,2,2,0,0.5,0.5,1529,1686
2001-03-24,Azerbaijan,Moldova,0,0,0,0.5,0.5,1458,1524
2001-03-24,Bosnia and Herzegovina,Austria,1,1,0,0.5,0.5,1596,1779
2001-03-24,British Virgin Islands,United States Virgin Islands,2,0,2,1.0,0.0,1432,1471
2001-03-24,Bulgaria,Iceland,2,1,1,1.0,0.0,1785,1684
2001-03-24,Croatia,Latvia,4,1,3,1.0,0.0,1836,1519
2001-03-24,Cyprus,Republic of Ireland,0,4,4,0.0,1.0,1605,1820
2001-03-24,England,Finland,2,1,1,1.0,0.0,1945,1681
2001-03-24,France,Japan,5,0,5,1.0,0.0,2048,1826
2001-03-24,Gabon,Kenya,1,1,0,0.5,0.5,1665,1642
2001-03-24,Germany,Albania,2,1,1,1.0,0.0,1959,1537
2001-03-24,Hungary,Lithuania,1,1,0,0.5,0.5,1736,1543
2001-03-24,Lesotho,Zimbabwe,0,1,1,0.0,1.0,1480,1693
2001-03-24,Luxembourg,Faroe Islands,0,2,2,0.0,1.0,1357,1462
2001-03-24,Madagascar,Namibia,1,2,1,0.0,1.0,1656,1552
2001-03-24,Malta,Denmark,0,5,5,0.0,1.0,1414,1872
2001-03-24,Morocco,Tunisia,2,0,2,1.0,0.0,1825,1798
2001-03-24,Northern Ireland,Czech Republic,0,1,1,0.0,1.0,1675,1840
2001-03-24,Norway,Poland,2,3,1,0.0,1.0,1864,1808
2001-03-24,Romania,Italy,0,2,2,0.0,1.0,1845,1972
2001-03-24,Russia,Slovenia,1,1,0,0.5,0.5,1857,1643
2001-03-24,Scotland,Belgium,2,2,0,0.5,0.5,1813,1848
2001-03-24,Senegal,Uganda,3,0,3,1.0,0.0,1686,1641
2001-03-24,Serbia,Switzerland,1,1,0,0.5,0.5,1828,1768
2001-03-24,South Africa,Mauritius,3,0,3,1.0,0.0,1782,1498
2001-03-24,Spain,Liechtenstein,5,0,5,1.0,0.0,1942,1420
2001-03-24,Sweden,North Macedonia,1,0,1,1.0,0.0,1875,1585
2001-03-24,Trinidad and Tobago,Guatemala,3,1,2,1.0,0.0,1739,1681
2001-03-24,Turkey,Slovakia,1,1,0,0.5,0.5,1752,1736
2001-03-24,Ukraine,Belarus,0,0,0,0.5,0.5,1673,1526
2001-03-24,Zambia,Nigeria,1,1,0,0.5,0.5,1697,1790
2001-03-24,Alderney,Guernsey,0,6,6,0.0,1.0,1282,1635
2001-03-25,Costa Rica,Trinidad and Tobago,3,0,3,1.0,0.0,1753,1732
2001-03-25,Angola,Burkina Faso,2,0,2,1.0,0.0,1663,1622
2001-03-25,Burundi,Algeria,0,1,1,0.0,1.0,1564,1740
2001-03-25,Congo,Liberia,0,1,1,0.0,1.0,1612,1623
2001-03-25,Ghana,DR Congo,3,0,3,1.0,0.0,1695,1656
2001-03-25,Malaysia,Palestine,4,3,1,1.0,0.0,1600,1481
2001-03-25,Mexico,Jamaica,4,0,4,1.0,0.0,1867,1726
2001-03-25,Qatar,Hong Kong,3,0,3,1.0,0.0,1751,1539
2001-03-25,Sudan,Ivory Coast,0,0,0,0.5,0.5,1586,1779
2001-03-27,Colombia,Bolivia,2,0,2,1.0,0.0,1848,1695
2001-03-27,Oman,United Arab Emirates,2,1,1,1.0,0.0,1594,1739
2001-03-27,Peru,Chile,3,1,2,1.0,0.0,1744,1774
2001-03-28,Albania,England,1,3,2,0.0,1.0,1536,1947
2001-03-28,Andorra,Republic of Ireland,0,3,3,0.0,1.0,1410,1822
2001-03-28,Argentina,Venezuela,5,0,5,1.0,0.0,1986,1519
2001-03-28,Austria,Israel,2,1,1,1.0,0.0,1786,1718
2001-03-28,Belarus,Norway,2,1,1,1.0,0.0,1540,1851
2001-03-28,Bulgaria,Northern Ireland,4,3,1,1.0,0.0,1791,1670
2001-03-28,Cyprus,Estonia,2,2,0,0.5,0.5,1603,1511
2001-03-28,Czech Republic,Denmark,0,0,0,0.5,0.5,1841,1872
2001-03-28,Ecuador,Brazil,1,0,1,1.0,0.0,1775,2049
2001-03-28,Georgia,Romania,0,2,2,0.0,1.0,1563,1848
2001-03-28,Greece,Germany,2,4,2,0.0,1.0,1777,1964
2001-03-28,Honduras,United States,1,2,1,0.0,1.0,1786,1870
2001-03-28,Italy,Lithuania,4,0,4,1.0,0.0,1974,1542
2001-03-28,Liechtenstein,Bosnia and Herzegovina,0,3,3,0.0,1.0,1416,1601
2001-03-28,North Macedonia,Turkey,1,2,1,0.0,1.0,1581,1757
2001-03-28,Martinique,Guadeloupe,4,1,3,1.0,0.0,1668,1525
2001-03-28,Moldova,Sweden,0,2,2,0.0,1.0,1523,1877
2001-03-28,Poland,Armenia,4,0,4,1.0,0.0,1811,1527
2001-03-28,Portugal,Netherlands,2,2,0,0.5,0.5,1929,1971
2001-03-28,Russia,Faroe Islands,1,0,1,1.0,0.0,1859,1461
2001-03-28,Scotland,San Marino,4,0,4,1.0,0.0,1815,1400
2001-03-28,Slovakia,Azerbaijan,3,1,2,1.0,0.0,1739,1456
2001-03-28,Slovenia,Serbia,1,1,0,0.5,0.5,1647,1825
2001-03-28,Spain,France,2,1,1,1.0,0.0,1953,2038
2001-03-28,Sri Lanka,Cambodia,1,0,1,1.0,0.0,1383,1383
2001-03-28,Switzerland,Luxembourg,5,0,5,1.0,0.0,1770,1356
2001-03-28,Uruguay,Paraguay,0,1,1,0.0,1.0,1800,1864
2001-03-28,Wales,Ukraine,1,1,0,0.5,0.5,1686,1674
2001-04-01,Maldives,Cambodia,6,0,6,1.0,0.0,1391,1375
2001-04-04,Barbados,Grenada,2,1,1,1.0,0.0,1576,1553
2001-04-04,Cayman Islands,British Virgin Islands,2,2,0,0.5,0.5,1467,1433
2001-04-04,Cuba,Dominica,3,1,2,1.0,0.0,1620,1452
2001-04-04,Guyana,Saint Martin,2,0,2,1.0,0.0,1464,1507
2001-04-04,Lebanon,Bahrain,1,1,0,0.5,0.5,1610,1602
2001-04-04,Suriname,Aruba,5,0,5,1.0,0.0,1578,1427
2001-04-05,Haiti,Panama,1,1,0,0.5,0.5,1616,1584
2001-04-05,Oman,Sudan,0,1,1,0.0,1.0,1586,1595
2001-04-06,Cuba,Saint Martin,1,0,1,1.0,0.0,1626,1502
2001-04-06,Grenada,Aruba,4,2,2,1.0,0.0,1559,1422
2001-04-06,Guyana,Dominica,2,0,2,1.0,0.0,1472,1445
2001-04-06,Martinique,British Virgin Islands,6,0,6,1.0,0.0,1672,1430
2001-04-06,Suriname,Barbados,2,2,0,0.5,0.5,1578,1577
2001-04-07,Brunei,Yemen,0,5,5,0.0,1.0,1313,1454
2001-04-07,Fiji,American Samoa,13,0,13,1.0,0.0,1683,1418
2001-04-07,Haiti,Panama,0,0,0,0.5,0.5,1616,1585
2001-04-07,Mauritania,Cape Verde,0,1,1,0.0,1.0,1439,1538
2001-04-07,Oman,Sudan,1,1,0,0.5,0.5,1587,1595
2001-04-07,Samoa,Tonga,0,1,1,0.0,1.0,1477,1487
2001-04-08,Barbados,Aruba,5,2,3,1.0,0.0,1582,1418
2001-04-08,Dominica,Saint Martin,2,3,1,0.0,1.0,1439,1509
2001-04-08,Guyana,Cuba,0,3,3,0.0,1.0,1468,1631
2001-04-08,India,United Arab Emirates,1,0,1,1.0,0.0,1526,1727
2001-04-08,Indonesia,Maldives,5,0,5,1.0,0.0,1625,1388
2001-04-08,Mali,Liberia,3,0,3,1.0,0.0,1627,1615
2001-04-08,Martinique,Cayman Islands,1,1,0,0.5,0.5,1668,1472
2001-04-08,Mauritius,Namibia,1,0,1,1.0,0.0,1508,1543
2001-04-08,Suriname,Grenada,3,1,2,1.0,0.0,1586,1552
2001-04-09,American Samoa,Samoa,0,8,8,0.0,1.0,1412,1484
2001-04-09,Australia,Tonga,22,0,22,1.0,0.0,1857,1486
2001-04-10,Guadeloupe,Saint Lucia,2,3,1,0.0,1.0,1518,1548
2001-04-10,Haiti,United States Virgin Islands,12,1,11,1.0,0.0,1621,1467
2001-04-11,Australia,American Samoa,31,0,31,1.0,0.0,1859,1411
2001-04-11,Mexico,Chile,1,0,1,1.0,0.0,1873,1769
2001-04-11,Samoa,Fiji,1,6,5,0.0,1.0,1481,1687
2001-04-12,Guadeloupe,United States Virgin Islands,11,0,11,1.0,0.0,1525,1461
2001-04-12,Haiti,Saint Lucia,3,2,1,1.0,0.0,1628,1542
2001-04-12,Iraq,Macau,8,0,8,1.0,0.0,1772,1410
2001-04-12,Nepal,Kazakhstan,0,6,6,0.0,1.0,1354,1613
2001-04-14,American Samoa,Tonga,0,5,5,0.0,1.0,1405,1493
2001-04-14,Australia,Fiji,2,0,2,1.0,0.0,1864,1683
2001-04-14,Brunei,United Arab Emirates,0,12,12,0.0,1.0,1312,1729
2001-04-14,Haiti,Guadeloupe,2,0,2,1.0,0.0,1634,1520
2001-04-14,Iraq,Nepal,9,1,8,1.0,0.0,1774,1353
2001-04-14,Kazakhstan,Macau,3,0,3,1.0,0.0,1617,1407
2001-04-14,Saint Lucia,United States Virgin Islands,14,1,13,1.0,0.0,1549,1455
2001-04-15,Cambodia,Maldives,1,1,0,0.5,0.5,1376,1388
2001-04-15,India,Yemen,1,1,0,0.5,0.5,1525,1456
2001-04-16,Australia,Samoa,11,0,11,1.0,0.0,1866,1480
2001-04-16,Bahrain,Oman,0,1,1,0.0,1.0,1594,1596
2001-04-16,Iraq,Kazakhstan,1,1,0,0.5,0.5,1771,1621
2001-04-16,Nepal,Macau,4,1,3,1.0,0.0,1363,1398
2001-04-16,Tonga,Fiji,1,8,7,0.0,1.0,1489,1688
2001-04-21,Burkina Faso,Malawi,4,2,2,1.0,0.0,1629,1560
2001-04-21,Kazakhstan,Nepal,4,0,4,1.0,0.0,1624,1361
2001-04-21,Macau,Iraq,0,5,5,0.0,1.0,1397,1773
2001-04-21,Morocco,Namibia,3,0,3,1.0,0.0,1828,1541
2001-04-21,Senegal,Algeria,3,0,3,1.0,0.0,1696,1731
2001-04-21,Sierra Leone,Nigeria,1,0,1,1.0,0.0,1601,1778
2001-04-21,Zambia,Angola,1,1,0,0.5,0.5,1697,1664
2001-04-22,Cameroon,Libya,1,0,1,1.0,0.0,1805,1615
2001-04-22,China PR,Maldives,10,1,9,1.0,0.0,1791,1387
2001-04-22,DR Congo,Madagascar,1,0,1,1.0,0.0,1664,1648
2001-04-22,Indonesia,Cambodia,6,0,6,1.0,0.0,1629,1373
2001-04-22,Ivory Coast,Congo,2,0,2,1.0,0.0,1784,1608
2001-04-22,Liberia,Sudan,2,0,2,1.0,0.0,1623,1588
2001-04-22,Mozambique,Lesotho,1,0,1,1.0,0.0,1540,1474
2001-04-23,Iraq,Nepal,4,2,2,1.0,0.0,1775,1360
2001-04-23,Kazakhstan,Macau,5,0,5,1.0,0.0,1628,1394
2001-04-23,Turkmenistan,Jordan,2,0,2,1.0,0.0,1572,1619
2001-04-23,Uzbekistan,Taiwan,7,0,7,1.0,0.0,1642,1432
2001-04-24,Belize,Nicaragua,2,0,2,1.0,0.0,1460,1309
2001-04-24,Chile,Uruguay,0,1,1,0.0,1.0,1762,1808
2001-04-24,Ecuador,Paraguay,2,1,1,1.0,0.0,1786,1854
2001-04-24,Egypt,Canada,3,0,3,1.0,0.0,1812,1745
2001-04-24,Georgia,Israel,3,2,1,1.0,0.0,1575,1707
2001-04-24,Iran,South Korea,0,1,1,0.0,1.0,1832,1876
2001-04-24,Panama,Haiti,2,0,2,1.0,0.0,1595,1625
2001-04-24,Venezuela,Colombia,2,2,0,0.5,0.5,1525,1843
2001-04-25,Austria,Liechtenstein,2,0,2,1.0,0.0,1788,1415
2001-04-25,Bolivia,Argentina,3,3,0,0.5,0.5,1701,1981
2001-04-25,Brazil,Peru,1,1,0,0.5,0.5,2044,1750
2001-04-25,Croatia,Greece,2,2,0,0.5,0.5,1835,1779
2001-04-25,Czech Republic,Belgium,1,1,0,0.5,0.5,1842,1848
2001-04-25,Denmark,Slovenia,3,0,3,1.0,0.0,1876,1644
2001-04-25,France,Portugal,4,0,4,1.0,0.0,2044,1924
2001-04-25,Hungary,Finland,0,0,0,0.5,0.5,1735,1683
2001-04-25,Republic of Ireland,Andorra,3,1,2,1.0,0.0,1824,1409
2001-04-25,Italy,South Africa,1,0,1,1.0,0.0,1978,1779
2001-04-25,Jamaica,Honduras,1,1,0,0.5,0.5,1728,1785
2001-04-25,Kazakhstan,Iraq,1,1,0,0.5,0.5,1632,1772
2001-04-25,Latvia,San Marino,1,1,0,0.5,0.5,1517,1403
2001-04-25,Lebanon,Philippines,3,0,3,1.0,0.0,1612,1264
2001-04-25,Macau,Nepal,1,6,5,0.0,1.0,1386,1369
2001-04-25,Malta,Iceland,1,4,3,0.0,1.0,1412,1687
2001-04-25,Moldova,Estonia,0,0,0,0.5,0.5,1523,1512
2001-04-25,Netherlands,Cyprus,4,0,4,1.0,0.0,1973,1602
2001-04-25,Norway,Bulgaria,2,1,1,1.0,0.0,1858,1785
2001-04-25,Poland,Scotland,1,1,0,0.5,0.5,1812,1815
2001-04-25,Romania,Slovakia,0,0,0,0.5,0.5,1846,1742
2001-04-25,Serbia,Russia,0,1,1,0.0,1.0,1818,1867
2001-04-25,Spain,Japan,1,0,1,1.0,0.0,1959,1821
2001-04-25,Switzerland,Sweden,0,2,2,0.0,1.0,1765,1883
2001-04-25,Trinidad and Tobago,Mexico,1,1,0,0.5,0.5,1736,1870
2001-04-25,Turkey,Albania,0,2,2,0.0,1.0,1745,1549
2001-04-25,United States,Costa Rica,1,0,1,1.0,0.0,1876,1748
2001-04-25,Uzbekistan,Turkmenistan,1,0,1,1.0,0.0,1649,1566
2001-04-25,Taiwan,Jordan,0,2,2,0.0,1.0,1428,1624
2001-04-26,Belize,Nicaragua,2,1,1,1.0,0.0,1465,1305
2001-04-26,Canada,Iran,1,0,1,1.0,0.0,1755,1823
2001-04-26,Egypt,South Korea,1,2,1,0.0,1.0,1806,1883
2001-04-26,United Arab Emirates,India,1,0,1,1.0,0.0,1733,1522
2001-04-27,Uzbekistan,Jordan,2,2,0,0.5,0.5,1649,1625
2001-04-27,Yemen,Brunei,1,0,1,1.0,0.0,1461,1308
2001-04-27,Taiwan,Turkmenistan,0,5,5,0.0,1.0,1424,1571
2001-04-28,Bangladesh,Bhutan,3,1,2,1.0,0.0,1458,1382
2001-04-28,Congo,Madagascar,2,0,2,1.0,0.0,1617,1640
2001-04-28,Maldives,China PR,0,1,1,0.0,1.0,1386,1793
2001-04-29,Cambodia,Indonesia,0,2,2,0.0,1.0,1371,1632
2001-04-29,Mozambique,South Africa,0,3,3,0.0,1.0,1537,1783
2001-04-30,Oman,Laos,12,0,12,1.0,0.0,1600,1388
2001-04-30,Syria,Philippines,12,0,12,1.0,0.0,1646,1263
2001-05-03,Jordan,Taiwan,6,0,6,1.0,0.0,1629,1421
2001-05-03,Turkmenistan,Uzbekistan,2,5,3,0.0,1.0,1565,1656
2001-05-04,Algeria,Morocco,1,2,1,0.0,1.0,1726,1834
2001-05-04,Oman,Laos,7,0,7,1.0,0.0,1604,1385
2001-05-04,Syria,Philippines,5,1,4,1.0,0.0,1648,1262
2001-05-04,United Arab Emirates,Brunei,4,0,4,1.0,0.0,1735,1307
2001-05-04,Yemen,India,3,3,0,0.5,0.5,1463,1521
2001-05-05,Jordan,Turkmenistan,1,2,1,0.0,1.0,1620,1575
2001-05-05,Madagascar,Tunisia,0,2,2,0.0,1.0,1636,1803
2001-05-05,Nigeria,Liberia,2,0,2,1.0,0.0,1783,1619
2001-05-05,Sierra Leone,Ghana,1,1,0,0.5,0.5,1604,1693
2001-05-05,South Africa,Zimbabwe,2,1,1,1.0,0.0,1789,1688
2001-05-05,Saint Kitts and Nevis,Puerto Rico,2,0,2,1.0,0.0,1548,1359
2001-05-05,Taiwan,Uzbekistan,0,4,4,0.0,1.0,1418,1660
2001-05-06,Angola,Cameroon,2,0,2,1.0,0.0,1676,1794
2001-05-06,Cambodia,China PR,0,4,4,0.0,1.0,1370,1795
2001-05-06,Congo,DR Congo,1,1,0,0.5,0.5,1619,1663
2001-05-06,Egypt,Senegal,1,0,1,1.0,0.0,1812,1691
2001-05-06,Maldives,Indonesia,0,2,2,0.0,1.0,1383,1636
2001-05-06,Togo,Zambia,3,2,1,1.0,0.0,1609,1687
2001-05-07,Jordan,Uzbekistan,1,1,0,0.5,0.5,1621,1660
2001-05-07,Oman,Philippines,7,0,7,1.0,0.0,1606,1261
2001-05-07,Syria,Laos,11,0,11,1.0,0.0,1651,1383
2001-05-07,Turkmenistan,Taiwan,1,0,1,1.0,0.0,1580,1414
2001-05-07,Guernsey,Jersey,4,1,3,1.0,0.0,1646,1717
2001-05-09,Estonia,Finland,1,1,0,0.5,0.5,1516,1680
2001-05-09,Georgia,Azerbaijan,1,0,1,1.0,0.0,1581,1451
2001-05-10,Trinidad and Tobago,Grenada,5,3,2,1.0,0.0,1741,1548
2001-05-11,Oman,Philippines,2,0,2,1.0,0.0,1608,1260
2001-05-11,Syria,Laos,9,0,9,1.0,0.0,1654,1381
2001-05-11,Yemen,United Arab Emirates,2,1,1,1.0,0.0,1477,1722
2001-05-11,Brunei,India,0,1,1,0.0,1.0,1304,1525
2001-05-13,China PR,Indonesia,5,1,4,1.0,0.0,1800,1632
2001-05-13,Lebanon,Pakistan,6,0,6,1.0,0.0,1616,1370
2001-05-13,Thailand,Sri Lanka,4,2,2,1.0,0.0,1749,1382
2001-05-15,Lebanon,Sri Lanka,4,0,4,1.0,0.0,1620,1379
2001-05-15,Martinique,Jamaica,0,1,1,0.0,1.0,1662,1735
2001-05-15,Thailand,Pakistan,3,0,3,1.0,0.0,1751,1369
2001-05-15,Trinidad and Tobago,Barbados,5,0,5,1.0,0.0,1746,1578
2001-05-16,Cuba,Suriname,4,3,1,1.0,0.0,1638,1580
2001-05-16,Haiti,Saint Kitts and Nevis,7,2,5,1.0,0.0,1632,1542
2001-05-17,Lebanon,Thailand,1,2,1,0.0,1.0,1615,1757
2001-05-17,Martinique,Barbados,3,1,2,1.0,0.0,1669,1572
2001-05-17,Pakistan,Sri Lanka,3,3,0,0.5,0.5,1370,1379
2001-05-17,Trinidad and Tobago,Jamaica,2,1,1,1.0,0.0,1754,1728
2001-05-17,Andalusia,Iraq,3,1,2,1.0,0.0,1541,1760
2001-05-18,Haiti,Suriname,1,1,0,0.5,0.5,1631,1582
2001-05-18,Saint Kitts and Nevis,Cuba,1,1,0,0.5,0.5,1545,1636
2001-05-18,Syria,Oman,3,3,0,0.5,0.5,1653,1610
2001-05-18,United Arab Emirates,Yemen,3,2,1,1.0,0.0,1726,1474
2001-05-19,Barbados,Jamaica,1,2,1,0.0,1.0,1568,1733
2001-05-19,Laos,Philippines,2,0,2,1.0,0.0,1387,1255
2001-05-19,Trinidad and Tobago,Martinique,1,2,1,0.0,1.0,1745,1679
2001-05-20,China PR,Cambodia,3,1,2,1.0,0.0,1802,1369
2001-05-20,Haiti,Cuba,0,0,0,0.5,0.5,1632,1636
2001-05-20,India,Brunei,5,0,5,1.0,0.0,1529,1301
2001-05-20,Lesotho,Eswatini,1,0,1,1.0,0.0,1483,1478
2001-05-20,Suriname,Saint Kitts and Nevis,0,4,4,0.0,1.0,1574,1554
2001-05-20,Tunisia,Ivory Coast,1,1,0,0.5,0.5,1803,1785
2001-05-22,Haiti,Martinique,5,0,5,1.0,0.0,1642,1670
2001-05-22,Singapore,New Zealand,3,0,3,1.0,0.0,1582,1674
2001-05-22,Trinidad and Tobago,Cuba,2,0,2,1.0,0.0,1751,1631
2001-05-23,Costa Rica,Belize,4,0,4,1.0,0.0,1751,1463
2001-05-23,El Salvador,Nicaragua,3,0,3,1.0,0.0,1618,1303
2001-05-23,Honduras,Panama,1,2,1,0.0,1.0,1774,1607
2001-05-24,Martinique,Cuba,1,0,1,1.0,0.0,1678,1624
2001-05-25,El Salvador,Panama,2,1,1,1.0,0.0,1626,1600
2001-05-25,England,Mexico,4,0,4,1.0,0.0,1954,1864
2001-05-25,Guatemala,Belize,3,3,0,0.5,0.5,1677,1468
2001-05-25,Honduras,Nicaragua,10,2,8,1.0,0.0,1775,1303
2001-05-25,South Korea,Cameroon,0,0,0,0.5,0.5,1881,1797
2001-05-25,Oman,Syria,2,0,2,1.0,0.0,1619,1645
2001-05-25,Trinidad and Tobago,Haiti,3,0,3,1.0,0.0,1757,1637
2001-05-26,Pakistan,Lebanon,1,8,7,0.0,1.0,1367,1619
2001-05-26,Philippines,Laos,1,1,0,0.5,0.5,1258,1385
2001-05-26,Thailand,Sri Lanka,3,0,3,1.0,0.0,1759,1378
2001-05-27,Costa Rica,Guatemala,1,1,0,0.5,0.5,1750,1679
2001-05-27,Honduras,El Salvador,1,1,0,0.5,0.5,1772,1630
2001-05-27,Indonesia,China PR,0,2,2,0.0,1.0,1628,1807
2001-05-27,Panama,Nicaragua,6,0,6,1.0,0.0,1603,1301
2001-05-28,Sri Lanka,Lebanon,0,5,5,0.0,1.0,1375,1623
2001-05-28,Thailand,Pakistan,6,0,6,1.0,0.0,1761,1366
2001-05-29,Germany,Slovakia,2,0,2,1.0,0.0,1968,1739
2001-05-30,El Salvador,Guatemala,0,0,0,0.5,0.5,1632,1678
2001-05-30,South Korea,France,0,5,5,0.0,1.0,1877,2049
2001-05-30,Mexico,Australia,0,2,2,0.0,1.0,1857,1874
2001-05-30,Panama,Costa Rica,1,2,1,0.0,1.0,1599,1755
2001-05-30,Sri Lanka,Pakistan,3,1,2,1.0,0.0,1383,1359
2001-05-30,Thailand,Lebanon,2,2,0,0.5,0.5,1758,1627
2001-05-31,Brazil,Cameroon,2,0,2,1.0,0.0,2048,1794
2001-05-31,Japan,Canada,3,0,3,1.0,0.0,1828,1749
2001-06-01,Algeria,Angola,3,2,1,1.0,0.0,1733,1670
2001-06-01,Australia,France,1,0,1,1.0,0.0,1886,2038
2001-06-01,El Salvador,Panama,1,1,0,0.5,0.5,1632,1600
2001-06-01,Guatemala,Costa Rica,2,0,2,1.0,0.0,1688,1746
2001-06-01,South Korea,Mexico,2,1,1,1.0,0.0,1885,1850
2001-06-02,Armenia,Belarus,0,0,0,0.5,0.5,1528,1540
2001-06-02,Belgium,Latvia,3,1,2,1.0,0.0,1851,1515
2001-06-02,Canada,Brazil,0,0,0,0.5,0.5,1755,2043
2001-06-02,Croatia,San Marino,4,0,4,1.0,0.0,1837,1402
2001-06-02,Denmark,Czech Republic,2,1,1,1.0,0.0,1884,1835
2001-06-02,Estonia,Netherlands,2,4,2,0.0,1.0,1515,1975
2001-06-02,Faroe Islands,Switzerland,0,1,1,0.0,1.0,1459,1768
2001-06-02,Finland,Germany,2,2,0,0.5,0.5,1686,1963
2001-06-02,Gabon,Tunisia,1,1,0,0.5,0.5,1669,1800
2001-06-02,Georgia,Italy,1,2,1,0.0,1.0,1580,1980
2001-06-02,Greece,Albania,1,0,1,1.0,0.0,1783,1546
2001-06-02,Iceland,Malta,3,0,3,1.0,0.0,1690,1410
2001-06-02,Republic of Ireland,Portugal,1,1,0,0.5,0.5,1827,1922
2001-06-02,Japan,Cameroon,2,0,2,1.0,0.0,1836,1787
2001-06-02,Kenya,Morocco,1,1,0,0.5,0.5,1647,1830
2001-06-02,Liechtenstein,Israel,0,3,3,0.0,1.0,1413,1710
2001-06-02,North Macedonia,Moldova,2,2,0,0.5,0.5,1580,1525
2001-06-02,Nigeria,Madagascar,1,0,1,1.0,0.0,1788,1632
2001-06-02,Northern Ireland,Bulgaria,0,1,1,0.0,1.0,1665,1791
2001-06-02,Paraguay,Chile,1,0,1,1.0,0.0,1860,1757
2001-06-02,Peru,Ecuador,1,2,1,0.0,1.0,1743,1794
2001-06-02,Romania,Hungary,2,0,2,1.0,0.0,1852,1730
2001-06-02,Russia,Serbia,1,1,0,0.5,0.5,1866,1820
2001-06-02,Slovenia,Luxembourg,2,0,2,1.0,0.0,1647,1354
2001-06-02,Spain,Bosnia and Herzegovina,4,1,3,1.0,0.0,1961,1600
2001-06-02,Sweden,Slovakia,2,0,2,1.0,0.0,1888,1735
2001-06-02,Turkey,Azerbaijan,3,0,3,1.0,0.0,1748,1449
2001-06-02,Uganda,Togo,0,3,3,0.0,1.0,1633,1618
2001-06-02,Ukraine,Norway,0,0,0,0.5,0.5,1678,1855
2001-06-02,Wales,Poland,1,2,1,0.0,1.0,1681,1818
2001-06-02,Zambia,Namibia,0,0,0,0.5,0.5,1684,1545
2001-06-03,Argentina,Colombia,3,0,3,1.0,0.0,1986,1839
2001-06-03,Bolivia,Venezuela,5,0,5,1.0,0.0,1706,1521
2001-06-03,Burundi,Burkina Faso,0,0,0,0.5,0.5,1566,1628
2001-06-03,Congo,Mauritius,0,0,0,0.5,0.5,1617,1511
2001-06-03,Egypt,Sudan,3,2,1,1.0,0.0,1816,1585
2001-06-03,Costa Rica,El Salvador,1,1,0,0.5,0.5,1744,1635
2001-06-03,France,Mexico,4,0,4,1.0,0.0,2043,1846
2001-06-03,Gambia,Senegal,0,0,0,0.5,0.5,1516,1688
2001-06-03,Guatemala,Panama,3,1,2,1.0,0.0,1695,1594
2001-06-03,South Korea,Australia,1,0,1,1.0,0.0,1894,1878
2001-06-03,Lesotho,DR Congo,0,0,0,0.5,0.5,1487,1660
2001-06-03,Liberia,South Africa,1,1,0,0.5,0.5,1623,1786
2001-06-03,Libya,Ivory Coast,0,3,3,0.0,1.0,1611,1790
2001-06-03,Zimbabwe,Ghana,1,2,1,0.0,1.0,1681,1701
2001-06-04,Cameroon,Canada,2,0,2,1.0,0.0,1795,1748
2001-06-04,Japan,Brazil,0,0,0,0.5,0.5,1841,2039
2001-06-04,Solomon Islands,Cook Islands,9,1,8,1.0,0.0,1616,1469
2001-06-04,Vanuatu,Tahiti,1,6,5,0.0,1.0,1461,1716
2001-06-06,Albania,Germany,0,2,2,0.0,1.0,1545,1965
2001-06-06,Armenia,Poland,1,1,0,0.5,0.5,1534,1813
2001-06-06,Azerbaijan,Slovakia,2,0,2,1.0,0.0,1463,1722
2001-06-06,Cook Islands,Vanuatu,1,8,7,0.0,1.0,1461,1470
2001-06-06,Czech Republic,Northern Ireland,3,1,2,1.0,0.0,1840,1661
2001-06-06,Denmark,Malta,2,1,1,1.0,0.0,1885,1410
2001-06-06,Estonia,Republic of Ireland,0,2,2,0.0,1.0,1513,1830
2001-06-06,Faroe Islands,Serbia,0,6,6,0.0,1.0,1458,1822
2001-06-06,Greece,England,0,2,2,0.0,1.0,1779,1959
2001-06-06,Hungary,Georgia,4,1,3,1.0,0.0,1735,1576
2001-06-06,Iceland,Bulgaria,1,1,0,0.5,0.5,1693,1789
2001-06-06,Israel,Spain,1,1,0,0.5,0.5,1715,1957
2001-06-06,Latvia,Croatia,0,1,1,0.0,1.0,1513,1840
2001-06-06,Lithuania,Romania,1,2,1,0.0,1.0,1540,1855
2001-06-06,Luxembourg,Russia,1,2,1,0.0,1.0,1354,1867
2001-06-06,New Zealand,Tahiti,5,0,5,1.0,0.0,1683,1708
2001-06-06,Norway,Belarus,1,1,0,0.5,0.5,1850,1546
2001-06-06,Portugal,Cyprus,6,0,6,1.0,0.0,1925,1600
2001-06-06,San Marino,Belgium,1,4,3,0.0,1.0,1401,1853
2001-06-06,Sweden,Moldova,6,0,6,1.0,0.0,1890,1524
2001-06-06,Switzerland,Slovenia,0,1,1,0.0,1.0,1758,1658
2001-06-06,Turkey,North Macedonia,3,3,0,0.5,0.5,1745,1584
2001-06-06,Ukraine,Wales,1,1,0,0.5,0.5,1679,1681
2001-06-07,France,Brazil,2,1,1,1.0,0.0,2051,2032
2001-06-07,Japan,Australia,1,0,1,1.0,0.0,1850,1870
2001-06-07,United States,Ecuador,0,0,0,0.5,0.5,1875,1796
2001-06-08,New Zealand,Cook Islands,2,0,2,1.0,0.0,1687,1458
2001-06-08,Vanuatu,Solomon Islands,2,7,5,0.0,1.0,1466,1621
2001-06-09,Australia,Brazil,1,0,1,1.0,0.0,1882,2021
2001-06-10,Angola,Mauritius,1,0,1,1.0,0.0,1675,1507
2001-06-10,Jamaica,Cuba,4,1,3,1.0,0.0,1739,1619
2001-06-10,Japan,France,0,1,1,0.0,1.0,1847,2055
2001-06-10,Kenya,Egypt,1,1,0,0.5,0.5,1651,1813
2001-06-10,Panama,Trinidad and Tobago,0,0,0,0.5,0.5,1598,1754
2001-06-10,Sierra Leone,Gambia,1,1,0,0.5,0.5,1603,1518
2001-06-11,Cook Islands,Tahiti,0,6,6,0.0,1.0,1455,1712
2001-06-11,New Zealand,Solomon Islands,5,1,4,1.0,0.0,1694,1615
2001-06-13,New Zealand,Vanuatu,7,0,7,1.0,0.0,1698,1463
2001-06-13,Tahiti,Solomon Islands,2,0,2,1.0,0.0,1718,1610
2001-06-16,Jamaica,United States,0,0,0,0.5,0.5,1742,1873
2001-06-16,Madagascar,Zambia,0,1,1,0.0,1.0,1626,1691
2001-06-16,Mauritius,Liberia,0,2,2,0.0,1.0,1502,1629
2001-06-16,Mexico,Costa Rica,1,2,1,0.0,1.0,1836,1755
2001-06-16,Morocco,Gabon,0,1,1,0.0,1.0,1819,1681
2001-06-16,Namibia,Nigeria,0,2,2,0.0,1.0,1542,1792
2001-06-16,Trinidad and Tobago,Honduras,2,4,2,0.0,1.0,1747,1780
2001-06-17,Angola,Burundi,2,1,1,1.0,0.0,1681,1561
2001-06-17,Burkina Faso,Algeria,1,0,1,1.0,0.0,1639,1723
2001-06-17,DR Congo,Zimbabwe,2,1,1,1.0,0.0,1669,1673
2001-06-17,Ghana,Lesotho,3,1,2,1.0,0.0,1705,1484
2001-06-17,Ivory Coast,Egypt,2,2,0,0.5,0.5,1791,1813
2001-06-17,South Africa,Congo,0,0,0,0.5,0.5,1783,1621
2001-06-17,Sudan,Libya,1,0,1,1.0,0.0,1594,1603
2001-06-17,Togo,Senegal,1,0,1,1.0,0.0,1628,1679
2001-06-17,Tunisia,Kenya,4,1,3,1.0,0.0,1805,1647
2001-06-20,Costa Rica,Jamaica,2,1,1,1.0,0.0,1763,1735
2001-06-20,Honduras,Mexico,3,1,2,1.0,0.0,1790,1827
2001-06-20,New Zealand,Australia,0,2,2,0.0,1.0,1694,1887
2001-06-20,United States,Trinidad and Tobago,2,0,2,1.0,0.0,1879,1742
2001-06-21,Slovakia,Bosnia and Herzegovina,0,1,1,0.0,1.0,1712,1611
2001-06-21,Malaysia,Bahrain,2,4,2,0.0,1.0,1592,1603
2001-06-23,Malaysia,Slovakia,0,2,2,0.0,1.0,1587,1718
2001-06-23,Bahrain,Bosnia and Herzegovina,0,1,1,0.0,1.0,1596,1619
2001-06-23,Bermuda,Trinidad and Tobago,0,5,5,0.0,1.0,1530,1746
2001-06-24,Australia,New Zealand,4,1,3,1.0,0.0,1891,1691
2001-06-24,Belize,Cuba,3,2,1,1.0,0.0,1480,1608
2001-06-24,Lesotho,Zambia,1,2,1,0.0,1.0,1481,1695
2001-06-25,Bahrain,Slovakia,2,0,2,1.0,0.0,1607,1708
2001-06-25,Malaysia,Bosnia and Herzegovina,2,2,0,0.5,0.5,1588,1619
2001-06-26,India,Uzbekistan,1,2,1,0.0,1.0,1524,1666
2001-06-28,Bahrain,Uzbekistan,0,2,2,0.0,1.0,1601,1673
2001-06-28,Paraguay,Serbia,2,0,2,1.0,0.0,1868,1815
2001-06-29,Libya,Angola,1,1,0,0.5,0.5,1605,1680
2001-06-30,Bosnia and Herzegovina,Uzbekistan,1,2,1,0.0,1.0,1613,1680
2001-06-30,Greenland,Tibet,4,1,3,1.0,0.0,1448,1491
2001-06-30,Morocco,Egypt,1,0,1,1.0,0.0,1827,1806
2001-06-30,Namibia,Algeria,0,4,4,0.0,1.0,1538,1728
2001-06-30,Trinidad and Tobago,Jamaica,1,2,1,0.0,1.0,1738,1744
2001-07-01,Burkina Faso,South Africa,1,1,0,0.5,0.5,1643,1780
2001-07-01,Cameroon,Togo,2,0,2,1.0,0.0,1800,1624
2001-07-01,Honduras,Costa Rica,2,3,1,0.0,1.0,1782,1772
2001-07-01,Ivory Coast,Madagascar,6,0,6,1.0,0.0,1796,1622
2001-07-01,Japan,Paraguay,2,0,2,1.0,0.0,1856,1860
2001-07-01,Liberia,Ghana,1,2,1,0.0,1.0,1623,1712
2001-07-01,Malawi,Eswatini,2,2,0,0.5,0.5,1559,1480
2001-07-01,Mexico,United States,1,0,1,1.0,0.0,1837,1870
2001-07-01,Sudan,Nigeria,0,4,4,0.0,1.0,1591,1796
2001-07-01,Tunisia,Congo,6,0,6,1.0,0.0,1810,1617
2001-07-01,Uruguay,Brazil,1,0,1,1.0,0.0,1821,2009
2001-07-02,El Salvador,Ecuador,0,1,1,0.0,1.0,1631,1801
2001-07-03,Latvia,Estonia,3,1,2,1.0,0.0,1521,1505
2001-07-04,Estonia,Lithuania,2,5,3,0.0,1.0,1498,1548
2001-07-04,Japan,Serbia,1,0,1,1.0,0.0,1864,1808
2001-07-05,Latvia,Lithuania,4,1,3,1.0,0.0,1530,1540
2001-07-07,Honduras,Ecuador,1,1,0,0.5,0.5,1783,1801
2001-07-08,Zimbabwe,Eswatini,2,1,1,1.0,0.0,1677,1477
2001-07-08,Ynys Môn,Saare County,4,1,3,1.0,0.0,1571,1465
2001-07-08,Jersey,Orkney,12,0,12,1.0,0.0,1721,1497
2001-07-08,Isle of Wight,Greenland,0,0,0,0.5,0.5,1571,1451
2001-07-08,Isle of Man,Falkland Islands,9,0,9,1.0,0.0,1508,1492
2001-07-09,Saare County,Shetland,2,3,1,0.0,1.0,1458,1487
2001-07-09,Orkney,Gibraltar,0,2,2,0.0,1.0,1490,1511
2001-07-09,Greenland,Rhodes,0,2,2,0.0,1.0,1445,1528
2001-07-09,Guernsey,Falkland Islands,3,0,3,1.0,0.0,1651,1488
2001-07-10,Singapore,Saudi Arabia,0,3,3,0.0,1.0,1580,1854
2001-07-10,Ynys Môn,Shetland,1,1,0,0.5,0.5,1570,1489
2001-07-10,Jersey,Gibraltar,2,1,1,1.0,0.0,1725,1508
2001-07-10,Rhodes,Isle of Wight,1,4,3,0.0,1.0,1521,1579
2001-07-10,Isle of Man,Guernsey,2,3,1,0.0,1.0,1504,1656
2001-07-11,Colombia,Venezuela,2,0,2,1.0,0.0,1842,1519
2001-07-11,Ecuador,Chile,1,4,3,0.0,1.0,1792,1767
2001-07-12,Brazil,Mexico,0,1,1,0.0,1.0,1998,1849
2001-07-12,Peru,Paraguay,3,3,0,0.5,0.5,1746,1858
2001-07-12,Saare County,Orkney,2,1,1,1.0,0.0,1467,1482
2001-07-12,Greenland,Falkland Islands,4,0,4,1.0,0.0,1454,1480
2001-07-12,Isle of Man,Rhodes,1,3,2,0.0,1.0,1497,1529
2001-07-12,Gibraltar,Shetland,2,0,2,1.0,0.0,1516,1482
2001-07-12,Isle of Wight,Guernsey,2,3,1,0.0,1.0,1573,1663
2001-07-12,Ynys Môn,Jersey,2,2,0,0.5,0.5,1574,1722
2001-07-13,Bolivia,Uruguay,0,1,1,0.0,1.0,1701,1827
2001-07-13,Egypt,Namibia,8,2,6,1.0,0.0,1809,1536
2001-07-13,Honduras,Costa Rica,0,1,1,0.0,1.0,1775,1781
2001-07-13,Orkney,Falkland Islands,1,4,3,0.0,1.0,1474,1489
2001-07-13,Greenland,Saare County,2,0,2,1.0,0.0,1463,1459
2001-07-13,Isle of Man,Shetland,2,2,0,0.5,0.5,1497,1483
2001-07-13,Gibraltar,Rhodes,2,0,2,1.0,0.0,1525,1521
2001-07-13,Isle of Wight,Jersey,0,2,2,0.0,1.0,1569,1727
2001-07-13,Guernsey,Ynys Môn,0,0,0,0.5,0.5,1661,1577
2001-07-14,Chile,Venezuela,1,0,1,1.0,0.0,1771,1516
2001-07-14,Colombia,Ecuador,1,0,1,1.0,0.0,1849,1786
2001-07-14,Monaco,Tibet,2,1,1,1.0,0.0,1500,1484
2001-07-14,Senegal,Morocco,1,0,1,1.0,0.0,1691,1816
2001-07-14,Sierra Leone,Liberia,0,1,1,0.0,1.0,1596,1631
2001-07-14,South Africa,Malawi,2,0,2,1.0,0.0,1784,1556
2001-07-14,Zambia,Cameroon,2,2,0,0.5,0.5,1698,1798
2001-07-15,Brazil,Peru,2,0,2,1.0,0.0,2002,1743
2001-07-15,Congo,Ivory Coast,1,1,0,0.5,0.5,1621,1793
2001-07-15,DR Congo,Tunisia,0,3,3,0.0,1.0,1665,1815
2001-07-15,Ghana,Sudan,1,0,1,1.0,0.0,1718,1586
2001-07-15,Paraguay,Mexico,0,0,0,0.5,0.5,1858,1850
2001-07-15,Togo,Libya,2,0,2,1.0,0.0,1632,1598
2001-07-15,Zimbabwe,Burkina Faso,1,0,1,1.0,0.0,1685,1636
2001-07-16,Honduras,Bolivia,2,0,2,1.0,0.0,1782,1695
2001-07-16,Uruguay,Costa Rica,1,1,0,0.5,0.5,1826,1783
2001-07-17,Colombia,Chile,2,0,2,1.0,0.0,1856,1765
2001-07-17,Ecuador,Venezuela,4,0,4,1.0,0.0,1789,1514
2001-07-18,Brazil,Paraguay,3,1,2,1.0,0.0,2007,1854
2001-07-18,Peru,Mexico,1,0,1,1.0,0.0,1754,1840
2001-07-19,Bolivia,Costa Rica,0,4,4,0.0,1.0,1689,1790
2001-07-19,Honduras,Uruguay,1,0,1,1.0,0.0,1792,1817
2001-07-19,Malaysia,Saudi Arabia,0,4,4,0.0,1.0,1586,1857
2001-07-20,Cuba,Jamaica,0,0,0,0.5,0.5,1611,1742
2001-07-21,Algeria,Egypt,1,1,0,0.5,0.5,1730,1808
2001-07-21,Malawi,South Africa,1,0,1,1.0,0.0,1569,1772
2001-07-21,Namibia,Senegal,0,5,5,0.0,1.0,1532,1696
2001-07-22,Bosnia and Herzegovina,Iran,2,2,0,0.5,0.5,1618,1819
2001-07-22,Chile,Mexico,0,2,2,0.0,1.0,1759,1847
2001-07-22,Uruguay,Costa Rica,2,1,1,1.0,0.0,1825,1783
2001-07-23,Brazil,Honduras,0,2,2,0.0,1.0,1995,1805
2001-07-23,Colombia,Peru,3,0,3,1.0,0.0,1862,1749
2001-07-23,Saudi Arabia,North Korea,1,0,1,1.0,0.0,1862,1681
2001-07-24,North Macedonia,Qatar,0,1,1,0.0,1.0,1580,1756
2001-07-25,Mexico,Uruguay,2,1,1,1.0,0.0,1855,1818
2001-07-26,Colombia,Honduras,2,0,2,1.0,0.0,1869,1799
2001-07-27,Jamaica,Martinique,0,0,0,0.5,0.5,1741,1680
2001-07-27,Libya,Zambia,2,4,2,0.0,1.0,1593,1704
2001-07-28,Malawi,Zimbabwe,0,1,1,0.0,1.0,1564,1691
2001-07-28,Saint Kitts and Nevis,Martinique,4,2,2,1.0,0.0,1565,1670
2001-07-29,Uruguay,Honduras,2,2,0,0.5,0.5,1818,1800
2001-07-29,Angola,Togo,1,1,0,0.5,0.5,1679,1634
2001-07-29,Colombia,Mexico,1,0,1,1.0,0.0,1877,1848
2001-07-29,Ivory Coast,DR Congo,1,2,1,0.0,1.0,1783,1676
2001-07-29,Madagascar,Congo,1,0,1,1.0,0.0,1630,1614
2001-07-29,Nigeria,Ghana,3,0,3,1.0,0.0,1803,1712
2001-07-29,Oman,Iraq,1,0,1,1.0,0.0,1631,1749
2001-07-29,Panama,Cuba,0,0,0,0.5,0.5,1599,1611
2001-07-29,Sudan,Sierra Leone,3,0,3,1.0,0.0,1595,1588
2001-07-30,Saint Kitts and Nevis,Jamaica,0,0,0,0.5,0.5,1569,1738
2001-08-01,Grenada,Jamaica,2,0,2,1.0,0.0,1560,1727
2001-08-01,Qatar,Iran,2,1,1,1.0,0.0,1766,1810
2001-08-01,Saudi Arabia,North Macedonia,1,1,0,0.5,0.5,1857,1586
2001-08-02,United Arab Emirates,Iraq,2,2,0,0.5,0.5,1727,1749
2001-08-03,China PR,North Korea,2,2,0,0.5,0.5,1805,1684
2001-08-03,Kuwait,Trinidad and Tobago,1,1,0,0.5,0.5,1764,1739
2001-08-04,Colombia,Liberia,2,1,1,1.0,0.0,1881,1628
2001-08-05,China PR,Trinidad and Tobago,3,0,3,1.0,0.0,1812,1733
2001-08-05,Cuba,Panama,1,0,1,1.0,0.0,1619,1592
2001-08-05,Kuwait,North Korea,1,1,0,0.5,0.5,1763,1686
2001-08-05,Saudi Arabia,Qatar,1,2,1,0.0,1.0,1847,1777
2001-08-08,Iran,Oman,5,2,3,1.0,0.0,1815,1627
2001-08-08,United Arab Emirates,Saudi Arabia,0,1,1,0.0,1.0,1722,1853
2001-08-09,Brazil,Panama,5,0,5,1.0,0.0,1997,1591
2001-08-10,Iran,Bosnia and Herzegovina,4,0,4,1.0,0.0,1819,1615
2001-08-10,Qatar,Bahrain,1,1,0,0.5,0.5,1774,1605
2001-08-13,Singapore,Thailand,0,5,5,0.0,1.0,1576,1763
2001-08-14,Chile,Bolivia,2,2,0,0.5,0.5,1758,1691
2001-08-14,Venezuela,Uruguay,2,0,2,1.0,0.0,1528,1805
2001-08-15,Austria,Switzerland,1,2,1,0.0,1.0,1780,1767
2001-08-15,Bosnia and Herzegovina,Malta,2,0,2,1.0,0.0,1619,1407
2001-08-15,Brazil,Paraguay,2,0,2,1.0,0.0,2002,1850
2001-08-15,Bulgaria,North Macedonia,1,0,1,1.0,0.0,1793,1583
2001-08-15,Czech Republic,South Korea,5,0,5,1.0,0.0,1850,1885
2001-08-15,Ecuador,Argentina,0,2,2,0.0,1.0,1786,1990
2001-08-15,England,Netherlands,0,2,2,0.0,1.0,1952,1983
2001-08-15,Estonia,Cyprus,2,2,0,0.5,0.5,1501,1598
2001-08-15,Finland,Belgium,4,1,3,1.0,0.0,1698,1842
2001-08-15,France,Denmark,1,0,1,1.0,0.0,2060,1881
2001-08-15,Hungary,Germany,2,5,3,0.0,1.0,1732,1969
2001-08-15,Iceland,Poland,1,1,0,0.5,0.5,1696,1811
2001-08-15,Republic of Ireland,Croatia,2,2,0,0.5,0.5,1831,1840
2001-08-15,Japan,Australia,3,0,3,1.0,0.0,1873,1883
2001-08-15,Latvia,Ukraine,0,1,1,0.0,1.0,1526,1684
2001-08-15,Lithuania,Israel,2,3,1,0.0,1.0,1536,1720
2001-08-15,Luxembourg,Georgia,0,3,3,0.0,1.0,1351,1580
2001-08-15,Norway,Turkey,1,1,0,0.5,0.5,1848,1748
2001-08-15,Portugal,Moldova,3,0,3,1.0,0.0,1927,1523
2001-08-15,Russia,Greece,0,0,0,0.5,0.5,1866,1781
2001-08-15,Serbia,Faroe Islands,2,0,2,1.0,0.0,1810,1457
2001-08-15,Slovakia,Iran,3,4,1,0.0,1.0,1703,1825
2001-08-15,Slovenia,Romania,2,2,0,0.5,0.5,1663,1851
2001-08-15,Sweden,South Africa,3,0,3,1.0,0.0,1896,1767
2001-08-16,Colombia,Peru,0,1,1,0.0,1.0,1871,1760
2001-08-16,Qatar,Oman,0,0,0,0.5,0.5,1771,1631
2001-08-17,Iraq,Thailand,4,0,4,1.0,0.0,1758,1755
2001-08-17,Saudi Arabia,Bahrain,1,1,0,0.5,0.5,1849,1610
2001-08-17,United Arab Emirates,Uzbekistan,4,1,3,1.0,0.0,1730,1673
2001-08-18,Zambia,Angola,1,1,0,0.5,0.5,1704,1680
2001-08-23,Bahrain,Iraq,2,0,2,1.0,0.0,1622,1747
2001-08-23,Mexico,Liberia,5,4,1,1.0,0.0,1852,1625
2001-08-24,Iran,Saudi Arabia,2,0,2,1.0,0.0,1834,1841
2001-08-25,China PR,United Arab Emirates,3,0,3,1.0,0.0,1819,1724
2001-08-25,Malawi,Zimbabwe,0,2,2,0.0,1.0,1559,1697
2001-08-26,Uzbekistan,Qatar,2,1,1,1.0,0.0,1684,1761
2001-08-31,Oman,China PR,0,2,2,0.0,1.0,1627,1824
2001-08-31,Saudi Arabia,Iraq,1,0,1,1.0,0.0,1847,1742
2001-08-31,United Arab Emirates,Qatar,0,2,2,0.0,1.0,1717,1769
2001-09-01,Albania,Finland,0,2,2,0.0,1.0,1541,1703
2001-09-01,Andorra,Portugal,1,7,6,0.0,1.0,1409,1928
2001-09-01,Belarus,Ukraine,0,2,2,0.0,1.0,1542,1689
2001-09-01,Bosnia and Herzegovina,Israel,0,0,0,0.5,0.5,1622,1718
2001-09-01,Chile,France,2,1,1,1.0,0.0,1772,2047
2001-09-01,Denmark,Northern Ireland,1,1,0,0.5,0.5,1877,1666
2001-09-01,Faroe Islands,Luxembourg,1,0,1,1.0,0.0,1463,1346
2001-09-01,Georgia,Hungary,3,1,2,1.0,0.0,1592,1721
2001-09-01,Germany,England,1,5,4,0.0,1.0,1961,1961
2001-09-01,Iceland,Czech Republic,3,1,2,1.0,0.0,1708,1839
2001-09-01,Republic of Ireland,Netherlands,1,0,1,1.0,0.0,1843,1972
2001-09-01,Lithuania,Italy,0,0,0,0.5,0.5,1543,1974
2001-09-01,North Macedonia,Sweden,1,2,1,0.0,1.0,1581,1899
2001-09-01,Malta,Bulgaria,0,2,2,0.0,1.0,1406,1795
2001-09-01,Moldova,Azerbaijan,2,0,2,1.0,0.0,1530,1457
2001-09-01,Poland,Norway,3,0,3,1.0,0.0,1820,1840
2001-09-01,Scotland,Croatia,0,0,0,0.5,0.5,1816,1840
2001-09-01,Slovakia,Turkey,0,1,1,0.0,1.0,1697,1755
2001-09-01,Slovenia,Russia,2,1,1,1.0,0.0,1676,1854
2001-09-01,Spain,Austria,4,0,4,1.0,0.0,1962,1776
2001-09-01,Switzerland,Serbia,1,2,1,0.0,1.0,1760,1818
2001-09-01,Thailand,Iran,0,0,0,0.5,0.5,1757,1833
2001-09-01,Trinidad and Tobago,Costa Rica,0,2,2,0.0,1.0,1727,1790
2001-09-01,United States,Honduras,2,3,1,0.0,1.0,1861,1810
2001-09-01,Wales,Armenia,0,0,0,0.5,0.5,1678,1538
2001-09-02,Jamaica,Mexico,1,2,1,0.0,1.0,1722,1858
2001-09-04,Chile,Venezuela,0,2,2,0.0,1.0,1760,1541
2001-09-04,Peru,Uruguay,0,2,2,0.0,1.0,1754,1812
2001-09-05,Argentina,Brazil,2,1,1,1.0,0.0,1999,1994
2001-09-05,Austria,Bosnia and Herzegovina,2,0,2,1.0,0.0,1781,1618
2001-09-05,Azerbaijan,North Macedonia,1,1,0,0.5,0.5,1460,1579
2001-09-05,Belarus,Poland,4,1,3,1.0,0.0,1556,1807
2001-09-05,Belgium,Scotland,2,0,2,1.0,0.0,1850,1809
2001-09-05,Bulgaria,Denmark,0,2,2,0.0,1.0,1789,1884
2001-09-05,Colombia,Ecuador,0,0,0,0.5,0.5,1870,1788
2001-09-05,Costa Rica,United States,2,0,2,1.0,0.0,1800,1852
2001-09-05,Cyprus,Portugal,1,3,2,0.0,1.0,1596,1931
2001-09-05,Czech Republic,Malta,3,2,1,1.0,0.0,1841,1405
2001-09-05,England,Albania,2,0,2,1.0,0.0,1963,1540
2001-09-05,Faroe Islands,Russia,0,3,3,0.0,1.0,1462,1856
2001-09-05,Finland,Greece,5,1,4,1.0,0.0,1713,1772
2001-09-05,Georgia,Lithuania,2,0,2,1.0,0.0,1599,1537
2001-09-05,Honduras,Jamaica,1,0,1,1.0,0.0,1817,1716
2001-09-05,Hungary,Romania,0,2,2,0.0,1.0,1716,1857
2001-09-05,Italy,Morocco,1,0,1,1.0,0.0,1979,1812
2001-09-05,Liechtenstein,Spain,0,2,2,0.0,1.0,1413,1963
2001-09-05,Luxembourg,Switzerland,0,3,3,0.0,1.0,1345,1762
2001-09-05,Mexico,Trinidad and Tobago,3,0,3,1.0,0.0,1864,1722
2001-09-05,Netherlands,Estonia,5,0,5,1.0,0.0,1973,1501
2001-09-05,Northern Ireland,Iceland,3,0,3,1.0,0.0,1675,1700
2001-09-05,Norway,Wales,3,2,1,1.0,0.0,1845,1674
2001-09-05,Paraguay,Bolivia,5,1,4,1.0,0.0,1855,1687
2001-09-05,San Marino,Croatia,0,4,4,0.0,1.0,1400,1842
2001-09-05,Serbia,Slovenia,1,1,0,0.5,0.5,1815,1680
2001-09-05,Slovakia,Moldova,4,2,2,1.0,0.0,1702,1526
2001-09-05,Turkey,Sweden,1,2,1,0.0,1.0,1751,1904
2001-09-05,Ukraine,Armenia,3,0,3,1.0,0.0,1694,1534
2001-09-06,Bahrain,Thailand,1,1,0,0.5,0.5,1625,1755
2001-09-07,Iraq,Iran,1,2,1,0.0,1.0,1737,1839
2001-09-07,Qatar,China PR,1,1,0,0.5,0.5,1771,1823
2001-09-07,Saudi Arabia,United Arab Emirates,0,2,2,0.0,1.0,1837,1728
2001-09-08,Uzbekistan,Oman,5,0,5,1.0,0.0,1691,1621
2001-09-13,South Korea,Nigeria,2,2,0,0.5,0.5,1884,1805
2001-09-14,Iran,Bahrain,0,0,0,0.5,0.5,1835,1630
2001-09-14,Oman,United Arab Emirates,1,1,0,0.5,0.5,1624,1726
2001-09-14,Qatar,Iraq,0,0,0,0.5,0.5,1771,1738
2001-09-15,China PR,Uzbekistan,2,0,2,1.0,0.0,1829,1686
2001-09-15,Thailand,Saudi Arabia,1,3,2,0.0,1.0,1749,1844
2001-09-16,Angola,Zimbabwe,0,0,0,0.5,0.5,1681,1697
2001-09-16,South Korea,Nigeria,2,1,1,1.0,0.0,1891,1799
2001-09-21,Bahrain,Saudi Arabia,0,4,4,0.0,1.0,1627,1848
2001-09-21,Oman,Qatar,0,3,3,0.0,1.0,1620,1776
2001-09-22,Thailand,Iraq,1,1,0,0.5,0.5,1749,1739
2001-09-22,Uzbekistan,United Arab Emirates,0,1,1,0.0,1.0,1679,1734
2001-09-27,United Arab Emirates,China PR,0,1,1,0.0,1.0,1729,1835
2001-09-28,Iraq,Bahrain,1,0,1,1.0,0.0,1745,1622
2001-09-28,Qatar,Uzbekistan,2,2,0,0.5,0.5,1774,1682
2001-09-28,Saudi Arabia,Iran,2,2,0,0.5,0.5,1848,1836
2001-09-29,Thailand,Oman,2,0,2,1.0,0.0,1755,1615
2001-09-30,Zimbabwe,Angola,0,1,1,0.0,1.0,1689,1690
2001-10-04,Japan,Senegal,0,2,2,0.0,1.0,1862,1708
2001-10-04,Qatar,United Arab Emirates,1,2,1,0.0,1.0,1765,1739
2001-10-05,Bahrain,Qatar,1,0,1,1.0,0.0,1634,1754
2001-10-05,Iran,Thailand,1,0,1,1.0,0.0,1843,1749
2001-10-05,Iraq,Saudi Arabia,1,2,1,0.0,1.0,1740,1854
2001-10-06,Armenia,Norway,1,4,3,0.0,1.0,1532,1848
2001-10-06,Bolivia,Ecuador,1,5,4,0.0,1.0,1682,1794
2001-10-06,Croatia,Belgium,1,0,1,1.0,0.0,1851,1842
2001-10-06,Czech Republic,Bulgaria,6,0,6,1.0,0.0,1848,1783
2001-10-06,Denmark,Iceland,6,0,6,1.0,0.0,1889,1696
2001-10-06,England,Greece,2,2,0,0.5,0.5,1959,1777
2001-10-06,France,Algeria,4,1,3,1.0,0.0,2050,1728
2001-10-06,Germany,Finland,0,0,0,0.5,0.5,1957,1718
2001-10-06,Republic of Ireland,Cyprus,4,0,4,1.0,0.0,1847,1593
2001-10-06,Italy,Hungary,1,0,1,1.0,0.0,1982,1714
2001-10-06,Malta,Northern Ireland,0,1,1,0.0,1.0,1403,1678
2001-10-06,Moldova,Turkey,0,3,3,0.0,1.0,1523,1755
2001-10-06,Netherlands,Andorra,4,0,4,1.0,0.0,1974,1409
2001-10-06,Poland,Ukraine,1,1,0,0.5,0.5,1805,1697
2001-10-06,Portugal,Estonia,5,0,5,1.0,0.0,1933,1500
2001-10-06,Romania,Georgia,1,1,0,0.5,0.5,1852,1605
2001-10-06,Russia,Switzerland,4,0,4,1.0,0.0,1862,1757
2001-10-06,Scotland,Latvia,2,1,1,1.0,0.0,1812,1524
2001-10-06,Serbia,Luxembourg,6,2,4,1.0,0.0,1817,1344
2001-10-06,Slovenia,Faroe Islands,3,0,3,1.0,0.0,1684,1459
2001-10-06,Venezuela,Peru,3,0,3,1.0,0.0,1554,1742
2001-10-06,Wales,Belarus,1,0,1,1.0,0.0,1680,1551
2001-10-07,Bosnia and Herzegovina,Liechtenstein,5,0,5,1.0,0.0,1622,1410
2001-10-07,Brazil,Chile,2,0,2,1.0,0.0,1998,1757
2001-10-07,China PR,Oman,1,0,1,1.0,0.0,1839,1612
2001-10-07,Costa Rica,Mexico,0,0,0,0.5,0.5,1802,1863
2001-10-07,Honduras,Trinidad and Tobago,0,1,1,0.0,1.0,1807,1733
2001-10-07,Japan,Nigeria,2,2,0,0.5,0.5,1861,1801
2001-10-07,North Macedonia,Slovakia,0,5,5,0.0,1.0,1574,1708
2001-10-07,Paraguay,Argentina,2,2,0,0.5,0.5,1859,1996
2001-10-07,Sweden,Azerbaijan,3,0,3,1.0,0.0,1906,1459
2001-10-07,Uruguay,Colombia,1,1,0,0.5,0.5,1814,1869
2001-10-07,United States,Jamaica,2,1,1,1.0,0.0,1858,1711
2001-10-12,Gambia,Morocco,0,2,2,0.0,1.0,1516,1815
2001-10-12,Iran,Iraq,2,1,1,1.0,0.0,1849,1735
2001-10-13,China PR,Qatar,3,0,3,1.0,0.0,1846,1748
2001-10-13,Oman,Uzbekistan,4,2,2,1.0,0.0,1622,1673
2001-10-14,Mali,Morocco,2,1,1,1.0,0.0,1639,1804
2001-10-15,Algeria,Burkina Faso,2,0,2,1.0,0.0,1734,1631
2001-10-16,Thailand,Bahrain,1,1,0,0.5,0.5,1747,1637
2001-10-18,Kuwait,Qatar,0,1,1,0.0,1.0,1755,1757
2001-10-19,United Arab Emirates,Oman,2,2,0,0.5,0.5,1737,1625
2001-10-19,Uzbekistan,China PR,1,0,1,1.0,0.0,1685,1835
2001-10-21,Bahamas,Haiti,0,2,2,0.0,1.0,1474,1642
2001-10-21,Bahrain,Iran,3,1,2,1.0,0.0,1650,1837
2001-10-21,Saudi Arabia,Thailand,4,1,3,1.0,0.0,1860,1742
2001-10-24,Kenya,Uganda,0,0,0,0.5,0.5,1647,1634
2001-10-24,Tanzania,DR Congo,2,2,0,0.5,0.5,1505,1673
2001-10-25,Iran,United Arab Emirates,1,0,1,1.0,0.0,1843,1732
2001-10-27,DR Congo,Uganda,0,1,1,0.0,1.0,1665,1643
2001-10-27,Israel,Austria,1,1,0,0.5,0.5,1720,1780
2001-10-27,Tanzania,Kenya,3,1,2,1.0,0.0,1517,1636
2001-10-31,Mexico,El Salvador,4,1,3,1.0,0.0,1867,1628
2001-10-31,United Arab Emirates,Iran,0,3,3,0.0,1.0,1727,1849
2001-11-03,Benin,Guinea-Bissau,2,7,5,0.0,1.0,1456,1506
2001-11-03,Mali,Mauritania,3,2,1,1.0,0.0,1643,1436
2001-11-05,Benin,Mauritania,2,0,2,1.0,0.0,1464,1429
2001-11-05,Mali,Guinea-Bissau,2,0,2,1.0,0.0,1648,1502
2001-11-07,Bolivia,Brazil,3,1,2,1.0,0.0,1696,1985
2001-11-07,Cape Verde,Gambia,1,1,0,0.5,0.5,1538,1517
2001-11-07,Colombia,Chile,3,1,2,1.0,0.0,1875,1752
2001-11-07,Ecuador,Uruguay,1,1,0,0.5,0.5,1795,1814
2001-11-07,Guinea-Bissau,Mauritania,1,0,1,1.0,0.0,1509,1423
2001-11-07,Japan,Italy,1,1,0,0.5,0.5,1864,1980
2001-11-07,Mali,Benin,0,0,0,0.5,0.5,1645,1468
2001-11-08,Argentina,Peru,2,0,2,1.0,0.0,2000,1739
2001-11-08,South Korea,Senegal,0,1,1,0.0,1.0,1880,1720
2001-11-08,Venezuela,Paraguay,3,1,2,1.0,0.0,1568,1846
2001-11-09,Mali,Gambia,0,1,1,0.0,1.0,1635,1528
2001-11-10,Austria,Turkey,0,1,1,0.0,1.0,1772,1764
2001-11-10,Belgium,Czech Republic,1,0,1,1.0,0.0,1851,1840
2001-11-10,Denmark,Netherlands,1,1,0,0.5,0.5,1891,1973
2001-11-10,England,Sweden,1,1,0,0.5,0.5,1958,1908
2001-11-10,Greece,Estonia,4,2,2,1.0,0.0,1780,1498
2001-11-10,Republic of Ireland,Iran,2,0,2,1.0,0.0,1856,1841
2001-11-10,South Korea,Croatia,2,0,2,1.0,0.0,1888,1844
2001-11-10,Slovenia,Romania,2,1,1,1.0,0.0,1696,1841
2001-11-10,South Africa,Egypt,1,0,1,1.0,0.0,1776,1800
2001-11-10,Ukraine,Germany,1,1,0,0.5,0.5,1703,1952
2001-11-11,Australia,France,1,1,0,0.5,0.5,1887,2047
2001-11-11,Jamaica,Costa Rica,0,1,1,0.0,1.0,1706,1808
2001-11-11,Mali,Guinea-Bissau,2,1,1,1.0,0.0,1641,1504
2001-11-11,Mexico,Honduras,3,0,3,1.0,0.0,1874,1801
2001-11-11,Trinidad and Tobago,United States,0,0,0,0.5,0.5,1736,1856
2001-11-13,South Korea,Croatia,1,1,0,0.5,0.5,1887,1846
2001-11-14,Brazil,Venezuela,3,0,3,1.0,0.0,1987,1567
2001-11-14,Chile,Ecuador,0,0,0,0.5,0.5,1753,1795
2001-11-14,Czech Republic,Belgium,0,1,1,0.0,1.0,1833,1859
2001-11-14,Estonia,Kazakhstan,0,0,0,0.5,0.5,1501,1630
2001-11-14,Germany,Ukraine,4,1,3,1.0,0.0,1956,1700
2001-11-14,Greece,Cyprus,1,2,1,0.0,1.0,1769,1605
2001-11-14,Hungary,North Macedonia,5,0,5,1.0,0.0,1719,1570
2001-11-14,Latvia,Russia,1,3,2,0.0,1.0,1522,1865
2001-11-14,Malta,Canada,2,1,1,1.0,0.0,1418,1734
2001-11-14,Morocco,Zambia,1,0,1,1.0,0.0,1810,1699
2001-11-14,Paraguay,Colombia,0,4,4,0.0,1.0,1839,1883
2001-11-14,Peru,Bolivia,1,1,0,0.5,0.5,1739,1697
2001-11-14,Poland,Cameroon,0,0,0,0.5,0.5,1805,1799
2001-11-14,Portugal,Angola,5,1,4,1.0,0.0,1937,1687
2001-11-14,Romania,Slovenia,1,1,0,0.5,0.5,1838,1700
2001-11-14,Spain,Mexico,1,0,1,1.0,0.0,1969,1869
2001-11-14,Turkey,Austria,5,0,5,1.0,0.0,1773,1764
2001-11-14,Uruguay,Argentina,1,1,0,0.5,0.5,1818,1997
2001-11-15,Iran,Republic of Ireland,1,0,1,1.0,0.0,1850,1848
2001-11-20,Australia,Uruguay,1,0,1,1.0,0.0,1894,1812
2001-11-20,Madagascar,Mayotte,1,0,1,1.0,0.0,1636,1495
2001-11-21,Ethiopia,Zambia,1,2,1,0.0,1.0,1595,1705
2001-11-25,Uruguay,Australia,3,0,3,1.0,0.0,1822,1885
2001-11-28,Tunisia,Togo,1,0,1,1.0,0.0,1820,1630
2001-11-29,Oman,Kuwait,1,1,0,0.5,0.5,1628,1753
2001-12-05,Algeria,Ghana,1,1,0,0.5,0.5,1734,1713
2001-12-05,Mali,Ivory Coast,0,3,3,0.0,1.0,1637,1788
2001-12-08,Rwanda,Somalia,3,0,3,1.0,0.0,1583,1403
2001-12-09,Burundi,Tanzania,1,2,1,0.0,1.0,1552,1527
2001-12-09,South Korea,United States,1,0,1,1.0,0.0,1895,1849
2001-12-09,Uganda,Djibouti,10,1,9,1.0,0.0,1646,1384
2001-12-10,Kenya,Eritrea,2,1,1,1.0,0.0,1642,1495
2001-12-11,Burundi,Djibouti,3,1,2,1.0,0.0,1557,1380
2001-12-11,Uganda,Tanzania,0,1,1,0.0,1.0,1636,1538
2001-12-12,Kenya,Somalia,3,0,3,1.0,0.0,1646,1400
2001-12-12,Rwanda,Eritrea,1,0,1,1.0,0.0,1590,1489
2001-12-13,Bahrain,Oman,2,2,0,0.5,0.5,1650,1629
2001-12-13,Ethiopia,Zanzibar,5,0,5,1.0,0.0,1600,1401
2001-12-13,Tanzania,Djibouti,4,1,3,1.0,0.0,1543,1376
2001-12-14,Eritrea,Somalia,0,0,0,0.5,0.5,1487,1403
2001-12-14,Uganda,Burundi,0,2,2,0.0,1.0,1627,1567
2001-12-15,Botswana,Namibia,3,2,1,1.0,0.0,1450,1522
2001-12-15,El Salvador,Haiti,0,0,0,0.5,0.5,1629,1642
2001-12-15,Rwanda,Kenya,0,0,0,0.5,0.5,1592,1645
2001-12-16,Botswana,Lesotho,1,0,1,1.0,0.0,1459,1473
2001-12-16,Burkina Faso,Togo,1,2,1,0.0,1.0,1623,1639
2001-12-17,Kenya,Eritrea,1,0,1,1.0,0.0,1650,1483
2001-12-18,Ethiopia,Burundi,2,2,0,0.5,0.5,1600,1568
2001-12-18,Rwanda,Uganda,3,2,1,1.0,0.0,1601,1619
2001-12-20,Rwanda,Ethiopia,0,1,1,0.0,1.0,1593,1609
2001-12-22,Kenya,Ethiopia,1,2,1,0.0,1.0,1642,1618
2001-12-22,Togo,Burkina Faso,1,0,1,1.0,0.0,1647,1616
2001-12-23,Oman,Syria,2,0,2,1.0,0.0,1638,1637
2001-12-25,Mali,Ghana,1,1,0,0.5,0.5,1639,1712
2001-12-25,Oman,Syria,1,0,1,1.0,0.0,1646,1630
2001-12-26,Senegal,Burkina Faso,2,4,2,0.0,1.0,1710,1627
2001-12-27,Andalusia,Tunisia,3,3,0,0.5,0.5,1547,1815
2001-12-28,Mali,Burkina Faso,2,1,1,1.0,0.0,1647,1620
2001-12-28,Catalonia,Chile,1,0,1,1.0,0.0,1562,1741
2001-12-29,Kuwait,Syria,0,0,0,0.5,0.5,1751,1633
2001-12-29,Basque Country,Ghana,3,2,1,1.0,0.0,1697,1704
2001-12-30,Benin,Togo,1,1,0,0.5,0.5,1472,1644
2001-12-30,Oman,North Macedonia,2,0,2,1.0,0.0,1653,1564
2001-12-30,Qatar,Egypt,2,2,0,0.5,0.5,1758,1800
2001-12-30,Saudi Arabia,Zimbabwe,0,2,2,0.0,1.0,1849,1701
2001-12-30,Senegal,Algeria,1,0,1,1.0,0.0,1719,1726
2001-12-30,Tunisia,Liberia,7,2,5,1.0,0.0,1820,1621
2001-12-31,Kuwait,Syria,2,2,0,0.5,0.5,1749,1636
2002-01-04,Bahrain,Finland,0,2,2,0.0,1.0,1644,1725
2002-01-04,Egypt,Ghana,2,0,2,1.0,0.0,1806,1699
2002-01-04,Martinique,Guadeloupe,1,3,2,0.0,1.0,1659,1532
2002-01-05,Albania,North Macedonia,0,0,0,0.5,0.5,1541,1564
2002-01-05,Kuwait,Zimbabwe,3,0,3,1.0,0.0,1756,1695
2002-01-06,Cuba,Guatemala,0,1,1,0.0,1.0,1613,1702
2002-01-06,Egypt,Mali,1,2,1,0.0,1.0,1795,1659
2002-01-06,Martinique,Haiti,3,3,0,0.5,0.5,1659,1643
2002-01-07,Albania,Finland,1,1,0,0.5,0.5,1545,1722
2002-01-07,Bahrain,North Macedonia,1,1,0,0.5,0.5,1643,1566
2002-01-07,Burkina Faso,Cameroon,1,3,2,0.0,1.0,1616,1804
2002-01-08,Kuwait,Iceland,0,0,0,0.5,0.5,1755,1698
2002-01-08,Qatar,Zimbabwe,0,2,2,0.0,1.0,1749,1705
2002-01-09,Cuba,Guatemala,0,0,0,0.5,0.5,1616,1700
2002-01-10,Bahrain,Albania,3,0,3,1.0,0.0,1649,1540
2002-01-10,Finland,North Macedonia,3,0,3,1.0,0.0,1727,1562
2002-01-10,Mali,Zambia,1,1,0,0.5,0.5,1661,1704
2002-01-10,Saudi Arabia,Iceland,1,0,1,1.0,0.0,1854,1694
2002-01-11,Egypt,Burkina Faso,2,2,0,0.5,0.5,1792,1620
2002-01-11,Grenada,Trinidad and Tobago,2,3,1,0.0,1.0,1556,1741
2002-01-11,Iraq,Oman,2,0,2,1.0,0.0,1742,1647
2002-01-11,Tunisia,Cameroon,0,1,1,0.0,1.0,1812,1813
2002-01-12,Ecuador,Guatemala,1,0,1,1.0,0.0,1801,1695
2002-01-12,Ivory Coast,Nigeria,1,1,0,0.5,0.5,1789,1801
2002-01-13,Morocco,Guinea,2,1,1,1.0,0.0,1815,1636
2002-01-13,Qatar,Iraq,1,3,2,0.0,1.0,1741,1751
2002-01-14,Algeria,Benin,4,0,4,1.0,0.0,1730,1469
2002-01-15,South Africa,Angola,1,0,1,1.0,0.0,1782,1682
2002-01-16,Gambia,Morocco,0,2,2,0.0,1.0,1526,1818
2002-01-16,Saudi Arabia,Kuwait,1,1,0,0.5,0.5,1852,1758
2002-01-17,Qatar,Bahrain,1,0,1,1.0,0.0,1747,1644
2002-01-17,United Arab Emirates,Oman,1,0,1,1.0,0.0,1734,1641
2002-01-18,Haiti,Canada,0,2,2,0.0,1.0,1638,1740
2002-01-18,Martinique,Costa Rica,0,2,2,0.0,1.0,1655,1813
2002-01-19,El Salvador,Mexico,0,1,1,0.0,1.0,1626,1873
2002-01-19,Kuwait,Oman,1,3,2,0.0,1.0,1748,1652
2002-01-19,Mali,Liberia,1,1,0,0.5,0.5,1661,1622
2002-01-19,Saint Kitts and Nevis,Grenada,1,1,0,0.5,0.5,1569,1557
2002-01-19,United States,South Korea,2,1,1,1.0,0.0,1859,1886
2002-01-20,Antigua and Barbuda,Dominica,4,0,4,1.0,0.0,1481,1432
2002-01-20,Cameroon,DR Congo,1,0,1,1.0,0.0,1818,1661
2002-01-20,Costa Rica,Trinidad and Tobago,1,1,0,0.5,0.5,1812,1743
2002-01-20,Ecuador,Haiti,0,2,2,0.0,1.0,1790,1650
2002-01-20,Egypt,Senegal,0,1,1,0.0,1.0,1783,1729
2002-01-20,Saudi Arabia,Bahrain,3,1,2,1.0,0.0,1856,1641
2002-01-20,South Africa,Burkina Faso,0,0,0,0.5,0.5,1779,1624
2002-01-20,United Arab Emirates,Qatar,0,2,2,0.0,1.0,1727,1755
2002-01-21,Algeria,Nigeria,0,1,1,0.0,1.0,1724,1808
2002-01-21,Mexico,Guatemala,3,1,2,1.0,0.0,1878,1691
2002-01-21,Morocco,Ghana,0,0,0,0.5,0.5,1816,1702
2002-01-21,Togo,Ivory Coast,0,0,0,0.5,0.5,1648,1786
2002-01-21,United States,Cuba,1,0,1,1.0,0.0,1863,1613
2002-01-21,Zambia,Tunisia,0,0,0,0.5,0.5,1707,1810
2002-01-22,Canada,Ecuador,0,2,2,0.0,1.0,1734,1797
2002-01-22,Kuwait,Bahrain,0,0,0,0.5,0.5,1746,1644
2002-01-22,Trinidad and Tobago,Martinique,0,1,1,0.0,1.0,1734,1665
2002-01-23,Guatemala,El Salvador,0,1,1,0.0,1.0,1682,1636
2002-01-23,South Korea,Cuba,0,0,0,0.5,0.5,1881,1619
2002-01-24,Mali,Nigeria,0,0,0,0.5,0.5,1665,1805
2002-01-24,South Africa,Ghana,0,0,0,0.5,0.5,1778,1704
2002-01-24,Oman,Qatar,1,2,1,0.0,1.0,1647,1761
2002-01-24,Saudi Arabia,United Arab Emirates,1,0,1,1.0,0.0,1862,1722
2002-01-25,Cameroon,Ivory Coast,1,0,1,1.0,0.0,1826,1779
2002-01-25,Egypt,Tunisia,1,0,1,1.0,0.0,1792,1802
2002-01-25,Liberia,Algeria,2,2,0,0.5,0.5,1625,1722
2002-01-26,Burkina Faso,Morocco,1,2,1,0.0,1.0,1621,1820
2002-01-26,Canada,Martinique,1,1,0,0.5,0.5,1733,1667
2002-01-26,DR Congo,Togo,0,0,0,0.5,0.5,1661,1649
2002-01-26,Costa Rica,Haiti,2,1,1,1.0,0.0,1817,1646
2002-01-26,Senegal,Zambia,1,0,1,1.0,0.0,1737,1700
2002-01-26,Kuwait,Qatar,0,1,1,0.0,1.0,1739,1769
2002-01-27,Mexico,South Korea,0,0,0,0.5,0.5,1879,1881
2002-01-27,United States,El Salvador,4,0,4,1.0,0.0,1867,1633
2002-01-27,United Arab Emirates,Bahrain,1,2,1,0.0,1.0,1713,1654
2002-01-27,Saudi Arabia,Oman,2,0,2,1.0,0.0,1866,1644
2002-01-28,Liberia,Nigeria,0,1,1,0.0,1.0,1621,1810
2002-01-28,Mali,Algeria,2,0,2,1.0,0.0,1675,1713
2002-01-29,Cameroon,Togo,3,0,3,1.0,0.0,1831,1645
2002-01-29,DR Congo,Ivory Coast,3,1,2,1.0,0.0,1672,1769
2002-01-29,Kuwait,United Arab Emirates,2,1,1,1.0,0.0,1747,1706
2002-01-30,Burkina Faso,Ghana,1,2,1,0.0,1.0,1615,1711
2002-01-30,Costa Rica,South Korea,3,1,2,1.0,0.0,1827,1872
2002-01-30,South Africa,Morocco,3,1,2,1.0,0.0,1787,1812
2002-01-30,United States,Canada,0,0,0,0.5,0.5,1865,1736
2002-01-30,Bahrain,Oman,1,1,0,0.5,0.5,1654,1645
2002-01-30,Saudi Arabia,Qatar,3,1,2,1.0,0.0,1872,1764
2002-01-31,Brazil,Bolivia,6,0,6,1.0,0.0,1990,1695
2002-01-31,Egypt,Zambia,2,1,1,1.0,0.0,1798,1695
2002-01-31,Senegal,Tunisia,0,0,0,0.5,0.5,1739,1801
2002-02-02,Canada,South Korea,2,1,1,1.0,0.0,1747,1862
2002-02-02,United States,Costa Rica,2,0,2,1.0,0.0,1873,1820
2002-02-03,Mali,South Africa,2,0,2,1.0,0.0,1686,1777
2002-02-03,Nigeria,Ghana,1,0,1,1.0,0.0,1816,1706
2002-02-04,Cameroon,Egypt,1,0,1,1.0,0.0,1839,1791
2002-02-04,Senegal,DR Congo,2,0,2,1.0,0.0,1746,1666
2002-02-06,Iran,Slovakia,2,3,1,0.0,1.0,1839,1720
2002-02-06,Saudi Arabia,Brazil,0,1,1,0.0,1.0,1867,1996
2002-02-07,Mali,Cameroon,0,3,3,0.0,1.0,1682,1844
2002-02-07,Nigeria,Senegal,1,2,1,0.0,1.0,1807,1756
2002-02-07,Singapore,North Korea,2,1,1,1.0,0.0,1587,1676
2002-02-09,Lithuania,Moldova,1,0,1,1.0,0.0,1545,1516
2002-02-09,Mali,Nigeria,0,1,1,0.0,1.0,1677,1813
2002-02-09,Malta,Jordan,2,1,1,1.0,0.0,1431,1609
2002-02-10,Faroe Islands,Poland,1,2,1,0.0,1.0,1458,1807
2002-02-10,North Korea,Qatar,1,1,0,0.5,0.5,1678,1763
2002-02-10,Senegal,Cameroon,0,0,0,0.5,0.5,1758,1843
2002-02-10,Thailand,Singapore,4,0,4,1.0,0.0,1747,1583
2002-02-11,Malta,Lithuania,1,1,0,0.5,0.5,1434,1543
2002-02-11,Moldova,Jordan,2,0,2,1.0,0.0,1527,1599
2002-02-12,Cyprus,Switzerland,1,1,0,0.5,0.5,1609,1754
2002-02-12,Czech Republic,Hungary,2,0,2,1.0,0.0,1839,1714
2002-02-12,North Korea,Singapore,4,2,2,1.0,0.0,1684,1578
2002-02-12,Slovenia,Honduras,1,5,4,0.0,1.0,1695,1807
2002-02-12,Thailand,Qatar,1,0,1,1.0,0.0,1756,1755
2002-02-12,Turkey,Ecuador,0,1,1,0.0,1.0,1766,1805
2002-02-13,Belgium,Norway,1,0,1,1.0,0.0,1867,1841
2002-02-13,Croatia,Bulgaria,0,0,0,0.5,0.5,1845,1785
2002-02-13,Cyprus,Czech Republic,3,4,1,0.0,1.0,1606,1843
2002-02-13,Faroe Islands,Liechtenstein,1,0,1,1.0,0.0,1465,1404
2002-02-13,France,Romania,2,1,1,1.0,0.0,2051,1835
2002-02-13,Germany,Israel,7,1,6,1.0,0.0,1960,1717
2002-02-13,Greece,Sweden,2,2,0,0.5,0.5,1773,1905
2002-02-13,Republic of Ireland,Russia,2,0,2,1.0,0.0,1857,1857
2002-02-13,Italy,United States,1,0,1,1.0,0.0,1986,1868
2002-02-13,Lithuania,Jordan,0,3,3,0.0,1.0,1537,1606
2002-02-13,Luxembourg,Albania,0,0,0,0.5,0.5,1349,1536
2002-02-13,Malta,Moldova,3,0,3,1.0,0.0,1445,1517
2002-02-13,Mexico,Serbia,1,2,1,0.0,1.0,1870,1827
2002-02-13,Netherlands,England,1,1,0,0.5,0.5,1973,1959
2002-02-13,Northern Ireland,Poland,1,4,3,0.0,1.0,1673,1813
2002-02-13,Paraguay,Bolivia,2,2,0,0.5,0.5,1836,1699
2002-02-13,Saudi Arabia,Denmark,0,1,1,0.0,1.0,1860,1899
2002-02-13,Spain,Portugal,1,1,0,0.5,0.5,1969,1938
2002-02-13,Switzerland,Hungary,2,1,1,1.0,0.0,1762,1707
2002-02-13,Uruguay,South Korea,2,1,1,1.0,0.0,1831,1854
2002-02-13,Wales,Argentina,1,1,0,0.5,0.5,1686,1992
2002-02-14,Qatar,Singapore,3,0,3,1.0,0.0,1760,1574
2002-02-14,Thailand,North Korea,0,1,1,0.0,1.0,1747,1694
2002-02-15,China PR,Slovenia,0,0,0,0.5,0.5,1832,1699
2002-02-16,Qatar,Singapore,2,0,2,1.0,0.0,1765,1570
2002-02-16,Thailand,North Korea,0,0,0,0.5,0.5,1746,1696
2002-02-18,Gibraltar,Monaco,2,2,0,0.5,0.5,1525,1501
2002-03-01,Iran,Venezuela,1,0,1,1.0,0.0,1842,1565
2002-03-02,Botswana,Eswatini,6,2,4,1.0,0.0,1468,1469
2002-03-02,United States,Honduras,4,0,4,1.0,0.0,1875,1801
2002-03-07,Brazil,Iceland,6,1,5,1.0,0.0,1999,1692
2002-03-09,American Samoa,New Caledonia,0,10,10,0.0,1.0,1401,1577
2002-03-09,Samoa,Tonga,2,0,2,1.0,0.0,1489,1481
2002-03-09,Alderney,Jersey,1,2,1,0.0,1.0,1281,1729
2002-03-10,Eswatini,Lesotho,1,0,1,1.0,0.0,1478,1465
2002-03-10,United States,Ecuador,1,0,1,1.0,0.0,1882,1799
2002-03-12,American Samoa,Tonga,2,7,5,0.0,1.0,1395,1488
2002-03-12,New Caledonia,Papua New Guinea,1,4,3,0.0,1.0,1567,1484
2002-03-13,Mexico,Albania,4,0,4,1.0,0.0,1873,1534
2002-03-13,Tunisia,South Korea,0,0,0,0.5,0.5,1803,1853
2002-03-14,Estonia,Saudi Arabia,2,0,2,1.0,0.0,1516,1846
2002-03-14,Papua New Guinea,Tonga,5,0,5,1.0,0.0,1493,1480
2002-03-14,Samoa,American Samoa,5,0,5,1.0,0.0,1495,1390
2002-03-16,Botswana,Namibia,3,1,2,1.0,0.0,1478,1513
2002-03-16,Mauritius,Madagascar,2,3,1,0.0,1.0,1497,1642
2002-03-16,New Caledonia,Tonga,9,0,9,1.0,0.0,1574,1474
2002-03-16,Samoa,Papua New Guinea,1,4,3,0.0,1.0,1487,1502
2002-03-17,Sri Lanka,Pakistan,1,1,0,0.5,0.5,1383,1360
2002-03-18,American Samoa,Papua New Guinea,0,7,7,0.0,1.0,1385,1508
2002-03-18,Samoa,New Caledonia,0,5,5,0.0,1.0,1481,1581
2002-03-19,Sri Lanka,Pakistan,0,0,0,0.5,0.5,1383,1361
2002-03-20,Finland,South Korea,0,2,2,0.0,1.0,1722,1859
2002-03-20,Saudi Arabia,South Africa,1,0,1,1.0,0.0,1853,1771
2002-03-21,Japan,Ukraine,1,0,1,1.0,0.0,1869,1696
2002-03-23,Sri Lanka,Pakistan,1,0,1,1.0,0.0,1391,1354
2002-03-25,Sri Lanka,Pakistan,2,1,1,1.0,0.0,1399,1347
2002-03-26,South Korea,Turkey,0,0,0,0.5,0.5,1857,1769
2002-03-26,Nigeria,Paraguay,1,1,0,0.5,0.5,1814,1836
2002-03-27,Albania,Azerbaijan,1,0,1,1.0,0.0,1541,1453
2002-03-27,Argentina,Cameroon,2,2,0,0.5,0.5,1989,1847
2002-03-27,Austria,Slovakia,2,0,2,1.0,0.0,1771,1714
2002-03-27,Belize,Guyana,3,1,2,1.0,0.0,1488,1461
2002-03-27,Bosnia and Herzegovina,North Macedonia,4,4,0,0.5,0.5,1621,1564
2002-03-27,Brazil,Serbia,1,0,1,1.0,0.0,2004,1823
2002-03-27,Bulgaria,Ecuador,0,3,3,0.0,1.0,1778,1807
2002-03-27,Croatia,Slovenia,0,0,0,0.5,0.5,1842,1703
2002-03-27,England,Italy,1,2,1,0.0,1.0,1952,1994
2002-03-27,Estonia,Russia,2,1,1,1.0,0.0,1531,1843
2002-03-27,France,Scotland,5,0,5,1.0,0.0,2055,1809
2002-03-27,Georgia,South Africa,4,1,3,1.0,0.0,1617,1760
2002-03-27,Germany,United States,4,2,2,1.0,0.0,1967,1876
2002-03-27,Republic of Ireland,Denmark,3,0,3,1.0,0.0,1866,1891
2002-03-27,Liechtenstein,Northern Ireland,0,0,0,0.5,0.5,1410,1668
2002-03-27,Luxembourg,Latvia,0,3,3,0.0,1.0,1345,1527
2002-03-27,Malta,Andorra,1,1,0,0.5,0.5,1445,1410
2002-03-27,Moldova,Hungary,0,2,2,0.0,1.0,1513,1712
2002-03-27,Netherlands,Spain,1,0,1,1.0,0.0,1981,1962
2002-03-27,Poland,Japan,0,2,2,0.0,1.0,1807,1876
2002-03-27,Portugal,Finland,1,4,3,0.0,1.0,1926,1735
2002-03-27,Romania,Ukraine,4,1,3,1.0,0.0,1840,1692
2002-03-27,Saudi Arabia,Uruguay,3,2,1,1.0,0.0,1861,1824
2002-03-27,Senegal,Bolivia,2,1,1,1.0,0.0,1765,1693
2002-03-27,Sweden,Switzerland,1,1,0,0.5,0.5,1902,1766
2002-03-27,Tunisia,Norway,0,0,0,0.5,0.5,1804,1841
2002-03-27,Wales,Czech Republic,0,0,0,0.5,0.5,1690,1840
2002-03-30,Botswana,South Africa,0,0,0,0.5,0.5,1484,1755
2002-03-30,Eswatini,Mozambique,1,2,1,0.0,1.0,1472,1544
2002-03-31,Eswatini,Mozambique,1,1,0,0.5,0.5,1474,1543
2002-04-04,Sri Lanka,Maldives,1,0,1,1.0,0.0,1407,1376
2002-04-06,Sri Lanka,Maldives,1,1,0,0.5,0.5,1407,1377
2002-04-07,Lesotho,Mozambique,0,2,2,0.0,1.0,1459,1550
2002-04-09,Singapore,Maldives,2,0,2,1.0,0.0,1574,1374
2002-04-10,Yemen,Ethiopia,1,1,0,0.5,0.5,1478,1615
2002-04-17,Andorra,Albania,2,0,2,1.0,0.0,1421,1531
2002-04-17,Austria,Cameroon,0,0,0,0.5,0.5,1773,1846
2002-04-17,Belgium,Slovakia,1,1,0,0.5,0.5,1864,1718
2002-04-17,Belize,Nicaragua,7,1,6,1.0,0.0,1493,1297
2002-04-17,Croatia,Bosnia and Herzegovina,2,0,2,1.0,0.0,1846,1618
2002-04-17,Denmark,Israel,3,1,2,1.0,0.0,1896,1713
2002-04-17,Ecuador,South Africa,0,0,0,0.5,0.5,1806,1757
2002-04-17,England,Paraguay,4,0,4,1.0,0.0,1958,1831
2002-04-17,France,Russia,0,0,0,0.5,0.5,2051,1848
2002-04-17,Germany,Argentina,0,1,1,0.0,1.0,1960,1997
2002-04-17,Greece,Czech Republic,0,0,0,0.5,0.5,1775,1839
2002-04-17,Hungary,Belarus,2,5,3,0.0,1.0,1701,1563
2002-04-17,Republic of Ireland,United States,2,1,1,1.0,0.0,1875,1868
2002-04-17,Italy,Uruguay,1,1,0,0.5,0.5,1991,1828
2002-04-17,Japan,Costa Rica,1,1,0,0.5,0.5,1875,1822
2002-04-17,Latvia,Kazakhstan,2,1,1,1.0,0.0,1538,1620
2002-04-17,Luxembourg,Liechtenstein,3,3,0,0.5,0.5,1347,1409
2002-04-17,North Macedonia,Finland,1,0,1,1.0,0.0,1576,1724
2002-04-17,Malta,Azerbaijan,1,0,1,1.0,0.0,1454,1445
2002-04-17,Mexico,Bulgaria,1,0,1,1.0,0.0,1879,1773
2002-04-17,Northern Ireland,Spain,0,5,5,0.0,1.0,1666,1965
2002-04-17,Norway,Sweden,0,0,0,0.5,0.5,1843,1901
2002-04-17,Poland,Romania,1,2,1,0.0,1.0,1800,1848
2002-04-17,Portugal,Brazil,1,1,0,0.5,0.5,1928,2003
2002-04-17,Scotland,Nigeria,1,2,1,0.0,1.0,1802,1822
2002-04-17,Serbia,Lithuania,4,1,3,1.0,0.0,1826,1535
2002-04-17,Slovenia,Tunisia,1,0,1,1.0,0.0,1714,1794
2002-04-17,Turkey,Chile,2,0,2,1.0,0.0,1777,1734
2002-04-17,Ukraine,Georgia,2,1,1,1.0,0.0,1699,1611
2002-04-21,South Korea,Costa Rica,2,0,2,1.0,0.0,1865,1815
2002-04-21,Eswatini,Namibia,2,1,1,1.0,0.0,1483,1505
2002-04-27,South Korea,China PR,0,0,0,0.5,0.5,1865,1833
2002-04-29,Japan,Slovakia,1,0,1,1.0,0.0,1880,1714
2002-05-02,Japan,Honduras,3,3,0,0.5,0.5,1879,1803
2002-05-04,Malawi,Tanzania,1,0,1,1.0,0.0,1567,1536
2002-05-04,Nigeria,Kenya,3,0,3,1.0,0.0,1827,1638
2002-05-05,Zimbabwe,Eswatini,0,2,2,0.0,1.0,1693,1496
2002-05-06,Jersey,Guernsey,2,1,1,1.0,0.0,1736,1655
2002-05-07,Venezuela,Colombia,0,0,0,0.5,0.5,1571,1878
2002-05-08,Ecuador,Serbia,1,0,1,1.0,0.0,1815,1818
2002-05-08,Hungary,Croatia,0,2,2,0.0,1.0,1697,1851
2002-05-09,Costa Rica,Colombia,1,2,1,0.0,1.0,1809,1885
2002-05-09,Germany,Kuwait,7,0,7,1.0,0.0,1964,1744
2002-05-11,Kenya,Tanzania,1,0,1,1.0,0.0,1644,1531
2002-05-12,Mexico,Colombia,2,1,1,1.0,0.0,1888,1877
2002-05-12,South Africa,Madagascar,1,0,1,1.0,0.0,1763,1637
2002-05-12,United States,Uruguay,2,1,1,1.0,0.0,1876,1821
2002-05-14,Belgium,Algeria,0,0,0,0.5,0.5,1861,1717
2002-05-14,Norway,Japan,3,0,3,1.0,0.0,1852,1871
2002-05-14,Saudi Arabia,Senegal,3,2,1,1.0,0.0,1867,1760
2002-05-14,Slovakia,Uzbekistan,4,1,3,1.0,0.0,1722,1678
2002-05-14,Wales,Germany,1,0,1,1.0,0.0,1704,1951
2002-05-15,Greece,Cyprus,3,1,2,1.0,0.0,1780,1602
2002-05-15,Switzerland,Canada,1,3,2,0.0,1.0,1758,1756
2002-05-16,China PR,Uruguay,0,2,2,0.0,1.0,1825,1830
2002-05-16,Republic of Ireland,Nigeria,1,2,1,0.0,1.0,1866,1837
2002-05-16,South Korea,Scotland,4,1,3,1.0,0.0,1872,1796
2002-05-16,Mexico,Bolivia,1,0,1,1.0,0.0,1892,1690
2002-05-16,United States,Jamaica,5,0,5,1.0,0.0,1881,1702
2002-05-17,Myanmar,Malaysia,1,1,0,0.5,0.5,1537,1585
2002-05-17,Denmark,Cameroon,2,1,1,1.0,0.0,1903,1840
2002-05-17,Russia,Belarus,1,1,0,0.5,0.5,1843,1569
2002-05-17,Slovenia,Ghana,2,0,2,1.0,0.0,1722,1699
2002-05-17,Sweden,Paraguay,1,2,1,0.0,1.0,1892,1841
2002-05-17,Ukraine,Serbia,2,0,2,1.0,0.0,1710,1808
2002-05-17,Canary Islands,Venezuela,0,2,2,0.0,1.0,1511,1578
2002-05-18,Czech Republic,Italy,1,0,1,1.0,0.0,1851,1980
2002-05-18,France,Belgium,1,2,1,0.0,1.0,2040,1873
2002-05-18,Germany,Austria,6,2,4,1.0,0.0,1956,1769
2002-05-18,Jamaica,Nigeria,0,1,1,0.0,1.0,1697,1843
2002-05-18,Malawi,Angola,2,1,1,1.0,0.0,1578,1672
2002-05-18,Poland,Estonia,1,0,1,1.0,0.0,1803,1529
2002-05-18,Tanzania,Kenya,0,5,5,0.0,1.0,1526,1650
2002-05-18,Catalonia,Brazil,1,3,2,0.0,1.0,1561,2005
2002-05-19,Belarus,Ukraine,2,0,2,1.0,0.0,1581,1699
2002-05-19,Myanmar,Malaysia,0,0,0,0.5,0.5,1539,1584
2002-05-19,Russia,Serbia,1,1,0,0.5,0.5,1843,1809
2002-05-19,United States,Netherlands,0,2,2,0.0,1.0,1876,1987
2002-05-20,Scotland,South Africa,0,2,2,0.0,1.0,1788,1772
2002-05-21,South Korea,England,1,1,0,0.5,0.5,1874,1957
2002-05-21,San Marino,Estonia,0,1,1,0.0,1.0,1395,1535
2002-05-21,Singapore,Uruguay,1,2,1,0.0,1.0,1572,1833
2002-05-22,Finland,Latvia,2,1,1,1.0,0.0,1729,1534
2002-05-22,Norway,Iceland,1,1,0,0.5,0.5,1849,1696
2002-05-23,Ecuador,Senegal,0,1,1,0.0,1.0,1806,1770
2002-05-23,South Africa,Turkey,2,0,2,1.0,0.0,1781,1769
2002-05-25,China PR,Portugal,0,2,2,0.0,1.0,1820,1934
2002-05-25,Japan,Sweden,1,1,0,0.5,0.5,1872,1892
2002-05-25,Malaysia,Brazil,0,4,4,0.0,1.0,1583,2007
2002-05-26,Belgium,Costa Rica,1,0,1,1.0,0.0,1880,1803
2002-05-26,Cameroon,England,2,2,0,0.5,0.5,1843,1955
2002-05-26,Denmark,Tunisia,2,1,1,1.0,0.0,1909,1789
2002-05-26,South Korea,France,2,3,1,0.0,1.0,1870,2045
2002-05-30,Kuwait,Iran,1,3,2,0.0,1.0,1739,1848
2002-05-31,France,Senegal,0,1,1,0.0,1.0,2032,1784
2002-06-01,Germany,Saudi Arabia,8,0,8,1.0,0.0,1962,1862
2002-06-01,Republic of Ireland,Cameroon,1,1,0,0.5,0.5,1866,1844
2002-06-01,Uruguay,Denmark,1,2,1,0.0,1.0,1827,1916
2002-06-02,Argentina,Nigeria,1,0,1,1.0,0.0,2002,1839
2002-06-02,England,Sweden,1,1,0,0.5,0.5,1954,1894
2002-06-02,Paraguay,South Africa,2,2,0,0.5,0.5,1840,1783
2002-06-02,Spain,Slovenia,3,1,2,1.0,0.0,1969,1719
2002-06-03,Brazil,Turkey,2,1,1,1.0,0.0,2011,1766
2002-06-03,Croatia,Mexico,0,1,1,0.0,1.0,1844,1900
2002-06-03,Italy,Ecuador,2,0,2,1.0,0.0,1985,1802
2002-06-04,China PR,Costa Rica,0,2,2,0.0,1.0,1812,1812
2002-06-04,Japan,Belgium,2,2,0,0.5,0.5,1873,1880
2002-06-04,South Korea,Poland,2,0,2,1.0,0.0,1877,1797
2002-06-05,Germany,Republic of Ireland,1,1,0,0.5,0.5,1960,1869
2002-06-05,Russia,Tunisia,2,0,2,1.0,0.0,1850,1783
2002-06-05,United States,Portugal,3,2,1,1.0,0.0,1886,1925
2002-06-06,Cameroon,Saudi Arabia,1,0,1,1.0,0.0,1853,1854
2002-06-06,Denmark,Senegal,1,1,0,0.5,0.5,1914,1787
2002-06-06,France,Uruguay,0,0,0,0.5,0.5,2028,1832
2002-06-06,Saint Martin,Anguilla,2,1,1,1.0,0.0,1515,1381
2002-06-07,Andorra,Armenia,0,2,2,0.0,1.0,1416,1538
2002-06-07,Argentina,England,0,1,1,0.0,1.0,1993,1964
2002-06-07,Spain,Paraguay,3,1,2,1.0,0.0,1975,1835
2002-06-07,Sweden,Nigeria,2,1,1,1.0,0.0,1901,1833
2002-06-08,Brazil,China PR,4,0,4,1.0,0.0,2015,1809
2002-06-08,Italy,Croatia,1,2,1,0.0,1.0,1974,1856
2002-06-08,Malawi,Botswana,2,0,2,1.0,0.0,1584,1479
2002-06-08,South Africa,Slovenia,1,0,1,1.0,0.0,1790,1713
2002-06-09,Costa Rica,Turkey,1,1,0,0.5,0.5,1811,1768
2002-06-09,Japan,Russia,1,0,1,1.0,0.0,1881,1843
2002-06-09,Malawi,Botswana,1,0,1,1.0,0.0,1590,1474
2002-06-09,Mexico,Ecuador,2,1,1,1.0,0.0,1906,1797
2002-06-10,South Korea,United States,1,1,0,0.5,0.5,1878,1886
2002-06-10,Portugal,Poland,4,0,4,1.0,0.0,1931,1792
2002-06-10,Tunisia,Belgium,1,1,0,0.5,0.5,1786,1878
2002-06-11,Cameroon,Germany,0,2,2,0.0,1.0,1848,1966
2002-06-11,Denmark,France,2,0,2,1.0,0.0,1925,2018
2002-06-11,Saudi Arabia,Republic of Ireland,0,3,3,0.0,1.0,1847,1877
2002-06-11,Senegal,Uruguay,3,3,0,0.5,0.5,1789,1831
2002-06-12,Nigeria,England,0,0,0,0.5,0.5,1836,1962
2002-06-12,Slovenia,Paraguay,1,3,2,0.0,1.0,1708,1841
2002-06-12,South Africa,Spain,2,3,1,0.0,1.0,1786,1980
2002-06-12,Sweden,Argentina,1,1,0,0.5,0.5,1904,1991
2002-06-13,Costa Rica,Brazil,2,5,3,0.0,1.0,1808,2019
2002-06-13,Ecuador,Croatia,1,0,1,1.0,0.0,1807,1847
2002-06-13,Mexico,Italy,1,1,0,0.5,0.5,1908,1973
2002-06-13,Turkey,China PR,3,0,3,1.0,0.0,1777,1801
2002-06-14,Belgium,Russia,3,2,1,1.0,0.0,1886,1836
2002-06-14,Japan,Tunisia,2,0,2,1.0,0.0,1887,1781
2002-06-14,South Korea,Portugal,1,0,1,1.0,0.0,1888,1922
2002-06-14,Poland,United States,3,1,2,1.0,0.0,1803,1876
2002-06-15,Denmark,England,0,3,3,0.0,1.0,1918,1970
2002-06-15,Germany,Paraguay,1,0,1,1.0,0.0,1972,1836
2002-06-16,Spain,Republic of Ireland,1,1,0,0.5,0.5,1978,1880
2002-06-16,Sweden,Senegal,1,2,1,0.0,1.0,1894,1800
2002-06-17,Brazil,Belgium,2,0,2,1.0,0.0,2025,1881
2002-06-17,Mexico,United States,0,2,2,0.0,1.0,1900,1885
2002-06-18,Japan,Turkey,0,1,1,0.0,1.0,1877,1788
2002-06-18,South Korea,Italy,2,1,1,1.0,0.0,1898,1964
2002-06-21,England,Brazil,1,2,1,0.0,1.0,1964,2032
2002-06-21,Germany,United States,1,0,1,1.0,0.0,1979,1879
2002-06-22,Grenada,British Virgin Islands,5,0,5,1.0,0.0,1563,1425
2002-06-22,South Korea,Spain,0,0,0,0.5,0.5,1900,1977
2002-06-22,Senegal,Turkey,0,1,1,0.0,1.0,1792,1797
2002-06-23,Saint Martin,Anguilla,1,0,1,1.0,0.0,1521,1376
2002-06-25,South Korea,Germany,0,1,1,0.0,1.0,1894,1986
2002-06-25,Mozambique,Angola,1,1,0,0.5,0.5,1553,1670
2002-06-26,Brazil,Turkey,1,0,1,1.0,0.0,2036,1794
2002-06-29,South Korea,Turkey,2,3,1,0.0,1.0,1884,1805
2002-06-30,Bhutan,Montserrat,4,0,4,1.0,0.0,1392,1423
2002-06-30,Germany,Brazil,0,2,2,0.0,1.0,1980,2043
2002-07-03,Estonia,Azerbaijan,0,0,0,0.5,0.5,1533,1448
2002-07-05,New Zealand,Tahiti,4,0,4,1.0,0.0,1700,1710
2002-07-05,Papua New Guinea,Solomon Islands,0,0,0,0.5,0.5,1511,1608
2002-07-06,Australia,Vanuatu,2,0,2,1.0,0.0,1887,1462
2002-07-06,British Virgin Islands,Anguilla,2,1,1,1.0,0.0,1432,1370
2002-07-06,Fiji,New Caledonia,2,1,1,1.0,0.0,1694,1576
2002-07-06,Grenada,Saint Martin,8,3,5,1.0,0.0,1571,1514
2002-07-06,Latvia,Azerbaijan,0,0,0,0.5,0.5,1533,1450
2002-07-06,Zambia,Mozambique,3,0,3,1.0,0.0,1700,1549
2002-07-07,Guadeloupe,Puerto Rico,4,0,4,1.0,0.0,1537,1355
2002-07-07,Kazakhstan,Estonia,1,1,0,0.5,0.5,1619,1535
2002-07-07,Malawi,Zimbabwe,3,2,1,1.0,0.0,1601,1683
2002-07-07,New Zealand,Papua New Guinea,9,1,8,1.0,0.0,1705,1507
2002-07-07,Solomon Islands,Tahiti,2,3,1,0.0,1.0,1603,1716
2002-07-08,Australia,New Caledonia,11,0,11,1.0,0.0,1890,1574
2002-07-08,Fiji,Vanuatu,0,1,1,0.0,1.0,1682,1475
2002-07-08,Malawi,Zimbabwe,2,2,0,0.5,0.5,1603,1682
2002-07-09,New Zealand,Solomon Islands,6,1,5,1.0,0.0,1711,1598
2002-07-09,Papua New Guinea,Tahiti,1,3,2,0.0,1.0,1504,1720
2002-07-10,Australia,Fiji,8,0,8,1.0,0.0,1894,1679
2002-07-10,New Caledonia,Vanuatu,0,1,1,0.0,1.0,1564,1486
2002-07-12,Australia,Tahiti,2,1,1,1.0,0.0,1899,1716
2002-07-12,New Zealand,Vanuatu,3,0,3,1.0,0.0,1715,1483
2002-07-14,British Virgin Islands,Saint Lucia,1,3,2,0.0,1.0,1427,1555
2002-07-14,New Zealand,Australia,1,0,1,1.0,0.0,1727,1888
2002-07-14,Tahiti,Vanuatu,1,0,1,1.0,0.0,1720,1480
2002-07-16,Malaysia,Singapore,1,2,1,0.0,1.0,1575,1581
2002-07-19,Iraq,Syria,2,0,2,1.0,0.0,1757,1631
2002-07-21,Puerto Rico,Guadeloupe,0,2,2,0.0,1.0,1351,1542
2002-07-21,South Africa,Madagascar,0,0,0,0.5,0.5,1783,1641
2002-07-22,Iraq,Syria,2,1,1,1.0,0.0,1763,1626
2002-07-25,Barbados,Trinidad and Tobago,0,0,0,0.5,0.5,1572,1731
2002-07-25,Saint Kitts and Nevis,Taiwan,3,0,3,1.0,0.0,1574,1410
2002-07-26,Ethiopia,Uganda,0,0,0,0.5,0.5,1616,1619
2002-07-26,Sudan,Chad,2,0,2,1.0,0.0,1601,1499
2002-07-27,Saint Kitts and Nevis,Barbados,3,0,3,1.0,0.0,1582,1565
2002-07-28,Aruba,Suriname,0,2,2,0.0,1.0,1414,1579
2002-07-28,Chad,Ethiopia,3,2,1,1.0,0.0,1510,1606
2002-07-28,Guyana,Curaçao,2,1,1,1.0,0.0,1471,1520
2002-07-28,Saint Kitts and Nevis,Trinidad and Tobago,2,1,1,1.0,0.0,1594,1720
2002-07-28,Saint Lucia,British Virgin Islands,8,1,7,1.0,0.0,1561,1422
2002-07-28,Sudan,Uganda,2,1,1,1.0,0.0,1610,1611
2002-07-30,Chad,Uganda,0,2,2,0.0,1.0,1505,1617
2002-07-30,Grenada,Taiwan,5,2,3,1.0,0.0,1576,1406
2002-07-30,Sudan,Ethiopia,3,0,3,1.0,0.0,1618,1599
2002-08-01,Eswatini,Mauritius,0,1,1,0.0,1.0,1489,1505
2002-08-02,Grenada,Jamaica,0,1,1,0.0,1.0,1571,1703
2002-08-03,Kenya,Uganda,0,0,0,0.5,0.5,1650,1618
2002-08-03,Eswatini,Mauritius,0,0,0,0.5,0.5,1490,1505
2002-08-04,Saint Martin,Grenada,1,7,6,0.0,1.0,1508,1578
2002-08-08,Egypt,Ethiopia,4,1,3,1.0,0.0,1795,1596
2002-08-10,Malawi,Zambia,1,0,1,1.0,0.0,1614,1690
2002-08-11,Curaçao,Guyana,1,0,1,1.0,0.0,1527,1465
2002-08-11,Saint Lucia,Jamaica,1,3,2,0.0,1.0,1557,1708
2002-08-11,Suriname,Aruba,6,0,6,1.0,0.0,1584,1410
2002-08-16,Dominican Republic,United States Virgin Islands,6,1,5,1.0,0.0,1506,1448
2002-08-17,Jordan,Kenya,1,1,0,0.5,0.5,1608,1649
2002-08-18,Dominican Republic,United States Virgin Islands,5,1,4,1.0,0.0,1513,1442
2002-08-19,Jordan,Sudan,0,0,0,0.5,0.5,1609,1618
2002-08-20,Algeria,DR Congo,1,1,0,0.5,0.5,1716,1668
2002-08-20,Egypt,Uganda,2,0,2,1.0,0.0,1800,1614
2002-08-21,Azerbaijan,Uzbekistan,2,0,2,1.0,0.0,1463,1666
2002-08-21,Bosnia and Herzegovina,Serbia,0,2,2,0.0,1.0,1615,1813
2002-08-21,Brazil,Paraguay,0,1,1,0.0,1.0,2031,1849
2002-08-21,Bulgaria,Germany,2,2,0,0.5,0.5,1778,1976
2002-08-21,Croatia,Wales,1,1,0,0.5,0.5,1844,1708
2002-08-21,Czech Republic,Slovakia,4,1,3,1.0,0.0,1857,1717
2002-08-21,Estonia,Moldova,1,0,1,1.0,0.0,1543,1506
2002-08-21,Faroe Islands,Liechtenstein,3,1,2,1.0,0.0,1472,1403
2002-08-21,Finland,Republic of Ireland,0,3,3,0.0,1.0,1725,1885
2002-08-21,Hungary,Spain,1,1,0,0.5,0.5,1703,1972
2002-08-21,Iceland,Andorra,3,0,3,1.0,0.0,1699,1414
2002-08-21,Italy,Slovenia,0,1,1,0.0,1.0,1951,1722
2002-08-21,Latvia,Belarus,2,4,2,0.0,1.0,1527,1588
2002-08-21,Lithuania,Israel,2,4,2,0.0,1.0,1531,1718
2002-08-21,Luxembourg,Morocco,0,2,2,0.0,1.0,1346,1814
2002-08-21,North Macedonia,Malta,5,0,5,1.0,0.0,1582,1449
2002-08-21,Mauritius,Réunion,1,1,0,0.5,0.5,1507,1551
2002-08-21,Northern Ireland,Cyprus,0,0,0,0.5,0.5,1665,1604
2002-08-21,Norway,Netherlands,0,1,1,0.0,1.0,1845,1992
2002-08-21,Poland,Belgium,1,1,0,0.5,0.5,1805,1880
2002-08-21,Romania,Greece,0,1,1,0.0,1.0,1839,1790
2002-08-21,Russia,Sweden,1,1,0,0.5,0.5,1838,1893
2002-08-21,Scotland,Denmark,0,1,1,0.0,1.0,1783,1924
2002-08-21,Switzerland,Austria,3,2,1,1.0,0.0,1767,1761
2002-08-21,Tunisia,France,1,1,0,0.5,0.5,1786,2014
2002-08-21,Turkey,Georgia,3,0,3,1.0,0.0,1809,1608
2002-08-21,Ukraine,Iran,0,1,1,0.0,1.0,1695,1853
2002-08-21,Venezuela,Bolivia,2,0,2,1.0,0.0,1589,1680
2002-08-23,Egypt,Sudan,3,0,3,1.0,0.0,1805,1614
2002-08-24,Rwanda,Kenya,0,0,0,0.5,0.5,1595,1648
2002-08-24,South Africa,Eswatini,4,1,3,1.0,0.0,1786,1488
2002-08-25,Angola,Gabon,1,0,1,1.0,0.0,1679,1673
2002-08-25,Gambia,Sierra Leone,1,0,1,1.0,0.0,1536,1579
2002-08-26,Botswana,Lesotho,0,1,1,0.0,1.0,1466,1468
2002-08-26,Congo,DR Congo,1,3,2,0.0,1.0,1608,1675
2002-08-27,Egypt,Libya,0,1,1,0.0,1.0,1793,1606
2002-08-29,India,Jamaica,0,3,3,0.0,1.0,1520,1713
2002-08-30,Jordan,Iran,1,0,1,1.0,0.0,1622,1841
2002-08-30,Syria,Palestine,2,1,1,1.0,0.0,1631,1477
2002-08-30,Zimbabwe,Lesotho,2,0,2,1.0,0.0,1686,1465
2002-08-31,Uganda,Zambia,2,2,0,0.5,0.5,1616,1689
2002-09-01,Congo,Gabon,0,0,0,0.5,0.5,1610,1672
2002-09-01,Gambia,Guinea,1,0,1,1.0,0.0,1547,1626
2002-09-01,India,Jamaica,0,0,0,0.5,0.5,1525,1709
2002-09-01,Lebanon,Jordan,0,1,1,0.0,1.0,1619,1631
2002-09-01,Palestine,Iraq,0,2,2,0.0,1.0,1475,1766
2002-09-02,Libya,Togo,4,0,4,1.0,0.0,1615,1637
2002-09-02,Tanzania,Zanzibar,1,1,0,0.5,0.5,1524,1404
2002-09-03,Iran,Lebanon,2,0,2,1.0,0.0,1845,1616
2002-09-03,Syria,Iraq,0,1,1,0.0,1.0,1626,1772
2002-09-05,Iraq,Iran,0,0,0,0.5,0.5,1774,1844
2002-09-05,Luxembourg,Israel,0,5,5,0.0,1.0,1345,1720
2002-09-05,Syria,Jordan,1,2,1,0.0,1.0,1619,1639
2002-09-06,Czech Republic,Serbia,5,0,5,1.0,0.0,1864,1807
2002-09-06,Mauritania,Cape Verde,0,2,2,0.0,1.0,1418,1544
2002-09-07,Armenia,Ukraine,2,2,0,0.5,0.5,1542,1692
2002-09-07,Austria,Moldova,2,0,2,1.0,0.0,1764,1504
2002-09-07,Azerbaijan,Italy,0,2,2,0.0,1.0,1463,1952
2002-09-07,Belgium,Bulgaria,0,2,2,0.0,1.0,1870,1789
2002-09-07,Bosnia and Herzegovina,Romania,0,3,3,0.0,1.0,1612,1843
2002-09-07,Botswana,Eswatini,0,0,0,0.5,0.5,1467,1488
2002-09-07,Madagascar,Egypt,1,0,1,1.0,0.0,1653,1782
2002-09-07,Croatia,Estonia,0,0,0,0.5,0.5,1839,1549
2002-09-07,Cyprus,France,1,2,1,0.0,1.0,1603,2016
2002-09-07,England,Portugal,1,1,0,0.5,0.5,1964,1923
2002-09-07,Faroe Islands,Scotland,2,2,0,0.5,0.5,1478,1778
2002-09-07,Finland,Wales,0,2,2,0.0,1.0,1717,1717
2002-09-07,Gabon,Morocco,0,1,1,0.0,1.0,1668,1819
2002-09-07,Greece,Spain,0,2,2,0.0,1.0,1786,1977
2002-09-07,Iceland,Hungary,0,2,2,0.0,1.0,1692,1711
2002-09-07,Jordan,Iraq,2,3,1,0.0,1.0,1634,1780
2002-09-07,Kenya,Togo,3,0,3,1.0,0.0,1656,1630
2002-09-07,South Korea,North Korea,0,0,0,0.5,0.5,1881,1700
2002-09-07,Latvia,Sweden,0,0,0,0.5,0.5,1534,1887
2002-09-07,Lithuania,Germany,0,2,2,0.0,1.0,1530,1978
2002-09-07,Namibia,Algeria,0,1,1,0.0,1.0,1502,1720
2002-09-07,Netherlands,Belarus,3,0,3,1.0,0.0,1994,1587
2002-09-07,Niger,Ethiopia,3,1,2,1.0,0.0,1544,1587
2002-09-07,Norway,Denmark,2,2,0,0.5,0.5,1847,1923
2002-09-07,Russia,Republic of Ireland,4,2,2,1.0,0.0,1848,1876
2002-09-07,San Marino,Poland,0,2,2,0.0,1.0,1394,1807
2002-09-07,Slovenia,Malta,3,0,3,1.0,0.0,1725,1447
2002-09-07,Syria,Iran,2,2,0,0.5,0.5,1624,1840
2002-09-07,Turkey,Slovakia,3,0,3,1.0,0.0,1815,1712
2002-09-07,Uganda,Ghana,1,0,1,1.0,0.0,1626,1690
2002-09-08,Angola,Nigeria,0,0,0,0.5,0.5,1683,1833
2002-09-08,Benin,Tanzania,4,0,4,1.0,0.0,1479,1515
2002-09-08,Congo,Burkina Faso,0,0,0,0.5,0.5,1611,1615
2002-09-08,Equatorial Guinea,Sierra Leone,1,3,2,0.0,1.0,1425,1584
2002-09-08,Guinea,Liberia,3,0,3,1.0,0.0,1634,1614
2002-09-08,Ivory Coast,South Africa,0,0,0,0.5,0.5,1770,1786
2002-09-08,Lesotho,Senegal,0,1,1,0.0,1.0,1463,1795
2002-09-08,Libya,DR Congo,3,2,1,1.0,0.0,1625,1666
2002-09-08,Liechtenstein,North Macedonia,1,1,0,0.5,0.5,1407,1579
2002-09-08,Seychelles,Eritrea,1,0,1,1.0,0.0,1428,1474
2002-09-08,Sudan,Zambia,0,1,1,0.0,1.0,1608,1696
2002-09-08,Switzerland,Georgia,4,1,3,1.0,0.0,1772,1604
2002-09-08,Zimbabwe,Mali,1,0,1,1.0,0.0,1694,1670
2002-09-09,Central African Republic,Mozambique,1,1,0,0.5,0.5,1450,1547
2002-09-17,Iran,Morocco,1,1,0,0.5,0.5,1840,1820
2002-09-18,Ivory Coast,Gambia,5,0,5,1.0,0.0,1774,1544
2002-09-19,Iran,Paraguay,1,1,0,0.5,0.5,1841,1849
2002-09-21,Malawi,South Africa,1,3,2,0.0,1.0,1610,1791
2002-09-24,Algeria,Uganda,1,1,0,0.5,0.5,1718,1629
2002-09-25,Oman,United Arab Emirates,2,1,1,1.0,0.0,1655,1697
2002-09-26,Mauritius,Seychelles,1,0,1,1.0,0.0,1514,1422
2002-09-28,South Africa,Malawi,1,0,1,1.0,0.0,1796,1606
2002-09-28,Zimbabwe,Zambia,0,0,0,0.5,0.5,1695,1696
2002-10-02,Mali,Mauritania,2,1,1,1.0,0.0,1674,1415
2002-10-03,Morocco,Niger,6,1,5,1.0,0.0,1823,1542
2002-10-05,Mali,Mauritania,2,0,2,1.0,0.0,1677,1413
2002-10-06,Barbados,Saint Lucia,3,2,1,1.0,0.0,1573,1550
2002-10-06,Eswatini,Lesotho,0,0,0,0.5,0.5,1488,1464
2002-10-08,Ghana,Lesotho,2,1,1,1.0,0.0,1694,1461
2002-10-09,Martinique,Saint Lucia,4,0,4,1.0,0.0,1673,1545
2002-10-11,Algeria,Chad,4,1,3,1.0,0.0,1722,1502
2002-10-11,Bosnia and Herzegovina,Germany,1,1,0,0.5,0.5,1619,1972
2002-10-12,Albania,Switzerland,1,1,0,0.5,0.5,1536,1768
2002-10-12,Andorra,Belgium,0,1,1,0.0,1.0,1413,1872
2002-10-12,Belarus,Austria,0,2,2,0.0,1.0,1583,1769
2002-10-12,Bulgaria,Croatia,2,0,2,1.0,0.0,1799,1830
2002-10-12,Denmark,Luxembourg,2,0,2,1.0,0.0,1924,1345
2002-10-12,Eritrea,Zimbabwe,0,1,1,0.0,1.0,1471,1699
2002-10-12,Finland,Azerbaijan,3,0,3,1.0,0.0,1721,1460
2002-10-12,France,Slovenia,5,0,5,1.0,0.0,2019,1723
2002-10-12,Iceland,Scotland,0,2,2,0.0,1.0,1686,1785
2002-10-12,Italy,Serbia,1,1,0,0.5,0.5,1949,1811
2002-10-12,Lithuania,Faroe Islands,2,0,2,1.0,0.0,1537,1472
2002-10-12,North Macedonia,Turkey,1,2,1,0.0,1.0,1576,1819
2002-10-12,Liberia,Niger,1,0,1,1.0,0.0,1621,1536
2002-10-12,Cape Verde,Kenya,0,1,1,0.0,1.0,1539,1662
2002-10-12,Malawi,Angola,1,0,1,1.0,0.0,1616,1674
2002-10-12,Malta,Israel,0,2,2,0.0,1.0,1445,1723
2002-10-12,Mauritius,Madagascar,0,1,1,0.0,1.0,1510,1658
2002-10-12,Moldova,Czech Republic,0,2,2,0.0,1.0,1503,1866
2002-10-12,Poland,Latvia,0,1,1,0.0,1.0,1794,1548
2002-10-12,Portugal,Tunisia,1,1,0,0.5,0.5,1920,1790
2002-10-12,Romania,Norway,0,1,1,0.0,1.0,1836,1855
2002-10-12,Senegal,Nigeria,2,2,0,0.5,0.5,1796,1833
2002-10-12,Sierra Leone,Gabon,2,0,2,1.0,0.0,1594,1659
2002-10-12,Slovakia,England,1,2,1,0.0,1.0,1709,1968
2002-10-12,Spain,Northern Ireland,3,0,3,1.0,0.0,1980,1663
2002-10-12,Sweden,Hungary,1,1,0,0.5,0.5,1884,1715
2002-10-12,Tanzania,Sudan,1,2,1,0.0,1.0,1510,1614
2002-10-12,Togo,Mauritania,1,0,1,1.0,0.0,1634,1410
2002-10-12,Ukraine,Greece,2,0,2,1.0,0.0,1703,1776
2002-10-12,Zambia,Benin,1,1,0,0.5,0.5,1692,1484
2002-10-13,Burkina Faso,Central African Republic,2,1,1,1.0,0.0,1620,1446
2002-10-13,South Africa,Burundi,2,0,2,1.0,0.0,1800,1565
2002-10-13,DR Congo,Botswana,2,0,2,1.0,0.0,1670,1464
2002-10-13,Estonia,New Zealand,3,2,1,1.0,0.0,1561,1716
2002-10-13,Ethiopia,Guinea,1,0,1,1.0,0.0,1597,1625
2002-10-13,Gambia,Lesotho,6,0,6,1.0,0.0,1551,1455
2002-10-13,Ghana,Rwanda,4,2,2,1.0,0.0,1700,1590
2002-10-13,Mali,Seychelles,3,0,3,1.0,0.0,1680,1420
2002-10-13,Morocco,Equatorial Guinea,5,0,5,1.0,0.0,1825,1424
2002-10-13,Mozambique,Congo,0,3,3,0.0,1.0,1541,1618
2002-10-13,Eswatini,Libya,2,1,1,1.0,0.0,1500,1614
2002-10-15,Scotland,Canada,3,1,2,1.0,0.0,1793,1749
2002-10-16,Austria,Netherlands,0,3,3,0.0,1.0,1766,1998
2002-10-16,Bulgaria,Andorra,2,1,1,1.0,0.0,1801,1412
2002-10-16,Costa Rica,Ecuador,1,1,0,0.5,0.5,1808,1808
2002-10-16,Czech Republic,Belarus,2,0,2,1.0,0.0,1869,1581
2002-10-16,England,North Macedonia,2,2,0,0.5,0.5,1962,1583
2002-10-16,Estonia,Belgium,0,1,1,0.0,1.0,1559,1875
2002-10-16,Germany,Faroe Islands,2,1,1,1.0,0.0,1973,1472
2002-10-16,Greece,Armenia,2,0,2,1.0,0.0,1780,1539
2002-10-16,Hungary,San Marino,3,0,3,1.0,0.0,1718,1392
2002-10-16,Iceland,Lithuania,3,0,3,1.0,0.0,1691,1533
2002-10-16,Republic of Ireland,Switzerland,1,2,1,0.0,1.0,1866,1779
2002-10-16,Japan,Jamaica,1,1,0,0.5,0.5,1874,1713
2002-10-16,Luxembourg,Romania,0,7,7,0.0,1.0,1345,1837
2002-10-16,Malta,France,0,4,4,0.0,1.0,1445,2020
2002-10-16,Northern Ireland,Ukraine,0,0,0,0.5,0.5,1664,1703
2002-10-16,Norway,Bosnia and Herzegovina,2,0,2,1.0,0.0,1859,1616
2002-10-16,Poland,New Zealand,2,0,2,1.0,0.0,1801,1710
2002-10-16,Russia,Albania,4,1,3,1.0,0.0,1851,1534
2002-10-16,Serbia,Finland,2,0,2,1.0,0.0,1817,1716
2002-10-16,Spain,Paraguay,0,0,0,0.5,0.5,1978,1852
2002-10-16,Sweden,Portugal,2,3,1,0.0,1.0,1877,1928
2002-10-16,Turkey,Liechtenstein,5,0,5,1.0,0.0,1821,1406
2002-10-16,Wales,Italy,2,1,1,1.0,0.0,1730,1937
2002-10-17,French Guiana,Suriname,1,1,0,0.5,0.5,1442,1581
2002-10-19,French Guiana,Suriname,0,1,1,0.0,1.0,1438,1586
2002-10-19,Sierra Leone,Ghana,2,1,1,1.0,0.0,1605,1690
2002-10-20,Venezuela,Ecuador,2,0,2,1.0,0.0,1602,1796
2002-10-23,Kenya,South Africa,1,1,0,0.5,0.5,1666,1797
2002-10-23,Tanzania,Uganda,0,2,2,0.0,1.0,1505,1635
2002-10-26,Kenya,Uganda,1,1,0,0.5,0.5,1666,1636
2002-10-26,Tanzania,South Africa,1,1,0,0.5,0.5,1511,1792
2002-10-26,Jersey,Kernow,0,3,3,0.0,1.0,1724,1513
2002-11-03,Martinique,Saint Kitts and Nevis,2,1,1,1.0,0.0,1680,1588
2002-11-06,Saint Lucia,Martinique,0,2,2,0.0,1.0,1540,1686
2002-11-08,Saint Lucia,Antigua and Barbuda,2,1,1,1.0,0.0,1547,1475
2002-11-09,Barbados,Jamaica,1,1,0,0.5,0.5,1577,1710
2002-11-09,Grenada,Guadeloupe,4,5,1,0.0,1.0,1570,1551
2002-11-10,Singapore,Indonesia,1,1,0,0.5,0.5,1583,1627
2002-11-11,Grenada,Barbados,0,2,2,0.0,1.0,1563,1585
2002-11-11,Jamaica,Guadeloupe,2,0,2,1.0,0.0,1715,1547
2002-11-13,Barbados,Guadeloupe,0,1,1,0.0,1.0,1577,1556
2002-11-13,Grenada,Jamaica,1,4,3,0.0,1.0,1559,1720
2002-11-13,Saint Kitts and Nevis,Saint Lucia,2,1,1,1.0,0.0,1596,1540
2002-11-15,Trinidad and Tobago,Saint Kitts and Nevis,2,0,2,1.0,0.0,1726,1591
2002-11-17,Cayman Islands,Nicaragua,0,1,1,0.0,1.0,1461,1309
2002-11-17,Trinidad and Tobago,Saint Lucia,0,1,1,0.0,1.0,1715,1552
2002-11-17,United States,El Salvador,2,0,2,1.0,0.0,1883,1630
2002-11-18,Haiti,Antigua and Barbuda,1,0,1,1.0,0.0,1651,1471
2002-11-19,South Africa,Senegal,1,1,0,0.5,0.5,1793,1796
2002-11-20,Antigua and Barbuda,Curaçao,1,1,0,0.5,0.5,1473,1526
2002-11-20,Austria,Norway,0,1,1,0.0,1.0,1761,1865
2002-11-20,Azerbaijan,Wales,0,2,2,0.0,1.0,1458,1733
2002-11-20,Cyprus,Malta,2,1,1,1.0,0.0,1608,1441
2002-11-20,Czech Republic,Sweden,3,3,0,0.5,0.5,1870,1877
2002-11-20,Denmark,Poland,2,0,2,1.0,0.0,1930,1796
2002-11-20,Ecuador,Costa Rica,2,2,0,0.5,0.5,1797,1808
2002-11-20,Estonia,Iceland,2,0,2,1.0,0.0,1570,1681
2002-11-20,France,Serbia,3,0,3,1.0,0.0,2024,1814
2002-11-20,Germany,Netherlands,1,3,2,0.0,1.0,1966,2006
2002-11-20,Greece,Republic of Ireland,0,0,0,0.5,0.5,1782,1865
2002-11-20,Honduras,Colombia,1,0,1,1.0,0.0,1813,1868
2002-11-20,Hungary,Moldova,1,1,0,0.5,0.5,1714,1508
2002-11-20,Italy,Turkey,1,1,0,0.5,0.5,1935,1824
2002-11-20,Japan,Argentina,0,2,2,0.0,1.0,1869,1997
2002-11-20,South Korea,Brazil,2,3,1,0.0,1.0,1877,2036
2002-11-20,Luxembourg,Cape Verde,0,0,0,0.5,0.5,1350,1535
2002-11-20,North Macedonia,Israel,2,3,1,0.0,1.0,1579,1728
2002-11-20,Morocco,Mali,1,3,2,0.0,1.0,1814,1692
2002-11-20,Nigeria,Jamaica,0,0,0,0.5,0.5,1831,1723
2002-11-20,Portugal,Scotland,2,0,2,1.0,0.0,1934,1788
2002-11-20,Qatar,Iraq,2,1,1,1.0,0.0,1774,1772
2002-11-20,Romania,Croatia,0,1,1,0.0,1.0,1829,1839
2002-11-20,San Marino,Latvia,0,1,1,0.0,1.0,1388,1553
2002-11-20,Slovakia,Ukraine,1,1,0,0.5,0.5,1709,1704
2002-11-20,Spain,Bulgaria,1,0,1,1.0,0.0,1983,1797
2002-11-20,Tunisia,Egypt,0,0,0,0.5,0.5,1790,1783
2002-11-20,Venezuela,Uruguay,1,0,1,1.0,0.0,1615,1819
2002-11-22,Haiti,Curaçao,3,0,3,1.0,0.0,1657,1521
2002-11-23,Bahrain,Iraq,2,2,0,0.5,0.5,1657,1770
2002-11-23,Monaco,Vatican City,0,0,0,0.5,0.5,1501,1501
2002-11-25,Nigeria,Egypt,1,1,0,0.5,0.5,1830,1785
2002-11-27,Cayman Islands,Cuba,0,5,5,0.0,1.0,1457,1624
2002-11-27,Martinique,Dominican Republic,4,0,4,1.0,0.0,1691,1509
2002-11-27,Sri Lanka,Vietnam,1,2,1,0.0,1.0,1403,1578
2002-11-29,Cayman Islands,Dominican Republic,1,0,1,1.0,0.0,1467,1500
2002-11-29,Jordan,Malaysia,1,0,1,1.0,0.0,1641,1569
2002-11-29,Martinique,Cuba,1,2,1,0.0,1.0,1682,1634
2002-11-29,Sri Lanka,Vietnam,1,1,0,0.5,0.5,1407,1575
2002-11-30,Jordan,Singapore,3,1,2,1.0,0.0,1648,1577
2002-11-30,Rwanda,Zanzibar,1,0,1,1.0,0.0,1595,1400
2002-11-30,Tanzania,Kenya,1,0,1,1.0,0.0,1523,1655
2002-12-01,Burundi,Eritrea,1,1,0,0.5,0.5,1563,1474
2002-12-01,Cayman Islands,Martinique,0,3,3,0.0,1.0,1464,1686
2002-12-01,Dominican Republic,Cuba,1,2,1,0.0,1.0,1495,1640
2002-12-01,Somalia,Uganda,0,2,2,0.0,1.0,1400,1640
2002-12-01,Sri Lanka,Vietnam,2,2,0,0.5,0.5,1411,1572
2002-12-02,Ethiopia,Zanzibar,0,0,0,0.5,0.5,1593,1405
2002-12-02,Tanzania,Sudan,1,1,0,0.5,0.5,1526,1612
2002-12-03,Kenya,Burundi,1,1,0,0.5,0.5,1653,1566
2002-12-03,Somalia,Rwanda,0,1,1,0.0,1.0,1397,1599
2002-12-04,Eritrea,Sudan,2,1,1,1.0,0.0,1486,1601
2002-12-04,Uganda,Ethiopia,3,0,3,1.0,0.0,1647,1587
2002-12-05,Tanzania,Burundi,2,0,2,1.0,0.0,1535,1558
2002-12-05,Zanzibar,Somalia,1,0,1,1.0,0.0,1413,1390
2002-12-06,Kenya,Eritrea,4,1,3,1.0,0.0,1658,1482
2002-12-06,Uganda,Rwanda,2,1,1,1.0,0.0,1654,1593
2002-12-07,Bahrain,Jordan,0,3,3,0.0,1.0,1649,1657
2002-12-07,China PR,Syria,3,1,2,1.0,0.0,1806,1620
2002-12-07,Ethiopia,Somalia,0,1,1,0.0,1.0,1575,1403
2002-12-07,Sudan,Burundi,2,1,1,1.0,0.0,1609,1551
2002-12-08,Tanzania,Eritrea,1,1,0,0.5,0.5,1534,1484
2002-12-08,Thailand,Vietnam,2,1,1,1.0,0.0,1751,1568
2002-12-08,Zanzibar,Uganda,0,2,2,0.0,1.0,1410,1658
2002-12-09,Bahrain,Syria,2,3,1,0.0,1.0,1641,1629
2002-12-09,China PR,Jordan,0,0,0,0.5,0.5,1803,1661
2002-12-09,Rwanda,Ethiopia,1,0,1,1.0,0.0,1601,1568
2002-12-09,Sudan,Kenya,0,1,1,0.0,1.0,1603,1665
2002-12-10,Chile,Palestine,3,1,2,1.0,0.0,1737,1473
2002-12-11,Malaysia,Cambodia,5,0,5,1.0,0.0,1573,1366
2002-12-11,Singapore,Philippines,2,0,2,1.0,0.0,1580,1256
2002-12-11,Tanzania,Rwanda,3,0,3,1.0,0.0,1544,1592
2002-12-12,Bahrain,China PR,2,2,0,0.5,0.5,1645,1800
2002-12-12,Jordan,Syria,3,0,3,1.0,0.0,1669,1622
2002-12-12,Uganda,Kenya,1,3,2,0.0,1.0,1651,1673
2002-12-13,Saudi Arabia,Lebanon,1,1,0,0.5,0.5,1843,1621
2002-12-14,Botswana,Zambia,1,0,1,1.0,0.0,1477,1680
2002-12-14,Rwanda,Uganda,2,1,1,1.0,0.0,1602,1642
2002-12-14,Tanzania,Kenya,2,3,1,0.0,1.0,1539,1679
2002-12-15,Ghana,Nigeria,0,1,1,0.0,1.0,1686,1835
2002-12-15,Indonesia,Myanmar,0,0,0,0.5,0.5,1626,1541
2002-12-15,Vietnam,Cambodia,9,2,7,1.0,0.0,1572,1363
2002-12-16,Palestine,Jordan,1,1,0,0.5,0.5,1478,1665
2002-12-16,United Arab Emirates,Egypt,1,2,1,0.0,1.0,1691,1792
2002-12-17,Indonesia,Cambodia,4,2,2,1.0,0.0,1629,1361
2002-12-17,Philippines,Myanmar,1,6,5,0.0,1.0,1254,1544
2002-12-17,Saudi Arabia,Bahrain,2,1,1,1.0,0.0,1847,1642
2002-12-17,Yemen,Syria,0,4,4,0.0,1.0,1474,1627
2002-12-18,Kuwait,Sudan,1,0,1,1.0,0.0,1745,1598
2002-12-18,Singapore,Malaysia,0,4,4,0.0,1.0,1572,1582
2002-12-18,Thailand,Laos,5,1,4,1.0,0.0,1753,1384
2002-12-19,Bahrain,Syria,2,0,2,1.0,0.0,1650,1620
2002-12-19,Myanmar,Cambodia,5,0,5,1.0,0.0,1549,1357
2002-12-19,Saudi Arabia,Lebanon,1,0,1,1.0,0.0,1851,1618
2002-12-19,Vietnam,Philippines,4,1,3,1.0,0.0,1575,1252
2002-12-20,Jordan,Sudan,2,1,1,1.0,0.0,1672,1592
2002-12-20,Singapore,Laos,2,1,1,1.0,0.0,1577,1380
2002-12-20,Thailand,Malaysia,1,3,2,0.0,1.0,1742,1594
2002-12-21,Bahrain,Yemen,3,1,2,1.0,0.0,1655,1470
2002-12-21,Cambodia,Philippines,1,0,1,1.0,0.0,1363,1247
2002-12-21,Indonesia,Vietnam,2,2,0,0.5,0.5,1628,1577
2002-12-21,Syria,Lebanon,4,1,3,1.0,0.0,1628,1611
2002-12-22,Egypt,Ghana,0,0,0,0.5,0.5,1790,1689
2002-12-22,Malaysia,Laos,1,1,0,0.5,0.5,1590,1385
2002-12-22,Singapore,Thailand,1,1,0,0.5,0.5,1581,1739
2002-12-23,Myanmar,Vietnam,2,4,2,0.0,1.0,1542,1585
2002-12-23,Indonesia,Philippines,13,1,12,1.0,0.0,1630,1246
2002-12-23,Kuwait,Jordan,1,2,1,0.0,1.0,1736,1682
2002-12-23,Sudan,Palestine,2,2,0,0.5,0.5,1590,1481
2002-12-24,Lebanon,Yemen,4,2,2,1.0,0.0,1616,1466
2002-12-24,Syria,Saudi Arabia,0,3,3,0.0,1.0,1625,1855
2002-12-25,Kuwait,Palestine,3,3,0,0.5,0.5,1731,1487
2002-12-26,Lebanon,Bahrain,0,0,0,0.5,0.5,1617,1655
2002-12-26,Yemen,Saudi Arabia,2,2,0,0.5,0.5,1473,1849
2002-12-27,Indonesia,Malaysia,1,0,1,1.0,0.0,1638,1583
2002-12-27,Niger,Burkina Faso,1,1,0,0.5,0.5,1538,1619
2002-12-27,Vietnam,Thailand,0,4,4,0.0,1.0,1581,1744
2002-12-27,Andalusia,Chile,3,2,1,1.0,0.0,1559,1726
2002-12-28,Jordan,Bahrain,1,2,1,0.0,1.0,1674,1664
2002-12-28,Basque Country,North Macedonia,1,1,0,0.5,0.5,1695,1582
2002-12-28,Catalonia,China PR,2,0,2,1.0,0.0,1574,1788
2002-12-29,Indonesia,Thailand,2,2,0,0.5,0.5,1641,1742
2002-12-29,Niger,Mali,2,2,0,0.5,0.5,1542,1689
2002-12-29,Vietnam,Malaysia,2,1,1,1.0,0.0,1590,1575
2002-12-30,Saudi Arabia,Bahrain,1,0,1,1.0,0.0,1854,1660
2003-01-10,India,Pakistan,0,1,1,0.0,1.0,1514,1359
2003-01-10,Sri Lanka,Afghanistan,1,0,1,1.0,0.0,1420,1407
2003-01-11,Bangladesh,Nepal,1,0,1,1.0,0.0,1464,1364
2003-01-11,Maldives,Bhutan,6,0,6,1.0,0.0,1383,1384
2003-01-12,Afghanistan,India,0,4,4,0.0,1.0,1402,1520
2003-01-12,Barbados,Jamaica,1,0,1,1.0,0.0,1589,1712
2003-01-12,Pakistan,Sri Lanka,2,1,1,1.0,0.0,1369,1411
2003-01-13,Bangladesh,Maldives,1,0,1,1.0,0.0,1471,1377
2003-01-13,Nepal,Bhutan,2,0,2,1.0,0.0,1373,1376
2003-01-14,Afghanistan,Pakistan,0,1,1,0.0,1.0,1394,1378
2003-01-14,India,Sri Lanka,1,1,0,0.5,0.5,1518,1414
2003-01-15,Bangladesh,Bhutan,3,0,3,1.0,0.0,1477,1371
2003-01-15,Nepal,Maldives,2,3,1,0.0,1.0,1366,1385
2003-01-17,El Salvador,Guatemala,0,0,0,0.5,0.5,1632,1681
2003-01-18,Bangladesh,India,2,1,1,1.0,0.0,1486,1510
2003-01-18,Pakistan,Maldives,0,1,1,0.0,1.0,1371,1393
2003-01-18,United States,Canada,4,0,4,1.0,0.0,1889,1744
2003-01-19,El Salvador,Guatemala,0,0,0,0.5,0.5,1634,1680
2003-01-20,Bangladesh,Maldives,1,1,0,0.5,0.5,1484,1396
2003-01-20,Pakistan,India,1,2,1,0.0,1.0,1367,1515
2003-01-25,Uganda,Algeria,0,1,1,0.0,1.0,1636,1729
2003-01-26,Barbados,Finland,0,0,0,0.5,0.5,1592,1714
2003-01-26,Ghana,Benin,3,0,3,1.0,0.0,1693,1481
2003-01-26,United Arab Emirates,Norway,1,1,0,0.5,0.5,1695,1862
2003-01-28,Oman,Norway,1,2,1,0.0,1.0,1652,1866
2003-01-29,Cyprus,Greece,1,2,1,0.0,1.0,1604,1787
2003-01-29,Trinidad and Tobago,Finland,1,2,1,0.0,1.0,1707,1723
2003-01-31,Honduras,Argentina,1,3,2,0.0,1.0,1809,2002
2003-02-04,Mexico,Argentina,0,1,1,0.0,1.0,1895,2008
2003-02-04,Uruguay,Iran,1,1,0,0.5,0.5,1820,1841
2003-02-08,United States,Argentina,0,1,1,0.0,1.0,1884,2014
2003-02-09,Croatia,North Macedonia,2,2,0,0.5,0.5,1834,1588
2003-02-09,Ecuador,Estonia,1,0,1,1.0,0.0,1801,1567
2003-02-09,Panama,El Salvador,1,2,1,0.0,1.0,1584,1642
2003-02-11,Cameroon,Ivory Coast,0,3,3,0.0,1.0,1839,1784
2003-02-11,Costa Rica,El Salvador,1,0,1,1.0,0.0,1813,1638
2003-02-11,Honduras,Nicaragua,2,0,2,1.0,0.0,1810,1309
2003-02-12,Albania,Vietnam,5,0,5,1.0,0.0,1544,1581
2003-02-12,Algeria,Belgium,1,3,2,0.0,1.0,1725,1880
2003-02-12,Barbados,Martinique,3,3,0,0.5,0.5,1595,1684
2003-02-12,Bulgaria,Hungary,1,0,1,1.0,0.0,1804,1708
2003-02-12,China PR,Brazil,0,0,0,0.5,0.5,1793,2032
2003-02-12,Croatia,Poland,0,0,0,0.5,0.5,1834,1797
2003-02-12,Cyprus,Russia,0,1,1,0.0,1.0,1601,1855
2003-02-12,Ecuador,Estonia,2,1,1,1.0,0.0,1805,1564
2003-02-12,Egypt,Denmark,1,4,3,0.0,1.0,1786,1935
2003-02-12,England,Australia,1,3,2,0.0,1.0,1953,1898
2003-02-12,France,Czech Republic,0,2,2,0.0,1.0,2013,1882
2003-02-12,Georgia,Moldova,2,2,0,0.5,0.5,1602,1511
2003-02-12,Greece,Norway,1,0,1,1.0,0.0,1797,1857
2003-02-12,Guinea,Mali,0,1,1,0.0,1.0,1619,1696
2003-02-12,Israel,Armenia,2,0,2,1.0,0.0,1733,1535
2003-02-12,Italy,Portugal,1,0,1,1.0,0.0,1943,1927
2003-02-12,Jamaica,United States,1,2,1,0.0,1.0,1708,1889
2003-02-12,Latvia,Lithuania,2,1,1,1.0,0.0,1561,1526
2003-02-12,Libya,Canada,2,4,2,0.0,1.0,1609,1750
2003-02-12,Malta,Kazakhstan,2,2,0,0.5,0.5,1445,1616
2003-02-12,Mexico,Colombia,0,0,0,0.5,0.5,1895,1869
2003-02-12,Morocco,Senegal,1,0,1,1.0,0.0,1822,1789
2003-02-12,Netherlands,Argentina,1,0,1,1.0,0.0,2015,2006
2003-02-12,Northern Ireland,Finland,0,1,1,0.0,1.0,1658,1730
2003-02-12,Romania,Slovakia,2,1,1,1.0,0.0,1835,1704
2003-02-12,Scotland,Republic of Ireland,0,2,2,0.0,1.0,1782,1872
2003-02-12,Serbia,Azerbaijan,2,2,0,0.5,0.5,1808,1465
2003-02-12,Slovenia,Switzerland,1,5,4,0.0,1.0,1717,1786
2003-02-12,Spain,Germany,3,1,2,1.0,0.0,1991,1959
2003-02-12,Tunisia,Sweden,1,0,1,1.0,0.0,1800,1868
2003-02-12,Turkey,Ukraine,0,0,0,0.5,0.5,1822,1707
2003-02-12,Wales,Bosnia and Herzegovina,2,2,0,0.5,0.5,1731,1619
2003-02-13,Costa Rica,Guatemala,1,1,0,0.5,0.5,1811,1683
2003-02-13,Cyprus,Slovakia,1,3,2,0.0,1.0,1596,1710
2003-02-13,El Salvador,Nicaragua,3,0,3,1.0,0.0,1641,1307
2003-02-14,North Macedonia,Poland,0,3,3,0.0,1.0,1585,1801
2003-02-15,Benin,Ghana,1,0,1,1.0,0.0,1494,1681
2003-02-15,Costa Rica,Nicaragua,1,0,1,1.0,0.0,1812,1307
2003-02-15,Honduras,El Salvador,0,1,1,0.0,1.0,1799,1653
2003-02-16,China PR,Estonia,1,0,1,1.0,0.0,1797,1561
2003-02-16,Gambia,Nigeria,0,1,1,0.0,1.0,1549,1838
2003-02-16,Panama,Guatemala,2,0,2,1.0,0.0,1595,1673
2003-02-16,Qatar,Sweden,2,3,1,0.0,1.0,1769,1874
2003-02-16,Thailand,North Korea,2,2,0,0.5,0.5,1742,1701
2003-02-18,Guatemala,Nicaragua,5,0,5,1.0,0.0,1675,1306
2003-02-18,North Korea,Sweden,1,1,0,0.5,0.5,1705,1871
2003-02-18,Panama,Honduras,1,1,0,0.5,0.5,1600,1795
2003-02-18,Thailand,Qatar,1,1,0,0.5,0.5,1743,1769
2003-02-20,Costa Rica,Honduras,1,0,1,1.0,0.0,1820,1788
2003-02-20,El Salvador,Guatemala,0,2,2,0.0,1.0,1646,1683
2003-02-20,North Korea,Qatar,2,2,0,0.5,0.5,1707,1768
2003-02-20,Thailand,Sweden,1,4,3,0.0,1.0,1738,1877
2003-02-21,Panama,Nicaragua,0,1,1,0.0,1.0,1587,1320
2003-02-22,Hong Kong,Taiwan,2,0,2,1.0,0.0,1545,1401
2003-02-22,North Korea,Sweden,0,4,4,0.0,1.0,1703,1882
2003-02-22,Macau,Mongolia,2,0,2,1.0,0.0,1395,1421
2003-02-22,Madagascar,Mauritius,2,1,1,1.0,0.0,1663,1506
2003-02-22,Malawi,DR Congo,1,1,0,0.5,0.5,1618,1669
2003-02-22,Thailand,Qatar,3,1,2,1.0,0.0,1747,1760
2003-02-23,Guatemala,Honduras,2,1,1,1.0,0.0,1694,1778
2003-02-23,Malawi,DR Congo,2,3,1,0.0,1.0,1612,1676
2003-02-23,Panama,Costa Rica,0,1,1,0.0,1.0,1584,1824
2003-02-23,Peru,Haiti,5,1,4,1.0,0.0,1746,1651
2003-02-24,Hong Kong,Macau,3,0,3,1.0,0.0,1550,1391
2003-02-24,Mongolia,Guam,2,0,2,1.0,0.0,1430,1417
2003-02-26,Guam,Macau,0,2,2,0.0,1.0,1409,1400
2003-02-28,Guam,Taiwan,0,7,7,0.0,1.0,1401,1410
2003-02-28,Hong Kong,Mongolia,10,0,10,1.0,0.0,1556,1425
2003-03-02,Hong Kong,Guam,11,0,11,1.0,0.0,1561,1397
2003-03-02,Macau,Taiwan,1,2,1,0.0,1.0,1393,1418
2003-03-04,Singapore,Maldives,4,1,3,1.0,0.0,1586,1392
2003-03-04,Sudan,DR Congo,1,3,2,0.0,1.0,1584,1683
2003-03-05,Israel,Moldova,0,0,0,0.5,0.5,1729,1516
2003-03-07,Benin,Niger,1,1,0,0.5,0.5,1496,1541
2003-03-09,Botswana,Lesotho,0,1,1,0.0,1.0,1469,1464
2003-03-09,DR Congo,Congo,3,0,3,1.0,0.0,1690,1612
2003-03-11,Cuba,Jamaica,0,0,0,0.5,0.5,1642,1707
2003-03-12,Tanzania,Uganda,0,0,0,0.5,0.5,1542,1634
2003-03-13,Cuba,Jamaica,1,0,1,1.0,0.0,1652,1698
2003-03-14,Martinique,French Guiana,2,1,1,1.0,0.0,1688,1435
2003-03-15,Namibia,Botswana,0,1,1,0.0,1.0,1494,1478
2003-03-15,Guadeloupe,French Guiana,2,2,0,0.5,0.5,1554,1438
2003-03-15,Kenya,Uganda,2,2,0,0.5,0.5,1678,1636
2003-03-15,Rwanda,Burundi,4,2,2,1.0,0.0,1609,1545
2003-03-16,Kyrgyzstan,Afghanistan,1,2,1,0.0,1.0,1429,1403
2003-03-16,Lesotho,DR Congo,2,2,0,0.5,0.5,1469,1686
2003-03-16,Zimbabwe,Malawi,0,0,0,0.5,0.5,1698,1614
2003-03-18,Nepal,Afghanistan,4,0,4,1.0,0.0,1375,1395
2003-03-19,Egypt,Qatar,6,0,6,1.0,0.0,1794,1753
2003-03-19,Mexico,Bolivia,2,0,2,1.0,0.0,1899,1677
2003-03-19,Eswatini,Lesotho,1,0,1,1.0,0.0,1508,1462
2003-03-20,Nepal,Kyrgyzstan,0,2,2,0.0,1.0,1369,1436
2003-03-21,Macau,Pakistan,0,3,3,0.0,1.0,1385,1376
2003-03-21,Maldives,Brunei,1,1,0,0.5,0.5,1390,1304
2003-03-21,Sri Lanka,Timor-Leste,3,2,1,1.0,0.0,1424,1491
2003-03-22,Mozambique,Lesotho,0,0,0,0.5,0.5,1540,1464
2003-03-22,Rwanda,Zambia,1,1,0,0.5,0.5,1611,1679
2003-03-22,Alderney,Guernsey,1,4,3,0.0,1.0,1280,1657
2003-03-23,Benin,Equatorial Guinea,2,1,1,1.0,0.0,1503,1418
2003-03-23,Myanmar,Brunei,5,0,5,1.0,0.0,1546,1301
2003-03-23,Jamaica,Barbados,2,1,1,1.0,0.0,1704,1590
2003-03-23,Kenya,Tanzania,4,0,4,1.0,0.0,1684,1537
2003-03-23,Singapore,Macau,2,0,2,1.0,0.0,1590,1382
2003-03-24,North Korea,India,2,0,2,1.0,0.0,1708,1511
2003-03-24,Rwanda,Zambia,0,3,3,0.0,1.0,1605,1686
2003-03-25,Hong Kong,Laos,5,1,4,1.0,0.0,1566,1381
2003-03-25,Maldives,Myanmar,0,2,2,0.0,1.0,1386,1551
2003-03-25,Singapore,Pakistan,3,0,3,1.0,0.0,1594,1373
2003-03-25,Sri Lanka,Taiwan,2,1,1,1.0,0.0,1432,1411
2003-03-26,Austria,Greece,2,2,0,0.5,0.5,1762,1797
2003-03-26,Burundi,Burkina Faso,0,0,0,0.5,0.5,1547,1618
2003-03-26,Guadeloupe,Cuba,2,3,1,0.0,1.0,1549,1658
2003-03-26,Haiti,Martinique,2,1,1,1.0,0.0,1660,1680
2003-03-26,Jamaica,Saint Lucia,5,0,5,1.0,0.0,1709,1548
2003-03-26,Mexico,Paraguay,1,1,0,0.5,0.5,1898,1854
2003-03-26,Trinidad and Tobago,Antigua and Barbuda,2,0,2,1.0,0.0,1711,1470
2003-03-27,Cameroon,Madagascar,2,0,2,1.0,0.0,1844,1659
2003-03-27,Laos,Bangladesh,2,1,1,1.0,0.0,1392,1474
2003-03-27,Serbia,Bulgaria,1,2,1,0.0,1.0,1800,1813
2003-03-27,Tunisia,Ghana,2,2,0,0.5,0.5,1798,1684
2003-03-28,Cuba,Antigua and Barbuda,2,0,2,1.0,0.0,1663,1466
2003-03-28,Jamaica,Martinique,2,2,0,0.5,0.5,1709,1681
2003-03-28,Japan,Uruguay,2,2,0,0.5,0.5,1868,1822
2003-03-28,Saint Lucia,Haiti,2,1,1,1.0,0.0,1559,1650
2003-03-28,Trinidad and Tobago,Guadeloupe,1,0,1,1.0,0.0,1716,1545
2003-03-29,Albania,Russia,3,1,2,1.0,0.0,1558,1842
2003-03-29,Angola,Algeria,1,1,0,0.5,0.5,1676,1724
2003-03-29,Armenia,Northern Ireland,1,0,1,1.0,0.0,1546,1648
2003-03-29,Belarus,Moldova,2,1,1,1.0,0.0,1588,1510
2003-03-29,Bosnia and Herzegovina,Luxembourg,2,0,2,1.0,0.0,1622,1348
2003-03-29,Cape Verde,Togo,2,1,1,1.0,0.0,1546,1624
2003-03-29,Costa Rica,Paraguay,2,1,1,1.0,0.0,1833,1846
2003-03-29,Croatia,Belgium,4,0,4,1.0,0.0,1844,1871
2003-03-29,Cyprus,Israel,1,1,0,0.5,0.5,1599,1727
2003-03-29,Estonia,Canada,2,1,1,1.0,0.0,1573,1739
2003-03-29,France,Malta,6,0,6,1.0,0.0,2014,1445
2003-03-29,Gabon,Equatorial Guinea,4,0,4,1.0,0.0,1663,1415
2003-03-29,Georgia,Republic of Ireland,1,2,1,0.0,1.0,1600,1875
2003-03-29,Germany,Lithuania,1,1,0,0.5,0.5,1953,1533
2003-03-29,Italy,Finland,2,0,2,1.0,0.0,1947,1727
2003-03-29,Kenya,Mauritania,4,0,4,1.0,0.0,1687,1408
2003-03-29,South Korea,Colombia,0,0,0,0.5,0.5,1877,1870
2003-03-29,Liechtenstein,England,0,2,2,0.0,1.0,1406,1954
2003-03-29,North Macedonia,Slovakia,0,2,2,0.0,1.0,1580,1716
2003-03-29,Malawi,Nigeria,0,1,1,0.0,1.0,1611,1842
2003-03-29,Mauritius,Egypt,0,1,1,0.0,1.0,1504,1797
2003-03-29,Netherlands,Czech Republic,1,1,0,0.5,0.5,2013,1885
2003-03-29,Poland,Hungary,0,0,0,0.5,0.5,1799,1711
2003-03-29,Portugal,Brazil,2,1,1,1.0,0.0,1938,2022
2003-03-29,Romania,Denmark,2,5,3,0.0,1.0,1830,1941
2003-03-29,Rwanda,Uganda,0,0,0,0.5,0.5,1606,1636
2003-03-29,Scotland,Iceland,2,1,1,1.0,0.0,1788,1676
2003-03-29,Sierra Leone,Morocco,0,0,0,0.5,0.5,1610,1818
2003-03-29,South Africa,Madagascar,2,0,2,1.0,0.0,1799,1654
2003-03-29,Sudan,Benin,3,0,3,1.0,0.0,1591,1497
2003-03-29,Tanzania,Zambia,0,1,1,0.0,1.0,1533,1691
2003-03-29,Ukraine,Spain,2,2,0,0.5,0.5,1713,1986
2003-03-29,United States,Venezuela,2,0,2,1.0,0.0,1892,1613
2003-03-29,Wales,Azerbaijan,4,0,4,1.0,0.0,1734,1463
2003-03-30,Burundi,Ivory Coast,0,1,1,0.0,1.0,1544,1788
2003-03-30,Chad,Namibia,2,0,2,1.0,0.0,1510,1487
2003-03-30,Chile,Peru,2,0,2,1.0,0.0,1735,1738
2003-03-30,Eritrea,Mali,0,2,2,0.0,1.0,1481,1700
2003-03-30,Ethiopia,Liberia,1,0,1,1.0,0.0,1578,1612
2003-03-30,Gambia,Senegal,0,0,0,0.5,0.5,1554,1785
2003-03-30,Ghana,Madagascar,3,3,0,0.5,0.5,1684,1655
2003-03-30,Guadeloupe,Antigua and Barbuda,2,0,2,1.0,0.0,1552,1460
2003-03-30,Guinea,Niger,2,0,2,1.0,0.0,1626,1535
2003-03-30,Hong Kong,Bangladesh,2,2,0,0.5,0.5,1564,1477
2003-03-30,India,North Korea,1,1,0,0.5,0.5,1516,1704
2003-03-30,Jamaica,Haiti,3,0,3,1.0,0.0,1716,1644
2003-03-30,Libya,Botswana,0,0,0,0.5,0.5,1607,1481
2003-03-30,Mozambique,Burkina Faso,1,0,1,1.0,0.0,1550,1609
2003-03-30,Saint Lucia,Martinique,4,5,1,0.0,1.0,1554,1687
2003-03-30,Eswatini,DR Congo,1,1,0,0.5,0.5,1512,1683
2003-03-30,Trinidad and Tobago,Cuba,1,3,2,0.0,1.0,1707,1673
2003-03-30,Tunisia,Cameroon,1,0,1,1.0,0.0,1808,1835
2003-03-30,Zimbabwe,Seychelles,3,1,2,1.0,0.0,1701,1418
2003-04-02,Albania,Republic of Ireland,0,0,0,0.5,0.5,1564,1870
2003-04-02,Belarus,Uzbekistan,2,2,0,0.5,0.5,1590,1665
2003-04-02,Croatia,Andorra,2,0,2,1.0,0.0,1846,1411
2003-04-02,Czech Republic,Austria,4,0,4,1.0,0.0,1891,1757
2003-04-02,Denmark,Bosnia and Herzegovina,0,2,2,0.0,1.0,1928,1636
2003-04-02,England,Turkey,2,0,2,1.0,0.0,1960,1817
2003-04-02,Estonia,Bulgaria,0,0,0,0.5,0.5,1578,1809
2003-04-02,Georgia,Switzerland,0,0,0,0.5,0.5,1604,1783
2003-04-02,Honduras,Paraguay,1,1,0,0.5,0.5,1780,1845
2003-04-02,Hungary,Sweden,1,2,1,0.0,1.0,1707,1887
2003-04-02,Israel,France,1,2,1,0.0,1.0,1725,2017
2003-04-02,Lithuania,Scotland,1,0,1,1.0,0.0,1547,1775
2003-04-02,Luxembourg,Norway,0,2,2,0.0,1.0,1348,1858
2003-04-02,North Macedonia,Portugal,0,1,1,0.0,1.0,1579,1940
2003-04-02,Moldova,Netherlands,1,2,1,0.0,1.0,1510,2014
2003-04-02,Northern Ireland,Greece,0,2,2,0.0,1.0,1644,1802
2003-04-02,Peru,Chile,3,0,3,1.0,0.0,1746,1728
2003-04-02,Poland,San Marino,5,0,5,1.0,0.0,1801,1387
2003-04-02,Slovakia,Liechtenstein,4,0,4,1.0,0.0,1719,1404
2003-04-02,Slovenia,Cyprus,4,1,3,1.0,0.0,1723,1594
2003-04-02,Spain,Armenia,3,0,3,1.0,0.0,1988,1545
2003-04-02,Ukraine,Latvia,1,0,1,1.0,0.0,1718,1557
2003-04-02,Venezuela,Jamaica,2,0,2,1.0,0.0,1624,1706
2003-04-16,South Korea,Japan,0,1,1,0.0,1.0,1869,1877
2003-04-20,Zimbabwe,Angola,1,0,1,1.0,0.0,1709,1669
2003-04-23,Bhutan,Guam,6,0,6,1.0,0.0,1380,1389
2003-04-23,Martinique,Trinidad and Tobago,3,2,1,1.0,0.0,1696,1699
2003-04-24,Algeria,Madagascar,3,1,2,1.0,0.0,1731,1649
2003-04-25,Guam,Mongolia,0,5,5,0.0,1.0,1382,1433
2003-04-25,Trinidad and Tobago,Honduras,0,2,2,0.0,1.0,1693,1787
2003-04-27,Bhutan,Mongolia,0,0,0,0.5,0.5,1382,1432
2003-04-27,Faroe Islands,Kazakhstan,3,2,1,1.0,0.0,1484,1605
2003-04-27,Madagascar,Mali,0,2,2,0.0,1.0,1643,1707
2003-04-27,Martinique,Honduras,2,4,2,0.0,1.0,1691,1793
2003-04-29,Faroe Islands,Kazakhstan,2,1,1,1.0,0.0,1495,1595
2003-04-30,Andorra,Estonia,0,2,2,0.0,1.0,1407,1583
2003-04-30,Belgium,Poland,3,1,2,1.0,0.0,1878,1795
2003-04-30,Bulgaria,Albania,2,0,2,1.0,0.0,1813,1561
2003-04-30,Chile,Costa Rica,1,0,1,1.0,0.0,1739,1823
2003-04-30,Czech Republic,Turkey,4,0,4,1.0,0.0,1898,1811
2003-04-30,Denmark,Ukraine,1,0,1,1.0,0.0,1932,1715
2003-04-30,Finland,Iceland,3,0,3,1.0,0.0,1734,1670
2003-04-30,France,Egypt,5,0,5,1.0,0.0,2021,1794
2003-04-30,Georgia,Russia,1,0,1,1.0,0.0,1617,1830
2003-04-30,Germany,Serbia,1,0,1,1.0,0.0,1958,1796
2003-04-30,Honduras,Colombia,0,0,0,0.5,0.5,1795,1869
2003-04-30,Hungary,Luxembourg,5,1,4,1.0,0.0,1709,1347
2003-04-30,Republic of Ireland,Norway,1,0,1,1.0,0.0,1878,1851
2003-04-30,Israel,Cyprus,2,0,2,1.0,0.0,1731,1589
2003-04-30,Latvia,San Marino,3,0,3,1.0,0.0,1562,1383
2003-04-30,Libya,Argentina,1,3,2,0.0,1.0,1606,2008
2003-04-30,Liechtenstein,Saudi Arabia,1,0,1,1.0,0.0,1419,1840
2003-04-30,Lithuania,Romania,0,1,1,0.0,1.0,1545,1833
2003-04-30,Malta,Slovenia,1,3,2,0.0,1.0,1443,1726
2003-04-30,Mexico,Brazil,0,0,0,0.5,0.5,1901,2020
2003-04-30,Morocco,Ivory Coast,0,1,1,0.0,1.0,1810,1797
2003-04-30,Netherlands,Portugal,1,1,0,0.5,0.5,2013,1942
2003-04-30,Peru,Paraguay,0,1,1,0.0,1.0,1741,1851
2003-04-30,Scotland,Austria,0,2,2,0.0,1.0,1767,1766
2003-04-30,Slovakia,Greece,2,2,0,0.5,0.5,1721,1801
2003-04-30,South Africa,Jamaica,0,0,0,0.5,0.5,1797,1709
2003-04-30,Spain,Ecuador,4,0,4,1.0,0.0,1993,1801
2003-04-30,Sweden,Croatia,1,2,1,0.0,1.0,1879,1855
2003-04-30,Switzerland,Italy,1,2,1,0.0,1.0,1779,1952
2003-04-30,Tunisia,Senegal,1,0,1,1.0,0.0,1816,1778
2003-04-30,Uzbekistan,Belarus,1,2,1,0.0,1.0,1656,1600
2003-04-30,Venezuela,Trinidad and Tobago,3,0,3,1.0,0.0,1634,1684
2003-05-01,Fiji,Tuvalu,9,0,9,1.0,0.0,1684,1486
2003-05-04,Congo,Central African Republic,2,1,1,1.0,0.0,1617,1442
2003-05-05,Guernsey,Jersey,3,3,0,0.5,0.5,1659,1723
2003-05-08,United States,Mexico,0,0,0,0.5,0.5,1893,1901
2003-05-16,Lesotho,Botswana,1,2,1,0.0,1.0,1457,1489
2003-05-17,Malawi,Zambia,0,1,1,0.0,1.0,1605,1698
2003-05-18,Jersey,Guernsey,1,0,1,1.0,0.0,1730,1653
2003-05-21,Lesotho,Malawi,0,0,0,0.5,0.5,1461,1602
2003-05-21,Uganda,Sudan,0,0,0,0.5,0.5,1635,1593
2003-05-22,Norway,Finland,2,0,2,1.0,0.0,1857,1729
2003-05-22,South Africa,England,1,2,1,0.0,1.0,1793,1965
2003-05-24,Botswana,Malawi,1,1,0,0.5,0.5,1492,1600
2003-05-24,Sudan,Kenya,1,1,0,0.5,0.5,1596,1685
2003-05-25,Jamaica,Nigeria,3,2,1,1.0,0.0,1720,1832
2003-05-25,Lesotho,Eswatini,2,1,1,1.0,0.0,1471,1503
2003-05-25,Togo,Benin,3,1,2,1.0,0.0,1630,1492
2003-05-26,United States,Wales,2,0,2,1.0,0.0,1898,1730
2003-05-27,Scotland,New Zealand,1,1,0,0.5,0.5,1766,1712
2003-05-29,Algeria,Burkina Faso,0,1,1,0.0,1.0,1721,1620
2003-05-30,Nigeria,Ghana,3,1,2,1.0,0.0,1837,1680
2003-05-31,Gabon,Angola,1,1,0,0.5,0.5,1664,1669
2003-05-31,Gambia,Mauritania,4,1,3,1.0,0.0,1559,1404
2003-05-31,Japan,South Korea,0,1,1,0.0,1.0,1869,1878
2003-05-31,Kenya,Trinidad and Tobago,1,1,0,0.5,0.5,1685,1685
2003-05-31,Senegal,Cape Verde,2,1,1,1.0,0.0,1782,1543
2003-05-31,Uganda,Tanzania,1,0,1,1.0,0.0,1641,1528
2003-06-01,Germany,Canada,4,1,3,1.0,0.0,1962,1736
2003-06-03,England,Serbia,2,1,1,1.0,0.0,1970,1792
2003-06-03,Guadeloupe,French Guiana,1,0,1,1.0,0.0,1558,1433
2003-06-03,Italy,Northern Ireland,2,0,2,1.0,0.0,1955,1642
2003-06-03,Uganda,Libya,3,2,1,1.0,0.0,1649,1599
2003-06-06,Mauritania,Kenya,0,0,0,0.5,0.5,1410,1680
2003-06-06,Poland,Kazakhstan,3,0,3,1.0,0.0,1799,1592
2003-06-06,Portugal,Paraguay,0,0,0,0.5,0.5,1940,1854
2003-06-07,Belarus,Netherlands,0,2,2,0.0,1.0,1599,2015
2003-06-07,Botswana,Libya,0,1,1,0.0,1.0,1487,1605
2003-06-07,Bulgaria,Belgium,2,2,0,0.5,0.5,1815,1877
2003-06-07,Burkina Faso,Mozambique,4,0,4,1.0,0.0,1627,1544
2003-06-07,Denmark,Norway,1,0,1,1.0,0.0,1939,1851
2003-06-07,Estonia,Andorra,2,0,2,1.0,0.0,1588,1403
2003-06-07,Finland,Serbia,3,0,3,1.0,0.0,1739,1783
2003-06-07,Hungary,Latvia,3,1,2,1.0,0.0,1714,1558
2003-06-07,Iceland,Faroe Islands,2,1,1,1.0,0.0,1675,1491
2003-06-07,Republic of Ireland,Albania,2,1,1,1.0,0.0,1881,1559
2003-06-07,Israel,Slovenia,0,0,0,0.5,0.5,1731,1727
2003-06-07,North Macedonia,Liechtenstein,3,1,2,1.0,0.0,1584,1415
2003-06-07,Mali,Eritrea,1,0,1,1.0,0.0,1711,1478
2003-06-07,Malta,Cyprus,1,2,1,0.0,1.0,1439,1594
2003-06-07,Moldova,Austria,1,0,1,1.0,0.0,1524,1753
2003-06-07,Namibia,Chad,2,1,1,1.0,0.0,1496,1502
2003-06-07,Niger,Guinea,1,0,1,1.0,0.0,1546,1616
2003-06-07,Nigeria,Malawi,4,1,3,1.0,0.0,1841,1597
2003-06-07,Romania,Bosnia and Herzegovina,2,0,2,1.0,0.0,1837,1633
2003-06-07,San Marino,Sweden,0,6,6,0.0,1.0,1383,1880
2003-06-07,Scotland,Germany,1,1,0,0.5,0.5,1771,1958
2003-06-07,Senegal,Gambia,3,1,2,1.0,0.0,1786,1556
2003-06-07,Seychelles,Zimbabwe,2,1,1,1.0,0.0,1432,1696
2003-06-07,Slovakia,Turkey,0,1,1,0.0,1.0,1716,1817
2003-06-07,Spain,Greece,0,1,1,0.0,1.0,1981,1814
2003-06-07,Switzerland,Russia,2,2,0,0.5,0.5,1781,1829
2003-06-07,Uganda,Rwanda,0,1,1,0.0,1.0,1641,1615
2003-06-07,Ukraine,Armenia,4,3,1,1.0,0.0,1720,1541
2003-06-07,Venezuela,Honduras,2,1,1,1.0,0.0,1646,1784
2003-06-07,Zambia,Tanzania,2,0,2,1.0,0.0,1703,1524
2003-06-08,Benin,Sudan,3,0,3,1.0,0.0,1503,1586
2003-06-08,Central African Republic,Congo,0,0,0,0.5,0.5,1446,1614
2003-06-08,Colombia,Ecuador,0,0,0,0.5,0.5,1868,1803
2003-06-08,DR Congo,Eswatini,2,0,2,1.0,0.0,1688,1499
2003-06-08,Costa Rica,Chile,1,0,1,1.0,0.0,1830,1733
2003-06-08,Egypt,Mauritius,7,0,7,1.0,0.0,1797,1502
2003-06-08,Equatorial Guinea,Gabon,2,1,1,1.0,0.0,1428,1652
2003-06-08,Ivory Coast,Burundi,6,1,5,1.0,0.0,1801,1541
2003-06-08,Japan,Argentina,1,4,3,0.0,1.0,1865,2013
2003-06-08,South Korea,Uruguay,0,2,2,0.0,1.0,1869,1832
2003-06-08,Liberia,Ethiopia,1,0,1,1.0,0.0,1620,1571
2003-06-08,Morocco,Sierra Leone,1,0,1,1.0,0.0,1814,1607
2003-06-08,Togo,Cape Verde,5,2,3,1.0,0.0,1637,1537
2003-06-08,United States,New Zealand,2,1,1,1.0,0.0,1903,1708
2003-06-10,Botswana,Trinidad and Tobago,0,0,0,0.5,0.5,1492,1681
2003-06-10,Portugal,Bolivia,4,0,4,1.0,0.0,1943,1675
2003-06-11,Austria,Belarus,5,0,5,1.0,0.0,1758,1595
2003-06-11,Azerbaijan,Serbia,2,1,1,1.0,0.0,1477,1770
2003-06-11,Belgium,Andorra,3,0,3,1.0,0.0,1878,1403
2003-06-11,Czech Republic,Moldova,5,0,5,1.0,0.0,1900,1523
2003-06-11,Ecuador,Peru,2,2,0,0.5,0.5,1802,1743
2003-06-11,England,Slovakia,2,1,1,1.0,0.0,1974,1713
2003-06-11,Estonia,Croatia,0,1,1,0.0,1.0,1586,1858
2003-06-11,Faroe Islands,Germany,0,2,2,0.0,1.0,1490,1960
2003-06-11,Finland,Italy,0,2,2,0.0,1.0,1736,1959
2003-06-11,Greece,Ukraine,1,0,1,1.0,0.0,1820,1715
2003-06-11,Honduras,Chile,1,2,1,0.0,1.0,1775,1743
2003-06-11,Republic of Ireland,Georgia,2,0,2,1.0,0.0,1884,1615
2003-06-11,Japan,Paraguay,0,0,0,0.5,0.5,1865,1855
2003-06-11,South Korea,Argentina,0,1,1,0.0,1.0,1865,2018
2003-06-11,Lithuania,Iceland,0,3,3,0.0,1.0,1540,1681
2003-06-11,Luxembourg,Denmark,0,2,2,0.0,1.0,1347,1940
2003-06-11,Nigeria,Brazil,0,3,3,0.0,1.0,1837,2025
2003-06-11,Northern Ireland,Spain,0,0,0,0.5,0.5,1649,1975
2003-06-11,Norway,Romania,1,1,0,0.5,0.5,1851,1838
2003-06-11,San Marino,Hungary,0,5,5,0.0,1.0,1381,1717
2003-06-11,Sweden,Poland,3,0,3,1.0,0.0,1887,1793
2003-06-11,Switzerland,Albania,3,2,1,1.0,0.0,1785,1556
2003-06-11,Turkey,North Macedonia,3,2,1,1.0,0.0,1821,1581
2003-06-13,Andorra,Gabon,0,2,2,0.0,1.0,1400,1656
2003-06-13,Ghana,Kenya,1,3,2,0.0,1.0,1672,1688
2003-06-14,Papua New Guinea,Solomon Islands,3,5,2,0.0,1.0,1499,1604
2003-06-14,Senegal,Lesotho,3,0,3,1.0,0.0,1789,1469
2003-06-14,South Africa,Trinidad and Tobago,2,1,1,1.0,0.0,1799,1676
2003-06-18,France,Colombia,1,0,1,1.0,0.0,2026,1864
2003-06-18,New Zealand,Japan,0,3,3,0.0,1.0,1704,1870
2003-06-19,Brazil,Cameroon,0,1,1,0.0,1.0,2014,1847
2003-06-19,Turkey,United States,2,1,1,1.0,0.0,1831,1894
2003-06-20,Algeria,Namibia,1,0,1,1.0,0.0,1725,1493
2003-06-20,Colombia,New Zealand,3,1,2,1.0,0.0,1869,1700
2003-06-20,Egypt,Madagascar,6,0,6,1.0,0.0,1802,1639
2003-06-20,France,Japan,2,1,1,1.0,0.0,2031,1866
2003-06-20,Morocco,Gabon,2,0,2,1.0,0.0,1819,1652
2003-06-21,Brazil,United States,1,0,1,1.0,0.0,2020,1889
2003-06-21,Burkina Faso,Congo,3,0,3,1.0,0.0,1635,1607
2003-06-21,Cameroon,Turkey,1,0,1,1.0,0.0,1855,1824
2003-06-21,Cape Verde,Mauritania,3,0,3,1.0,0.0,1543,1405
2003-06-21,Eritrea,Seychelles,1,0,1,1.0,0.0,1485,1426
2003-06-21,Liberia,Guinea,1,2,1,0.0,1.0,1612,1625
2003-06-21,Nigeria,Angola,2,2,0,0.5,0.5,1834,1673
2003-06-21,Zambia,Sudan,1,1,0,0.5,0.5,1701,1589
2003-06-22,DR Congo,Libya,2,1,1,1.0,0.0,1695,1599
2003-06-22,Ethiopia,Niger,2,0,2,1.0,0.0,1579,1539
2003-06-22,France,New Zealand,5,0,5,1.0,0.0,2034,1698
2003-06-22,Ghana,Uganda,1,1,0,0.5,0.5,1672,1642
2003-06-22,Guatemala,Honduras,1,2,1,0.0,1.0,1688,1782
2003-06-22,Japan,Colombia,0,1,1,0.0,1.0,1859,1877
2003-06-22,Mali,Zimbabwe,0,0,0,0.5,0.5,1711,1697
2003-06-22,Mozambique,Central African Republic,1,0,1,1.0,0.0,1550,1441
2003-06-22,Sierra Leone,Equatorial Guinea,2,0,2,1.0,0.0,1612,1424
2003-06-22,South Africa,Ivory Coast,2,1,1,1.0,0.0,1808,1793
2003-06-22,Eswatini,Botswana,3,2,1,1.0,0.0,1507,1485
2003-06-22,Tanzania,Benin,0,1,1,0.0,1.0,1516,1512
2003-06-22,Togo,Kenya,2,0,2,1.0,0.0,1647,1679
2003-06-23,Brazil,Turkey,2,2,0,0.5,0.5,2016,1829
2003-06-23,United States,Cameroon,0,0,0,0.5,0.5,1889,1856
2003-06-26,Cameroon,Colombia,1,0,1,1.0,0.0,1865,1869
2003-06-26,France,Turkey,3,2,1,1.0,0.0,2038,1826
2003-06-26,Peru,Venezuela,1,0,1,1.0,0.0,1749,1641
2003-06-27,Panama,Cuba,2,0,2,1.0,0.0,1595,1663
2003-06-28,Colombia,Turkey,1,2,1,0.0,1.0,1861,1835
2003-06-29,France,Cameroon,1,0,1,1.0,0.0,2043,1861
2003-06-29,Honduras,El Salvador,1,1,0,0.5,0.5,1780,1649
2003-06-29,Panama,Cuba,1,0,1,1.0,0.0,1605,1654
2003-06-29,Saare County,Ynys Môn,0,2,2,0.0,1.0,1454,1583
2003-06-29,Frøya,Jersey,1,5,4,0.0,1.0,1478,1734
2003-06-29,Shetland,Gotland,0,0,0,0.5,0.5,1484,1516
2003-06-29,Guernsey,Alderney,7,1,6,1.0,0.0,1655,1279
2003-06-29,Gibraltar,Sark,19,0,19,1.0,0.0,1533,1493
2003-06-29,Isle of Wight,Greenland,1,2,1,0.0,1.0,1559,1474
2003-06-30,Fiji,Vanuatu,0,0,0,0.5,0.5,1680,1485
2003-06-30,Papua New Guinea,New Caledonia,0,2,2,0.0,1.0,1493,1571
2003-06-30,Tahiti,Micronesia,17,0,17,1.0,0.0,1724,1488
2003-06-30,Tuvalu,Kiribati,3,2,1,1.0,0.0,1494,1477
2003-06-30,Isle of Man,Saare County,4,0,4,1.0,0.0,1505,1447
2003-06-30,Gotland,Frøya,2,2,0,0.5,0.5,1516,1479
2003-06-30,Jersey,Shetland,5,0,5,1.0,0.0,1738,1481
2003-06-30,Guernsey,Orkney,10,0,10,1.0,0.0,1660,1470
2003-06-30,Sark,Isle of Wight,0,20,20,0.0,1.0,1487,1566
2003-06-30,Gibraltar,Greenland,2,0,2,1.0,0.0,1540,1468
2003-07-01,Fiji,Tuvalu,4,0,4,1.0,0.0,1685,1490
2003-07-01,Micronesia,New Caledonia,0,18,18,0.0,1.0,1482,1578
2003-07-01,Papua New Guinea,Tonga,2,2,0,0.5,0.5,1493,1475
2003-07-01,Solomon Islands,Vanuatu,2,2,0,0.5,0.5,1602,1488
2003-07-01,Ynys Môn,Isle of Man,1,2,1,0.0,1.0,1574,1515
2003-07-01,Shetland,Frøya,3,1,2,1.0,0.0,1489,1472
2003-07-01,Jersey,Gotland,0,0,0,0.5,0.5,1734,1521
2003-07-01,Orkney,Alderney,3,1,2,1.0,0.0,1474,1276
2003-07-01,Isle of Wight,Gibraltar,2,1,1,1.0,0.0,1574,1533
2003-07-01,Greenland,Sark,16,0,16,1.0,0.0,1477,1479
2003-07-02,El Salvador,Paraguay,0,1,1,0.0,1.0,1646,1859
2003-07-02,Guatemala,Peru,1,2,1,0.0,1.0,1682,1756
2003-07-03,Estonia,Lithuania,1,5,4,0.0,1.0,1577,1550
2003-07-03,Solomon Islands,Kiribati,7,0,7,1.0,0.0,1608,1472
2003-07-03,Tahiti,Papua New Guinea,3,0,3,1.0,0.0,1728,1490
2003-07-03,Tonga,New Caledonia,0,4,4,0.0,1.0,1470,1584
2003-07-03,Trinidad and Tobago,Venezuela,2,2,0,0.5,0.5,1676,1642
2003-07-03,Tuvalu,Vanuatu,0,1,1,0.0,1.0,1482,1497
2003-07-03,Frøya,Sark,15,0,15,1.0,0.0,1481,1471
2003-07-03,Alderney,Greenland,0,3,3,0.0,1.0,1273,1481
2003-07-03,Gotland,Saare County,3,0,3,1.0,0.0,1528,1441
2003-07-03,Orkney,Gibraltar,1,7,6,0.0,1.0,1468,1540
2003-07-03,Isle of Man,Jersey,2,1,1,1.0,0.0,1528,1722
2003-07-03,Guernsey,Isle of Wight,3,1,2,1.0,0.0,1667,1568
2003-07-04,Latvia,Lithuania,2,1,1,1.0,0.0,1566,1543
2003-07-04,Saare County,Alderney,0,1,1,0.0,1.0,1430,1285
2003-07-04,Gotland,Greenland,2,1,1,1.0,0.0,1535,1475
2003-07-04,Orkney,Shetland,0,6,6,0.0,1.0,1461,1497
2003-07-04,Gibraltar,Ynys Môn,0,2,2,0.0,1.0,1533,1582
2003-07-04,Jersey,Isle of Wight,3,0,3,1.0,0.0,1727,1564
2003-07-04,Guernsey,Isle of Man,3,1,2,1.0,0.0,1672,1524
2003-07-05,Botswana,DR Congo,0,0,0,0.5,0.5,1490,1691
2003-07-05,Estonia,Latvia,0,0,0,0.5,0.5,1577,1567
2003-07-05,Fiji,Kiribati,12,0,12,1.0,0.0,1689,1469
2003-07-05,Kenya,Cape Verde,1,0,1,1.0,0.0,1685,1538
2003-07-05,Libya,Eswatini,6,2,4,1.0,0.0,1605,1502
2003-07-05,Mauritania,Togo,0,0,0,0.5,0.5,1410,1643
2003-07-05,Niger,Liberia,1,0,1,1.0,0.0,1549,1603
2003-07-05,Seychelles,Mali,0,2,2,0.0,1.0,1424,1714
2003-07-05,Tahiti,New Caledonia,0,4,4,0.0,1.0,1717,1596
2003-07-05,Tonga,Micronesia,7,0,7,1.0,0.0,1479,1474
2003-07-05,Tuvalu,Solomon Islands,0,4,4,0.0,1.0,1477,1614
2003-07-05,Zimbabwe,Eritrea,2,0,2,1.0,0.0,1701,1482
2003-07-06,Angola,Malawi,5,1,4,1.0,0.0,1680,1591
2003-07-06,Benin,Zambia,3,0,3,1.0,0.0,1524,1690
2003-07-06,Burundi,South Africa,0,2,2,0.0,1.0,1539,1811
2003-07-06,Central African Republic,Burkina Faso,0,3,3,0.0,1.0,1438,1639
2003-07-06,Chad,Algeria,0,0,0,0.5,0.5,1507,1721
2003-07-06,Congo,Mozambique,0,0,0,0.5,0.5,1606,1552
2003-07-06,El Salvador,Mexico,2,1,1,1.0,0.0,1660,1888
2003-07-06,Equatorial Guinea,Morocco,0,1,1,0.0,1.0,1423,1821
2003-07-06,Gabon,Sierra Leone,2,0,2,1.0,0.0,1660,1605
2003-07-06,Guinea,Ethiopia,3,0,3,1.0,0.0,1632,1573
2003-07-06,Jamaica,Cuba,1,2,1,0.0,1.0,1711,1664
2003-07-06,Lesotho,Gambia,1,0,1,1.0,0.0,1479,1547
2003-07-06,Madagascar,Mauritius,0,2,2,0.0,1.0,1628,1514
2003-07-06,Rwanda,Ghana,1,0,1,1.0,0.0,1625,1663
2003-07-06,Sudan,Tanzania,3,0,3,1.0,0.0,1596,1510
2003-07-06,United States,Paraguay,2,0,2,1.0,0.0,1897,1852
2003-07-07,Fiji,Solomon Islands,2,1,1,1.0,0.0,1696,1608
2003-07-07,Kiribati,Vanuatu,0,18,18,0.0,1.0,1462,1505
2003-07-07,Papua New Guinea,Micronesia,10,0,10,1.0,0.0,1498,1467
2003-07-07,Tahiti,Tonga,4,0,4,1.0,0.0,1721,1476
2003-07-08,El Salvador,Guatemala,1,2,1,0.0,1.0,1653,1690
2003-07-09,Fiji,Tahiti,2,1,1,1.0,0.0,1705,1713
2003-07-09,Jamaica,Paraguay,2,0,2,1.0,0.0,1723,1841
2003-07-09,New Caledonia,Vanuatu,1,1,0,0.5,0.5,1594,1508
2003-07-11,Fiji,New Caledonia,2,0,2,1.0,0.0,1711,1589
2003-07-11,Tahiti,Vanuatu,0,1,1,0.0,1.0,1701,1521
2003-07-12,Costa Rica,Canada,0,1,1,0.0,1.0,1820,1747
2003-07-12,United States,El Salvador,2,0,2,1.0,0.0,1901,1650
2003-07-13,Jamaica,Colombia,0,1,1,0.0,1.0,1719,1866
2003-07-13,Mexico,Brazil,1,0,1,1.0,0.0,1899,2006
2003-07-13,Eswatini,Madagascar,2,0,2,1.0,0.0,1513,1618
2003-07-14,Canada,Cuba,0,2,2,0.0,1.0,1738,1674
2003-07-14,United States,Martinique,2,0,2,1.0,0.0,1905,1688
2003-07-15,Brazil,Honduras,2,1,1,1.0,0.0,2010,1777
2003-07-15,Guatemala,Jamaica,0,2,2,0.0,1.0,1683,1727
2003-07-16,Argentina,Uruguay,2,2,0,0.5,0.5,2015,1836
2003-07-16,Cuba,Costa Rica,0,3,3,0.0,1.0,1670,1825
2003-07-16,El Salvador,Martinique,1,0,1,1.0,0.0,1659,1680
2003-07-17,Colombia,Guatemala,1,1,0,0.5,0.5,1863,1687
2003-07-17,Mexico,Honduras,0,0,0,0.5,0.5,1897,1780
2003-07-19,Colombia,Brazil,0,2,2,0.0,1.0,1859,2015
2003-07-19,Costa Rica,El Salvador,5,2,3,1.0,0.0,1830,1655
2003-07-19,South Africa,Zimbabwe,0,1,1,0.0,1.0,1801,1712
2003-07-19,United States,Cuba,5,0,5,1.0,0.0,1909,1667
2003-07-20,Mexico,Jamaica,5,0,5,1.0,0.0,1902,1723
2003-07-23,United States,Brazil,1,2,1,0.0,1.0,1904,2021
2003-07-24,Mexico,Costa Rica,2,0,2,1.0,0.0,1909,1824
2003-07-24,Peru,Uruguay,3,4,1,0.0,1.0,1750,1843
2003-07-26,Nigeria,Venezuela,1,0,1,1.0,0.0,1838,1639
2003-07-26,United States,Costa Rica,3,2,1,1.0,0.0,1911,1818
2003-07-27,Zambia,Mozambique,4,2,2,1.0,0.0,1695,1548
2003-07-27,Mexico,Brazil,1,0,1,1.0,0.0,1920,2011
2003-07-29,Saint Kitts and Nevis,Haiti,1,0,1,1.0,0.0,1601,1635
2003-07-30,Uruguay,Peru,1,0,1,1.0,0.0,1849,1745
2003-07-31,Haiti,Trinidad and Tobago,2,0,2,1.0,0.0,1644,1668
2003-08-02,Saint Kitts and Nevis,Trinidad and Tobago,1,2,1,0.0,1.0,1595,1675
2003-08-04,Singapore,Hong Kong,4,1,3,1.0,0.0,1602,1557
2003-08-13,Iran,Iraq,0,1,1,0.0,1.0,1832,1780
2003-08-15,Iraq,Uruguay,2,5,3,0.0,1.0,1774,1856
2003-08-16,Malawi,Zambia,1,1,0,0.5,0.5,1594,1693
2003-08-16,Mayotte,Réunion,1,1,0,0.5,0.5,1497,1550
2003-08-19,Republic of Ireland,Australia,2,1,1,1.0,0.0,1893,1890
2003-08-19,Luxembourg,Malta,1,1,0,0.5,0.5,1350,1437
2003-08-20,Angola,DR Congo,0,2,2,0.0,1.0,1673,1699
2003-08-20,Argentina,Uruguay,3,2,1,1.0,0.0,2020,1852
2003-08-20,Austria,Costa Rica,2,0,2,1.0,0.0,1768,1809
2003-08-20,Belarus,Iran,2,1,1,1.0,0.0,1608,1820
2003-08-20,Belgium,Netherlands,1,1,0,0.5,0.5,1882,2012
2003-08-20,Bulgaria,Lithuania,3,0,3,1.0,0.0,1818,1541
2003-08-20,China PR,Chile,0,0,0,0.5,0.5,1796,1745
2003-08-20,Colombia,Slovakia,0,0,0,0.5,0.5,1856,1717
2003-08-20,Denmark,Finland,1,1,0,0.5,0.5,1936,1741
2003-08-20,Ecuador,Guatemala,2,0,2,1.0,0.0,1808,1682
2003-08-20,England,Croatia,3,1,2,1.0,0.0,1980,1853
2003-08-20,Estonia,Poland,1,2,1,0.0,1.0,1574,1797
2003-08-20,Faroe Islands,Iceland,1,2,1,0.0,1.0,1487,1685
2003-08-20,Germany,Italy,0,1,1,0.0,1.0,1952,1968
2003-08-20,Japan,Nigeria,3,0,3,1.0,0.0,1867,1831
2003-08-20,Latvia,Uzbekistan,0,3,3,0.0,1.0,1562,1662
2003-08-20,Liechtenstein,San Marino,2,2,0,0.5,0.5,1415,1382
2003-08-20,North Macedonia,Albania,3,1,2,1.0,0.0,1589,1549
2003-08-20,Mexico,Peru,1,3,2,0.0,1.0,1909,1757
2003-08-20,Norway,Scotland,0,0,0,0.5,0.5,1850,1773
2003-08-20,Panama,Paraguay,1,2,1,0.0,1.0,1602,1845
2003-08-20,Portugal,Kazakhstan,1,0,1,1.0,0.0,1945,1591
2003-08-20,Russia,Israel,1,2,1,0.0,1.0,1819,1742
2003-08-20,Serbia,Wales,1,0,1,1.0,0.0,1778,1723
2003-08-20,Slovenia,Hungary,2,1,1,1.0,0.0,1735,1710
2003-08-20,Sweden,Greece,1,2,1,0.0,1.0,1878,1830
2003-08-20,Switzerland,France,0,2,2,0.0,1.0,1783,2046
2003-08-20,Tunisia,Guinea,0,0,0,0.5,0.5,1813,1636
2003-08-20,Turkey,Moldova,2,0,2,1.0,0.0,1838,1521
2003-08-20,Ukraine,Romania,0,2,2,0.0,1.0,1710,1844
2003-08-20,Venezuela,Haiti,3,2,1,1.0,0.0,1648,1636
2003-08-22,Lebanon,Syria,1,0,1,1.0,0.0,1626,1617
2003-08-26,Jordan,Iraq,2,1,1,1.0,0.0,1685,1764
2003-08-27,Peru,Guatemala,0,0,0,0.5,0.5,1756,1684
2003-08-28,Seychelles,Madagascar,1,1,0,0.5,0.5,1429,1614
2003-08-30,Mauritius,Madagascar,3,1,2,1.0,0.0,1525,1604
2003-08-30,Réunion,Comoros,1,0,1,1.0,0.0,1556,1442
2003-08-31,Bolivia,Panama,3,0,3,1.0,0.0,1682,1596
2003-08-31,Haiti,China PR,4,3,1,1.0,0.0,1648,1785
2003-08-31,Zimbabwe,Eswatini,2,0,2,1.0,0.0,1716,1510
2003-09-02,Mauritius,Seychelles,0,0,0,0.5,0.5,1523,1432
2003-09-02,Comoros,Réunion,0,4,4,0.0,1.0,1437,1562
2003-09-04,Algeria,Qatar,1,0,1,1.0,0.0,1730,1745
2003-09-04,North Korea,Lebanon,0,1,1,0.0,1.0,1695,1636
2003-09-04,Singapore,Kuwait,1,3,2,0.0,1.0,1597,1737
2003-09-04,Mauritius,Comoros,5,0,5,1.0,0.0,1530,1431
2003-09-04,Réunion,Seychelles,1,0,1,1.0,0.0,1568,1427
2003-09-05,Iran,Jordan,4,1,3,1.0,0.0,1826,1680
2003-09-06,Andorra,Croatia,0,3,3,0.0,1.0,1399,1855
2003-09-06,Argentina,Chile,2,2,0,0.5,0.5,2015,1751
2003-09-06,Armenia,Greece,0,1,1,0.0,1.0,1539,1833
2003-09-06,Azerbaijan,Finland,1,2,1,0.0,1.0,1475,1744
2003-09-06,Belarus,Czech Republic,1,3,2,0.0,1.0,1606,1903
2003-09-06,Bosnia and Herzegovina,Norway,1,0,1,1.0,0.0,1646,1838
2003-09-06,Bulgaria,Estonia,2,0,2,1.0,0.0,1822,1571
2003-09-06,Ecuador,Venezuela,2,0,2,1.0,0.0,1813,1644
2003-09-06,France,Cyprus,5,0,5,1.0,0.0,2048,1593
2003-09-06,Georgia,Albania,3,0,3,1.0,0.0,1622,1543
2003-09-06,Iceland,Germany,0,0,0,0.5,0.5,1691,1947
2003-09-06,Republic of Ireland,Russia,1,1,0,0.5,0.5,1892,1821
2003-09-06,Italy,Wales,4,0,4,1.0,0.0,1972,1720
2003-09-06,Latvia,Poland,0,2,2,0.0,1.0,1559,1801
2003-09-06,Liechtenstein,Turkey,0,3,3,0.0,1.0,1414,1840
2003-09-06,North Macedonia,England,1,2,1,0.0,1.0,1588,1982
2003-09-06,Netherlands,Austria,3,1,2,1.0,0.0,2016,1765
2003-09-06,Peru,Paraguay,4,1,3,1.0,0.0,1767,1835
2003-09-06,Portugal,Spain,0,3,3,0.0,1.0,1938,1983
2003-09-06,Romania,Luxembourg,4,0,4,1.0,0.0,1845,1350
2003-09-06,Scotland,Faroe Islands,3,1,2,1.0,0.0,1776,1485
2003-09-06,Slovenia,Israel,3,1,2,1.0,0.0,1744,1734
2003-09-06,Eswatini,Botswana,0,3,3,0.0,1.0,1502,1499
2003-09-06,Sweden,San Marino,5,0,5,1.0,0.0,1879,1382
2003-09-06,Ukraine,Northern Ireland,0,0,0,0.5,0.5,1709,1651
2003-09-06,Seychelles,Comoros,2,0,2,1.0,0.0,1436,1423
2003-09-06,Mauritius,Réunion,2,1,1,1.0,0.0,1539,1560
2003-09-07,Angola,Namibia,2,0,2,1.0,0.0,1678,1489
2003-09-07,Australia,Jamaica,2,1,1,1.0,0.0,1895,1719
2003-09-07,Colombia,Brazil,1,2,1,0.0,1.0,1852,2016
2003-09-07,Costa Rica,China PR,2,0,2,1.0,0.0,1817,1778
2003-09-07,Uruguay,Bolivia,5,0,5,1.0,0.0,1857,1678
2003-09-09,Chile,Peru,2,1,1,1.0,0.0,1760,1759
2003-09-09,Republic of Ireland,Turkey,2,2,0,0.5,0.5,1891,1842
2003-09-09,Venezuela,Argentina,0,3,3,0.0,1.0,1643,2017
2003-09-10,Albania,Georgia,3,1,2,1.0,0.0,1553,1613
2003-09-10,Andorra,Bulgaria,0,3,3,0.0,1.0,1398,1824
2003-09-10,Belgium,Croatia,2,1,1,1.0,0.0,1890,1848
2003-09-10,Bolivia,Colombia,4,0,4,1.0,0.0,1690,1841
2003-09-10,Brazil,Ecuador,1,0,1,1.0,0.0,2020,1810
2003-09-10,Czech Republic,Netherlands,3,1,2,1.0,0.0,1914,2006
2003-09-10,Denmark,Romania,2,2,0,0.5,0.5,1934,1848
2003-09-10,England,Liechtenstein,2,0,2,1.0,0.0,1983,1414
2003-09-10,Faroe Islands,Lithuania,1,3,2,0.0,1.0,1479,1548
2003-09-10,Germany,Scotland,2,1,1,1.0,0.0,1952,1772
2003-09-10,Israel,Malta,2,2,0,0.5,0.5,1729,1443
2003-09-10,Japan,Senegal,0,1,1,0.0,1.0,1858,1799
2003-09-10,Latvia,Hungary,3,1,2,1.0,0.0,1571,1699
2003-09-10,Luxembourg,Bosnia and Herzegovina,0,1,1,0.0,1.0,1348,1649
2003-09-10,Moldova,Belarus,2,1,1,1.0,0.0,1531,1597
2003-09-10,Morocco,Trinidad and Tobago,2,0,2,1.0,0.0,1826,1671
2003-09-10,Northern Ireland,Armenia,0,1,1,0.0,1.0,1641,1550
2003-09-10,Norway,Portugal,0,1,1,0.0,1.0,1833,1944
2003-09-10,Oman,Bahrain,1,0,1,1.0,0.0,1661,1652
2003-09-10,Paraguay,Uruguay,4,1,3,1.0,0.0,1844,1849
2003-09-10,Poland,Sweden,0,2,2,0.0,1.0,1795,1886
2003-09-10,Russia,Switzerland,4,1,3,1.0,0.0,1829,1776
2003-09-10,Serbia,Italy,1,1,0,0.5,0.5,1783,1968
2003-09-10,Slovakia,North Macedonia,1,1,0,0.5,0.5,1715,1591
2003-09-10,Slovenia,France,0,2,2,0.0,1.0,1742,2051
2003-09-10,Spain,Ukraine,2,1,1,1.0,0.0,1986,1707
2003-09-10,Tunisia,Ivory Coast,3,2,1,1.0,0.0,1821,1786
2003-09-10,Wales,Finland,1,1,0,0.5,0.5,1721,1744
2003-09-14,Kuwait,Qatar,2,1,1,1.0,0.0,1746,1737
2003-09-14,Rwanda,Kenya,0,1,1,0.0,1.0,1619,1692
2003-09-16,Singapore,Oman,1,3,2,0.0,1.0,1591,1668
2003-09-17,Yemen,Sudan,3,2,1,1.0,0.0,1484,1586
2003-09-19,Bahrain,Lebanon,4,3,1,1.0,0.0,1660,1629
2003-09-19,Jordan,Syria,0,0,0,0.5,0.5,1679,1619
2003-09-19,Yemen,Sudan,1,2,1,0.0,1.0,1479,1592
2003-09-20,Namibia,Angola,1,3,2,0.0,1.0,1485,1683
2003-09-20,Qatar,Kuwait,2,2,0,0.5,0.5,1738,1746
2003-09-24,Algeria,Gabon,2,2,0,0.5,0.5,1729,1662
2003-09-24,Benin,Burkina Faso,0,1,1,0.0,1.0,1519,1645
2003-09-24,Qatar,Palestine,1,1,0,0.5,0.5,1734,1492
2003-09-25,South Korea,Vietnam,5,0,5,1.0,0.0,1868,1579
2003-09-25,Nepal,Oman,0,7,7,0.0,1.0,1367,1671
2003-09-26,Algeria,Burkina Faso,0,0,0,0.5,0.5,1728,1647
2003-09-26,Benin,Gabon,0,4,4,0.0,1.0,1515,1667
2003-09-26,Jordan,Iran,3,2,1,1.0,0.0,1691,1815
2003-09-26,Malaysia,Indonesia,1,1,0,0.5,0.5,1577,1640
2003-09-27,South Korea,Oman,1,0,1,1.0,0.0,1872,1668
2003-09-27,Kuwait,Singapore,4,0,4,1.0,0.0,1751,1587
2003-09-27,Malawi,Zimbabwe,1,2,1,0.0,1.0,1589,1722
2003-09-27,Qatar,Palestine,2,1,1,1.0,0.0,1738,1489
2003-09-27,Syria,Yemen,8,2,6,1.0,0.0,1624,1475
2003-09-27,Vietnam,Nepal,5,0,5,1.0,0.0,1583,1364
2003-09-29,South Korea,Nepal,16,0,16,1.0,0.0,1873,1364
2003-09-29,Vietnam,Oman,0,6,6,0.0,1.0,1577,1675
2003-09-30,Saudi Arabia,Syria,1,1,0,0.5,0.5,1836,1629
2003-10-04,Lesotho,Eswatini,5,2,3,1.0,0.0,1488,1494
2003-10-05,Kuwait,Palestine,2,1,1,1.0,0.0,1754,1487
2003-10-05,Zimbabwe,Malawi,2,0,2,1.0,0.0,1728,1584
2003-10-06,Indonesia,Bhutan,2,0,2,1.0,0.0,1643,1380
2003-10-06,Saudi Arabia,Yemen,7,0,7,1.0,0.0,1838,1474
2003-10-08,Iraq,Bahrain,5,1,4,1.0,0.0,1770,1655
2003-10-08,Kuwait,Palestine,4,0,4,1.0,0.0,1757,1485
2003-10-08,Lesotho,South Africa,0,3,3,0.0,1.0,1486,1804
2003-10-08,Malaysia,Myanmar,4,0,4,1.0,0.0,1585,1544
2003-10-08,Oman,Jordan,2,1,1,1.0,0.0,1684,1683
2003-10-08,Saudi Arabia,Bhutan,6,0,6,1.0,0.0,1840,1379
2003-10-08,Tunisia,Japan,0,1,1,0.0,1.0,1814,1866
2003-10-08,Yemen,Indonesia,0,3,3,0.0,1.0,1470,1648
2003-10-10,Bhutan,Yemen,0,8,8,0.0,1.0,1374,1476
2003-10-10,Myanmar,Bahrain,1,3,2,0.0,1.0,1539,1661
2003-10-10,Egypt,Senegal,1,0,1,1.0,0.0,1810,1792
2003-10-10,Guinea-Bissau,Mali,1,2,1,0.0,1.0,1501,1718
2003-10-10,Malaysia,Iraq,0,0,0,0.5,0.5,1589,1767
2003-10-10,Saudi Arabia,Indonesia,5,0,5,1.0,0.0,1844,1645
2003-10-11,Armenia,Spain,0,4,4,0.0,1.0,1549,1988
2003-10-11,Austria,Czech Republic,2,3,1,0.0,1.0,1761,1919
2003-10-11,Belgium,Estonia,2,0,2,1.0,0.0,1893,1569
2003-10-11,Bolivia,Honduras,1,0,1,1.0,0.0,1701,1770
2003-10-11,Bosnia and Herzegovina,Denmark,1,1,0,0.5,0.5,1655,1929
2003-10-11,Botswana,Lesotho,4,1,3,1.0,0.0,1507,1479
2003-10-11,Croatia,Bulgaria,1,0,1,1.0,0.0,1856,1817
2003-10-11,Cyprus,Slovenia,2,2,0,0.5,0.5,1597,1739
2003-10-11,Equatorial Guinea,Togo,1,0,1,1.0,0.0,1436,1631
2003-10-11,Finland,Canada,3,2,1,1.0,0.0,1752,1731
2003-10-11,France,Israel,3,0,3,1.0,0.0,2054,1727
2003-10-11,Germany,Iceland,3,0,3,1.0,0.0,1955,1689
2003-10-11,Greece,Northern Ireland,1,0,1,1.0,0.0,1837,1638
2003-10-11,Hungary,Poland,1,2,1,0.0,1.0,1694,1801
2003-10-11,Italy,Azerbaijan,4,0,4,1.0,0.0,1969,1475
2003-10-11,Liechtenstein,Slovakia,0,2,2,0.0,1.0,1412,1718
2003-10-11,Madagascar,Benin,1,1,0,0.5,0.5,1602,1518
2003-10-11,Netherlands,Moldova,5,0,5,1.0,0.0,2007,1531
2003-10-11,Niger,Algeria,0,1,1,0.0,1.0,1545,1733
2003-10-11,Norway,Luxembourg,1,0,1,1.0,0.0,1834,1348
2003-10-11,Portugal,Albania,5,3,2,1.0,0.0,1946,1552
2003-10-11,Romania,Japan,1,1,0,0.5,0.5,1849,1866
2003-10-11,Russia,Georgia,3,1,2,1.0,0.0,1833,1610
2003-10-11,São Tomé and Príncipe,Libya,0,1,1,0.0,1.0,1454,1610
2003-10-11,Scotland,Lithuania,1,0,1,1.0,0.0,1776,1545
2003-10-11,Seychelles,Zambia,0,4,4,0.0,1.0,1434,1696
2003-10-11,South Africa,Costa Rica,2,1,1,1.0,0.0,1813,1809
2003-10-11,Sweden,Latvia,0,1,1,0.0,1.0,1873,1585
2003-10-11,Switzerland,Republic of Ireland,2,0,2,1.0,0.0,1787,1881
2003-10-11,Tanzania,Kenya,0,0,0,0.5,0.5,1514,1689
2003-10-11,Tunisia,Morocco,0,0,0,0.5,0.5,1815,1826
2003-10-11,Turkey,England,0,0,0,0.5,0.5,1846,1980
2003-10-11,Uganda,Mauritius,3,0,3,1.0,0.0,1648,1534
2003-10-11,Ukraine,North Macedonia,0,0,0,0.5,0.5,1705,1594
2003-10-11,United Arab Emirates,Uzbekistan,2,2,0,0.5,0.5,1695,1663
2003-10-11,Wales,Serbia,2,3,1,0.0,1.0,1715,1790
2003-10-11,Kernow,Jersey,1,0,1,1.0,0.0,1526,1715
2003-10-11,Sudan,Eritrea,3,0,3,1.0,0.0,1598,1477
2003-10-12,Brazil,Jamaica,1,0,1,1.0,0.0,2023,1717
2003-10-12,Burundi,Gabon,0,0,0,0.5,0.5,1542,1665
2003-10-12,Chad,Angola,3,1,2,1.0,0.0,1519,1672
2003-10-12,Congo,Sierra Leone,1,0,1,1.0,0.0,1614,1598
2003-10-12,Ethiopia,Malawi,1,3,2,0.0,1.0,1566,1592
2003-10-12,Gambia,Liberia,2,0,2,1.0,0.0,1557,1594
2003-10-12,Guinea,Mozambique,1,0,1,1.0,0.0,1643,1542
2003-10-12,Iran,New Zealand,3,0,3,1.0,0.0,1821,1693
2003-10-12,Iraq,Myanmar,3,0,3,1.0,0.0,1771,1536
2003-10-12,Malaysia,Bahrain,2,2,0,0.5,0.5,1591,1660
2003-10-12,Rwanda,Namibia,3,0,3,1.0,0.0,1625,1480
2003-10-12,Eswatini,Cape Verde,1,1,0,0.5,0.5,1496,1537
2003-10-12,Zimbabwe,Mauritania,3,0,3,1.0,0.0,1731,1408
2003-10-13,Bhutan,Indonesia,0,2,2,0.0,1.0,1372,1648
2003-10-13,Saudi Arabia,Yemen,3,1,2,1.0,0.0,1846,1475
2003-10-15,Indonesia,Yemen,2,2,0,0.5,0.5,1645,1479
2003-10-15,Mexico,Uruguay,0,2,2,0.0,1.0,1900,1859
2003-10-15,Saudi Arabia,Bhutan,4,0,4,1.0,0.0,1847,1372
2003-10-15,Syria,Sri Lanka,5,0,5,1.0,0.0,1633,1429
2003-10-16,Thailand,India,2,0,2,1.0,0.0,1751,1513
2003-10-17,Jordan,Lebanon,1,0,1,1.0,0.0,1690,1623
2003-10-17,Saudi Arabia,Indonesia,6,0,6,1.0,0.0,1851,1642
2003-10-17,Yemen,Bhutan,4,0,4,1.0,0.0,1485,1367
2003-10-18,Syria,Sri Lanka,8,0,8,1.0,0.0,1637,1426
2003-10-19,Oman,Nepal,6,0,6,1.0,0.0,1687,1362
2003-10-19,Singapore,Palestine,2,0,2,1.0,0.0,1593,1480
2003-10-19,Turkmenistan,United Arab Emirates,1,0,1,1.0,0.0,1591,1685
2003-10-19,Vietnam,South Korea,1,0,1,1.0,0.0,1591,1860
2003-10-20,Bahrain,Myanmar,4,0,4,1.0,0.0,1666,1531
2003-10-20,Iraq,Malaysia,5,1,4,1.0,0.0,1776,1587
2003-10-21,Nepal,Vietnam,0,2,2,0.0,1.0,1359,1595
2003-10-21,Oman,South Korea,3,1,2,1.0,0.0,1699,1849
2003-10-22,Bahrain,Malaysia,3,1,2,1.0,0.0,1673,1581
2003-10-22,Myanmar,Iraq,1,3,2,0.0,1.0,1528,1780
2003-10-22,India,Rwanda,3,1,2,1.0,0.0,1524,1615
2003-10-22,Singapore,Palestine,0,0,0,0.5,0.5,1591,1483
2003-10-23,Burkina Faso,Zimbabwe,1,4,3,0.0,1.0,1641,1738
2003-10-24,Bahrain,Iraq,1,0,1,1.0,0.0,1684,1770
2003-10-24,Myanmar,Malaysia,2,1,1,1.0,0.0,1538,1572
2003-10-24,Nepal,South Korea,0,7,7,0.0,1.0,1359,1850
2003-10-24,Oman,Vietnam,2,0,2,1.0,0.0,1705,1590
2003-10-27,North Korea,Iran,1,3,2,0.0,1.0,1690,1827
2003-10-29,India,Zimbabwe,5,3,2,1.0,0.0,1537,1726
2003-10-30,United Arab Emirates,Turkmenistan,1,1,0,0.5,0.5,1683,1594
2003-10-31,Rwanda,Zimbabwe,2,2,0,0.5,0.5,1618,1724
2003-11-03,Lebanon,North Korea,1,1,0,0.5,0.5,1625,1689
2003-11-06,Thailand,Tajikistan,0,1,1,0.0,1.0,1739,1553
2003-11-06,Uzbekistan,Hong Kong,4,1,3,1.0,0.0,1669,1552
2003-11-07,Syria,United Arab Emirates,1,3,2,0.0,1.0,1631,1690
2003-11-08,Gabon,Burkina Faso,0,0,0,0.5,0.5,1665,1642
2003-11-08,Hong Kong,Tajikistan,0,0,0,0.5,0.5,1553,1553
2003-11-08,Uzbekistan,Thailand,3,0,3,1.0,0.0,1679,1730
2003-11-09,Mozambique,Eswatini,2,0,2,1.0,0.0,1549,1490
2003-11-09,Turkmenistan,Sri Lanka,1,0,1,1.0,0.0,1599,1422
2003-11-10,Hong Kong,Thailand,2,1,1,1.0,0.0,1565,1719
2003-11-10,Uzbekistan,Tajikistan,0,0,0,0.5,0.5,1677,1556
2003-11-11,Uganda,Tanzania,2,1,1,1.0,0.0,1654,1509
2003-11-12,Equatorial Guinea,São Tomé and Príncipe,3,1,2,1.0,0.0,1445,1446
2003-11-12,Iran,North Korea,3,0,3,1.0,0.0,1832,1685
2003-11-12,Lebanon,Jordan,0,2,2,0.0,1.0,1619,1697
2003-11-12,Poland,Italy,3,1,2,1.0,0.0,1813,1958
2003-11-12,Turkmenistan,Sri Lanka,3,0,3,1.0,0.0,1604,1418
2003-11-14,Algeria,Niger,6,0,6,1.0,0.0,1738,1541
2003-11-14,Mali,Guinea-Bissau,2,0,2,1.0,0.0,1722,1498
2003-11-14,Mauritania,Zimbabwe,2,1,1,1.0,0.0,1422,1711
2003-11-14,United Arab Emirates,Syria,3,1,2,1.0,0.0,1697,1625
2003-11-15,Albania,Estonia,2,0,2,1.0,0.0,1561,1561
2003-11-15,Argentina,Bolivia,3,0,3,1.0,0.0,2020,1699
2003-11-15,Colombia,Venezuela,0,1,1,0.0,1.0,1829,1656
2003-11-15,Croatia,Slovenia,1,1,0,0.5,0.5,1854,1742
2003-11-15,Czech Republic,Canada,5,1,4,1.0,0.0,1924,1727
2003-11-15,Egypt,South Africa,2,1,1,1.0,0.0,1819,1805
2003-11-15,Gabon,Burundi,4,1,3,1.0,0.0,1671,1537
2003-11-15,Germany,France,0,3,3,0.0,1.0,1950,2060
2003-11-15,Kenya,Tanzania,3,0,3,1.0,0.0,1694,1505
2003-11-15,Latvia,Turkey,1,0,1,1.0,0.0,1599,1833
2003-11-15,Malawi,Ethiopia,0,0,0,0.5,0.5,1592,1567
2003-11-15,Morocco,Burkina Faso,1,0,1,1.0,0.0,1831,1638
2003-11-15,Namibia,Rwanda,1,1,0,0.5,0.5,1484,1615
2003-11-15,Paraguay,Ecuador,2,1,1,1.0,0.0,1852,1803
2003-11-15,Portugal,Greece,1,1,0,0.5,0.5,1944,1840
2003-11-15,Russia,Wales,0,0,0,0.5,0.5,1831,1718
2003-11-15,Scotland,Netherlands,1,0,1,1.0,0.0,1789,1995
2003-11-15,Senegal,Ivory Coast,1,0,1,1.0,0.0,1800,1779
2003-11-15,Spain,Norway,2,1,1,1.0,0.0,1993,1830
2003-11-15,Uruguay,Chile,2,1,1,1.0,0.0,1865,1755
2003-11-15,Zambia,Seychelles,1,1,0,0.5,0.5,1691,1440
2003-11-16,Angola,Chad,2,0,2,1.0,0.0,1677,1515
2003-11-16,Benin,Madagascar,3,2,1,1.0,0.0,1528,1593
2003-11-16,Cape Verde,Eswatini,3,0,3,1.0,0.0,1544,1484
2003-11-16,England,Denmark,2,3,1,0.0,1.0,1971,1939
2003-11-16,Eritrea,Sudan,0,0,0,0.5,0.5,1480,1596
2003-11-16,Ghana,Somalia,5,0,5,1.0,0.0,1666,1401
2003-11-16,Honduras,Finland,1,2,1,0.0,1.0,1762,1761
2003-11-16,Italy,Romania,1,0,1,1.0,0.0,1964,1844
2003-11-16,Jamaica,El Salvador,3,0,3,1.0,0.0,1724,1649
2003-11-16,Lesotho,Botswana,0,0,0,0.5,0.5,1480,1507
2003-11-16,Liberia,Gambia,3,0,3,1.0,0.0,1602,1550
2003-11-16,Libya,São Tomé and Príncipe,8,0,8,1.0,0.0,1615,1442
2003-11-16,Mauritius,Uganda,3,1,2,1.0,0.0,1545,1644
2003-11-16,Mozambique,Guinea,3,4,1,0.0,1.0,1544,1649
2003-11-16,Peru,Brazil,1,1,0,0.5,0.5,1765,2018
2003-11-16,Poland,Serbia,4,3,1,1.0,0.0,1821,1783
2003-11-16,Sierra Leone,Congo,1,1,0,0.5,0.5,1599,1614
2003-11-16,Togo,Equatorial Guinea,2,0,2,1.0,0.0,1636,1441
2003-11-17,Tajikistan,Uzbekistan,1,4,3,0.0,1.0,1551,1683
2003-11-17,Thailand,Hong Kong,4,0,4,1.0,0.0,1724,1561
2003-11-18,Chile,Paraguay,0,1,1,0.0,1.0,1750,1858
2003-11-18,Egypt,Sweden,1,0,1,1.0,0.0,1829,1864
2003-11-18,Republic of Ireland,Canada,3,0,3,1.0,0.0,1886,1723
2003-11-18,Jordan,North Korea,3,0,3,1.0,0.0,1705,1678
2003-11-18,South Korea,Bulgaria,0,1,1,0.0,1.0,1842,1826
2003-11-18,United Arab Emirates,Sri Lanka,3,1,2,1.0,0.0,1700,1416
2003-11-18,Venezuela,Bolivia,2,1,1,1.0,0.0,1665,1691
2003-11-19,Brazil,Uruguay,3,3,0,0.5,0.5,2015,1869
2003-11-19,Colombia,Argentina,1,1,0,0.5,0.5,1834,2016
2003-11-19,Costa Rica,Finland,2,1,1,1.0,0.0,1816,1755
2003-11-19,Ecuador,Peru,0,0,0,0.5,0.5,1803,1766
2003-11-19,Ghana,Somalia,2,0,2,1.0,0.0,1669,1399
2003-11-19,Hong Kong,Uzbekistan,0,1,1,0.0,1.0,1556,1689
2003-11-19,Hungary,Estonia,0,1,1,0.0,1.0,1684,1572
2003-11-19,Japan,Cameroon,0,0,0,0.5,0.5,1866,1862
2003-11-19,Lebanon,Iran,0,3,3,0.0,1.0,1616,1836
2003-11-19,Mexico,Iceland,0,0,0,0.5,0.5,1896,1694
2003-11-19,Morocco,Mali,0,1,1,0.0,1.0,1821,1733
2003-11-19,Netherlands,Scotland,6,0,6,1.0,0.0,1999,1786
2003-11-19,Norway,Spain,0,3,3,0.0,1.0,1826,1998
2003-11-19,Portugal,Kuwait,8,0,8,1.0,0.0,1949,1753
2003-11-19,Qatar,Singapore,2,0,2,1.0,0.0,1743,1587
2003-11-19,Slovenia,Croatia,0,1,1,0.0,1.0,1737,1860
2003-11-19,Thailand,Tajikistan,1,0,1,1.0,0.0,1729,1547
2003-11-19,Trinidad and Tobago,Cuba,2,1,1,1.0,0.0,1679,1660
2003-11-19,Tunisia,South Africa,2,0,2,1.0,0.0,1823,1798
2003-11-19,Turkey,Latvia,2,2,0,0.5,0.5,1829,1604
2003-11-19,Turkmenistan,Afghanistan,11,0,11,1.0,0.0,1608,1392
2003-11-19,Wales,Russia,0,1,1,0.0,1.0,1713,1837
2003-11-20,Luxembourg,Moldova,1,2,1,0.0,1.0,1344,1536
2003-11-21,Tajikistan,Hong Kong,1,0,1,1.0,0.0,1556,1548
2003-11-21,Thailand,Uzbekistan,4,1,3,1.0,0.0,1737,1682
2003-11-22,United Arab Emirates,Sri Lanka,3,0,3,1.0,0.0,1703,1414
2003-11-23,Afghanistan,Turkmenistan,0,2,2,0.0,1.0,1389,1612
2003-11-23,Taiwan,Macau,3,0,3,1.0,0.0,1419,1375
2003-11-26,Bangladesh,Tajikistan,0,2,2,0.0,1.0,1471,1563
2003-11-28,Iran,Lebanon,1,0,1,1.0,0.0,1840,1613
2003-11-28,Syria,Turkmenistan,1,1,0,0.5,0.5,1625,1613
2003-11-29,Laos,Sri Lanka,0,0,0,0.5,0.5,1393,1414
2003-11-29,Macau,Taiwan,1,3,2,0.0,1.0,1369,1426
2003-11-29,Mongolia,Maldives,0,1,1,0.0,1.0,1423,1396
2003-11-29,Pakistan,Kyrgyzstan,0,2,2,0.0,1.0,1367,1443
2003-11-29,Singapore,Qatar,0,2,2,0.0,1.0,1583,1748
2003-11-30,Sudan,Zanzibar,4,0,4,1.0,0.0,1601,1406
2003-11-30,Tajikistan,Bangladesh,2,0,2,1.0,0.0,1569,1466
2003-11-30,Uganda,Eritrea,2,1,1,1.0,0.0,1649,1476
2003-12-02,Kenya,Eritrea,3,2,1,1.0,0.0,1698,1473
2003-12-02,Rwanda,Zanzibar,2,2,0,0.5,0.5,1611,1411
2003-12-03,Kyrgyzstan,Pakistan,4,0,4,1.0,0.0,1450,1361
2003-12-03,Maldives,Mongolia,12,0,12,1.0,0.0,1405,1415
2003-12-03,Sri Lanka,Laos,3,0,3,1.0,0.0,1422,1386
2003-12-04,Hong Kong,South Korea,1,3,2,0.0,1.0,1546,1845
2003-12-04,Japan,China PR,2,0,2,1.0,0.0,1873,1772
2003-12-04,Sudan,Rwanda,3,0,3,1.0,0.0,1610,1603
2003-12-04,Uganda,Kenya,1,1,0,0.5,0.5,1651,1697
2003-12-07,South Korea,China PR,1,0,1,1.0,0.0,1852,1766
2003-12-08,Kenya,Rwanda,1,1,0,0.5,0.5,1695,1606
2003-12-08,Sudan,Uganda,0,0,0,0.5,0.5,1611,1651
2003-12-10,China PR,Hong Kong,3,1,2,1.0,0.0,1770,1543
2003-12-10,Japan,South Korea,0,0,0,0.5,0.5,1873,1853
2003-12-10,Sudan,Kenya,1,2,1,0.0,1.0,1605,1702
2003-12-10,Uganda,Rwanda,2,0,2,1.0,0.0,1658,1600
2003-12-11,Malta,Poland,0,4,4,0.0,1.0,1442,1823
2003-12-12,Bahrain,Iraq,2,2,0,0.5,0.5,1686,1769
2003-12-12,Kenya,Egypt,0,1,1,0.0,1.0,1697,1835
2003-12-13,Botswana,Zimbabwe,0,2,2,0.0,1.0,1504,1715
2003-12-14,Lithuania,Poland,1,3,2,0.0,1.0,1543,1826
2003-12-14,United Arab Emirates,Azerbaijan,3,3,0,0.5,0.5,1699,1480
2003-12-15,Bahrain,Egypt,0,1,1,0.0,1.0,1682,1840
2003-12-15,Iraq,Kenya,2,0,2,1.0,0.0,1776,1691
2003-12-16,Kuwait,Lebanon,2,0,2,1.0,0.0,1758,1609
2003-12-17,Saudi Arabia,Estonia,1,1,0,0.5,0.5,1846,1578
2003-12-18,Bahrain,Kenya,2,1,1,1.0,0.0,1691,1683
2003-12-18,Egypt,Iraq,2,0,2,1.0,0.0,1847,1770
2003-12-18,Kuwait,Lebanon,0,0,0,0.5,0.5,1755,1613
2003-12-20,Latvia,Kuwait,0,2,2,0.0,1.0,1600,1760
2003-12-20,Oman,Estonia,3,1,2,1.0,0.0,1711,1573
2003-12-20,Saudi Arabia,Azerbaijan,1,0,1,1.0,0.0,1848,1479
2003-12-21,Qatar,Iraq,0,0,0,0.5,0.5,1749,1770
2003-12-21,United Arab Emirates,Kenya,2,2,0,0.5,0.5,1699,1684
2003-12-26,Bermuda,Barbados,1,2,1,0.0,1.0,1524,1597
2003-12-26,Kuwait,Oman,0,0,0,0.5,0.5,1759,1713
2003-12-26,United Arab Emirates,Saudi Arabia,0,2,2,0.0,1.0,1695,1853
2003-12-27,Bahamas,Haiti,0,6,6,0.0,1.0,1470,1653
2003-12-27,Bahrain,Qatar,0,0,0,0.5,0.5,1693,1748
2003-12-27,Basque Country,Uruguay,2,1,1,1.0,0.0,1707,1858
2003-12-27,Andalusia,Latvia,1,0,1,1.0,0.0,1568,1592
2003-12-28,Yemen,Oman,1,1,0,0.5,0.5,1490,1709
2003-12-28,Catalonia,Ecuador,4,2,2,1.0,0.0,1587,1791
2003-12-29,Kuwait,United Arab Emirates,0,2,2,0.0,1.0,1750,1705
2003-12-29,Saudi Arabia,Qatar,0,0,0,0.5,0.5,1851,1751
2003-12-30,Bahrain,Yemen,5,1,4,1.0,0.0,1697,1487
2003-12-31,Oman,United Arab Emirates,2,0,2,1.0,0.0,1717,1698
2004-01-01,Bahrain,Saudi Arabia,0,1,1,0.0,1.0,1693,1856
2004-01-01,Bermuda,Barbados,0,4,4,0.0,1.0,1518,1604
2004-01-01,Kuwait,Yemen,4,0,4,1.0,0.0,1753,1485
2004-01-03,Oman,Bahrain,0,1,1,0.0,1.0,1709,1702
2004-01-03,United Arab Emirates,Qatar,0,0,0,0.5,0.5,1700,1750
2004-01-04,Kuwait,Saudi Arabia,1,1,0,0.5,0.5,1756,1854
2004-01-05,Qatar,Yemen,3,0,3,1.0,0.0,1753,1483
2004-01-06,Oman,Saudi Arabia,1,2,1,0.0,1.0,1705,1859
2004-01-07,United Arab Emirates,Bahrain,1,3,2,0.0,1.0,1693,1710
2004-01-08,Cuba,Martinique,0,0,0,0.5,0.5,1661,1680
2004-01-08,Egypt,Rwanda,5,1,4,1.0,0.0,1851,1597
2004-01-08,Kuwait,Qatar,1,2,1,0.0,1.0,1748,1762
2004-01-08,Yemen,Saudi Arabia,0,2,2,0.0,1.0,1482,1861
2004-01-10,Kuwait,Bahrain,0,4,4,0.0,1.0,1740,1719
2004-01-10,Mauritius,South Africa,2,0,2,1.0,0.0,1558,1786
2004-01-10,Suriname,Curaçao,1,1,0,0.5,0.5,1585,1523
2004-01-11,Barbados,Grenada,2,0,2,1.0,0.0,1611,1553
2004-01-11,Oman,Qatar,2,0,2,1.0,0.0,1715,1753
2004-01-11,Yemen,United Arab Emirates,0,3,3,0.0,1.0,1479,1697
2004-01-14,Egypt,DR Congo,2,2,0,0.5,0.5,1848,1703
2004-01-14,Tunisia,Benin,2,0,2,1.0,0.0,1826,1526
2004-01-15,Algeria,Mali,0,2,2,0.0,1.0,1730,1742
2004-01-16,Libya,Kenya,2,0,2,1.0,0.0,1625,1675
2004-01-17,Curaçao,Suriname,2,0,2,1.0,0.0,1533,1576
2004-01-17,Egypt,Burkina Faso,1,1,0,0.5,0.5,1844,1643
2004-01-17,Tunisia,Benin,2,1,1,1.0,0.0,1829,1524
2004-01-18,Barbados,Canada,0,1,1,0.0,1.0,1606,1729
2004-01-18,Guadeloupe,Saint Lucia,2,0,2,1.0,0.0,1566,1547
2004-01-18,Senegal,South Africa,2,1,1,1.0,0.0,1808,1779
2004-01-19,Libya,Kenya,2,0,2,1.0,0.0,1635,1666
2004-01-20,Guinea,Burkina Faso,1,0,1,1.0,0.0,1657,1636
2004-01-22,Sweden,Norway,0,3,3,0.0,1.0,1856,1835
2004-01-24,Tunisia,Rwanda,2,1,1,1.0,0.0,1833,1594
2004-01-25,Cameroon,Algeria,1,1,0,0.5,0.5,1860,1733
2004-01-25,DR Congo,Guinea,1,2,1,0.0,1.0,1694,1667
2004-01-25,Norway,Honduras,3,1,2,1.0,0.0,1842,1756
2004-01-25,Zimbabwe,Egypt,1,2,1,0.0,1.0,1710,1850
2004-01-26,Kenya,Mali,1,3,2,0.0,1.0,1660,1749
2004-01-26,Senegal,Burkina Faso,0,0,0,0.5,0.5,1805,1640
2004-01-27,China PR,North Macedonia,0,0,0,0.5,0.5,1767,1598
2004-01-27,Nigeria,Morocco,0,1,1,0.0,1.0,1823,1830
2004-01-27,South Africa,Benin,2,0,2,1.0,0.0,1782,1522
2004-01-28,British Virgin Islands,Dominica,0,1,1,0.0,1.0,1415,1440
2004-01-28,Curaçao,Aruba,6,1,5,1.0,0.0,1539,1405
2004-01-28,El Salvador,Panama,1,1,0,0.5,0.5,1648,1598
2004-01-28,Rwanda,Guinea,1,1,0,0.5,0.5,1596,1666
2004-01-28,Singapore,Norway,2,5,3,0.0,1.0,1581,1845
2004-01-28,Tunisia,DR Congo,3,0,3,1.0,0.0,1838,1690
2004-01-29,Algeria,Egypt,2,1,1,1.0,0.0,1744,1840
2004-01-29,Cameroon,Zimbabwe,5,3,2,1.0,0.0,1865,1706
2004-01-29,China PR,North Macedonia,1,0,1,1.0,0.0,1772,1594
2004-01-30,British Virgin Islands,United States Virgin Islands,5,0,5,1.0,0.0,1424,1434
2004-01-30,Burkina Faso,Mali,1,3,2,0.0,1.0,1635,1755
2004-01-30,Senegal,Kenya,3,0,3,1.0,0.0,1810,1656
2004-01-31,Dominica,United States Virgin Islands,5,0,5,1.0,0.0,1448,1427
2004-01-31,Grenada,Barbados,0,1,1,0.0,1.0,1547,1613
2004-01-31,Haiti,Nicaragua,1,1,0,0.5,0.5,1648,1326
2004-01-31,Morocco,Benin,4,0,4,1.0,0.0,1833,1520
2004-01-31,Nigeria,South Africa,4,0,4,1.0,0.0,1831,1775
2004-02-01,British Virgin Islands,Dominica,1,2,1,0.0,1.0,1417,1456
2004-02-01,Rwanda,DR Congo,1,0,1,1.0,0.0,1607,1680
2004-02-01,Tunisia,Guinea,1,1,0,0.5,0.5,1835,1670
2004-02-02,Burkina Faso,Kenya,0,3,3,0.0,1.0,1628,1664
2004-02-02,Senegal,Mali,1,1,0,0.5,0.5,1809,1757
2004-02-03,Algeria,Zimbabwe,1,2,1,0.0,1.0,1736,1715
2004-02-03,Cameroon,Egypt,0,0,0,0.5,0.5,1865,1841
2004-02-03,China PR,Finland,2,1,1,1.0,0.0,1780,1748
2004-02-04,Morocco,South Africa,1,1,0,0.5,0.5,1832,1777
2004-02-04,Nigeria,Benin,2,1,1,1.0,0.0,1834,1518
2004-02-07,China PR,Finland,2,1,1,1.0,0.0,1788,1741
2004-02-07,Japan,Malaysia,4,0,4,1.0,0.0,1876,1570
2004-02-07,Mali,Guinea,2,1,1,1.0,0.0,1764,1664
2004-02-07,Tunisia,Senegal,1,0,1,1.0,0.0,1843,1802
2004-02-08,Cameroon,Nigeria,1,2,1,0.0,1.0,1857,1843
2004-02-08,Lebanon,Bahrain,2,1,1,1.0,0.0,1624,1709
2004-02-08,Morocco,Algeria,3,1,2,1.0,0.0,1838,1731
2004-02-08,Saint Lucia,Saint Vincent and the Grenadines,1,2,1,0.0,1.0,1540,1573
2004-02-10,Bermuda,Trinidad and Tobago,0,1,1,0.0,1.0,1514,1684
2004-02-11,Morocco,Mali,4,0,4,1.0,0.0,1845,1758
2004-02-11,Tunisia,Nigeria,1,1,0,0.5,0.5,1843,1843
2004-02-12,Bermuda,Trinidad and Tobago,2,2,0,0.5,0.5,1518,1681
2004-02-12,Japan,Iraq,2,0,2,1.0,0.0,1882,1765
2004-02-12,Jordan,Indonesia,2,1,1,1.0,0.0,1712,1636
2004-02-13,Nigeria,Mali,2,1,1,1.0,0.0,1850,1752
2004-02-13,Qatar,Bahrain,2,0,2,1.0,0.0,1760,1703
2004-02-14,Belarus,Estonia,1,2,1,0.0,1.0,1589,1582
2004-02-14,South Korea,Oman,5,0,5,1.0,0.0,1858,1711
2004-02-14,Malta,Moldova,0,0,0,0.5,0.5,1445,1534
2004-02-14,Tunisia,Morocco,2,1,1,1.0,0.0,1852,1837
2004-02-15,Barbados,Guyana,0,2,2,0.0,1.0,1602,1477
2004-02-16,Malta,Estonia,5,2,3,1.0,0.0,1457,1571
2004-02-18,Albania,Sweden,2,1,1,1.0,0.0,1575,1843
2004-02-18,Antigua and Barbuda,Curaçao,2,0,2,1.0,0.0,1470,1530
2004-02-18,Bahrain,Syria,2,1,1,1.0,0.0,1710,1619
2004-02-18,Belgium,France,0,2,2,0.0,1.0,1889,2065
2004-02-18,China PR,Kuwait,1,0,1,1.0,0.0,1795,1734
2004-02-18,Croatia,Germany,1,2,1,0.0,1.0,1855,1956
2004-02-18,Cyprus,Belarus,0,2,2,0.0,1.0,1589,1598
2004-02-18,Estonia,Moldova,1,0,1,1.0,0.0,1579,1527
2004-02-18,Greece,Bulgaria,2,0,2,1.0,0.0,1848,1819
2004-02-18,Haiti,Turks and Caicos Islands,5,0,5,1.0,0.0,1653,1468
2004-02-18,Honduras,Colombia,1,1,0,0.5,0.5,1758,1833
2004-02-18,Hungary,Armenia,2,0,2,1.0,0.0,1690,1544
2004-02-18,India,Singapore,1,0,1,1.0,0.0,1547,1572
2004-02-18,Iran,Qatar,3,1,2,1.0,0.0,1847,1754
2004-02-18,Republic of Ireland,Brazil,0,0,0,0.5,0.5,1889,2013
2004-02-18,Italy,Czech Republic,2,2,0,0.5,0.5,1964,1925
2004-02-18,Jamaica,Uruguay,2,0,2,1.0,0.0,1735,1848
2004-02-18,Japan,Oman,1,0,1,1.0,0.0,1887,1707
2004-02-18,Jordan,Laos,5,0,5,1.0,0.0,1715,1384
2004-02-18,South Korea,Lebanon,2,0,2,1.0,0.0,1862,1621
2004-02-18,Kyrgyzstan,Tajikistan,1,2,1,0.0,1.0,1445,1575
2004-02-18,Latvia,Kazakhstan,3,1,2,1.0,0.0,1600,1584
2004-02-18,Libya,Ukraine,1,1,0,0.5,0.5,1637,1704
2004-02-18,North Macedonia,Bosnia and Herzegovina,1,0,1,1.0,0.0,1604,1646
2004-02-18,Malaysia,Hong Kong,1,3,2,0.0,1.0,1562,1552
2004-02-18,Mexico,Chile,1,1,0,0.5,0.5,1893,1754
2004-02-18,Morocco,Switzerland,2,1,1,1.0,0.0,1844,1781
2004-02-18,Netherlands,United States,1,0,1,1.0,0.0,2006,1905
2004-02-18,Northern Ireland,Norway,1,4,3,0.0,1.0,1635,1849
2004-02-18,Palestine,Taiwan,8,0,8,1.0,0.0,1490,1420
2004-02-18,Poland,Slovenia,2,0,2,1.0,0.0,1832,1732
2004-02-18,Portugal,England,1,1,0,0.5,0.5,1950,1971
2004-02-18,Romania,Georgia,3,0,3,1.0,0.0,1848,1607
2004-02-18,Saudi Arabia,Indonesia,3,0,3,1.0,0.0,1865,1633
2004-02-18,Spain,Peru,2,1,1,1.0,0.0,2002,1763
2004-02-18,Turkmenistan,Sri Lanka,2,0,2,1.0,0.0,1617,1419
2004-02-18,United Arab Emirates,Thailand,1,0,1,1.0,0.0,1706,1729
2004-02-18,Uzbekistan,Iraq,1,1,0,0.5,0.5,1684,1764
2004-02-18,Venezuela,Australia,1,1,0,0.5,0.5,1670,1891
2004-02-18,Vietnam,Maldives,4,0,4,1.0,0.0,1595,1401
2004-02-18,United States Virgin Islands,Saint Kitts and Nevis,0,4,4,0.0,1.0,1423,1600
2004-02-18,Wales,Scotland,4,0,4,1.0,0.0,1723,1777
2004-02-18,Yemen,North Korea,1,1,0,0.5,0.5,1484,1674
2004-02-19,Cyprus,Georgia,3,1,2,1.0,0.0,1598,1599
2004-02-19,Kazakhstan,Armenia,3,3,0,0.5,0.5,1584,1545
2004-02-19,Latvia,Hungary,1,2,1,0.0,1.0,1595,1696
2004-02-21,Belarus,Latvia,4,1,3,1.0,0.0,1606,1588
2004-02-21,Cyprus,Kazakhstan,2,1,1,1.0,0.0,1606,1577
2004-02-21,Georgia,Armenia,0,2,2,0.0,1.0,1590,1555
2004-02-21,Poland,Faroe Islands,6,0,6,1.0,0.0,1834,1478
2004-02-21,Turks and Caicos Islands,Haiti,0,2,2,0.0,1.0,1464,1658
2004-02-22,British Virgin Islands,Saint Lucia,0,1,1,0.0,1.0,1412,1546
2004-02-22,Cayman Islands,Cuba,1,2,1,0.0,1.0,1461,1665
2004-02-24,Faroe Islands,Luxembourg,4,2,2,1.0,0.0,1484,1339
2004-02-28,Aruba,Suriname,1,2,1,0.0,1.0,1401,1581
2004-02-28,Grenada,Guyana,5,0,5,1.0,0.0,1554,1471
2004-02-28,Lesotho,Botswana,0,0,0,0.5,0.5,1481,1504
2004-02-29,Bermuda,Montserrat,13,0,13,1.0,0.0,1524,1418
2004-02-29,Nicaragua,Haiti,1,1,0,0.5,0.5,1332,1653
2004-03-02,Trinidad and Tobago,Guyana,1,0,1,1.0,0.0,1685,1468
2004-03-06,Alderney,Jersey,0,4,4,0.0,1.0,1284,1717
2004-03-10,Mexico,Ecuador,2,1,1,1.0,0.0,1899,1786
2004-03-10,Venezuela,Honduras,2,1,1,1.0,0.0,1680,1749
2004-03-12,Barbados,Dominica,2,1,1,1.0,0.0,1607,1452
2004-03-13,United States,Haiti,1,1,0,0.5,0.5,1901,1658
2004-03-14,Guyana,Grenada,1,3,2,0.0,1.0,1462,1561
2004-03-16,Cuba,Panama,1,1,0,0.5,0.5,1664,1600
2004-03-17,China PR,Myanmar,2,0,2,1.0,0.0,1798,1536
2004-03-17,Malaysia,Indonesia,0,0,0,0.5,0.5,1564,1632
2004-03-17,Yemen,Turkmenistan,1,2,1,0.0,1.0,1479,1623
2004-03-18,Cuba,Panama,3,0,3,1.0,0.0,1671,1594
2004-03-19,Dominican Republic,Anguilla,0,0,0,0.5,0.5,1493,1373
2004-03-20,Saint Kitts and Nevis,British Virgin Islands,4,0,4,1.0,0.0,1605,1408
2004-03-21,Bahrain,Jordan,0,0,0,0.5,0.5,1711,1715
2004-03-21,Dominican Republic,Anguilla,6,0,6,1.0,0.0,1499,1368
2004-03-21,Montserrat,Bermuda,0,7,7,0.0,1.0,1413,1530
2004-03-21,Saint Kitts and Nevis,Antigua and Barbuda,2,3,1,0.0,1.0,1595,1481
2004-03-21,Saint Vincent and the Grenadines,Saint Lucia,1,1,0,0.5,0.5,1573,1547
2004-03-23,Bahrain,Jordan,0,2,2,0.0,1.0,1704,1723
2004-03-23,Lebanon,Syria,0,1,1,0.0,1.0,1613,1628
2004-03-26,Bahamas,Dominica,1,1,0,0.5,0.5,1470,1453
2004-03-26,Libya,Qatar,1,0,1,1.0,0.0,1648,1744
2004-03-26,Syria,Palestine,1,1,0,0.5,0.5,1625,1494
2004-03-27,Cuba,Cayman Islands,3,0,3,1.0,0.0,1675,1458
2004-03-27,Suriname,Aruba,8,1,7,1.0,0.0,1586,1397
2004-03-28,Bahamas,Dominica,1,3,2,0.0,1.0,1462,1462
2004-03-28,Saint Lucia,British Virgin Islands,9,0,9,1.0,0.0,1552,1404
2004-03-30,Argentina,Ecuador,1,0,1,1.0,0.0,2020,1783
2004-03-30,Australia,South Africa,1,0,1,1.0,0.0,1897,1772
2004-03-30,Bolivia,Chile,0,2,2,0.0,1.0,1685,1761
2004-03-30,Israel,Lithuania,2,1,1,1.0,0.0,1732,1539
2004-03-31,Estonia,Northern Ireland,0,1,1,0.0,1.0,1573,1642
2004-03-31,Albania,Iceland,2,1,1,1.0,0.0,1586,1684
2004-03-31,Bermuda,Nicaragua,3,0,3,1.0,0.0,1534,1329
2004-03-31,Bulgaria,Russia,2,2,0,0.5,0.5,1820,1837
2004-03-31,Croatia,Turkey,2,2,0,0.5,0.5,1855,1830
2004-03-31,Curaçao,Antigua and Barbuda,3,0,3,1.0,0.0,1537,1475
2004-03-31,Egypt,Trinidad and Tobago,2,1,1,1.0,0.0,1846,1681
2004-03-31,El Salvador,Guatemala,0,3,3,0.0,1.0,1641,1692
2004-03-31,Germany,Belgium,3,0,3,1.0,0.0,1963,1883
2004-03-31,Greece,Switzerland,1,0,1,1.0,0.0,1855,1775
2004-03-31,Hong Kong,China PR,0,1,1,0.0,1.0,1549,1802
2004-03-31,India,Oman,1,5,4,0.0,1.0,1543,1712
2004-03-31,Republic of Ireland,Czech Republic,2,1,1,1.0,0.0,1898,1917
2004-03-31,Jamaica,Honduras,2,2,0,0.5,0.5,1736,1749
2004-03-31,Jordan,Qatar,1,0,1,1.0,0.0,1732,1736
2004-03-31,North Korea,United Arab Emirates,0,0,0,0.5,0.5,1675,1706
2004-03-31,Kyrgyzstan,Syria,1,1,0,0.5,0.5,1449,1622
2004-03-31,Laos,Iran,0,7,7,0.0,1.0,1383,1849
2004-03-31,Luxembourg,Bosnia and Herzegovina,1,2,1,0.0,1.0,1337,1649
2004-03-31,North Macedonia,Ukraine,1,0,1,1.0,0.0,1615,1694
2004-03-31,Malaysia,Kuwait,0,2,2,0.0,1.0,1560,1739
2004-03-31,Maldives,South Korea,0,0,0,0.5,0.5,1408,1856
2004-03-31,Malta,Finland,1,2,1,0.0,1.0,1455,1744
2004-03-31,Mexico,Costa Rica,2,0,2,1.0,0.0,1906,1810
2004-03-31,Moldova,Azerbaijan,2,1,1,1.0,0.0,1534,1473
2004-03-31,Morocco,Angola,3,1,2,1.0,0.0,1849,1673
2004-03-31,Netherlands,France,0,0,0,0.5,0.5,2008,2064
2004-03-31,Palestine,Iraq,1,1,0,0.5,0.5,1500,1759
2004-03-31,Paraguay,Brazil,0,0,0,0.5,0.5,1862,2010
2004-03-31,Peru,Colombia,0,2,2,0.0,1.0,1757,1840
2004-03-31,Poland,United States,0,1,1,0.0,1.0,1828,1908
2004-03-31,Portugal,Italy,1,2,1,0.0,1.0,1943,1972
2004-03-31,Scotland,Romania,1,2,1,0.0,1.0,1771,1855
2004-03-31,Serbia,Norway,0,1,1,0.0,1.0,1777,1856
2004-03-31,Singapore,Japan,1,2,1,0.0,1.0,1570,1890
2004-03-31,Slovakia,Austria,1,1,0,0.5,0.5,1719,1761
2004-03-31,Slovenia,Latvia,0,1,1,0.0,1.0,1721,1600
2004-03-31,Spain,Denmark,2,0,2,1.0,0.0,2009,1933
2004-03-31,Sri Lanka,Saudi Arabia,0,1,1,0.0,1.0,1418,1867
2004-03-31,Saint Kitts and Nevis,United States Virgin Islands,7,0,7,1.0,0.0,1600,1419
2004-03-31,Sweden,England,1,0,1,1.0,0.0,1854,1961
2004-03-31,Tajikistan,Bahrain,0,0,0,0.5,0.5,1578,1702
2004-03-31,Tunisia,Ivory Coast,0,2,2,0.0,1.0,1843,1789
2004-03-31,Turkmenistan,Indonesia,3,1,2,1.0,0.0,1632,1624
2004-03-31,Uruguay,Venezuela,0,3,3,0.0,1.0,1837,1692
2004-03-31,Vietnam,Lebanon,0,2,2,0.0,1.0,1588,1621
2004-03-31,Yemen,Thailand,0,3,3,0.0,1.0,1476,1733
2004-03-31,Taiwan,Uzbekistan,0,1,1,0.0,1.0,1418,1687
2004-04-02,Bermuda,Nicaragua,2,1,1,1.0,0.0,1538,1326
2004-04-03,Vanuatu,Solomon Islands,1,2,1,0.0,1.0,1515,1615
2004-04-06,Vanuatu,Solomon Islands,1,2,1,0.0,1.0,1510,1621
2004-04-07,Honduras,Panama,0,0,0,0.5,0.5,1746,1598
2004-04-11,Mozambique,Eswatini,2,0,2,1.0,0.0,1551,1478
2004-04-14,Andorra,China PR,0,0,0,0.5,0.5,1405,1796
2004-04-18,Mozambique,Madagascar,2,0,2,1.0,0.0,1560,1585
2004-04-19,Sudan,Syria,1,2,1,0.0,1.0,1598,1630
2004-04-21,Sudan,Syria,0,0,0,0.5,0.5,1599,1630
2004-04-25,Hungary,Japan,3,2,1,1.0,0.0,1709,1878
2004-04-27,Curaçao,Dominican Republic,3,1,2,1.0,0.0,1545,1492
2004-04-28,Algeria,China PR,0,1,1,0.0,1.0,1725,1803
2004-04-28,Armenia,Turkmenistan,1,0,1,1.0,0.0,1565,1623
2004-04-28,Austria,Luxembourg,4,1,3,1.0,0.0,1763,1336
2004-04-28,Belarus,Lithuania,1,0,1,1.0,0.0,1613,1533
2004-04-28,Belgium,Turkey,2,3,1,0.0,1.0,1874,1840
2004-04-28,Bosnia and Herzegovina,Finland,1,0,1,1.0,0.0,1660,1734
2004-04-28,Bulgaria,Cameroon,3,0,3,1.0,0.0,1829,1849
2004-04-28,Chile,Peru,1,1,0,0.5,0.5,1761,1758
2004-04-28,Czech Republic,Japan,0,1,1,0.0,1.0,1909,1887
2004-04-28,Denmark,Scotland,1,0,1,1.0,0.0,1938,1767
2004-04-28,El Salvador,Colombia,0,2,2,0.0,1.0,1638,1844
2004-04-28,Estonia,Albania,1,1,0,0.5,0.5,1574,1586
2004-04-28,Ghana,Angola,1,1,0,0.5,0.5,1670,1673
2004-04-28,Honduras,Ecuador,1,1,0,0.5,0.5,1747,1783
2004-04-28,Hungary,Brazil,1,4,3,0.0,1.0,1707,2013
2004-04-28,Israel,Moldova,1,1,0,0.5,0.5,1728,1539
2004-04-28,Italy,Spain,1,1,0,0.5,0.5,1973,2009
2004-04-28,Ivory Coast,Guinea,4,2,2,1.0,0.0,1795,1659
2004-04-28,Jamaica,Venezuela,2,1,1,1.0,0.0,1743,1686
2004-04-28,Kazakhstan,Azerbaijan,2,3,1,0.0,1.0,1567,1484
2004-04-28,South Korea,Paraguay,0,0,0,0.5,0.5,1857,1862
2004-04-28,Latvia,Iceland,0,0,0,0.5,0.5,1602,1683
2004-04-28,North Macedonia,Croatia,0,1,1,0.0,1.0,1612,1859
2004-04-28,Morocco,Argentina,0,1,1,0.0,1.0,1845,2025
2004-04-28,Namibia,Botswana,0,0,0,0.5,0.5,1485,1504
2004-04-28,Netherlands,Greece,4,0,4,1.0,0.0,2013,1851
2004-04-28,Northern Ireland,Serbia,1,1,0,0.5,0.5,1645,1775
2004-04-28,Norway,Russia,3,2,1,1.0,0.0,1864,1830
2004-04-28,Panama,Bermuda,4,1,3,1.0,0.0,1605,1532
2004-04-28,Poland,Republic of Ireland,0,0,0,0.5,0.5,1830,1897
2004-04-28,Portugal,Sweden,2,2,0,0.5,0.5,1941,1857
2004-04-28,Romania,Germany,5,1,4,1.0,0.0,1866,1953
2004-04-28,San Marino,Liechtenstein,1,0,1,1.0,0.0,1391,1404
2004-04-28,Switzerland,Slovenia,2,1,1,1.0,0.0,1782,1715
2004-04-28,Tunisia,Mali,1,0,1,1.0,0.0,1849,1747
2004-04-28,Ukraine,Slovakia,1,1,0,0.5,0.5,1695,1719
2004-04-28,United States,Mexico,1,0,1,1.0,0.0,1916,1899
2004-04-30,Libya,Jordan,1,0,1,1.0,0.0,1658,1723
2004-04-30,Nicaragua,Bermuda,2,0,2,1.0,0.0,1339,1520
2004-05-01,Guatemala,Panama,1,2,1,0.0,1.0,1683,1615
2004-05-01,Zambia,Zimbabwe,1,1,0,0.5,0.5,1692,1715
2004-05-02,Nicaragua,Bermuda,2,0,2,1.0,0.0,1351,1509
2004-05-03,Jersey,Guernsey,3,0,3,1.0,0.0,1724,1666
2004-05-05,Cook Islands,Samoa,0,0,0,0.5,0.5,1456,1481
2004-05-05,Guatemala,Haiti,1,0,1,1.0,0.0,1691,1651
2004-05-08,Grenada,Saint Vincent and the Grenadines,1,1,0,0.5,0.5,1562,1573
2004-05-09,Angola,Namibia,2,1,1,1.0,0.0,1678,1481
2004-05-10,Papua New Guinea,Vanuatu,1,1,0,0.5,0.5,1499,1510
2004-05-10,Samoa,American Samoa,4,0,4,1.0,0.0,1487,1380
2004-05-10,Solomon Islands,Tonga,6,0,6,1.0,0.0,1626,1472
2004-05-10,Tahiti,Cook Islands,2,0,2,1.0,0.0,1705,1453
2004-05-12,American Samoa,Vanuatu,1,9,8,0.0,1.0,1375,1516
2004-05-12,El Salvador,Haiti,3,3,0,0.5,0.5,1639,1651
2004-05-12,Fiji,Papua New Guinea,4,2,2,1.0,0.0,1715,1496
2004-05-12,Solomon Islands,Cook Islands,5,0,5,1.0,0.0,1631,1449
2004-05-12,Tahiti,New Caledonia,0,0,0,0.5,0.5,1703,1592
2004-05-15,Fiji,American Samoa,11,0,11,1.0,0.0,1717,1374
2004-05-15,Samoa,Vanuatu,0,3,3,0.0,1.0,1480,1524
2004-05-15,Solomon Islands,New Caledonia,2,0,2,1.0,0.0,1639,1585
2004-05-15,Tonga,Cook Islands,2,1,1,1.0,0.0,1480,1442
2004-05-15,Åland Islands,Sealand,2,2,0,0.5,0.5,1530,1501
2004-05-16,Zimbabwe,Zambia,0,0,0,0.5,0.5,1715,1693
2004-05-17,American Samoa,Papua New Guinea,0,10,10,0.0,1.0,1369,1502
2004-05-17,New Caledonia,Cook Islands,8,0,8,1.0,0.0,1590,1438
2004-05-17,Samoa,Fiji,0,4,4,0.0,1.0,1477,1721
2004-05-17,Tahiti,Tonga,2,0,2,1.0,0.0,1707,1477
2004-05-19,Cyprus,Jordan,0,0,0,0.5,0.5,1609,1721
2004-05-19,Fiji,Vanuatu,0,3,3,0.0,1.0,1709,1537
2004-05-19,New Caledonia,Tonga,8,0,8,1.0,0.0,1596,1472
2004-05-19,Samoa,Papua New Guinea,1,4,3,0.0,1.0,1470,1510
2004-05-19,Solomon Islands,Tahiti,1,1,0,0.5,0.5,1641,1706
2004-05-20,Benin,Togo,0,1,1,0.0,1.0,1513,1642
2004-05-20,Cuba,Grenada,2,2,0,0.5,0.5,1673,1565
2004-05-20,France,Brazil,0,0,0,0.5,0.5,2063,2015
2004-05-21,Australia,Turkey,1,3,2,0.0,1.0,1888,1850
2004-05-22,Sudan,Uganda,2,1,1,1.0,0.0,1609,1649
2004-05-22,Zambia,Malawi,0,2,2,0.0,1.0,1683,1603
2004-05-23,DR Congo,Angola,1,3,2,0.0,1.0,1672,1687
2004-05-23,Saint Kitts and Nevis,Saint Vincent and the Grenadines,3,2,1,1.0,0.0,1608,1566
2004-05-23,Togo,Benin,1,1,0,0.5,0.5,1640,1516
2004-05-23,Trinidad and Tobago,Iraq,2,0,2,1.0,0.0,1691,1750
2004-05-24,Australia,Turkey,0,1,1,0.0,1.0,1880,1859
2004-05-24,Egypt,Zimbabwe,2,0,2,1.0,0.0,1852,1710
2004-05-25,Austria,Russia,0,0,0,0.5,0.5,1765,1829
2004-05-25,Sudan,Zambia,0,2,2,0.0,1.0,1603,1690
2004-05-25,Catalonia,Brazil,2,5,3,0.0,1.0,1586,2017
2004-05-26,Benin,Burkina Faso,1,0,1,1.0,0.0,1527,1618
2004-05-26,Lebanon,Bahrain,2,2,0,0.5,0.5,1623,1701
2004-05-26,Mozambique,Botswana,0,0,0,0.5,0.5,1559,1506
2004-05-27,Estonia,Scotland,0,1,1,0.0,1.0,1571,1771
2004-05-27,Georgia,Israel,0,1,1,0.0,1.0,1586,1733
2004-05-27,Germany,Malta,7,0,7,1.0,0.0,1954,1455
2004-05-27,Republic of Ireland,Romania,1,0,1,1.0,0.0,1905,1859
2004-05-27,Norway,Wales,0,0,0,0.5,0.5,1861,1727
2004-05-28,Azerbaijan,Uzbekistan,3,1,2,1.0,0.0,1497,1675
2004-05-28,Finland,Sweden,1,3,2,0.0,1.0,1729,1863
2004-05-28,France,Andorra,4,0,4,1.0,0.0,2064,1405
2004-05-28,Mali,Morocco,0,0,0,0.5,0.5,1750,1843
2004-05-28,Rwanda,Uganda,1,1,0,0.5,0.5,1608,1649
2004-05-29,Australia,New Zealand,1,0,1,1.0,0.0,1885,1689
2004-05-29,Croatia,Slovakia,1,0,1,1.0,0.0,1864,1715
2004-05-29,Egypt,Gabon,2,0,2,1.0,0.0,1857,1667
2004-05-29,Republic of Ireland,Nigeria,0,3,3,0.0,1.0,1896,1860
2004-05-29,Netherlands,Belgium,0,1,1,0.0,1.0,2002,1886
2004-05-29,Poland,Greece,1,0,1,1.0,0.0,1839,1843
2004-05-29,Portugal,Luxembourg,3,0,3,1.0,0.0,1942,1336
2004-05-29,Senegal,Guinea,1,1,0,0.5,0.5,1799,1663
2004-05-29,Tahiti,Fiji,0,0,0,0.5,0.5,1707,1709
2004-05-29,Vanuatu,Solomon Islands,0,1,1,0.0,1.0,1532,1647
2004-05-30,Algeria,Jordan,1,1,0,0.5,0.5,1725,1722
2004-05-30,Barbados,Northern Ireland,1,1,0,0.5,0.5,1608,1645
2004-05-30,Burkina Faso,Libya,3,2,1,1.0,0.0,1627,1650
2004-05-30,Estonia,Denmark,2,2,0,0.5,0.5,1578,1932
2004-05-30,Iceland,Japan,2,3,1,0.0,1.0,1680,1891
2004-05-30,Scotland,Trinidad and Tobago,4,1,3,1.0,0.0,1778,1685
2004-05-30,Saint Vincent and the Grenadines,Martinique,2,0,2,1.0,0.0,1577,1670
2004-05-30,Tunisia,Italy,0,4,4,0.0,1.0,1844,1979
2004-05-30,Wales,Canada,1,0,1,1.0,0.0,1736,1721
2004-05-31,Australia,Tahiti,9,0,9,1.0,0.0,1890,1703
2004-05-31,Fiji,Vanuatu,1,0,1,1.0,0.0,1714,1528
2004-05-31,Mozambique,Eswatini,1,1,0,0.5,0.5,1558,1480
2004-05-31,New Zealand,Solomon Islands,3,0,3,1.0,0.0,1697,1640
2004-05-31,Nigeria,Jamaica,2,0,2,1.0,0.0,1866,1738
2004-05-31,Oman,Maldives,3,0,3,1.0,0.0,1715,1406
2004-05-31,Qatar,Turkmenistan,5,0,5,1.0,0.0,1742,1618
2004-05-31,United Arab Emirates,Bahrain,2,3,1,0.0,1.0,1698,1710
2004-06-01,Bolivia,Paraguay,2,1,1,1.0,0.0,1697,1851
2004-06-01,China PR,Hungary,2,1,1,1.0,0.0,1809,1702
2004-06-01,England,Japan,1,1,0,0.5,0.5,1960,1893
2004-06-01,Kuwait,Syria,0,1,1,0.0,1.0,1729,1641
2004-06-01,Netherlands,Faroe Islands,3,0,3,1.0,0.0,2003,1484
2004-06-01,Uruguay,Peru,1,3,2,0.0,1.0,1828,1768
2004-06-01,Venezuela,Chile,0,1,1,0.0,1.0,1680,1768
2004-06-02,Australia,Fiji,6,1,5,1.0,0.0,1895,1710
2004-06-02,Brazil,Argentina,3,1,2,1.0,0.0,2026,2017
2004-06-02,Czech Republic,Bulgaria,3,1,2,1.0,0.0,1916,1823
2004-06-02,Ecuador,Colombia,2,1,1,1.0,0.0,1793,1835
2004-06-02,Grenada,Saint Lucia,2,0,2,1.0,0.0,1573,1545
2004-06-02,Republic of Ireland,Jamaica,1,0,1,1.0,0.0,1901,1734
2004-06-02,South Korea,Turkey,0,1,1,0.0,1.0,1850,1867
2004-06-02,New Zealand,Vanuatu,2,4,2,0.0,1.0,1686,1540
2004-06-02,Saint Kitts and Nevis,Northern Ireland,0,2,2,0.0,1.0,1601,1653
2004-06-02,Switzerland,Germany,0,2,2,0.0,1.0,1778,1959
2004-06-02,Tahiti,Solomon Islands,0,4,4,0.0,1.0,1694,1650
2004-06-02,United States,Honduras,4,0,4,1.0,0.0,1921,1743
2004-06-03,Indonesia,India,1,1,0,0.5,0.5,1623,1545
2004-06-03,Kuwait,Syria,1,2,1,0.0,1.0,1720,1651
2004-06-03,Liechtenstein,Greece,0,2,2,0.0,1.0,1403,1845
2004-06-03,Oman,Maldives,4,1,3,1.0,0.0,1718,1404
2004-06-04,Australia,Vanuatu,3,0,3,1.0,0.0,1897,1539
2004-06-04,Costa Rica,Nicaragua,5,1,4,1.0,0.0,1812,1350
2004-06-04,Fiji,Solomon Islands,1,2,1,0.0,1.0,1701,1660
2004-06-04,New Zealand,Tahiti,10,0,10,1.0,0.0,1695,1686
2004-06-05,Algeria,Angola,0,0,0,0.5,0.5,1725,1688
2004-06-05,Burkina Faso,Ghana,1,0,1,1.0,0.0,1636,1662
2004-06-05,Denmark,Croatia,1,2,1,0.0,1.0,1923,1874
2004-06-05,Ecuador,Bolivia,3,2,1,1.0,0.0,1799,1692
2004-06-05,England,Iceland,6,1,5,1.0,0.0,1963,1678
2004-06-05,Gabon,Zimbabwe,1,1,0,0.5,0.5,1668,1710
2004-06-05,South Korea,Turkey,2,1,1,1.0,0.0,1859,1859
2004-06-05,Malawi,Morocco,1,1,0,0.5,0.5,1608,1839
2004-06-05,Netherlands,Republic of Ireland,0,1,1,0.0,1.0,1993,1912
2004-06-05,Nigeria,Rwanda,2,0,2,1.0,0.0,1869,1606
2004-06-05,Portugal,Lithuania,4,1,3,1.0,0.0,1944,1532
2004-06-05,Qatar,Kyrgyzstan,0,0,0,0.5,0.5,1737,1455
2004-06-05,Senegal,Congo,2,0,2,1.0,0.0,1804,1610
2004-06-05,South Africa,Cape Verde,2,1,1,1.0,0.0,1776,1541
2004-06-05,Spain,Andorra,4,0,4,1.0,0.0,2010,1405
2004-06-05,Sweden,Poland,3,1,2,1.0,0.0,1871,1832
2004-06-05,Tunisia,Botswana,4,1,3,1.0,0.0,1847,1504
2004-06-05,Zambia,Togo,1,0,1,1.0,0.0,1697,1634
2004-06-06,Argentina,Paraguay,0,0,0,0.5,0.5,2014,1855
2004-06-06,Australia,Solomon Islands,2,2,0,0.5,0.5,1893,1665
2004-06-06,Cameroon,Benin,2,1,1,1.0,0.0,1852,1525
2004-06-06,Chile,Brazil,1,1,0,0.5,0.5,1774,2021
2004-06-06,Colombia,Uruguay,5,0,5,1.0,0.0,1843,1821
2004-06-06,Czech Republic,Estonia,2,0,2,1.0,0.0,1919,1576
2004-06-06,Fiji,New Zealand,0,2,2,0.0,1.0,1693,1704
2004-06-06,France,Ukraine,1,0,1,1.0,0.0,2066,1694
2004-06-06,Germany,Hungary,0,2,2,0.0,1.0,1946,1716
2004-06-06,Ivory Coast,Libya,2,0,2,1.0,0.0,1800,1646
2004-06-06,Latvia,Azerbaijan,2,2,0,0.5,0.5,1600,1500
2004-06-06,Liberia,Mali,1,0,1,1.0,0.0,1614,1739
2004-06-06,Peru,Venezuela,0,0,0,0.5,0.5,1767,1682
2004-06-06,Sudan,Egypt,0,3,3,0.0,1.0,1600,1861
2004-06-06,Switzerland,Liechtenstein,1,0,1,1.0,0.0,1780,1402
2004-06-06,Tahiti,Vanuatu,2,1,1,1.0,0.0,1691,1535
2004-06-06,Trinidad and Tobago,Northern Ireland,0,3,3,0.0,1.0,1677,1662
2004-06-06,Uganda,DR Congo,1,0,1,1.0,0.0,1658,1664
2004-06-09,Bahrain,Kyrgyzstan,5,0,5,1.0,0.0,1713,1453
2004-06-09,China PR,Malaysia,4,0,4,1.0,0.0,1813,1557
2004-06-09,Indonesia,Sri Lanka,1,0,1,1.0,0.0,1627,1415
2004-06-09,Iran,Jordan,0,1,1,0.0,1.0,1839,1733
2004-06-09,Iraq,Taiwan,6,1,5,1.0,0.0,1753,1416
2004-06-09,Japan,India,7,0,7,1.0,0.0,1895,1544
2004-06-09,South Korea,Vietnam,2,0,2,1.0,0.0,1862,1586
2004-06-09,Kuwait,Hong Kong,4,0,4,1.0,0.0,1725,1545
2004-06-09,Lebanon,Maldives,3,0,3,1.0,0.0,1627,1401
2004-06-09,Oman,Singapore,7,0,7,1.0,0.0,1723,1566
2004-06-09,Qatar,Laos,5,0,5,1.0,0.0,1739,1382
2004-06-09,Saudi Arabia,Turkmenistan,3,0,3,1.0,0.0,1871,1615
2004-06-09,Thailand,North Korea,1,4,3,0.0,1.0,1724,1685
2004-06-09,United Arab Emirates,Yemen,3,0,3,1.0,0.0,1702,1473
2004-06-09,Uzbekistan,Palestine,3,0,3,1.0,0.0,1680,1496
2004-06-10,Syria,Tajikistan,2,1,1,1.0,0.0,1658,1572
2004-06-11,Estonia,North Macedonia,2,4,2,0.0,1.0,1569,1620
2004-06-12,Cuba,Costa Rica,2,2,0,0.5,0.5,1677,1809
2004-06-12,Curaçao,Honduras,1,2,1,0.0,1.0,1542,1747
2004-06-12,Haiti,Jamaica,1,1,0,0.5,0.5,1653,1733
2004-06-12,Portugal,Greece,1,2,1,0.0,1.0,1934,1856
2004-06-12,Spain,Russia,1,0,1,1.0,0.0,2015,1825
2004-06-12,Suriname,Guatemala,1,1,0,0.5,0.5,1589,1689
2004-06-13,Barbados,Saint Kitts and Nevis,0,2,2,0.0,1.0,1600,1610
2004-06-13,Burkina Faso,Benin,4,2,2,1.0,0.0,1642,1520
2004-06-13,Canada,Belize,4,0,4,1.0,0.0,1725,1490
2004-06-13,Cape Verde,Senegal,1,3,2,0.0,1.0,1539,1807
2004-06-13,Dominican Republic,Trinidad and Tobago,0,2,2,0.0,1.0,1488,1682
2004-06-13,El Salvador,Bermuda,2,1,1,1.0,0.0,1645,1504
2004-06-13,France,England,2,1,1,1.0,0.0,2072,1958
2004-06-13,Mozambique,Malawi,2,0,2,1.0,0.0,1568,1599
2004-06-13,Panama,Saint Lucia,4,0,4,1.0,0.0,1622,1539
2004-06-13,Switzerland,Croatia,0,0,0,0.5,0.5,1783,1872
2004-06-13,United States,Grenada,3,0,3,1.0,0.0,1923,1572
2004-06-13,Nicaragua,Saint Vincent and the Grenadines,2,2,0,0.5,0.5,1355,1573
2004-06-14,Denmark,Italy,0,0,0,0.5,0.5,1925,1978
2004-06-14,Ghana,Togo,0,0,0,0.5,0.5,1662,1635
2004-06-14,Sweden,Bulgaria,5,0,5,1.0,0.0,1878,1817
2004-06-15,Czech Republic,Latvia,2,1,1,1.0,0.0,1922,1598
2004-06-15,Germany,Netherlands,1,1,0,0.5,0.5,1948,1992
2004-06-16,Canada,Belize,4,0,4,1.0,0.0,1729,1487
2004-06-16,Greece,Spain,1,1,0,0.5,0.5,1860,2012
2004-06-16,Portugal,Russia,2,0,2,1.0,0.0,1940,1820
2004-06-17,Croatia,France,2,2,0,0.5,0.5,1877,2068
2004-06-17,England,Switzerland,3,0,3,1.0,0.0,1963,1779
2004-06-17,Iran,Lebanon,4,0,4,1.0,0.0,1843,1624
2004-06-17,Palestine,Jordan,1,1,0,0.5,0.5,1501,1729
2004-06-18,Bulgaria,Denmark,0,2,2,0.0,1.0,1812,1931
2004-06-18,Italy,Sweden,1,1,0,0.5,0.5,1976,1881
2004-06-18,Libya,Cameroon,0,0,0,0.5,0.5,1651,1848
2004-06-19,Botswana,Malawi,2,0,2,1.0,0.0,1515,1589
2004-06-19,Cape Verde,Uganda,1,0,1,1.0,0.0,1550,1648
2004-06-19,Dominica,Mexico,0,10,10,0.0,1.0,1461,1901
2004-06-19,Honduras,Curaçao,4,0,4,1.0,0.0,1751,1539
2004-06-19,Iraq,Palestine,2,1,1,1.0,0.0,1757,1498
2004-06-19,Latvia,Germany,0,0,0,0.5,0.5,1605,1942
2004-06-19,Mali,Zambia,1,1,0,0.5,0.5,1739,1698
2004-06-19,Netherlands,Czech Republic,2,3,1,0.0,1.0,1983,1932
2004-06-19,Rwanda,Gabon,3,1,2,1.0,0.0,1616,1659
2004-06-19,Saint Kitts and Nevis,Barbados,3,2,1,1.0,0.0,1618,1593
2004-06-19,Syria,Lebanon,3,1,2,1.0,0.0,1666,1617
2004-06-20,Angola,Nigeria,1,0,1,1.0,0.0,1700,1858
2004-06-20,Benin,Sudan,1,1,0,0.5,0.5,1522,1599
2004-06-20,Bermuda,El Salvador,2,2,0,0.5,0.5,1508,1642
2004-06-20,Congo,Liberia,3,0,3,1.0,0.0,1619,1606
2004-06-20,DR Congo,Burkina Faso,3,2,1,1.0,0.0,1672,1635
2004-06-20,Costa Rica,Cuba,1,1,0,0.5,0.5,1807,1680
2004-06-20,Egypt,Ivory Coast,1,2,1,0.0,1.0,1852,1810
2004-06-20,Ghana,South Africa,3,0,3,1.0,0.0,1673,1766
2004-06-20,Grenada,United States,2,3,1,0.0,1.0,1571,1925
2004-06-20,Guatemala,Suriname,3,1,2,1.0,0.0,1695,1584
2004-06-20,Guinea,Tunisia,2,1,1,1.0,0.0,1675,1836
2004-06-20,Jamaica,Haiti,3,0,3,1.0,0.0,1740,1647
2004-06-20,Portugal,Spain,1,0,1,1.0,0.0,1950,2003
2004-06-20,Russia,Greece,2,1,1,1.0,0.0,1829,1852
2004-06-20,Saint Lucia,Panama,0,3,3,0.0,1.0,1533,1629
2004-06-20,Togo,Senegal,3,1,2,1.0,0.0,1647,1796
2004-06-20,Trinidad and Tobago,Dominican Republic,4,0,4,1.0,0.0,1686,1485
2004-06-20,Zimbabwe,Algeria,1,1,0,0.5,0.5,1711,1725
2004-06-20,Saint Vincent and the Grenadines,Nicaragua,4,1,3,1.0,0.0,1577,1352
2004-06-21,Croatia,England,2,4,2,0.0,1.0,1871,1970
2004-06-21,Iran,Syria,7,1,6,1.0,0.0,1848,1662
2004-06-21,Jordan,Iraq,2,0,2,1.0,0.0,1738,1749
2004-06-21,Switzerland,France,1,3,2,0.0,1.0,1777,2071
2004-06-22,Denmark,Sweden,2,2,0,0.5,0.5,1930,1883
2004-06-22,Italy,Bulgaria,2,1,1,1.0,0.0,1981,1808
2004-06-23,Germany,Czech Republic,1,2,1,0.0,1.0,1934,1941
2004-06-23,Iran,Iraq,2,1,1,1.0,0.0,1854,1744
2004-06-23,Jordan,Syria,1,1,0,0.5,0.5,1737,1664
2004-06-23,Netherlands,Latvia,3,0,3,1.0,0.0,1985,1604
2004-06-24,Portugal,England,2,2,0,0.5,0.5,1951,1970
2004-06-25,France,Greece,0,1,1,0.0,1.0,2059,1865
2004-06-25,Iran,Syria,4,1,3,1.0,0.0,1859,1660
2004-06-25,Iraq,Jordan,1,3,2,0.0,1.0,1736,1746
2004-06-26,Sweden,Netherlands,0,0,0,0.5,0.5,1886,1983
2004-06-27,Argentina,Colombia,0,2,2,0.0,1.0,2003,1855
2004-06-27,Czech Republic,Denmark,3,0,3,1.0,0.0,1949,1923
2004-06-27,Mexico,Dominica,8,0,8,1.0,0.0,1903,1460
2004-06-27,Eswatini,Zimbabwe,0,5,5,0.0,1.0,1477,1715
2004-06-30,Argentina,Peru,2,1,1,1.0,0.0,2007,1764
2004-06-30,Portugal,Netherlands,2,1,1,1.0,0.0,1960,1975
2004-07-01,Greece,Czech Republic,1,0,1,1.0,0.0,1875,1940
2004-07-03,Botswana,Morocco,0,1,1,0.0,1.0,1513,1842
2004-07-03,Cape Verde,DR Congo,1,1,0,0.5,0.5,1553,1670
2004-07-03,China PR,Lebanon,6,0,6,1.0,0.0,1817,1614
2004-07-03,Gabon,Angola,2,2,0,0.5,0.5,1660,1700
2004-07-03,Malawi,Guinea,1,1,0,0.5,0.5,1591,1674
2004-07-03,Nigeria,Algeria,1,0,1,1.0,0.0,1864,1720
2004-07-03,Rwanda,Zimbabwe,0,2,2,0.0,1.0,1611,1721
2004-07-03,Senegal,Zambia,1,0,1,1.0,0.0,1802,1693
2004-07-03,South Africa,Burkina Faso,2,0,2,1.0,0.0,1772,1630
2004-07-03,Sudan,Libya,0,1,1,0.0,1.0,1593,1658
2004-07-03,Uganda,Ghana,1,1,0,0.5,0.5,1649,1673
2004-07-04,Benin,Egypt,3,3,0,0.5,0.5,1528,1847
2004-07-04,Cameroon,Ivory Coast,2,0,2,1.0,0.0,1856,1803
2004-07-04,Liberia,Togo,0,0,0,0.5,0.5,1607,1647
2004-07-04,Portugal,Greece,0,1,1,0.0,1.0,1951,1885
2004-07-04,Congo,Mali,1,0,1,1.0,0.0,1630,1729
2004-07-05,Thailand,Bahrain,0,2,2,0.0,1.0,1716,1722
2004-07-06,Malawi,Eswatini,1,2,1,0.0,1.0,1581,1488
2004-07-06,Peru,Bolivia,2,2,0,0.5,0.5,1763,1694
2004-07-06,Venezuela,Colombia,0,1,1,0.0,1.0,1678,1860
2004-07-07,Argentina,Ecuador,6,1,5,1.0,0.0,2011,1796
2004-07-07,Mexico,Uruguay,2,2,0,0.5,0.5,1902,1823
2004-07-08,Brazil,Chile,1,0,1,1.0,0.0,2025,1771
2004-07-08,Costa Rica,Paraguay,0,1,1,0.0,1.0,1801,1862
2004-07-08,Malawi,Eswatini,1,1,0,0.5,0.5,1579,1491
2004-07-08,Thailand,Jordan,0,0,0,0.5,0.5,1717,1746
2004-07-09,Colombia,Bolivia,1,0,1,1.0,0.0,1865,1690
2004-07-09,Japan,Slovakia,3,1,2,1.0,0.0,1900,1711
2004-07-09,Peru,Venezuela,3,1,2,1.0,0.0,1770,1672
2004-07-10,Argentina,Mexico,0,1,1,0.0,1.0,2001,1913
2004-07-10,China PR,United Arab Emirates,2,2,0,0.5,0.5,1815,1705
2004-07-10,South Korea,Bahrain,2,0,2,1.0,0.0,1867,1718
2004-07-10,Thailand,Trinidad and Tobago,3,2,1,1.0,0.0,1725,1679
2004-07-10,Uruguay,Ecuador,2,1,1,1.0,0.0,1831,1789
2004-07-11,Brazil,Costa Rica,4,1,3,1.0,0.0,2029,1798
2004-07-11,Paraguay,Chile,1,1,0,0.5,0.5,1860,1774
2004-07-11,Serbia,Slovakia,2,0,2,1.0,0.0,1782,1705
2004-07-11,United States,Poland,1,1,0,0.5,0.5,1923,1835
2004-07-12,Malaysia,Singapore,2,0,2,1.0,0.0,1566,1558
2004-07-12,Peru,Colombia,2,2,0,0.5,0.5,1773,1863
2004-07-12,Venezuela,Bolivia,1,1,0,0.5,0.5,1673,1690
2004-07-13,Argentina,Uruguay,4,2,2,1.0,0.0,2006,1827
2004-07-13,Japan,Serbia,1,0,1,1.0,0.0,1906,1777
2004-07-13,Mexico,Ecuador,2,1,1,1.0,0.0,1919,1784
2004-07-14,Brazil,Paraguay,1,2,1,0.0,1.0,2018,1872
2004-07-14,Costa Rica,Chile,2,1,1,1.0,0.0,1806,1767
2004-07-14,South Korea,Trinidad and Tobago,1,1,0,0.5,0.5,1864,1683
2004-07-17,China PR,Bahrain,2,2,0,0.5,0.5,1813,1721
2004-07-17,Colombia,Costa Rica,2,0,2,1.0,0.0,1870,1800
2004-07-17,Peru,Argentina,0,1,1,0.0,1.0,1770,2010
2004-07-18,Angola,Botswana,1,1,0,0.5,0.5,1697,1517
2004-07-18,El Salvador,Guatemala,0,1,1,0.0,1.0,1636,1702
2004-07-18,Iraq,Uzbekistan,0,1,1,0.0,1.0,1727,1690
2004-07-18,Mexico,Brazil,0,4,4,0.0,1.0,1914,2024
2004-07-18,Paraguay,Uruguay,1,3,2,0.0,1.0,1863,1837
2004-07-18,Qatar,Indonesia,1,2,1,0.0,1.0,1729,1638
2004-07-18,Saudi Arabia,Turkmenistan,2,2,0,0.5,0.5,1866,1621
2004-07-19,South Korea,Jordan,0,0,0,0.5,0.5,1862,1749
2004-07-19,Kuwait,United Arab Emirates,3,1,2,1.0,0.0,1733,1698
2004-07-20,Argentina,Colombia,3,0,3,1.0,0.0,2015,1866
2004-07-20,Iran,Thailand,3,0,3,1.0,0.0,1865,1720
2004-07-20,Japan,Oman,1,0,1,1.0,0.0,1911,1719
2004-07-21,Bahrain,Qatar,1,1,0,0.5,0.5,1722,1729
2004-07-21,China PR,Indonesia,5,0,5,1.0,0.0,1818,1634
2004-07-21,Uruguay,Brazil,1,1,0,0.5,0.5,1841,2021
2004-07-22,Turkmenistan,Iraq,2,3,1,0.0,1.0,1616,1733
2004-07-22,Uzbekistan,Saudi Arabia,1,0,1,1.0,0.0,1702,1855
2004-07-23,Jordan,Kuwait,2,0,2,1.0,0.0,1757,1726
2004-07-23,Panama,Guatemala,1,1,0,0.5,0.5,1631,1701
2004-07-23,United Arab Emirates,South Korea,0,2,2,0.0,1.0,1694,1867
2004-07-24,Colombia,Uruguay,1,2,1,0.0,1.0,1858,1850
2004-07-24,Oman,Iran,2,2,0,0.5,0.5,1723,1862
2004-07-24,Thailand,Japan,1,4,3,0.0,1.0,1717,1915
2004-07-25,Argentina,Brazil,2,2,0,0.5,0.5,2016,2021
2004-07-25,Bahrain,Indonesia,3,1,2,1.0,0.0,1729,1628
2004-07-25,China PR,Qatar,1,0,1,1.0,0.0,1824,1724
2004-07-26,Saudi Arabia,Iraq,1,2,1,0.0,1.0,1845,1744
2004-07-26,Turkmenistan,Uzbekistan,0,1,1,0.0,1.0,1610,1709
2004-07-27,Jordan,United Arab Emirates,0,0,0,0.5,0.5,1756,1696
2004-07-27,South Korea,Kuwait,4,0,4,1.0,0.0,1872,1722
2004-07-28,Honduras,Panama,0,0,0,0.5,0.5,1749,1634
2004-07-28,Japan,Iran,0,0,0,0.5,0.5,1914,1864
2004-07-28,Oman,Thailand,2,0,2,1.0,0.0,1731,1710
2004-07-30,China PR,Iraq,3,0,3,1.0,0.0,1831,1738
2004-07-30,Uzbekistan,Bahrain,2,2,0,0.5,0.5,1710,1729
2004-07-31,Japan,Jordan,1,1,0,0.5,0.5,1911,1760
2004-07-31,South Korea,Iran,3,4,1,0.0,1.0,1864,1873
2004-07-31,Zambia,Mauritius,3,1,2,1.0,0.0,1699,1553
2004-08-03,Bahrain,Japan,3,4,1,0.0,1.0,1725,1916
2004-08-03,China PR,Iran,1,1,0,0.5,0.5,1832,1873
2004-08-03,El Salvador,Honduras,0,4,4,0.0,1.0,1631,1755
2004-08-06,El Salvador,Guatemala,0,2,2,0.0,1.0,1625,1708
2004-08-06,Iran,Bahrain,4,2,2,1.0,0.0,1878,1721
2004-08-07,China PR,Japan,1,3,2,0.0,1.0,1826,1923
2004-08-07,Uganda,Kenya,1,1,0,0.5,0.5,1650,1664
2004-08-11,Guatemala,Trinidad and Tobago,4,1,3,1.0,0.0,1716,1676
2004-08-14,Uganda,Rwanda,1,2,1,0.0,1.0,1642,1620
2004-08-17,Algeria,Burkina Faso,2,2,0,0.5,0.5,1718,1633
2004-08-18,Austria,Germany,1,3,2,0.0,1.0,1761,1939
2004-08-18,Canada,Guatemala,0,2,2,0.0,1.0,1721,1725
2004-08-18,DR Congo,Mali,0,3,3,0.0,1.0,1664,1736
2004-08-18,Costa Rica,Honduras,2,5,3,0.0,1.0,1791,1765
2004-08-18,Croatia,Israel,1,0,1,1.0,0.0,1876,1729
2004-08-18,Cyprus,Albania,2,1,1,1.0,0.0,1617,1579
2004-08-18,Czech Republic,Greece,0,0,0,0.5,0.5,1939,1887
2004-08-18,El Salvador,Panama,2,1,1,1.0,0.0,1634,1626
2004-08-18,England,Ukraine,3,0,3,1.0,0.0,1973,1692
2004-08-18,Faroe Islands,Malta,3,2,1,1.0,0.0,1492,1448
2004-08-18,France,Bosnia and Herzegovina,1,1,0,0.5,0.5,2053,1667
2004-08-18,Haiti,Brazil,0,6,6,0.0,1.0,1646,2023
2004-08-18,Iceland,Italy,2,0,2,1.0,0.0,1692,1968
2004-08-18,Republic of Ireland,Bulgaria,1,1,0,0.5,0.5,1910,1811
2004-08-18,Jamaica,United States,1,1,0,0.5,0.5,1744,1920
2004-08-18,Japan,Argentina,1,2,1,0.0,1.0,1918,2022
2004-08-18,Jordan,Azerbaijan,1,1,0,0.5,0.5,1755,1506
2004-08-18,Kenya,Uganda,4,1,3,1.0,0.0,1672,1635
2004-08-18,Latvia,Wales,0,2,2,0.0,1.0,1599,1742
2004-08-18,Liechtenstein,Estonia,1,2,1,0.0,1.0,1398,1574
2004-08-18,Moldova,Georgia,1,0,1,1.0,0.0,1549,1577
2004-08-18,Norway,Belgium,2,2,0,0.5,0.5,1862,1886
2004-08-18,Poland,Denmark,1,5,4,0.0,1.0,1829,1930
2004-08-18,Romania,Finland,2,1,1,1.0,0.0,1865,1724
2004-08-18,Russia,Lithuania,4,3,1,1.0,0.0,1832,1530
2004-08-18,Scotland,Hungary,0,3,3,0.0,1.0,1769,1726
2004-08-18,Senegal,Ivory Coast,1,2,1,0.0,1.0,1795,1811
2004-08-18,Slovakia,Luxembourg,3,1,2,1.0,0.0,1707,1335
2004-08-18,Slovenia,Serbia,1,1,0,0.5,0.5,1717,1776
2004-08-18,Spain,Venezuela,3,2,1,1.0,0.0,2006,1671
2004-08-18,Sweden,Netherlands,2,2,0,0.5,0.5,1889,1973
2004-08-18,Switzerland,Northern Ireland,0,0,0,0.5,0.5,1775,1665
2004-08-18,Tunisia,South Africa,0,2,2,0.0,1.0,1827,1782
2004-08-18,Turkey,Belarus,1,2,1,0.0,1.0,1847,1626
2004-08-18,Zimbabwe,Botswana,2,0,2,1.0,0.0,1725,1514
2004-08-18,North Macedonia,Armenia,3,0,3,1.0,0.0,1627,1559
2004-08-18,Saint Vincent and the Grenadines,Trinidad and Tobago,0,2,2,0.0,1.0,1572,1682
2004-08-19,Thailand,Malaysia,1,2,1,0.0,1.0,1699,1578
2004-08-20,Vietnam,Myanmar,5,0,5,1.0,0.0,1593,1530
2004-08-22,India,Myanmar,2,1,1,1.0,0.0,1552,1523
2004-08-22,Zimbabwe,Uganda,2,0,2,1.0,0.0,1731,1630
2004-08-24,Vietnam,India,2,1,1,1.0,0.0,1601,1545
2004-08-26,Bahrain,Kuwait,0,0,0,0.5,0.5,1722,1722
2004-08-26,Yemen,Syria,1,2,1,0.0,1.0,1469,1665
2004-08-28,Yemen,Syria,2,1,1,1.0,0.0,1482,1653
2004-08-28,Zambia,Rwanda,2,1,1,1.0,0.0,1706,1614
2004-08-31,Jordan,Lebanon,2,2,0,0.5,0.5,1752,1618
2004-08-31,Maldives,Oman,0,1,1,0.0,1.0,1399,1734
2004-09-01,Saudi Arabia,Kuwait,1,1,0,0.5,0.5,1843,1725
2004-09-02,Bahrain,Palestine,1,0,1,1.0,0.0,1726,1495
2004-09-03,Libya,Benin,4,1,3,1.0,0.0,1664,1523
2004-09-03,Maldives,Oman,1,2,1,0.0,1.0,1397,1737
2004-09-03,Netherlands,Liechtenstein,3,0,3,1.0,0.0,1974,1398
2004-09-03,Spain,Scotland,1,1,0,0.5,0.5,2002,1774
2004-09-04,Albania,Greece,2,1,1,1.0,0.0,1593,1874
2004-09-04,Austria,England,2,2,0,0.5,0.5,1766,1969
2004-09-04,Azerbaijan,Wales,1,1,0,0.5,0.5,1511,1738
2004-09-04,Belgium,Lithuania,1,1,0,0.5,0.5,1880,1537
2004-09-04,Burkina Faso,Uganda,2,0,2,1.0,0.0,1641,1623
2004-09-04,Canada,Honduras,1,1,0,0.5,0.5,1723,1764
2004-09-04,Croatia,Hungary,3,0,3,1.0,0.0,1881,1722
2004-09-04,Denmark,Ukraine,1,1,0,0.5,0.5,1926,1697
2004-09-04,Estonia,Luxembourg,4,0,4,1.0,0.0,1578,1332
2004-09-04,Finland,Andorra,3,0,3,1.0,0.0,1727,1403
2004-09-04,France,Israel,0,0,0,0.5,0.5,2048,1735
2004-09-04,Iceland,Bulgaria,1,3,2,0.0,1.0,1687,1817
2004-09-04,Republic of Ireland,Cyprus,3,0,3,1.0,0.0,1913,1615
2004-09-04,Italy,Norway,2,1,1,1.0,0.0,1974,1857
2004-09-04,Jamaica,Panama,1,2,1,0.0,1.0,1734,1637
2004-09-04,Kenya,Malawi,3,2,1,1.0,0.0,1678,1574
2004-09-04,Latvia,Portugal,0,2,2,0.0,1.0,1598,1953
2004-09-04,Malta,Sweden,0,7,7,0.0,1.0,1447,1891
2004-09-04,Morocco,Tunisia,1,1,0,0.5,0.5,1842,1828
2004-09-04,Northern Ireland,Poland,0,3,3,0.0,1.0,1661,1834
2004-09-04,Peru,Argentina,1,3,2,0.0,1.0,1767,2026
2004-09-04,Romania,North Macedonia,2,1,1,1.0,0.0,1869,1624
2004-09-04,Russia,Slovakia,1,1,0,0.5,0.5,1830,1710
2004-09-04,San Marino,Serbia,0,3,3,0.0,1.0,1390,1778
2004-09-04,Singapore,Indonesia,2,0,2,1.0,0.0,1568,1619
2004-09-04,Slovenia,Moldova,3,0,3,1.0,0.0,1722,1545
2004-09-04,Saint Kitts and Nevis,Trinidad and Tobago,1,2,1,0.0,1.0,1612,1689
2004-09-04,Switzerland,Faroe Islands,6,0,6,1.0,0.0,1778,1490
2004-09-04,Turkey,Georgia,1,1,0,0.5,0.5,1842,1583
2004-09-04,United States,El Salvador,2,0,2,1.0,0.0,1923,1632
2004-09-04,Zambia,Liberia,1,0,1,1.0,0.0,1712,1602
2004-09-05,Algeria,Gabon,0,3,3,0.0,1.0,1709,1670
2004-09-05,Angola,Rwanda,1,0,1,1.0,0.0,1704,1608
2004-09-05,Brazil,Bolivia,3,1,2,1.0,0.0,2026,1688
2004-09-05,Chile,Colombia,0,0,0,0.5,0.5,1770,1856
2004-09-05,DR Congo,South Africa,1,0,1,1.0,0.0,1675,1772
2004-09-05,Egypt,Cameroon,3,2,1,1.0,0.0,1856,1848
2004-09-05,Ghana,Cape Verde,2,0,2,1.0,0.0,1679,1548
2004-09-05,Guatemala,Costa Rica,2,1,1,1.0,0.0,1735,1782
2004-09-05,Guinea,Botswana,4,0,4,1.0,0.0,1679,1510
2004-09-05,Ivory Coast,Sudan,5,0,5,1.0,0.0,1815,1590
2004-09-05,Mali,Senegal,2,2,0,0.5,0.5,1738,1794
2004-09-05,Paraguay,Venezuela,1,0,1,1.0,0.0,1867,1668
2004-09-05,Togo,Congo,2,0,2,1.0,0.0,1655,1623
2004-09-05,Uruguay,Ecuador,1,0,1,1.0,0.0,1857,1778
2004-09-05,Zimbabwe,Nigeria,0,3,3,0.0,1.0,1726,1870
2004-09-08,Andorra,Romania,1,5,4,0.0,1.0,1402,1871
2004-09-08,Armenia,Finland,0,2,2,0.0,1.0,1555,1732
2004-09-08,Austria,Azerbaijan,2,0,2,1.0,0.0,1769,1509
2004-09-08,Bosnia and Herzegovina,Spain,1,1,0,0.5,0.5,1673,1997
2004-09-08,Costa Rica,Canada,1,0,1,1.0,0.0,1789,1717
2004-09-08,El Salvador,Jamaica,0,3,3,0.0,1.0,1627,1740
2004-09-08,Faroe Islands,France,0,2,2,0.0,1.0,1490,2049
2004-09-08,Georgia,Albania,2,0,2,1.0,0.0,1592,1585
2004-09-08,Germany,Brazil,1,1,0,0.5,0.5,1941,2025
2004-09-08,Greece,Turkey,0,0,0,0.5,0.5,1874,1843
2004-09-08,Honduras,Guatemala,2,2,0,0.5,0.5,1764,1736
2004-09-08,Hong Kong,Kuwait,0,2,2,0.0,1.0,1541,1730
2004-09-08,Hungary,Iceland,3,2,1,1.0,0.0,1730,1680
2004-09-08,India,Japan,0,4,4,0.0,1.0,1544,1920
2004-09-08,Israel,Cyprus,2,1,1,1.0,0.0,1741,1610
2004-09-08,Jordan,Iran,0,2,2,0.0,1.0,1747,1884
2004-09-08,Kazakhstan,Ukraine,1,2,1,0.0,1.0,1562,1703
2004-09-08,North Korea,Thailand,4,1,3,1.0,0.0,1694,1691
2004-09-08,Kyrgyzstan,Bahrain,1,2,1,0.0,1.0,1451,1729
2004-09-08,Laos,Qatar,1,6,5,0.0,1.0,1381,1726
2004-09-08,Lithuania,San Marino,4,0,4,1.0,0.0,1542,1386
2004-09-08,Luxembourg,Latvia,3,4,1,0.0,1.0,1330,1601
2004-09-08,Malaysia,China PR,0,1,1,0.0,1.0,1575,1830
2004-09-08,Maldives,Lebanon,2,5,3,0.0,1.0,1394,1622
2004-09-08,Moldova,Italy,0,1,1,0.0,1.0,1544,1976
2004-09-08,Netherlands,Czech Republic,2,0,2,1.0,0.0,1982,1932
2004-09-08,Norway,Belarus,1,1,0,0.5,0.5,1853,1631
2004-09-08,Palestine,Uzbekistan,0,3,3,0.0,1.0,1492,1714
2004-09-08,Panama,United States,1,1,0,0.5,0.5,1643,1918
2004-09-08,Poland,England,1,2,1,0.0,1.0,1829,1975
2004-09-08,Portugal,Estonia,4,0,4,1.0,0.0,1955,1577
2004-09-08,Scotland,Slovenia,0,0,0,0.5,0.5,1773,1724
2004-09-08,Singapore,Oman,0,2,2,0.0,1.0,1564,1742
2004-09-08,Slovakia,Liechtenstein,7,0,7,1.0,0.0,1713,1396
2004-09-08,Sri Lanka,Indonesia,2,2,0,0.5,0.5,1420,1615
2004-09-08,Sweden,Croatia,0,1,1,0.0,1.0,1883,1890
2004-09-08,Switzerland,Republic of Ireland,1,1,0,0.5,0.5,1781,1911
2004-09-08,Tajikistan,Syria,0,1,1,0.0,1.0,1566,1660
2004-09-08,Trinidad and Tobago,Mexico,1,3,2,0.0,1.0,1686,1918
2004-09-08,Turkmenistan,Saudi Arabia,0,1,1,0.0,1.0,1607,1847
2004-09-08,Vietnam,South Korea,1,2,1,0.0,1.0,1599,1867
2004-09-08,Wales,Northern Ireland,2,2,0,0.5,0.5,1737,1663
2004-09-08,Yemen,United Arab Emirates,3,1,2,1.0,0.0,1495,1684
2004-09-08,Taiwan,Iraq,1,4,3,0.0,1.0,1414,1741
2004-09-10,Saint Vincent and the Grenadines,Saint Kitts and Nevis,1,0,1,1.0,0.0,1581,1604
2004-09-19,Mozambique,Angola,0,1,1,0.0,1.0,1563,1710
2004-09-25,British Virgin Islands,United States Virgin Islands,2,1,1,1.0,0.0,1413,1411
2004-09-29,Kuwait,Syria,1,1,0,0.5,0.5,1729,1662
2004-09-30,Botswana,Zambia,1,0,1,1.0,0.0,1523,1700
2004-10-02,Jamaica,Guatemala,2,2,0,0.5,0.5,1740,1737
2004-10-03,Gabon,Benin,2,0,2,1.0,0.0,1675,1519
2004-10-03,Lebanon,Kuwait,1,3,2,0.0,1.0,1617,1735
2004-10-06,Lebanon,Kuwait,1,1,0,0.5,0.5,1620,1733
2004-10-06,Saudi Arabia,Syria,2,2,0,0.5,0.5,1844,1666
2004-10-06,Mexico,Saint Vincent and the Grenadines,7,0,7,1.0,0.0,1921,1579
2004-10-07,Oman,Iraq,1,0,1,1.0,0.0,1750,1734
2004-10-08,Libya,Egypt,2,1,1,1.0,0.0,1677,1844
2004-10-08,Qatar,Syria,1,2,1,0.0,1.0,1717,1676
2004-10-08,Singapore,United Arab Emirates,1,2,1,0.0,1.0,1559,1690
2004-10-08,Thailand,Jordan,2,3,1,0.0,1.0,1685,1754
2004-10-09,Albania,Denmark,0,2,2,0.0,1.0,1584,1928
2004-10-09,Argentina,Uruguay,4,2,2,1.0,0.0,2031,1853
2004-10-09,Austria,Poland,1,3,2,0.0,1.0,1763,1836
2004-10-09,Azerbaijan,Northern Ireland,0,0,0,0.5,0.5,1513,1660
2004-10-09,Belarus,Moldova,4,0,4,1.0,0.0,1638,1538
2004-10-09,Bolivia,Peru,1,0,1,1.0,0.0,1698,1758
2004-10-09,Bosnia and Herzegovina,Serbia,0,0,0,0.5,0.5,1676,1776
2004-10-09,Botswana,Kenya,2,1,1,1.0,0.0,1535,1667
2004-10-09,Cape Verde,Burkina Faso,1,0,1,1.0,0.0,1559,1631
2004-10-09,Colombia,Paraguay,1,1,0,0.5,0.5,1857,1867
2004-10-09,Costa Rica,Guatemala,5,0,5,1.0,0.0,1796,1731
2004-10-09,Croatia,Bulgaria,2,2,0,0.5,0.5,1889,1819
2004-10-09,Cyprus,Faroe Islands,2,2,0,0.5,0.5,1608,1493
2004-10-09,Czech Republic,Romania,1,0,1,1.0,0.0,1939,1865
2004-10-09,El Salvador,United States,0,2,2,0.0,1.0,1625,1921
2004-10-09,England,Wales,2,0,2,1.0,0.0,1979,1734
2004-10-09,Finland,Armenia,3,1,2,1.0,0.0,1737,1551
2004-10-09,France,Republic of Ireland,0,0,0,0.5,0.5,2046,1915
2004-10-09,Gabon,Nigeria,1,1,0,0.5,0.5,1680,1866
2004-10-09,Honduras,Canada,1,1,0,0.5,0.5,1763,1719
2004-10-09,Iran,Germany,0,2,2,0.0,1.0,1878,1948
2004-10-09,Israel,Switzerland,2,2,0,0.5,0.5,1742,1781
2004-10-09,Liechtenstein,Portugal,2,2,0,0.5,0.5,1404,1948
2004-10-09,Luxembourg,Russia,0,4,4,0.0,1.0,1330,1831
2004-10-09,North Macedonia,Netherlands,2,2,0,0.5,0.5,1631,1976
2004-10-09,Malawi,Tunisia,2,2,0,0.5,0.5,1579,1824
2004-10-09,Malta,Iceland,0,0,0,0.5,0.5,1452,1676
2004-10-09,Panama,Jamaica,1,1,0,0.5,0.5,1646,1738
2004-10-09,Rwanda,Algeria,1,1,0,0.5,0.5,1611,1707
2004-10-09,Scotland,Norway,0,1,1,0.0,1.0,1767,1860
2004-10-09,Slovakia,Latvia,4,1,3,1.0,0.0,1719,1596
2004-10-09,Slovenia,Italy,1,0,1,1.0,0.0,1737,1964
2004-10-09,Solomon Islands,Australia,1,5,4,0.0,1.0,1662,1897
2004-10-09,Spain,Belgium,2,0,2,1.0,0.0,2003,1875
2004-10-09,Sri Lanka,Turkmenistan,2,2,0,0.5,0.5,1424,1604
2004-10-09,Sudan,Cameroon,1,1,0,0.5,0.5,1596,1843
2004-10-09,Sweden,Hungary,3,0,3,1.0,0.0,1888,1726
2004-10-09,Turkey,Kazakhstan,4,0,4,1.0,0.0,1846,1560
2004-10-09,Ukraine,Greece,1,1,0,0.5,0.5,1707,1871
2004-10-09,Venezuela,Brazil,2,5,3,0.0,1.0,1667,2027
2004-10-10,Angola,Zimbabwe,1,0,1,1.0,0.0,1719,1718
2004-10-10,Benin,Ivory Coast,0,1,1,0.0,1.0,1517,1818
2004-10-10,Congo,Zambia,2,3,1,0.0,1.0,1617,1707
2004-10-10,Ecuador,Chile,2,0,2,1.0,0.0,1786,1763
2004-10-10,Ghana,DR Congo,0,0,0,0.5,0.5,1679,1676
2004-10-10,Guinea,Morocco,1,1,0,0.5,0.5,1683,1839
2004-10-10,Liberia,Senegal,0,3,3,0.0,1.0,1599,1798
2004-10-10,Togo,Mali,1,0,1,1.0,0.0,1665,1729
2004-10-10,Trinidad and Tobago,Saint Kitts and Nevis,5,1,4,1.0,0.0,1693,1598
2004-10-10,Uganda,South Africa,0,1,1,0.0,1.0,1619,1777
2004-10-10,Saint Vincent and the Grenadines,Mexico,0,1,1,0.0,1.0,1578,1923
2004-10-12,Australia,Solomon Islands,6,0,6,1.0,0.0,1901,1659
2004-10-12,Bolivia,Uruguay,0,0,0,0.5,0.5,1702,1850
2004-10-12,Indonesia,Saudi Arabia,1,3,2,0.0,1.0,1612,1848
2004-10-13,Andorra,North Macedonia,1,0,1,1.0,0.0,1415,1619
2004-10-13,Armenia,Czech Republic,0,3,3,0.0,1.0,1550,1941
2004-10-13,Azerbaijan,England,0,1,1,0.0,1.0,1512,1981
2004-10-13,Brazil,Colombia,0,0,0,0.5,0.5,2024,1861
2004-10-13,Bulgaria,Malta,4,1,3,1.0,0.0,1821,1451
2004-10-13,Canada,Costa Rica,1,3,2,0.0,1.0,1713,1803
2004-10-13,Chile,Argentina,0,0,0,0.5,0.5,1769,2026
2004-10-13,Cyprus,France,0,2,2,0.0,1.0,1607,2048
2004-10-13,Denmark,Turkey,1,1,0,0.5,0.5,1927,1848
2004-10-13,Guatemala,Honduras,1,0,1,1.0,0.0,1740,1755
2004-10-13,Hong Kong,Malaysia,2,0,2,1.0,0.0,1550,1567
2004-10-13,Iceland,Sweden,1,4,3,0.0,1.0,1673,1892
2004-10-13,Iraq,Uzbekistan,1,2,1,0.0,1.0,1726,1723
2004-10-13,Republic of Ireland,Faroe Islands,2,0,2,1.0,0.0,1917,1492
2004-10-13,Italy,Belarus,4,3,1,1.0,0.0,1967,1636
2004-10-13,Jamaica,El Salvador,0,0,0,0.5,0.5,1736,1628
2004-10-13,Kazakhstan,Albania,0,1,1,0.0,1.0,1553,1592
2004-10-13,North Korea,Yemen,2,1,1,1.0,0.0,1698,1492
2004-10-13,Kuwait,China PR,1,0,1,1.0,0.0,1744,1820
2004-10-13,Laos,Jordan,2,3,1,0.0,1.0,1380,1756
2004-10-13,Latvia,Estonia,2,2,0,0.5,0.5,1596,1578
2004-10-13,Lebanon,South Korea,1,1,0,0.5,0.5,1625,1863
2004-10-13,Lithuania,Spain,0,0,0,0.5,0.5,1549,1997
2004-10-13,Luxembourg,Liechtenstein,0,4,4,0.0,1.0,1324,1411
2004-10-13,Maldives,Vietnam,3,0,3,1.0,0.0,1407,1587
2004-10-13,Mexico,Trinidad and Tobago,3,0,3,1.0,0.0,1927,1690
2004-10-13,Moldova,Scotland,1,1,0,0.5,0.5,1543,1763
2004-10-13,Netherlands,Finland,3,1,2,1.0,0.0,1980,1734
2004-10-13,Northern Ireland,Austria,3,3,0,0.5,0.5,1663,1761
2004-10-13,Norway,Slovenia,3,0,3,1.0,0.0,1866,1732
2004-10-13,Oman,Japan,0,1,1,0.0,1.0,1746,1925
2004-10-13,Paraguay,Peru,1,1,0,0.5,0.5,1865,1761
2004-10-13,Portugal,Russia,7,1,6,1.0,0.0,1954,1826
2004-10-13,Qatar,Iran,2,3,1,0.0,1.0,1713,1883
2004-10-13,Serbia,San Marino,5,0,5,1.0,0.0,1778,1385
2004-10-13,Singapore,India,2,0,2,1.0,0.0,1567,1537
2004-10-13,Saint Kitts and Nevis,Saint Vincent and the Grenadines,0,3,3,0.0,1.0,1590,1587
2004-10-13,Syria,Bahrain,2,2,0,0.5,0.5,1678,1728
2004-10-13,Tajikistan,Kyrgyzstan,2,1,1,1.0,0.0,1572,1446
2004-10-13,Thailand,United Arab Emirates,3,0,3,1.0,0.0,1694,1682
2004-10-13,Ukraine,Georgia,2,0,2,1.0,0.0,1713,1587
2004-10-13,United States,Panama,6,0,6,1.0,0.0,1924,1644
2004-10-13,Wales,Poland,2,3,1,0.0,1.0,1729,1842
2004-10-14,Venezuela,Ecuador,3,1,2,1.0,0.0,1678,1776
2004-10-14,Taiwan,Palestine,0,1,1,0.0,1.0,1408,1499
2004-10-16,Jersey,Kernow,1,4,3,0.0,1.0,1712,1539
2004-10-17,Saint Lucia,Grenada,3,1,2,1.0,0.0,1542,1563
2004-10-19,Suriname,French Guiana,1,2,1,0.0,1.0,1573,1445
2004-10-20,Ecuador,Jordan,0,3,3,0.0,1.0,1768,1765
2004-10-22,Libya,Jordan,1,0,1,1.0,0.0,1687,1756
2004-10-22,Nigeria,Ecuador,2,2,0,0.5,0.5,1864,1771
2004-10-24,Zimbabwe,Zambia,0,0,0,0.5,0.5,1718,1708
2004-10-27,Mexico,Ecuador,2,1,1,1.0,0.0,1932,1767
2004-10-31,Saint Kitts and Nevis,Montserrat,6,1,5,1.0,0.0,1595,1409
2004-11-01,Yemen,Zambia,2,2,0,0.5,0.5,1497,1704
2004-11-02,Montserrat,Antigua and Barbuda,4,5,1,0.0,1.0,1403,1482
2004-11-02,Saint Kitts and Nevis,Saint Lucia,1,1,0,0.5,0.5,1594,1544
2004-11-04,Saint Kitts and Nevis,Antigua and Barbuda,2,0,2,1.0,0.0,1600,1477
2004-11-05,Kuwait,India,2,3,1,0.0,1.0,1732,1550
2004-11-06,Antigua and Barbuda,Saint Lucia,1,2,1,0.0,1.0,1471,1551
2004-11-10,Guadeloupe,French Guiana,0,1,1,0.0,1.0,1556,1456
2004-11-10,Kuwait,Kyrgyzstan,3,0,3,1.0,0.0,1735,1444
2004-11-10,Martinique,Dominica,5,1,4,1.0,0.0,1674,1457
2004-11-10,Mexico,Guatemala,2,0,2,1.0,0.0,1936,1737
2004-11-11,United Arab Emirates,Jordan,4,0,4,1.0,0.0,1692,1747
2004-11-12,Guadeloupe,Dominica,7,0,7,1.0,0.0,1562,1452
2004-11-12,Martinique,French Guiana,0,0,0,0.5,0.5,1670,1461
2004-11-13,Guatemala,Bolivia,1,0,1,1.0,0.0,1745,1695
2004-11-13,Saint Kitts and Nevis,Mexico,0,5,5,0.0,1.0,1598,1939
2004-11-14,Dominica,French Guiana,0,4,4,0.0,1.0,1445,1469
2004-11-14,Martinique,Guadeloupe,0,0,0,0.5,0.5,1668,1565
2004-11-16,Australia,Norway,2,2,0,0.5,0.5,1901,1867
2004-11-16,Iraq,Palestine,4,1,3,1.0,0.0,1730,1496
2004-11-16,Republic of Ireland,Croatia,1,0,1,1.0,0.0,1925,1882
2004-11-17,Algeria,Senegal,1,2,1,0.0,1.0,1702,1804
2004-11-17,Andorra,Netherlands,0,3,3,0.0,1.0,1415,1981
2004-11-17,Argentina,Venezuela,3,2,1,1.0,0.0,2028,1677
2004-11-17,Armenia,Romania,1,1,0,0.5,0.5,1556,1860
2004-11-17,Azerbaijan,Bulgaria,0,0,0,0.5,0.5,1518,1816
2004-11-17,Bahrain,Tajikistan,4,0,4,1.0,0.0,1733,1568
2004-11-17,Belgium,Serbia,0,2,2,0.0,1.0,1865,1789
2004-11-17,China PR,Hong Kong,7,0,7,1.0,0.0,1823,1548
2004-11-17,Colombia,Bolivia,1,0,1,1.0,0.0,1866,1691
2004-11-17,Cyprus,Israel,1,2,1,0.0,1.0,1602,1748
2004-11-17,Ecuador,Brazil,1,0,1,1.0,0.0,1781,2011
2004-11-17,France,Poland,0,0,0,0.5,0.5,2044,1847
2004-11-17,Georgia,Denmark,2,2,0,0.5,0.5,1594,1921
2004-11-17,Germany,Cameroon,3,0,3,1.0,0.0,1954,1838
2004-11-17,Greece,Kazakhstan,3,1,2,1.0,0.0,1874,1551
2004-11-17,Guatemala,Canada,0,1,1,0.0,1.0,1737,1722
2004-11-17,Honduras,Costa Rica,0,0,0,0.5,0.5,1757,1802
2004-11-17,Indonesia,Turkmenistan,3,1,2,1.0,0.0,1620,1597
2004-11-17,Iran,Laos,7,0,7,1.0,0.0,1884,1380
2004-11-17,Italy,Finland,1,0,1,1.0,0.0,1971,1731
2004-11-17,Japan,Singapore,1,0,1,1.0,0.0,1927,1566
2004-11-17,Kenya,Guinea,2,1,1,1.0,0.0,1676,1675
2004-11-17,South Korea,Maldives,2,0,2,1.0,0.0,1865,1406
2004-11-17,Kuwait,Malaysia,6,1,5,1.0,0.0,1740,1563
2004-11-17,Lebanon,Vietnam,0,0,0,0.5,0.5,1625,1588
2004-11-17,Liechtenstein,Latvia,1,3,2,0.0,1.0,1407,1601
2004-11-17,Luxembourg,Portugal,0,5,5,0.0,1.0,1324,1955
2004-11-17,North Macedonia,Czech Republic,0,2,2,0.0,1.0,1617,1944
2004-11-17,Malta,Hungary,0,2,2,0.0,1.0,1449,1729
2004-11-17,Mexico,Saint Kitts and Nevis,8,0,8,1.0,0.0,1941,1597
2004-11-17,Morocco,Burkina Faso,4,0,4,1.0,0.0,1843,1628
2004-11-17,Oman,India,0,0,0,0.5,0.5,1742,1555
2004-11-17,Panama,El Salvador,3,0,3,1.0,0.0,1652,1621
2004-11-17,Peru,Chile,2,1,1,1.0,0.0,1770,1761
2004-11-17,Qatar,Jordan,2,0,2,1.0,0.0,1722,1739
2004-11-17,Russia,Estonia,4,0,4,1.0,0.0,1830,1575
2004-11-17,San Marino,Lithuania,0,1,1,0.0,1.0,1381,1554
2004-11-17,Saudi Arabia,Sri Lanka,3,0,3,1.0,0.0,1850,1423
2004-11-17,Scotland,Sweden,1,4,3,0.0,1.0,1758,1898
2004-11-17,Slovakia,Slovenia,0,0,0,0.5,0.5,1720,1732
2004-11-17,South Africa,Nigeria,2,1,1,1.0,0.0,1787,1855
2004-11-17,Spain,England,1,0,1,1.0,0.0,2005,1974
2004-11-17,Syria,Kyrgyzstan,0,1,1,0.0,1.0,1666,1457
2004-11-17,Thailand,Yemen,1,1,0,0.5,0.5,1690,1502
2004-11-17,Turkey,Ukraine,0,3,3,0.0,1.0,1838,1724
2004-11-17,United Arab Emirates,North Korea,1,0,1,1.0,0.0,1701,1690
2004-11-17,Uruguay,Paraguay,1,0,1,1.0,0.0,1859,1857
2004-11-17,United States,Jamaica,1,1,0,0.5,0.5,1921,1740
2004-11-17,Uzbekistan,Taiwan,6,1,5,1.0,0.0,1726,1406
2004-11-17,Trinidad and Tobago,Saint Vincent and the Grenadines,2,1,1,1.0,0.0,1696,1582
2004-11-20,Zambia,Angola,0,0,0,0.5,0.5,1705,1719
2004-11-22,United Arab Emirates,Belarus,2,3,1,0.0,1.0,1692,1646
2004-11-24,Cayman Islands,Bermuda,1,2,1,0.0,1.0,1452,1515
2004-11-24,Grenada,Suriname,2,2,0,0.5,0.5,1564,1573
2004-11-24,Haiti,United States Virgin Islands,11,0,11,1.0,0.0,1650,1408
2004-11-24,Jamaica,Saint Martin,12,0,12,1.0,0.0,1744,1505
2004-11-24,Trinidad and Tobago,Puerto Rico,5,0,5,1.0,0.0,1698,1350
2004-11-26,British Virgin Islands,Cayman Islands,0,1,1,0.0,1.0,1406,1460
2004-11-26,Jamaica,United States Virgin Islands,11,1,10,1.0,0.0,1747,1406
2004-11-26,Puerto Rico,Suriname,1,1,0,0.5,0.5,1355,1569
2004-11-26,Saint Martin,Haiti,0,2,2,0.0,1.0,1501,1655
2004-11-26,Trinidad and Tobago,Grenada,2,0,2,1.0,0.0,1704,1559
2004-11-27,United Arab Emirates,Kuwait,0,1,1,0.0,1.0,1686,1747
2004-11-28,Bermuda,British Virgin Islands,0,2,2,0.0,1.0,1505,1417
2004-11-28,Grenada,Puerto Rico,5,2,3,1.0,0.0,1563,1352
2004-11-28,Jamaica,Haiti,3,1,2,1.0,0.0,1753,1650
2004-11-28,Singapore,Myanmar,1,0,1,1.0,0.0,1574,1516
2004-11-28,Trinidad and Tobago,Suriname,1,0,1,1.0,0.0,1710,1564
2004-11-28,United States Virgin Islands,Saint Martin,0,0,0,0.5,0.5,1409,1499
2004-11-29,Egypt,Bulgaria,1,1,0,0.5,0.5,1844,1817
2004-11-30,Hungary,Slovakia,0,1,1,0.0,1.0,1721,1729
2004-11-30,Singapore,Hong Kong,0,0,0,0.5,0.5,1574,1549
2004-11-30,Thailand,Estonia,0,0,0,0.5,0.5,1688,1578
2004-12-01,Bahrain,Finland,1,2,1,0.0,1.0,1725,1740
2004-12-01,Latvia,Oman,2,3,1,0.0,1.0,1597,1747
2004-12-01,Qatar,Lebanon,4,1,3,1.0,0.0,1728,1620
2004-12-02,Hong Kong,Myanmar,2,2,0,0.5,0.5,1549,1517
2004-12-02,Hungary,Estonia,5,0,5,1.0,0.0,1726,1574
2004-12-02,Thailand,Slovakia,1,1,0,0.5,0.5,1689,1729
2004-12-03,Bahrain,Latvia,2,2,0,0.5,0.5,1723,1600
2004-12-03,Finland,Oman,0,0,0,0.5,0.5,1741,1747
2004-12-03,Iraq,Yemen,3,1,2,1.0,0.0,1734,1499
2004-12-03,United Arab Emirates,Kuwait,1,1,0,0.5,0.5,1688,1746
2004-12-05,Qatar,Yemen,3,0,3,1.0,0.0,1732,1496
2004-12-06,Kuwait,Tajikistan,3,0,3,1.0,0.0,1751,1564
2004-12-07,Laos,Indonesia,0,6,6,0.0,1.0,1377,1624
2004-12-07,Vietnam,Singapore,1,1,0,0.5,0.5,1588,1575
2004-12-08,Malaysia,Timor-Leste,5,0,5,1.0,0.0,1570,1485
2004-12-08,Philippines,Myanmar,0,1,1,0.0,1.0,1244,1520
2004-12-09,Indonesia,Singapore,0,0,0,0.5,0.5,1623,1577
2004-12-09,Vietnam,Cambodia,9,1,8,1.0,0.0,1592,1360
2004-12-10,Iraq,Oman,1,3,2,0.0,1.0,1727,1755
2004-12-10,Malaysia,Philippines,4,1,3,1.0,0.0,1573,1242
2004-12-10,Qatar,United Arab Emirates,2,2,0,0.5,0.5,1731,1690
2004-12-10,Thailand,Myanmar,1,1,0,0.5,0.5,1686,1524
2004-12-11,Bahrain,Yemen,1,1,0,0.5,0.5,1719,1501
2004-12-11,Ethiopia,Burundi,2,1,1,1.0,0.0,1575,1530
2004-12-11,Laos,Cambodia,2,1,1,1.0,0.0,1385,1353
2004-12-11,Rwanda,Zanzibar,4,2,2,1.0,0.0,1615,1408
2004-12-11,Saudi Arabia,Kuwait,1,2,1,0.0,1.0,1840,1762
2004-12-11,Vietnam,Indonesia,0,3,3,0.0,1.0,1585,1631
2004-12-12,British Virgin Islands,Trinidad and Tobago,0,4,4,0.0,1.0,1415,1713
2004-12-12,Cuba,Martinique,2,0,2,1.0,0.0,1688,1661
2004-12-12,Timor-Leste,Thailand,0,8,8,0.0,1.0,1482,1690
2004-12-12,Haiti,Saint Kitts and Nevis,1,0,1,1.0,0.0,1657,1591
2004-12-12,Kenya,Sudan,2,2,0,0.5,0.5,1675,1598
2004-12-12,Malaysia,Myanmar,0,1,1,0.0,1.0,1564,1534
2004-12-12,Saint Lucia,Jamaica,1,1,0,0.5,0.5,1556,1749
2004-12-12,Uganda,Somalia,2,0,2,1.0,0.0,1623,1396
2004-12-13,Burundi,Rwanda,3,1,2,1.0,0.0,1540,1606
2004-12-13,Indonesia,Cambodia,8,0,8,1.0,0.0,1634,1351
2004-12-13,Oman,United Arab Emirates,2,1,1,1.0,0.0,1762,1684
2004-12-13,Qatar,Iraq,3,3,0,0.5,0.5,1731,1728
2004-12-13,Singapore,Laos,6,2,4,1.0,0.0,1581,1382
2004-12-13,Zanzibar,Tanzania,4,2,2,1.0,0.0,1419,1495
2004-12-14,Kuwait,Bahrain,1,1,0,0.5,0.5,1762,1720
2004-12-14,Malaysia,Thailand,2,1,1,1.0,0.0,1575,1680
2004-12-14,Philippines,Timor-Leste,2,1,1,1.0,0.0,1255,1470
2004-12-14,Saudi Arabia,Yemen,2,0,2,1.0,0.0,1842,1500
2004-12-14,Somalia,Kenya,0,1,1,0.0,1.0,1394,1678
2004-12-14,Sudan,Uganda,2,1,1,1.0,0.0,1607,1615
2004-12-15,Cambodia,Singapore,0,3,3,0.0,1.0,1348,1585
2004-12-15,Ethiopia,Rwanda,0,0,0,0.5,0.5,1576,1606
2004-12-15,Lesotho,Botswana,1,1,0,0.5,0.5,1483,1534
2004-12-15,Saint Kitts and Nevis,Haiti,0,2,2,0.0,1.0,1585,1664
2004-12-15,Tanzania,Burundi,0,2,2,0.0,1.0,1489,1547
2004-12-15,Vietnam,Laos,3,0,3,1.0,0.0,1589,1379
2004-12-16,Myanmar,Timor-Leste,3,1,2,1.0,0.0,1541,1464
2004-12-16,Iraq,United Arab Emirates,1,1,0,0.5,0.5,1727,1686
2004-12-16,Japan,Germany,0,3,3,0.0,1.0,1920,1962
2004-12-16,Qatar,Oman,2,1,1,1.0,0.0,1740,1754
2004-12-16,Thailand,Philippines,3,1,2,1.0,0.0,1682,1254
2004-12-17,Bahrain,Saudi Arabia,3,0,3,1.0,0.0,1731,1832
2004-12-17,Burundi,Zanzibar,2,1,1,1.0,0.0,1553,1414
2004-12-17,Ethiopia,Tanzania,2,0,2,1.0,0.0,1583,1483
2004-12-17,Kuwait,Yemen,3,0,3,1.0,0.0,1765,1498
2004-12-18,Iran,Panama,1,0,1,1.0,0.0,1888,1649
2004-12-18,Kenya,Uganda,1,1,0,0.5,0.5,1677,1617
2004-12-18,Maldives,Sri Lanka,0,0,0,0.5,0.5,1407,1423
2004-12-18,Sudan,Somalia,4,0,4,1.0,0.0,1611,1391
2004-12-19,Ethiopia,Zanzibar,3,0,3,1.0,0.0,1588,1410
2004-12-19,Jamaica,Saint Lucia,2,1,1,1.0,0.0,1753,1553
2004-12-19,South Korea,Germany,3,1,2,1.0,0.0,1876,1952
2004-12-19,Tanzania,Rwanda,1,5,4,0.0,1.0,1478,1612
2004-12-19,Trinidad and Tobago,British Virgin Islands,2,0,2,1.0,0.0,1716,1413
2004-12-20,Oman,Bahrain,3,2,1,1.0,0.0,1762,1724
2004-12-20,Qatar,Kuwait,2,0,2,1.0,0.0,1749,1757
2004-12-21,Martinique,Cuba,0,2,2,0.0,1.0,1654,1696
2004-12-21,Thailand,Germany,1,5,4,0.0,1.0,1680,1955
2004-12-21,Venezuela,Guatemala,0,1,1,0.0,1.0,1671,1744
2004-12-22,Ethiopia,Kenya,2,2,0,0.5,0.5,1591,1675
2004-12-22,Sudan,Burundi,1,2,1,0.0,1.0,1602,1563
2004-12-23,Bahrain,Kuwait,3,1,2,1.0,0.0,1733,1749
2004-12-24,Qatar,Oman,1,1,0,0.5,0.5,1750,1762
2004-12-25,Ethiopia,Burundi,3,0,3,1.0,0.0,1599,1556
2004-12-25,Kenya,Sudan,1,2,1,0.0,1.0,1666,1612
2004-12-28,Indonesia,Malaysia,1,2,1,0.0,1.0,1625,1585
2004-12-29,Myanmar,Singapore,3,4,1,0.0,1.0,1535,1592
2004-12-29,Basque Country,Honduras,2,0,2,1.0,0.0,1717,1748
2004-12-29,Catalonia,Argentina,0,3,3,0.0,1.0,1585,2030
2004-12-29,Andalusia,Malta,0,0,0,0.5,0.5,1566,1452
2005-01-02,Singapore,Myanmar,4,2,2,1.0,0.0,1599,1529
2005-01-03,Malaysia,Indonesia,1,4,3,0.0,1.0,1578,1633
2005-01-08,Egypt,Uganda,3,0,3,1.0,0.0,1848,1614
2005-01-08,Indonesia,Singapore,1,3,2,0.0,1.0,1625,1608
2005-01-08,Jamaica,French Guiana,5,0,5,1.0,0.0,1756,1467
2005-01-09,Haiti,Cuba,0,1,1,0.0,1.0,1657,1704
2005-01-12,Antigua and Barbuda,Trinidad and Tobago,2,1,1,1.0,0.0,1484,1704
2005-01-12,Costa Rica,Haiti,3,3,0,0.5,0.5,1799,1661
2005-01-15,Colombia,South Korea,2,1,1,1.0,0.0,1875,1868
2005-01-15,French Guiana,Jamaica,0,0,0,0.5,0.5,1473,1751
2005-01-15,Malaysia,Myanmar,2,1,1,1.0,0.0,1585,1523
2005-01-16,Cuba,Haiti,1,1,0,0.5,0.5,1704,1662
2005-01-16,Singapore,Indonesia,2,1,1,1.0,0.0,1617,1617
2005-01-17,Guatemala,Colombia,1,1,0,0.5,0.5,1747,1873
2005-01-19,Paraguay,South Korea,1,1,0,0.5,0.5,1858,1868
2005-01-21,Trinidad and Tobago,Azerbaijan,1,0,1,1.0,0.0,1709,1514
2005-01-22,Kuwait,Norway,1,1,0,0.5,0.5,1752,1865
2005-01-22,Sweden,South Korea,1,1,0,0.5,0.5,1898,1869
2005-01-23,Barbados,Grenada,3,0,3,1.0,0.0,1601,1556
2005-01-23,Guatemala,Paraguay,1,2,1,0.0,1.0,1742,1864
2005-01-23,Trinidad and Tobago,Azerbaijan,2,0,2,1.0,0.0,1713,1511
2005-01-25,Bahrain,Norway,0,1,1,0.0,1.0,1728,1871
2005-01-25,Saudi Arabia,Tajikistan,3,0,3,1.0,0.0,1835,1562
2005-01-26,Ecuador,Panama,2,0,2,1.0,0.0,1787,1644
2005-01-26,Kuwait,Syria,3,2,1,1.0,0.0,1759,1660
2005-01-26,Mexico,Sweden,0,0,0,0.5,0.5,1941,1899
2005-01-28,Jordan,Norway,0,0,0,0.5,0.5,1742,1869
2005-01-29,Ecuador,Panama,2,0,2,1.0,0.0,1792,1640
2005-01-29,Japan,Kazakhstan,4,0,4,1.0,0.0,1922,1550
2005-01-29,Saudi Arabia,Turkmenistan,1,0,1,1.0,0.0,1839,1594
2005-02-01,Trinidad and Tobago,Haiti,1,0,1,1.0,0.0,1720,1656
2005-02-02,Bahrain,Lebanon,2,1,1,1.0,0.0,1734,1615
2005-02-02,Hungary,Saudi Arabia,0,0,0,0.5,0.5,1729,1837
2005-02-02,Iran,Bosnia and Herzegovina,2,1,1,1.0,0.0,1892,1673
2005-02-02,Japan,Syria,3,0,3,1.0,0.0,1925,1658
2005-02-02,North Korea,Kuwait,0,0,0,0.5,0.5,1692,1758
2005-02-03,Trinidad and Tobago,Haiti,2,1,1,1.0,0.0,1727,1650
2005-02-04,South Korea,Egypt,0,1,1,0.0,1.0,1861,1857
2005-02-06,Barbados,Antigua and Barbuda,3,2,1,1.0,0.0,1607,1479
2005-02-06,Trinidad and Tobago,Haiti,0,1,1,0.0,1.0,1718,1660
2005-02-08,Cyprus,Austria,1,1,0,0.5,0.5,1606,1758
2005-02-08,Ivory Coast,DR Congo,2,2,0,0.5,0.5,1815,1680
2005-02-08,Latvia,Finland,1,2,1,0.0,1.0,1596,1746
2005-02-09,Albania,Ukraine,0,2,2,0.0,1.0,1587,1730
2005-02-09,Algeria,Burkina Faso,3,0,3,1.0,0.0,1709,1622
2005-02-09,Austria,Latvia,1,1,0,0.5,0.5,1755,1600
2005-02-09,Azerbaijan,Moldova,0,0,0,0.5,0.5,1512,1543
2005-02-09,Bahrain,Iran,0,0,0,0.5,0.5,1738,1889
2005-02-09,Bulgaria,Serbia,0,0,0,0.5,0.5,1817,1790
2005-02-09,Cameroon,Senegal,1,0,1,1.0,0.0,1846,1797
2005-02-09,Chile,Ecuador,3,0,3,1.0,0.0,1770,1784
2005-02-09,Costa Rica,Mexico,1,2,1,0.0,1.0,1795,1946
2005-02-09,Cyprus,Finland,1,2,1,0.0,1.0,1602,1751
2005-02-09,Egypt,Belgium,4,0,4,1.0,0.0,1866,1857
2005-02-09,England,Netherlands,0,0,0,0.5,0.5,1975,1981
2005-02-09,France,Sweden,1,1,0,0.5,0.5,2041,1903
2005-02-09,Georgia,Lithuania,1,0,1,1.0,0.0,1602,1547
2005-02-09,Germany,Argentina,2,2,0,0.5,0.5,1957,2029
2005-02-09,Greece,Denmark,2,1,1,1.0,0.0,1884,1912
2005-02-09,Guinea,Mali,2,2,0,0.5,0.5,1677,1728
2005-02-09,Hong Kong,Brazil,1,7,6,0.0,1.0,1548,2013
2005-02-09,Republic of Ireland,Portugal,1,0,1,1.0,0.0,1934,1947
2005-02-09,Israel,Croatia,3,3,0,0.5,0.5,1751,1880
2005-02-09,Italy,Russia,2,0,2,1.0,0.0,1976,1826
2005-02-09,Japan,North Korea,2,1,1,1.0,0.0,1929,1689
2005-02-09,South Korea,Kuwait,2,0,2,1.0,0.0,1867,1753
2005-02-09,North Macedonia,Andorra,0,0,0,0.5,0.5,1613,1420
2005-02-09,Malta,Norway,0,3,3,0.0,1.0,1451,1871
2005-02-09,Morocco,Kenya,5,1,4,1.0,0.0,1848,1662
2005-02-09,Northern Ireland,Canada,0,1,1,0.0,1.0,1657,1729
2005-02-09,Panama,Guatemala,0,0,0,0.5,0.5,1643,1740
2005-02-09,Poland,Belarus,1,3,2,0.0,1.0,1835,1659
2005-02-09,Romania,Slovakia,2,2,0,0.5,0.5,1858,1732
2005-02-09,Slovenia,Czech Republic,0,3,3,0.0,1.0,1729,1948
2005-02-09,South Africa,Australia,1,1,0,0.5,0.5,1790,1899
2005-02-09,Spain,San Marino,5,0,5,1.0,0.0,2006,1381
2005-02-09,Trinidad and Tobago,United States,1,2,1,0.0,1.0,1715,1925
2005-02-09,United Arab Emirates,Switzerland,1,2,1,0.0,1.0,1681,1787
2005-02-09,Uzbekistan,Saudi Arabia,1,1,0,0.5,0.5,1729,1835
2005-02-09,Venezuela,Estonia,3,0,3,1.0,0.0,1677,1569
2005-02-09,Wales,Hungary,2,0,2,1.0,0.0,1737,1721
2005-02-12,Occitania,Monaco,0,0,0,0.5,0.5,1501,1501
2005-02-13,Barbados,Guyana,3,3,0,0.5,0.5,1604,1466
2005-02-13,Guatemala,Haiti,2,1,1,1.0,0.0,1747,1654
2005-02-16,Costa Rica,Ecuador,1,2,1,0.0,1.0,1787,1793
2005-02-19,El Salvador,Panama,0,1,1,0.0,1.0,1614,1651
2005-02-19,Guatemala,Belize,2,0,2,1.0,0.0,1750,1485
2005-02-19,Honduras,Nicaragua,5,1,4,1.0,0.0,1750,1351
2005-02-20,Barbados,Cuba,0,3,3,0.0,1.0,1599,1710
2005-02-20,Jamaica,Trinidad and Tobago,2,1,1,1.0,0.0,1759,1708
2005-02-21,Belize,Honduras,0,4,4,0.0,1.0,1483,1753
2005-02-21,Costa Rica,El Salvador,2,1,1,1.0,0.0,1792,1610
2005-02-21,Guatemala,Nicaragua,4,0,4,1.0,0.0,1752,1350
2005-02-22,Barbados,Jamaica,0,1,1,0.0,1.0,1595,1764
2005-02-22,Congo,Angola,0,2,2,0.0,1.0,1612,1725
2005-02-22,Trinidad and Tobago,Cuba,1,2,1,0.0,1.0,1701,1718
2005-02-23,Guatemala,Honduras,1,1,0,0.5,0.5,1753,1753
2005-02-23,Mexico,Colombia,1,1,0,0.5,0.5,1945,1875
2005-02-23,Nicaragua,Belize,1,0,1,1.0,0.0,1361,1473
2005-02-23,Panama,Costa Rica,0,1,1,0.0,1.0,1647,1797
2005-02-24,Barbados,Trinidad and Tobago,2,3,1,0.0,1.0,1590,1707
2005-02-24,Cuba,Jamaica,0,1,1,0.0,1.0,1712,1771
2005-02-25,Guatemala,Costa Rica,0,4,4,0.0,1.0,1747,1804
2005-02-25,Honduras,Panama,1,0,1,1.0,0.0,1759,1642
2005-02-26,Botswana,Zambia,0,0,0,0.5,0.5,1538,1702
2005-02-26,Mauritius,Madagascar,2,0,2,1.0,0.0,1562,1577
2005-02-26,Seychelles,South Africa,0,3,3,0.0,1.0,1439,1792
2005-02-27,Costa Rica,Honduras,1,1,0,0.5,0.5,1803,1761
2005-02-27,Guatemala,Panama,3,0,3,1.0,0.0,1753,1637
2005-02-27,Malawi,Zimbabwe,2,1,1,1.0,0.0,1591,1707
2005-02-27,Mauritius,South Africa,0,1,1,0.0,1.0,1559,1796
2005-03-05,Hong Kong,Mongolia,6,0,6,1.0,0.0,1554,1410
2005-03-07,Guam,Hong Kong,0,15,15,0.0,1.0,1378,1559
2005-03-07,North Korea,Mongolia,6,0,6,1.0,0.0,1692,1408
2005-03-09,Mexico,Argentina,1,1,0,0.5,0.5,1947,2028
2005-03-09,Mongolia,Guam,4,1,3,1.0,0.0,1416,1371
2005-03-09,United States,Colombia,3,0,3,1.0,0.0,1932,1869
2005-03-11,Guam,North Korea,0,21,21,0.0,1.0,1369,1695
2005-03-12,Kenya,Rwanda,1,1,0,0.5,0.5,1661,1614
2005-03-12,Kuwait,Finland,0,1,1,0.0,1.0,1745,1760
2005-03-12,Sudan,Ethiopia,3,1,2,1.0,0.0,1620,1592
2005-03-12,Alderney,Guernsey,1,2,1,0.0,1.0,1283,1668
2005-03-13,Hong Kong,North Korea,0,2,2,0.0,1.0,1554,1701
2005-03-14,Saudi Arabia,Egypt,0,1,1,0.0,1.0,1828,1874
2005-03-16,Zimbabwe,Botswana,1,1,0,0.5,0.5,1704,1542
2005-03-18,Kuwait,Armenia,3,1,2,1.0,0.0,1750,1552
2005-03-18,Saudi Arabia,Finland,1,4,3,0.0,1.0,1819,1770
2005-03-19,Gabon,Congo,0,0,0,0.5,0.5,1679,1614
2005-03-19,Lesotho,Namibia,1,2,1,0.0,1.0,1475,1490
2005-03-19,United States,Honduras,1,0,1,1.0,0.0,1937,1757
2005-03-20,South Korea,Burkina Faso,1,0,1,1.0,0.0,1871,1619
2005-03-23,Kenya,Ghana,2,2,0,0.5,0.5,1662,1679
2005-03-25,Iran,Japan,2,1,1,1.0,0.0,1898,1921
2005-03-25,North Korea,Bahrain,1,2,1,0.0,1.0,1694,1746
2005-03-25,Kuwait,Uzbekistan,2,1,1,1.0,0.0,1758,1722
2005-03-25,Saudi Arabia,South Korea,2,0,2,1.0,0.0,1829,1862
2005-03-26,Armenia,Andorra,2,1,1,1.0,0.0,1558,1415
2005-03-26,Australia,Iraq,2,1,1,1.0,0.0,1904,1723
2005-03-26,Belgium,Bosnia and Herzegovina,4,1,3,1.0,0.0,1862,1669
2005-03-26,Bolivia,Argentina,1,2,1,0.0,1.0,1689,2031
2005-03-26,Bulgaria,Sweden,0,3,3,0.0,1.0,1811,1910
2005-03-26,Burkina Faso,Cape Verde,1,2,1,0.0,1.0,1610,1569
2005-03-26,Chile,Uruguay,1,1,0,0.5,0.5,1773,1857
2005-03-26,Costa Rica,Panama,2,1,1,1.0,0.0,1808,1633
2005-03-26,Croatia,Iceland,4,0,4,1.0,0.0,1884,1670
2005-03-26,Cyprus,Jordan,2,1,1,1.0,0.0,1614,1731
2005-03-26,Czech Republic,Finland,4,3,1,1.0,0.0,1953,1766
2005-03-26,Denmark,Kazakhstan,3,0,3,1.0,0.0,1914,1549
2005-03-26,England,Northern Ireland,4,0,4,1.0,0.0,1978,1655
2005-03-26,Estonia,Slovakia,1,2,1,0.0,1.0,1565,1737
2005-03-26,France,Switzerland,0,0,0,0.5,0.5,2037,1792
2005-03-26,Georgia,Greece,1,3,2,0.0,1.0,1600,1887
2005-03-26,Guatemala,Trinidad and Tobago,5,1,4,1.0,0.0,1760,1701
2005-03-26,Israel,Republic of Ireland,1,1,0,0.5,0.5,1755,1931
2005-03-26,Italy,Scotland,2,0,2,1.0,0.0,1980,1755
2005-03-26,Kenya,Botswana,1,0,1,1.0,0.0,1668,1537
2005-03-26,Liechtenstein,Russia,1,2,1,0.0,1.0,1406,1828
2005-03-26,Morocco,Guinea,1,0,1,1.0,0.0,1853,1673
2005-03-26,Nigeria,Gabon,2,0,2,1.0,0.0,1860,1675
2005-03-26,Poland,Azerbaijan,8,0,8,1.0,0.0,1838,1510
2005-03-26,Portugal,Canada,4,1,3,1.0,0.0,1951,1726
2005-03-26,Romania,Netherlands,0,2,2,0.0,1.0,1853,1987
2005-03-26,Senegal,Liberia,6,1,5,1.0,0.0,1801,1596
2005-03-26,Slovenia,Germany,0,1,1,0.0,1.0,1726,1961
2005-03-26,South Africa,Uganda,2,1,1,1.0,0.0,1801,1610
2005-03-26,Spain,China PR,3,0,3,1.0,0.0,2011,1819
2005-03-26,Tunisia,Malawi,7,0,7,1.0,0.0,1828,1588
2005-03-26,Turkey,Albania,2,0,2,1.0,0.0,1842,1584
2005-03-26,Venezuela,Colombia,0,0,0,0.5,0.5,1682,1865
2005-03-26,Wales,Austria,0,2,2,0.0,1.0,1730,1763
2005-03-26,Zambia,Congo,2,0,2,1.0,0.0,1709,1608
2005-03-27,Algeria,Rwanda,1,0,1,1.0,0.0,1715,1609
2005-03-27,Brazil,Peru,1,0,1,1.0,0.0,2017,1767
2005-03-27,Cameroon,Sudan,2,1,1,1.0,0.0,1850,1617
2005-03-27,DR Congo,Ghana,1,1,0,0.5,0.5,1680,1680
2005-03-27,Ecuador,Paraguay,5,2,3,1.0,0.0,1803,1855
2005-03-27,Egypt,Libya,4,1,3,1.0,0.0,1879,1683
2005-03-27,Ivory Coast,Benin,3,0,3,1.0,0.0,1818,1515
2005-03-27,Mali,Togo,1,2,1,0.0,1.0,1719,1675
2005-03-27,Mexico,United States,2,1,1,1.0,0.0,1955,1930
2005-03-27,Zimbabwe,Angola,2,0,2,1.0,0.0,1713,1717
2005-03-29,Australia,Indonesia,3,0,3,1.0,0.0,1907,1615
2005-03-29,Bolivia,Venezuela,3,1,2,1.0,0.0,1697,1675
2005-03-29,Republic of Ireland,China PR,1,0,1,1.0,0.0,1937,1814
2005-03-30,Andorra,Czech Republic,0,4,4,0.0,1.0,1415,1954
2005-03-30,Argentina,Colombia,1,0,1,1.0,0.0,2036,1861
2005-03-30,Austria,Wales,1,0,1,1.0,0.0,1771,1723
2005-03-30,Bosnia and Herzegovina,Lithuania,1,1,0,0.5,0.5,1667,1550
2005-03-30,Croatia,Malta,3,0,3,1.0,0.0,1886,1450
2005-03-30,England,Azerbaijan,2,0,2,1.0,0.0,1980,1509
2005-03-30,Estonia,Russia,1,1,0,0.5,0.5,1571,1823
2005-03-30,Georgia,Turkey,2,5,3,0.0,1.0,1597,1846
2005-03-30,Greece,Albania,2,0,2,1.0,0.0,1890,1582
2005-03-30,Hungary,Bulgaria,1,1,0,0.5,0.5,1724,1809
2005-03-30,Israel,France,1,1,0,0.5,0.5,1761,2032
2005-03-30,Italy,Iceland,0,0,0,0.5,0.5,1975,1676
2005-03-30,Japan,Bahrain,1,0,1,1.0,0.0,1926,1742
2005-03-30,North Korea,Iran,0,2,2,0.0,1.0,1691,1902
2005-03-30,South Korea,Uzbekistan,2,1,1,1.0,0.0,1867,1718
2005-03-30,Kuwait,Saudi Arabia,0,0,0,0.5,0.5,1760,1828
2005-03-30,Latvia,Luxembourg,4,0,4,1.0,0.0,1603,1322
2005-03-30,North Macedonia,Romania,1,2,1,0.0,1.0,1610,1857
2005-03-30,Moldova,Norway,0,0,0,0.5,0.5,1549,1866
2005-03-30,Netherlands,Armenia,2,0,2,1.0,0.0,1989,1557
2005-03-30,Panama,Mexico,1,1,0,0.5,0.5,1639,1950
2005-03-30,Paraguay,Chile,2,1,1,1.0,0.0,1862,1767
2005-03-30,Peru,Ecuador,2,2,0,0.5,0.5,1768,1803
2005-03-30,Poland,Northern Ireland,1,0,1,1.0,0.0,1843,1651
2005-03-30,San Marino,Belgium,1,2,1,0.0,1.0,1381,1863
2005-03-30,Serbia,Spain,0,0,0,0.5,0.5,1795,2007
2005-03-30,Slovakia,Portugal,1,1,0,0.5,0.5,1742,1947
2005-03-30,Slovenia,Belarus,1,1,0,0.5,0.5,1725,1661
2005-03-30,Switzerland,Cyprus,1,0,1,1.0,0.0,1797,1610
2005-03-30,Trinidad and Tobago,Costa Rica,0,0,0,0.5,0.5,1704,1806
2005-03-30,Ukraine,Denmark,1,0,1,1.0,0.0,1742,1903
2005-03-30,Uruguay,Brazil,1,1,0,0.5,0.5,1861,2014
2005-03-30,United States,Guatemala,2,0,2,1.0,0.0,1935,1756
2005-04-16,Mozambique,Zimbabwe,0,3,3,0.0,1.0,1559,1718
2005-04-16,Namibia,Botswana,1,1,0,0.5,0.5,1492,1536
2005-04-17,Botswana,Zimbabwe,0,2,2,0.0,1.0,1532,1723
2005-04-20,Estonia,Norway,1,2,1,0.0,1.0,1569,1869
2005-04-20,Guatemala,Jamaica,0,1,1,0.0,1.0,1749,1779
2005-04-27,Brazil,Guatemala,3,0,3,1.0,0.0,2017,1747
2005-04-27,Mexico,Poland,1,1,0,0.5,0.5,1948,1846
2005-05-02,Guernsey,Jersey,0,0,0,0.5,0.5,1670,1711
2005-05-03,Occitania,Chechnya,14,0,14,1.0,0.0,1509,1493
2005-05-04,Ecuador,Paraguay,1,0,1,1.0,0.0,1813,1853
2005-05-15,Jersey,Guernsey,3,3,0,0.5,0.5,1711,1671
2005-05-17,Monaco,Occitania,1,1,0,0.5,0.5,1502,1509
2005-05-21,Lithuania,Latvia,2,0,2,1.0,0.0,1560,1594
2005-05-22,Japan,Peru,0,1,1,0.0,1.0,1915,1780
2005-05-22,Sudan,Chad,4,1,3,1.0,0.0,1623,1510
2005-05-24,Norway,Costa Rica,1,0,1,1.0,0.0,1876,1800
2005-05-24,Peru,United Arab Emirates,0,0,0,0.5,0.5,1778,1684
2005-05-25,Trinidad and Tobago,Bermuda,4,0,4,1.0,0.0,1708,1502
2005-05-25,Venezuela,Panama,1,1,0,0.5,0.5,1675,1640
2005-05-27,Gibraltar,Monaco,4,0,4,1.0,0.0,1541,1495
2005-05-27,Japan,United Arab Emirates,0,1,1,0.0,1.0,1903,1697
2005-05-27,Kuwait,Egypt,0,1,1,0.0,1.0,1755,1885
2005-05-27,Libya,Malawi,1,1,0,0.5,0.5,1681,1591
2005-05-27,Saudi Arabia,Bahrain,1,1,0,0.5,0.5,1827,1744
2005-05-27,Sudan,Chad,1,1,0,0.5,0.5,1621,1513
2005-05-27,Trinidad and Tobago,Bermuda,1,0,1,1.0,0.0,1712,1499
2005-05-27,Tunisia,Angola,4,1,3,1.0,0.0,1834,1712
2005-05-28,United States,England,1,2,1,0.0,1.0,1929,1987
2005-05-29,Hong Kong,Macau,8,1,7,1.0,0.0,1559,1365
2005-05-29,Iran,Azerbaijan,2,1,1,1.0,0.0,1904,1508
2005-05-29,Poland,Albania,1,0,1,1.0,0.0,1849,1580
2005-05-29,Togo,Burkina Faso,1,0,1,1.0,0.0,1682,1604
2005-05-31,Colombia,England,2,3,1,0.0,1.0,1856,1993
2005-05-31,France,Hungary,2,1,1,1.0,0.0,2035,1722
2005-06-01,Gabon,Zambia,0,1,1,0.0,1.0,1668,1717
2005-06-01,Lesotho,Eswatini,3,4,1,0.0,1.0,1468,1499
2005-06-02,Finland,Denmark,0,1,1,0.0,1.0,1762,1908
2005-06-03,Bahrain,Japan,0,1,1,0.0,1.0,1740,1908
2005-06-03,Iran,North Korea,1,0,1,1.0,0.0,1908,1688
2005-06-03,Libya,Ivory Coast,0,0,0,0.5,0.5,1685,1815
2005-06-03,Saudi Arabia,Kuwait,3,0,3,1.0,0.0,1834,1749
2005-06-03,Uzbekistan,South Korea,1,1,0,0.5,0.5,1722,1864
2005-06-04,Albania,Georgia,3,2,1,1.0,0.0,1589,1589
2005-06-04,Armenia,North Macedonia,1,2,1,0.0,1.0,1551,1617
2005-06-04,Azerbaijan,Poland,0,3,3,0.0,1.0,1507,1851
2005-06-04,Belarus,Slovenia,1,1,0,0.5,0.5,1663,1724
2005-06-04,Benin,Cameroon,1,4,3,0.0,1.0,1513,1853
2005-06-04,Botswana,Tunisia,1,3,2,0.0,1.0,1530,1837
2005-06-04,Bulgaria,Croatia,1,3,2,0.0,1.0,1803,1893
2005-06-04,Cape Verde,South Africa,1,2,1,0.0,1.0,1566,1805
2005-06-04,Chile,Bolivia,3,1,2,1.0,0.0,1774,1691
2005-06-04,Colombia,Peru,5,0,5,1.0,0.0,1863,1772
2005-06-04,Czech Republic,Andorra,8,1,7,1.0,0.0,1955,1415
2005-06-04,Ecuador,Argentina,2,0,2,1.0,0.0,1826,2024
2005-06-04,Estonia,Liechtenstein,2,0,2,1.0,0.0,1574,1402
2005-06-04,Faroe Islands,Switzerland,1,3,2,0.0,1.0,1490,1800
2005-06-04,Guatemala,Mexico,0,2,2,0.0,1.0,1744,1952
2005-06-04,Iceland,Hungary,2,3,1,0.0,1.0,1670,1729
2005-06-04,Republic of Ireland,Israel,2,2,0,0.5,0.5,1934,1765
2005-06-04,Jamaica,Honduras,0,0,0,0.5,0.5,1779,1758
2005-06-04,Morocco,Malawi,4,1,3,1.0,0.0,1856,1589
2005-06-04,Netherlands,Romania,2,0,2,1.0,0.0,1995,1852
2005-06-04,Northern Ireland,Germany,1,4,3,0.0,1.0,1649,1964
2005-06-04,Norway,Italy,0,0,0,0.5,0.5,1879,1973
2005-06-04,Portugal,Slovakia,2,0,2,1.0,0.0,1951,1739
2005-06-04,Russia,Latvia,2,0,2,1.0,0.0,1827,1591
2005-06-04,San Marino,Bosnia and Herzegovina,1,3,2,0.0,1.0,1379,1670
2005-06-04,Scotland,Moldova,2,0,2,1.0,0.0,1759,1546
2005-06-04,Serbia,Belgium,0,0,0,0.5,0.5,1797,1862
2005-06-04,Singapore,Malaysia,2,0,2,1.0,0.0,1625,1578
2005-06-04,Spain,Lithuania,1,0,1,1.0,0.0,2009,1559
2005-06-04,Sweden,Malta,6,0,6,1.0,0.0,1912,1449
2005-06-04,Trinidad and Tobago,Panama,2,0,2,1.0,0.0,1719,1634
2005-06-04,Turkey,Greece,0,0,0,0.5,0.5,1848,1889
2005-06-04,Ukraine,Kazakhstan,2,0,2,1.0,0.0,1746,1546
2005-06-04,United States,Costa Rica,3,0,3,1.0,0.0,1935,1795
2005-06-04,Venezuela,Uruguay,1,1,0,0.5,0.5,1679,1858
2005-06-05,Angola,Algeria,2,1,1,1.0,0.0,1721,1707
2005-06-05,Brazil,Paraguay,4,1,3,1.0,0.0,2022,1849
2005-06-05,Congo,Senegal,0,0,0,0.5,0.5,1613,1797
2005-06-05,DR Congo,Uganda,4,0,4,1.0,0.0,1687,1604
2005-06-05,Egypt,Sudan,6,1,5,1.0,0.0,1888,1619
2005-06-05,Ghana,Burkina Faso,2,1,1,1.0,0.0,1687,1598
2005-06-05,Guinea,Kenya,1,0,1,1.0,0.0,1681,1661
2005-06-05,Mali,Liberia,4,1,3,1.0,0.0,1725,1591
2005-06-05,Rwanda,Nigeria,1,1,0,0.5,0.5,1614,1856
2005-06-05,Togo,Zambia,4,1,3,1.0,0.0,1691,1709
2005-06-05,Zimbabwe,Gabon,1,0,1,1.0,0.0,1730,1662
2005-06-07,Peru,Uruguay,0,0,0,0.5,0.5,1774,1857
2005-06-08,Argentina,Brazil,3,1,2,1.0,0.0,2032,2015
2005-06-08,Belarus,Scotland,0,0,0,0.5,0.5,1666,1757
2005-06-08,Chile,Venezuela,2,1,1,1.0,0.0,1780,1674
2005-06-08,Colombia,Ecuador,3,0,3,1.0,0.0,1871,1819
2005-06-08,Costa Rica,Guatemala,3,2,1,1.0,0.0,1802,1738
2005-06-08,Czech Republic,North Macedonia,6,1,5,1.0,0.0,1958,1615
2005-06-08,Denmark,Albania,3,1,2,1.0,0.0,1911,1587
2005-06-08,Estonia,Portugal,0,1,1,0.0,1.0,1573,1953
2005-06-08,Faroe Islands,Republic of Ireland,0,2,2,0.0,1.0,1489,1936
2005-06-08,Finland,Netherlands,0,4,4,0.0,1.0,1759,1999
2005-06-08,Germany,Russia,2,2,0,0.5,0.5,1961,1831
2005-06-08,Greece,Ukraine,0,1,1,0.0,1.0,1878,1758
2005-06-08,Iceland,Malta,4,1,3,1.0,0.0,1674,1446
2005-06-08,Iran,Bahrain,1,0,1,1.0,0.0,1913,1736
2005-06-08,Italy,Serbia,1,1,0,0.5,0.5,1970,1801
2005-06-08,Jordan,Iraq,0,1,1,0.0,1.0,1723,1732
2005-06-08,Kazakhstan,Turkey,0,6,6,0.0,1.0,1544,1851
2005-06-08,North Korea,Japan,0,2,2,0.0,1.0,1685,1912
2005-06-08,Kuwait,South Korea,0,4,4,0.0,1.0,1744,1870
2005-06-08,Latvia,Liechtenstein,1,0,1,1.0,0.0,1596,1398
2005-06-08,Luxembourg,Slovakia,0,4,4,0.0,1.0,1321,1741
2005-06-08,Malaysia,Singapore,1,2,1,0.0,1.0,1572,1632
2005-06-08,Mexico,Trinidad and Tobago,2,0,2,1.0,0.0,1956,1716
2005-06-08,Panama,United States,0,3,3,0.0,1.0,1632,1938
2005-06-08,Paraguay,Bolivia,4,1,3,1.0,0.0,1854,1687
2005-06-08,Romania,Armenia,3,0,3,1.0,0.0,1855,1549
2005-06-08,Saudi Arabia,Uzbekistan,3,0,3,1.0,0.0,1840,1717
2005-06-08,Spain,Bosnia and Herzegovina,1,1,0,0.5,0.5,2003,1677
2005-06-08,Sweden,Norway,2,3,1,0.0,1.0,1904,1888
2005-06-09,Australia,New Zealand,1,0,1,1.0,0.0,1911,1701
2005-06-10,Gambia,Guinea,2,3,1,0.0,1.0,1545,1687
2005-06-10,Sierra Leone,Liberia,2,0,2,1.0,0.0,1607,1584
2005-06-11,Ecuador,Italy,1,1,0,0.5,0.5,1823,1967
2005-06-11,Lesotho,Malawi,1,2,1,0.0,1.0,1463,1595
2005-06-11,Tunisia,Guinea,2,0,2,1.0,0.0,1842,1683
2005-06-11,Zambia,Eswatini,3,0,3,1.0,0.0,1713,1496
2005-06-12,Algeria,Mali,0,3,3,0.0,1.0,1700,1733
2005-06-12,Pakistan,India,1,1,0,0.5,0.5,1366,1551
2005-06-12,Sierra Leone,Gambia,1,0,1,1.0,0.0,1614,1539
2005-06-12,Zambia,Malawi,2,1,1,1.0,0.0,1719,1590
2005-06-14,Sierra Leone,Guinea,2,0,2,1.0,0.0,1624,1674
2005-06-15,Argentina,Tunisia,2,1,1,1.0,0.0,2037,1838
2005-06-15,Germany,Australia,4,3,1,1.0,0.0,1968,1905
2005-06-16,Brazil,Greece,3,0,3,1.0,0.0,2020,1874
2005-06-16,Japan,Mexico,1,2,1,0.0,1.0,1906,1963
2005-06-16,Pakistan,India,0,1,1,0.0,1.0,1362,1556
2005-06-18,Australia,Argentina,2,4,2,0.0,1.0,1900,2043
2005-06-18,Burkina Faso,DR Congo,2,0,2,1.0,0.0,1609,1677
2005-06-18,Gabon,Rwanda,3,0,3,1.0,0.0,1669,1608
2005-06-18,Germany,Tunisia,3,0,3,1.0,0.0,1974,1833
2005-06-18,Kenya,Morocco,0,0,0,0.5,0.5,1666,1852
2005-06-18,Malawi,Botswana,1,3,2,0.0,1.0,1581,1540
2005-06-18,Nigeria,Angola,1,1,0,0.5,0.5,1854,1724
2005-06-18,Pakistan,India,3,0,3,1.0,0.0,1375,1544
2005-06-18,Senegal,Togo,2,2,0,0.5,0.5,1795,1694
2005-06-18,South Africa,Ghana,0,2,2,0.0,1.0,1795,1698
2005-06-18,Uganda,Cape Verde,1,0,1,1.0,0.0,1612,1559
2005-06-18,Zambia,Mali,2,1,1,1.0,0.0,1728,1725
2005-06-19,Algeria,Zimbabwe,2,2,0,0.5,0.5,1701,1730
2005-06-19,Cameroon,Libya,1,0,1,1.0,0.0,1858,1681
2005-06-19,China PR,Costa Rica,2,2,0,0.5,0.5,1814,1803
2005-06-19,Greece,Japan,0,1,1,0.0,1.0,1867,1914
2005-06-19,Ivory Coast,Egypt,2,0,2,1.0,0.0,1825,1879
2005-06-19,Liberia,Congo,0,2,2,0.0,1.0,1577,1621
2005-06-19,Mexico,Brazil,1,0,1,1.0,0.0,1973,2011
2005-06-21,Australia,Tunisia,0,2,2,0.0,1.0,1891,1843
2005-06-21,Germany,Argentina,2,2,0,0.5,0.5,1976,2042
2005-06-22,China PR,Costa Rica,2,0,2,1.0,0.0,1822,1796
2005-06-22,Greece,Mexico,0,0,0,0.5,0.5,1870,1971
2005-06-22,Japan,Brazil,2,2,0,0.5,0.5,1917,2009
2005-06-23,Chechnya,Ambazonia,2,2,0,0.5,0.5,1494,1500
2005-06-25,Germany,Brazil,2,3,1,0.0,1.0,1969,2017
2005-06-26,Mexico,Argentina,1,1,0,0.5,0.5,1973,2041
2005-06-26,Mozambique,Lesotho,1,0,1,1.0,0.0,1565,1458
2005-06-29,Brazil,Argentina,4,1,3,1.0,0.0,2026,2033
2005-06-29,Germany,Mexico,4,3,1,1.0,0.0,1978,1965
2005-07-01,Botswana,DR Congo,0,0,0,0.5,0.5,1544,1674
2005-07-02,Canada,Honduras,1,2,1,0.0,1.0,1719,1766
2005-07-06,Colombia,Panama,0,1,1,0.0,1.0,1859,1645
2005-07-06,Trinidad and Tobago,Honduras,1,1,0,0.5,0.5,1718,1765
2005-07-07,Canada,Costa Rica,0,1,1,0.0,1.0,1713,1803
2005-07-07,United States,Cuba,4,1,3,1.0,0.0,1942,1709
2005-07-08,Guatemala,Jamaica,3,4,1,0.0,1.0,1731,1787
2005-07-08,South Africa,Mexico,2,1,1,1.0,0.0,1807,1954
2005-07-09,Costa Rica,Cuba,3,1,2,1.0,0.0,1809,1704
2005-07-09,United States,Canada,2,0,2,1.0,0.0,1946,1710
2005-07-10,Honduras,Colombia,2,1,1,1.0,0.0,1776,1849
2005-07-10,Jamaica,South Africa,3,3,0,0.5,0.5,1788,1807
2005-07-10,Mexico,Guatemala,4,0,4,1.0,0.0,1958,1728
2005-07-10,Panama,Trinidad and Tobago,2,2,0,0.5,0.5,1647,1717
2005-07-10,Saare County,Åland Islands,2,1,1,1.0,0.0,1441,1520
2005-07-10,Shetland,Falkland Islands,4,0,4,1.0,0.0,1505,1482
2005-07-10,Guernsey,Orkney,3,0,3,1.0,0.0,1675,1458
2005-07-10,Greenland,Ynys Môn,0,0,0,0.5,0.5,1478,1580
2005-07-11,Shetland,Åland Islands,3,1,2,1.0,0.0,1514,1512
2005-07-11,Isle of Man,Saare County,2,2,0,0.5,0.5,1523,1443
2005-07-11,Orkney,Greenland,1,2,1,0.0,1.0,1451,1486
2005-07-11,Guernsey,Western Isles,2,1,1,1.0,0.0,1680,1496
2005-07-12,Canada,Cuba,2,1,1,1.0,0.0,1718,1697
2005-07-12,Colombia,Trinidad and Tobago,2,0,2,1.0,0.0,1855,1712
2005-07-12,Honduras,Panama,1,0,1,1.0,0.0,1782,1642
2005-07-12,United States,Costa Rica,0,0,0,0.5,0.5,1943,1813
2005-07-12,Saare County,Falkland Islands,1,2,1,0.0,1.0,1436,1490
2005-07-12,Åland Islands,Isle of Man,0,1,1,0.0,1.0,1505,1531
2005-07-12,Orkney,Ynys Môn,0,2,2,0.0,1.0,1446,1586
2005-07-12,Western Isles,Greenland,4,4,0,0.5,0.5,1496,1487
2005-07-13,Guatemala,South Africa,1,1,0,0.5,0.5,1730,1806
2005-07-13,Mexico,Jamaica,1,0,1,1.0,0.0,1963,1784
2005-07-13,Shetland,Saare County,0,0,0,0.5,0.5,1513,1438
2005-07-13,Falkland Islands,Isle of Man,0,9,9,0.0,1.0,1483,1539
2005-07-13,Ynys Môn,Western Isles,0,0,0,0.5,0.5,1584,1499
2005-07-13,Greenland,Guernsey,0,6,6,0.0,1.0,1484,1684
2005-07-14,Shetland,Isle of Man,0,1,1,0.0,1.0,1506,1547
2005-07-14,Åland Islands,Falkland Islands,2,1,1,1.0,0.0,1513,1476
2005-07-14,Guernsey,Ynys Môn,3,0,3,1.0,0.0,1690,1579
2005-07-14,Western Isles,Orkney,5,4,1,1.0,0.0,1506,1440
2005-07-15,Orkney,Falkland Islands,2,0,2,1.0,0.0,1449,1468
2005-07-15,Åland Islands,Greenland,3,2,1,1.0,0.0,1521,1477
2005-07-15,Ynys Môn,Saare County,3,2,1,1.0,0.0,1584,1434
2005-07-15,Western Isles,Isle of Man,4,0,4,1.0,0.0,1515,1539
2005-07-15,Shetland,Guernsey,2,0,2,1.0,0.0,1518,1679
2005-07-16,Honduras,Costa Rica,3,2,1,1.0,0.0,1791,1805
2005-07-16,United States,Jamaica,3,1,2,1.0,0.0,1948,1780
2005-07-17,Mexico,Colombia,1,2,1,0.0,1.0,1953,1866
2005-07-17,South Africa,Panama,1,1,0,0.5,0.5,1803,1646
2005-07-21,Colombia,Panama,2,3,1,0.0,1.0,1854,1659
2005-07-21,United States,Honduras,2,1,1,1.0,0.0,1953,1787
2005-07-24,United States,Panama,0,0,0,0.5,0.5,1948,1665
2005-07-28,Kuwait,United Arab Emirates,1,1,0,0.5,0.5,1743,1699
2005-07-30,Egypt,United Arab Emirates,0,0,0,0.5,0.5,1876,1703
2005-07-31,North Korea,Japan,1,0,1,1.0,0.0,1698,1905
2005-07-31,South Korea,China PR,1,1,0,0.5,0.5,1869,1824
2005-08-03,Bahrain,Turkmenistan,5,0,5,1.0,0.0,1741,1590
2005-08-03,Japan,China PR,2,2,0,0.5,0.5,1904,1826
2005-08-04,South Korea,North Korea,0,0,0,0.5,0.5,1866,1702
2005-08-07,Bahrain,Iraq,2,2,0,0.5,0.5,1741,1733
2005-08-07,China PR,North Korea,2,0,2,1.0,0.0,1832,1697
2005-08-07,South Korea,Japan,0,1,1,0.0,1.0,1859,1912
2005-08-09,Botswana,Angola,0,0,0,0.5,0.5,1548,1721
2005-08-10,Angola,Botswana,0,0,0,0.5,0.5,1718,1552
2005-08-12,Fiji,India,1,0,1,1.0,0.0,1698,1540
2005-08-13,Angola,Zimbabwe,1,2,1,0.0,1.0,1711,1738
2005-08-13,Cyprus,Iraq,2,1,1,1.0,0.0,1621,1723
2005-08-13,South Africa,Zambia,2,2,0,0.5,0.5,1802,1730
2005-08-14,Fiji,India,2,1,1,1.0,0.0,1703,1536
2005-08-14,South Korea,North Korea,3,0,3,1.0,0.0,1864,1693
2005-08-14,Zambia,Zimbabwe,0,1,1,0.0,1.0,1723,1746
2005-08-15,Poland,Serbia,3,2,1,1.0,0.0,1858,1795
2005-08-15,Ukraine,Israel,0,0,0,0.5,0.5,1759,1765
2005-08-16,DR Congo,Guinea,3,1,2,1.0,0.0,1682,1666
2005-08-17,Albania,Azerbaijan,2,1,1,1.0,0.0,1594,1501
2005-08-17,Angola,Cape Verde,2,1,1,1.0,0.0,1716,1555
2005-08-17,Austria,Scotland,2,2,0,0.5,0.5,1771,1758
2005-08-17,Bahrain,North Korea,2,3,1,0.0,1.0,1732,1703
2005-08-17,Belgium,Greece,2,0,2,1.0,0.0,1871,1862
2005-08-17,Bulgaria,Turkey,3,1,2,1.0,0.0,1813,1842
2005-08-17,Croatia,Brazil,1,1,0,0.5,0.5,1896,2024
2005-08-17,Denmark,England,4,1,3,1.0,0.0,1921,1984
2005-08-17,Ecuador,Venezuela,3,1,2,1.0,0.0,1828,1670
2005-08-17,Estonia,Bosnia and Herzegovina,1,0,1,1.0,0.0,1584,1667
2005-08-17,Faroe Islands,Cyprus,0,3,3,0.0,1.0,1484,1627
2005-08-17,France,Ivory Coast,3,0,3,1.0,0.0,2039,1822
2005-08-17,Guatemala,Panama,2,1,1,1.0,0.0,1737,1659
2005-08-17,Hungary,Argentina,1,2,1,0.0,1.0,1727,2036
2005-08-17,Iceland,South Africa,4,1,3,1.0,0.0,1685,1792
2005-08-17,Republic of Ireland,Italy,1,2,1,0.0,1.0,1929,1975
2005-08-17,Japan,Iran,2,1,1,1.0,0.0,1921,1905
2005-08-17,Jordan,Armenia,0,0,0,0.5,0.5,1720,1553
2005-08-17,Kazakhstan,Georgia,1,2,1,0.0,1.0,1538,1596
2005-08-17,South Korea,Saudi Arabia,0,1,1,0.0,1.0,1856,1849
2005-08-17,Latvia,Russia,1,1,0,0.5,0.5,1601,1827
2005-08-17,Libya,Nigeria,0,1,1,0.0,1.0,1677,1859
2005-08-17,Liechtenstein,Slovakia,0,0,0,0.5,0.5,1405,1735
2005-08-17,Lithuania,Belarus,1,0,1,1.0,0.0,1570,1656
2005-08-17,North Macedonia,Finland,0,3,3,0.0,1.0,1611,1764
2005-08-17,Malta,Northern Ireland,1,1,0,0.5,0.5,1451,1645
2005-08-17,Mexico,Costa Rica,2,0,2,1.0,0.0,1958,1801
2005-08-17,Morocco,Togo,0,1,1,0.0,1.0,1841,1706
2005-08-17,Netherlands,Germany,2,2,0,0.5,0.5,1999,1979
2005-08-17,Norway,Switzerland,0,2,2,0.0,1.0,1879,1810
2005-08-17,Paraguay,El Salvador,3,0,3,1.0,0.0,1858,1607
2005-08-17,Peru,Chile,3,1,2,1.0,0.0,1783,1772
2005-08-17,Poland,Israel,3,2,1,1.0,0.0,1864,1760
2005-08-17,Portugal,Egypt,2,0,2,1.0,0.0,1960,1870
2005-08-17,Romania,Andorra,2,0,2,1.0,0.0,1857,1414
2005-08-17,Senegal,Ghana,0,0,0,0.5,0.5,1793,1701
2005-08-17,Spain,Uruguay,2,0,2,1.0,0.0,2008,1853
2005-08-17,Sudan,Benin,1,0,1,1.0,0.0,1625,1508
2005-08-17,Sweden,Czech Republic,2,1,1,1.0,0.0,1914,1949
2005-08-17,Tunisia,Kenya,1,0,1,1.0,0.0,1848,1662
2005-08-17,Ukraine,Serbia,2,1,1,1.0,0.0,1768,1787
2005-08-17,United States,Trinidad and Tobago,1,0,1,1.0,0.0,1952,1709
2005-08-17,Uzbekistan,Kuwait,3,2,1,1.0,0.0,1726,1735
2005-08-17,Wales,Slovenia,0,0,0,0.5,0.5,1724,1724
2005-08-24,Iran,Libya,4,0,4,1.0,0.0,1909,1674
2005-08-28,Zimbabwe,Mozambique,0,0,0,0.5,0.5,1743,1569
2005-09-02,Libya,Sudan,0,0,0,0.5,0.5,1673,1627
2005-09-03,Albania,Kazakhstan,2,1,1,1.0,0.0,1601,1532
2005-09-03,Andorra,Finland,0,0,0,0.5,0.5,1421,1758
2005-09-03,Armenia,Netherlands,0,1,1,0.0,1.0,1552,2001
2005-09-03,Australia,Solomon Islands,7,0,7,1.0,0.0,1895,1656
2005-09-03,Bolivia,Ecuador,1,2,1,0.0,1.0,1683,1833
2005-09-03,Bosnia and Herzegovina,Belgium,1,0,1,1.0,0.0,1680,1859
2005-09-03,Burkina Faso,South Africa,3,1,2,1.0,0.0,1621,1781
2005-09-03,Estonia,Latvia,2,1,1,1.0,0.0,1593,1593
2005-09-03,France,Faroe Islands,3,0,3,1.0,0.0,2040,1484
2005-09-03,Georgia,Ukraine,1,1,0,0.5,0.5,1600,1765
2005-09-03,Hungary,Malta,4,0,4,1.0,0.0,1730,1449
2005-09-03,Iceland,Croatia,1,3,2,0.0,1.0,1682,1900
2005-09-03,Kenya,Tunisia,0,2,2,0.0,1.0,1658,1853
2005-09-03,Mali,Congo,2,0,2,1.0,0.0,1731,1616
2005-09-03,Moldova,Belarus,2,0,2,1.0,0.0,1557,1646
2005-09-03,Morocco,Botswana,1,0,1,1.0,0.0,1844,1550
2005-09-03,Northern Ireland,Azerbaijan,2,0,2,1.0,0.0,1650,1497
2005-09-03,Panama,Costa Rica,1,3,2,0.0,1.0,1655,1806
2005-09-03,Paraguay,Argentina,1,0,1,1.0,0.0,1870,2025
2005-09-03,Poland,Austria,3,2,1,1.0,0.0,1870,1766
2005-09-03,Portugal,Luxembourg,6,0,6,1.0,0.0,1961,1321
2005-09-03,Romania,Czech Republic,2,0,2,1.0,0.0,1868,1939
2005-09-03,Russia,Liechtenstein,2,0,2,1.0,0.0,1829,1404
2005-09-03,Scotland,Italy,1,1,0,0.5,0.5,1763,1971
2005-09-03,Serbia,Lithuania,2,0,2,1.0,0.0,1791,1567
2005-09-03,Slovakia,Germany,2,0,2,1.0,0.0,1748,1967
2005-09-03,Slovenia,Norway,2,3,1,0.0,1.0,1720,1884
2005-09-03,Spain,Canada,2,1,1,1.0,0.0,2011,1716
2005-09-03,Sweden,Bulgaria,3,0,3,1.0,0.0,1920,1808
2005-09-03,Switzerland,Israel,1,1,0,0.5,0.5,1809,1762
2005-09-03,Trinidad and Tobago,Guatemala,3,2,1,1.0,0.0,1718,1729
2005-09-03,Turkey,Denmark,2,2,0,0.5,0.5,1844,1920
2005-09-03,United States,Mexico,2,0,2,1.0,0.0,1961,1950
2005-09-03,Venezuela,Peru,4,1,3,1.0,0.0,1681,1773
2005-09-03,Wales,England,0,1,1,0.0,1.0,1722,1987
2005-09-03,Zambia,Senegal,0,1,1,0.0,1.0,1717,1800
2005-09-04,Algeria,Nigeria,2,5,3,0.0,1.0,1697,1864
2005-09-04,Angola,Gabon,3,0,3,1.0,0.0,1723,1663
2005-09-04,Brazil,Chile,5,0,5,1.0,0.0,2028,1769
2005-09-04,DR Congo,Cape Verde,2,1,1,1.0,0.0,1688,1550
2005-09-04,Egypt,Benin,4,1,3,1.0,0.0,1872,1507
2005-09-04,Ghana,Uganda,2,0,2,1.0,0.0,1707,1607
2005-09-04,Guinea,Malawi,3,1,2,1.0,0.0,1673,1575
2005-09-04,Ivory Coast,Cameroon,2,3,1,0.0,1.0,1815,1866
2005-09-04,Togo,Liberia,3,0,3,1.0,0.0,1712,1572
2005-09-04,Uruguay,Colombia,3,2,1,1.0,0.0,1862,1846
2005-09-04,Zimbabwe,Rwanda,3,1,2,1.0,0.0,1749,1603
2005-09-06,Solomon Islands,Australia,1,2,1,0.0,1.0,1653,1899
2005-09-07,Azerbaijan,Austria,0,0,0,0.5,0.5,1503,1761
2005-09-07,Belarus,Italy,1,4,3,0.0,1.0,1644,1974
2005-09-07,Belgium,San Marino,8,0,8,1.0,0.0,1860,1379
2005-09-07,Bulgaria,Iceland,3,2,1,1.0,0.0,1814,1677
2005-09-07,Costa Rica,Trinidad and Tobago,2,0,2,1.0,0.0,1813,1712
2005-09-07,Cyprus,Switzerland,1,3,2,0.0,1.0,1623,1814
2005-09-07,Czech Republic,Armenia,4,1,3,1.0,0.0,1941,1551
2005-09-07,Denmark,Georgia,6,1,5,1.0,0.0,1923,1598
2005-09-07,Faroe Islands,Israel,0,2,2,0.0,1.0,1482,1765
2005-09-07,Finland,North Macedonia,5,1,4,1.0,0.0,1763,1607
2005-09-07,Germany,South Africa,4,2,2,1.0,0.0,1972,1777
2005-09-07,Guatemala,United States,0,0,0,0.5,0.5,1734,1957
2005-09-07,Hungary,Sweden,0,1,1,0.0,1.0,1726,1925
2005-09-07,Republic of Ireland,France,0,1,1,0.0,1.0,1924,2046
2005-09-07,Japan,Honduras,5,4,1,1.0,0.0,1927,1782
2005-09-07,Kazakhstan,Greece,1,2,1,0.0,1.0,1530,1865
2005-09-07,Latvia,Slovakia,1,1,0,0.5,0.5,1597,1745
2005-09-07,Liechtenstein,Luxembourg,3,0,3,1.0,0.0,1411,1315
2005-09-07,Lithuania,Bosnia and Herzegovina,0,1,1,0.0,1.0,1562,1686
2005-09-07,Malta,Croatia,1,1,0,0.5,0.5,1456,1894
2005-09-07,Mexico,Panama,5,0,5,1.0,0.0,1953,1653
2005-09-07,Moldova,Slovenia,1,2,1,0.0,1.0,1553,1725
2005-09-07,Netherlands,Andorra,4,0,4,1.0,0.0,2002,1421
2005-09-07,Northern Ireland,England,1,0,1,1.0,0.0,1664,1974
2005-09-07,Norway,Scotland,1,2,1,0.0,1.0,1874,1774
2005-09-07,Poland,Wales,1,0,1,1.0,0.0,1875,1718
2005-09-07,Russia,Portugal,0,0,0,0.5,0.5,1832,1959
2005-09-07,Spain,Serbia,1,1,0,0.5,0.5,2007,1796
2005-09-07,Ukraine,Turkey,0,1,1,0.0,1.0,1759,1851
2005-09-23,United Arab Emirates,Benin,0,0,0,0.5,0.5,1699,1512
2005-09-24,Malawi,Zimbabwe,2,0,2,1.0,0.0,1587,1738
2005-09-25,Mozambique,Zimbabwe,3,2,1,1.0,0.0,1581,1727
2005-09-25,Zambia,DR Congo,2,2,0,0.5,0.5,1717,1689
2005-09-27,DR Congo,Zambia,0,0,0,0.5,0.5,1690,1717
2005-09-30,Guyana,Dominica,3,0,3,1.0,0.0,1474,1438
2005-10-01,Guatemala,Jamaica,1,2,1,0.0,1.0,1728,1787
2005-10-01,Liberia,Zambia,0,5,5,0.0,1.0,1568,1722
2005-10-02,Guyana,Dominica,3,0,3,1.0,0.0,1482,1431
2005-10-07,Poland,Iceland,3,2,1,1.0,0.0,1879,1674
2005-10-08,Belgium,Spain,0,2,2,0.0,1.0,1856,2012
2005-10-08,Bosnia and Herzegovina,San Marino,3,0,3,1.0,0.0,1689,1377
2005-10-08,Botswana,Guinea,1,2,1,0.0,1.0,1545,1679
2005-10-08,Bulgaria,Hungary,2,0,2,1.0,0.0,1821,1720
2005-10-08,Cameroon,Egypt,1,1,0,0.5,0.5,1867,1872
2005-10-08,Cape Verde,Ghana,0,4,4,0.0,1.0,1546,1712
2005-10-08,Colombia,Chile,1,1,0,0.5,0.5,1845,1771
2005-10-08,Congo,Togo,2,3,1,0.0,1.0,1611,1718
2005-10-08,Costa Rica,United States,3,0,3,1.0,0.0,1825,1946
2005-10-08,Croatia,Sweden,1,0,1,1.0,0.0,1903,1917
2005-10-08,Cyprus,Republic of Ireland,0,1,1,0.0,1.0,1621,1927
2005-10-08,Czech Republic,Netherlands,0,2,2,0.0,1.0,1935,2009
2005-10-08,Denmark,Greece,1,0,1,1.0,0.0,1930,1859
2005-10-08,Ecuador,Uruguay,0,0,0,0.5,0.5,1834,1862
2005-10-08,England,Austria,1,0,1,1.0,0.0,1978,1758
2005-10-08,Finland,Romania,0,1,1,0.0,1.0,1758,1874
2005-10-08,Gabon,Algeria,0,0,0,0.5,0.5,1664,1697
2005-10-08,Georgia,Kazakhstan,0,0,0,0.5,0.5,1597,1532
2005-10-08,Israel,Faroe Islands,2,1,1,1.0,0.0,1768,1480
2005-10-08,Italy,Slovenia,1,0,1,1.0,0.0,1978,1722
2005-10-08,Latvia,Japan,2,2,0,0.5,0.5,1603,1922
2005-10-08,Lithuania,Serbia,0,2,2,0.0,1.0,1559,1800
2005-10-08,Malawi,Kenya,3,0,3,1.0,0.0,1597,1649
2005-10-08,Mexico,Guatemala,5,2,3,1.0,0.0,1957,1725
2005-10-08,Nigeria,Zimbabwe,5,1,4,1.0,0.0,1869,1723
2005-10-08,Northern Ireland,Wales,2,3,1,0.0,1.0,1658,1725
2005-10-08,Norway,Moldova,1,0,1,1.0,0.0,1877,1551
2005-10-08,Panama,Trinidad and Tobago,0,1,1,0.0,1.0,1647,1719
2005-10-08,Portugal,Liechtenstein,2,1,1,1.0,0.0,1960,1411
2005-10-08,Russia,Luxembourg,5,1,4,1.0,0.0,1833,1315
2005-10-08,Rwanda,Angola,0,1,1,0.0,1.0,1598,1729
2005-10-08,Scotland,Belarus,0,1,1,0.0,1.0,1764,1655
2005-10-08,Senegal,Mali,3,0,3,1.0,0.0,1807,1725
2005-10-08,Slovakia,Estonia,1,0,1,1.0,0.0,1750,1589
2005-10-08,South Africa,DR Congo,2,2,0,0.5,0.5,1776,1692
2005-10-08,Sudan,Ivory Coast,1,3,2,0.0,1.0,1623,1820
2005-10-08,Switzerland,France,1,1,0,0.5,0.5,1819,2042
2005-10-08,Tunisia,Morocco,2,2,0,0.5,0.5,1853,1845
2005-10-08,Turkey,Germany,2,1,1,1.0,0.0,1862,1962
2005-10-08,Uganda,Burkina Faso,2,2,0,0.5,0.5,1608,1621
2005-10-08,Ukraine,Albania,2,2,0,0.5,0.5,1756,1605
2005-10-08,Uzbekistan,Bahrain,1,1,0,0.5,0.5,1727,1732
2005-10-08,Venezuela,Paraguay,0,1,1,0.0,1.0,1677,1875
2005-10-09,Argentina,Peru,2,0,2,1.0,0.0,2029,1770
2005-10-09,Australia,Jamaica,5,0,5,1.0,0.0,1905,1782
2005-10-09,Benin,Libya,1,0,1,1.0,0.0,1524,1662
2005-10-09,Bolivia,Brazil,1,1,0,0.5,0.5,1690,2022
2005-10-11,Cambodia,Singapore,0,2,2,0.0,1.0,1346,1635
2005-10-11,Qatar,Iraq,0,0,0,0.5,0.5,1750,1724
2005-10-11,United Arab Emirates,Oman,2,2,0,0.5,0.5,1701,1761
2005-10-12,Albania,Turkey,0,1,1,0.0,1.0,1603,1865
2005-10-12,Andorra,Armenia,0,3,3,0.0,1.0,1416,1557
2005-10-12,Austria,Northern Ireland,2,0,2,1.0,0.0,1764,1653
2005-10-12,Bahrain,Uzbekistan,0,0,0,0.5,0.5,1732,1728
2005-10-12,Belarus,Norway,0,1,1,0.0,1.0,1652,1881
2005-10-12,Brazil,Venezuela,3,0,3,1.0,0.0,2024,1676
2005-10-12,Chile,Ecuador,0,0,0,0.5,0.5,1773,1833
2005-10-12,England,Poland,2,1,1,1.0,0.0,1984,1874
2005-10-12,Finland,Czech Republic,0,3,3,0.0,1.0,1754,1940
2005-10-12,France,Cyprus,4,0,4,1.0,0.0,2044,1620
2005-10-12,Germany,China PR,1,0,1,1.0,0.0,1968,1827
2005-10-12,Greece,Georgia,1,0,1,1.0,0.0,1862,1595
2005-10-12,Guatemala,Costa Rica,3,1,2,1.0,0.0,1736,1815
2005-10-12,Hungary,Croatia,0,0,0,0.5,0.5,1724,1900
2005-10-12,Republic of Ireland,Switzerland,0,0,0,0.5,0.5,1925,1822
2005-10-12,Italy,Moldova,2,1,1,1.0,0.0,1980,1550
2005-10-12,Kazakhstan,Denmark,1,2,1,0.0,1.0,1531,1932
2005-10-12,South Korea,Iran,2,0,2,1.0,0.0,1866,1900
2005-10-12,Lithuania,Belgium,1,1,0,0.5,0.5,1565,1851
2005-10-12,Luxembourg,Estonia,0,2,2,0.0,1.0,1313,1592
2005-10-12,Malta,Bulgaria,1,1,0,0.5,0.5,1463,1815
2005-10-12,Netherlands,North Macedonia,0,0,0,0.5,0.5,2003,1614
2005-10-12,Paraguay,Colombia,0,1,1,0.0,1.0,1867,1854
2005-10-12,Peru,Bolivia,4,1,3,1.0,0.0,1777,1684
2005-10-12,Portugal,Latvia,3,0,3,1.0,0.0,1962,1602
2005-10-12,San Marino,Spain,0,6,6,0.0,1.0,1377,2013
2005-10-12,Serbia,Bosnia and Herzegovina,1,0,1,1.0,0.0,1806,1684
2005-10-12,Slovakia,Russia,0,0,0,0.5,0.5,1752,1832
2005-10-12,Slovenia,Scotland,0,3,3,0.0,1.0,1715,1772
2005-10-12,Sweden,Iceland,3,1,2,1.0,0.0,1921,1671
2005-10-12,Trinidad and Tobago,Mexico,2,1,1,1.0,0.0,1732,1945
2005-10-12,Ukraine,Japan,1,0,1,1.0,0.0,1768,1911
2005-10-12,Uruguay,Argentina,1,0,1,1.0,0.0,1874,2018
2005-10-12,United States,Panama,2,0,2,1.0,0.0,1949,1645
2005-10-12,Wales,Azerbaijan,2,0,2,1.0,0.0,1729,1500
2005-10-15,Kernow,Jersey,3,2,1,1.0,0.0,1551,1700
2005-10-23,Madagascar,Mauritius,2,0,2,1.0,0.0,1585,1552
2005-10-25,Oman,Syria,0,0,0,0.5,0.5,1759,1661
2005-10-26,Mexico,Uruguay,3,1,2,1.0,0.0,1952,1868
2005-10-27,Bahrain,Panama,5,0,5,1.0,0.0,1739,1639
2005-10-30,Puerto Rico,Guadeloupe,1,3,2,0.0,1.0,1349,1569
2005-11-06,Zanzibar,Tanzania,0,1,1,0.0,1.0,1404,1485
2005-11-09,France,Costa Rica,3,2,1,1.0,0.0,2048,1812
2005-11-09,Tajikistan,Afghanistan,4,0,4,1.0,0.0,1567,1385
2005-11-09,Tanzania,Zanzibar,1,0,1,1.0,0.0,1492,1398
2005-11-11,DR Congo,Tunisia,2,2,0,0.5,0.5,1696,1850
2005-11-11,Paraguay,Togo,4,2,2,1.0,0.0,1872,1714
2005-11-12,Belarus,Latvia,3,1,2,1.0,0.0,1659,1596
2005-11-12,Bulgaria,Georgia,6,2,4,1.0,0.0,1819,1592
2005-11-12,England,Argentina,3,2,1,1.0,0.0,1993,2010
2005-11-12,Finland,Estonia,2,2,0,0.5,0.5,1751,1596
2005-11-12,France,Germany,0,0,0,0.5,0.5,2047,1970
2005-11-12,South Korea,Sweden,2,2,0,0.5,0.5,1868,1920
2005-11-12,Liechtenstein,North Macedonia,1,2,1,0.0,1.0,1408,1618
2005-11-12,Netherlands,Italy,1,3,2,0.0,1.0,1995,1989
2005-11-12,Norway,Czech Republic,0,1,1,0.0,1.0,1875,1947
2005-11-12,Portugal,Croatia,2,0,2,1.0,0.0,1969,1894
2005-11-12,Romania,Ivory Coast,1,2,1,0.0,1.0,1865,1830
2005-11-12,Scotland,United States,1,1,0,0.5,0.5,1776,1946
2005-11-12,South Africa,Senegal,2,3,1,0.0,1.0,1769,1815
2005-11-12,Spain,Slovakia,5,1,4,1.0,0.0,2016,1750
2005-11-12,Switzerland,Turkey,2,0,2,1.0,0.0,1831,1857
2005-11-12,Trinidad and Tobago,Bahrain,1,1,0,0.5,0.5,1733,1739
2005-11-12,United Arab Emirates,Brazil,0,8,8,0.0,1.0,1699,2027
2005-11-12,Uruguay,Australia,1,0,1,1.0,0.0,1877,1897
2005-11-13,China PR,Serbia,0,2,2,0.0,1.0,1819,1815
2005-11-13,Ecuador,Poland,0,3,3,0.0,1.0,1826,1882
2005-11-13,Iran,Togo,2,0,2,1.0,0.0,1905,1710
2005-11-14,Saudi Arabia,Ghana,1,3,2,0.0,1.0,1838,1724
2005-11-15,Morocco,Cameroon,0,0,0,0.5,0.5,1846,1867
2005-11-15,Northern Ireland,Portugal,1,1,0,0.5,0.5,1659,1964
2005-11-16,Australia,Uruguay,1,0,1,1.0,0.0,1905,1870
2005-11-16,Bahrain,Trinidad and Tobago,0,1,1,0.0,1.0,1731,1742
2005-11-16,Cyprus,Wales,1,0,1,1.0,0.0,1631,1719
2005-11-16,Czech Republic,Norway,1,0,1,1.0,0.0,1954,1869
2005-11-16,Egypt,Tunisia,1,2,1,0.0,1.0,1864,1859
2005-11-16,Georgia,Jordan,3,2,1,1.0,0.0,1603,1710
2005-11-16,Greece,Hungary,2,1,1,1.0,0.0,1867,1720
2005-11-16,Ivory Coast,Italy,1,1,0,0.5,0.5,1834,1986
2005-11-16,Japan,Angola,1,0,1,1.0,0.0,1916,1725
2005-11-16,South Korea,Serbia,2,0,2,1.0,0.0,1875,1809
2005-11-16,Libya,DR Congo,2,1,1,1.0,0.0,1671,1688
2005-11-16,Luxembourg,Canada,0,1,1,0.0,1.0,1312,1718
2005-11-16,Mexico,Bulgaria,0,3,3,0.0,1.0,1942,1830
2005-11-16,Poland,Estonia,3,1,2,1.0,0.0,1885,1594
2005-11-16,Qatar,Argentina,0,3,3,0.0,1.0,1748,2013
2005-11-16,Romania,Nigeria,3,0,3,1.0,0.0,1874,1861
2005-11-16,Slovakia,Spain,1,1,0,0.5,0.5,1756,2011
2005-11-16,Syria,United Arab Emirates,0,3,3,0.0,1.0,1654,1707
2005-11-16,Turkey,Switzerland,4,2,2,1.0,0.0,1865,1824
2005-11-18,Guinea,Guinea-Bissau,2,2,0,0.5,0.5,1676,1502
2005-11-20,Guinea-Bissau,Sierra Leone,1,1,0,0.5,0.5,1505,1622
2005-11-22,Guinea,Sierra Leone,1,0,1,1.0,0.0,1683,1616
2005-11-24,Sudan,Ethiopia,1,5,4,0.0,1.0,1615,1601
2005-11-26,Kuwait,Iraq,0,0,0,0.5,0.5,1735,1725
2005-11-26,Rwanda,Zanzibar,0,1,1,0.0,1.0,1586,1411
2005-11-27,Djibouti,Somalia,1,2,1,0.0,1.0,1369,1399
2005-11-27,Ethiopia,Uganda,0,0,0,0.5,0.5,1602,1608
2005-11-28,Burundi,Tanzania,1,2,1,0.0,1.0,1547,1502
2005-11-28,Eritrea,Zanzibar,0,3,3,0.0,1.0,1464,1421
2005-11-29,Somalia,Sudan,1,4,3,0.0,1.0,1396,1619
2005-11-30,Burundi,Zanzibar,1,2,1,0.0,1.0,1537,1432
2005-11-30,Djibouti,Uganda,1,6,5,0.0,1.0,1366,1612
2005-11-30,Rwanda,Eritrea,3,2,1,1.0,0.0,1592,1459
2005-12-01,Ethiopia,Sudan,3,1,2,1.0,0.0,1611,1611
2005-12-01,Iraq,Palestine,4,0,4,1.0,0.0,1729,1493
2005-12-01,Somalia,Uganda,0,7,7,0.0,1.0,1393,1616
2005-12-02,Burundi,Eritrea,0,0,0,0.5,0.5,1536,1461
2005-12-02,Tanzania,Zanzibar,1,1,0,0.5,0.5,1501,1434
2005-12-02,United Arab Emirates,Libya,1,1,0,0.5,0.5,1707,1672
2005-12-03,Djibouti,Ethiopia,0,6,6,0.0,1.0,1363,1615
2005-12-03,Oman,Syria,1,3,2,0.0,1.0,1749,1665
2005-12-03,Saudi Arabia,Palestine,2,0,2,1.0,0.0,1840,1492
2005-12-03,Sudan,Uganda,0,3,3,0.0,1.0,1604,1624
2005-12-04,Bahrain,Syria,2,2,0,0.5,0.5,1730,1667
2005-12-04,Eritrea,Tanzania,0,1,1,0.0,1.0,1454,1509
2005-12-04,Rwanda,Burundi,2,0,2,1.0,0.0,1599,1530
2005-12-05,Djibouti,Sudan,0,4,4,0.0,1.0,1360,1608
2005-12-05,Ethiopia,Somalia,3,1,2,1.0,0.0,1619,1390
2005-12-05,Iraq,Saudi Arabia,5,1,4,1.0,0.0,1740,1830
2005-12-06,Bahrain,Oman,2,2,0,0.5,0.5,1731,1749
2005-12-06,Rwanda,Tanzania,3,1,2,1.0,0.0,1605,1504
2005-12-07,Maldives,Afghanistan,9,1,8,1.0,0.0,1415,1378
2005-12-07,Pakistan,Sri Lanka,1,0,1,1.0,0.0,1385,1414
2005-12-08,Bangladesh,Bhutan,3,0,3,1.0,0.0,1472,1362
2005-12-08,India,Nepal,2,1,1,1.0,0.0,1541,1355
2005-12-08,Iraq,Saudi Arabia,2,0,2,1.0,0.0,1751,1820
2005-12-08,Rwanda,Uganda,1,0,1,1.0,0.0,1614,1616
2005-12-08,Zanzibar,Ethiopia,0,4,4,0.0,1.0,1430,1624
2005-12-09,Maldives,Sri Lanka,2,0,2,1.0,0.0,1423,1407
2005-12-09,Pakistan,Afghanistan,1,0,1,1.0,0.0,1393,1371
2005-12-10,Bangladesh,Nepal,2,0,2,1.0,0.0,1478,1350
2005-12-10,India,Bhutan,3,0,3,1.0,0.0,1546,1358
2005-12-10,Rwanda,Ethiopia,0,1,1,0.0,1.0,1607,1632
2005-12-10,Syria,Iraq,2,2,0,0.5,0.5,1669,1750
2005-12-10,Zanzibar,Uganda,0,0,0,0.5,0.5,1434,1613
2005-12-11,DR Congo,Zambia,1,1,0,0.5,0.5,1689,1722
2005-12-11,Pakistan,Maldives,0,0,0,0.5,0.5,1394,1423
2005-12-11,Sri Lanka,Afghanistan,1,2,1,0.0,1.0,1399,1380
2005-12-12,Bangladesh,India,1,1,0,0.5,0.5,1480,1545
2005-12-12,Nepal,Bhutan,3,1,2,1.0,0.0,1359,1350
2005-12-14,Maldives,India,0,1,1,0.0,1.0,1418,1551
2005-12-14,Mexico,Hungary,2,0,2,1.0,0.0,1946,1717
2005-12-14,Pakistan,Bangladesh,0,1,1,0.0,1.0,1388,1487
2005-12-14,Zambia,DR Congo,4,1,3,1.0,0.0,1730,1682
2005-12-16,Mauritius,Réunion,1,1,0,0.5,0.5,1553,1560
2005-12-17,Bangladesh,India,0,2,2,0.0,1.0,1481,1558
2005-12-17,Occitania,Monaco,1,2,1,0.0,1.0,1501,1504
2005-12-18,Antigua and Barbuda,Hungary,0,3,3,0.0,1.0,1476,1721
2005-12-18,Réunion,Mauritius,1,2,1,0.0,1.0,1552,1562
2005-12-22,Bangladesh,Pakistan,0,0,0,0.5,0.5,1479,1391
2005-12-24,Thailand,Latvia,1,1,0,0.5,0.5,1679,1598
2005-12-25,Galicia,Uruguay,3,2,1,1.0,0.0,1515,1856
2005-12-26,North Korea,Latvia,1,1,0,0.5,0.5,1701,1601
2005-12-26,Pakistan,Bangladesh,0,1,1,0.0,1.0,1385,1486
2005-12-27,Ecuador,Senegal,1,2,1,0.0,1.0,1818,1824
2005-12-27,Egypt,Uganda,2,0,2,1.0,0.0,1868,1610
2005-12-28,Thailand,North Korea,0,2,2,0.0,1.0,1672,1709
2005-12-28,Basque Country,Cameroon,0,1,1,0.0,1.0,1713,1872
2005-12-28,Catalonia,Paraguay,1,1,0,0.5,0.5,1591,1867
2005-12-28,Andalusia,China PR,4,1,3,1.0,0.0,1579,1807
2005-12-29,Ecuador,Uganda,1,2,1,0.0,1.0,1806,1623
2005-12-29,Egypt,Senegal,4,2,2,1.0,0.0,1875,1818
2005-12-30,Latvia,North Korea,2,1,1,1.0,0.0,1612,1699
2006-01-02,Qatar,Libya,2,0,2,1.0,0.0,1755,1666
2006-01-05,Egypt,Zimbabwe,2,0,2,1.0,0.0,1880,1719
2006-01-07,Guinea,Togo,1,0,1,1.0,0.0,1692,1702
2006-01-09,Morocco,DR Congo,3,0,3,1.0,0.0,1851,1678
2006-01-11,Ghana,Togo,0,1,1,0.0,1.0,1716,1711
2006-01-12,Tunisia,Libya,1,0,1,1.0,0.0,1863,1663
2006-01-14,Egypt,South Africa,1,2,1,0.0,1.0,1870,1780
2006-01-14,Morocco,Zimbabwe,1,0,1,1.0,0.0,1857,1714
2006-01-14,Senegal,DR Congo,0,0,0,0.5,0.5,1815,1682
2006-01-15,Tunisia,Ghana,2,0,2,1.0,0.0,1868,1712
2006-01-17,Ivory Coast,Jordan,2,0,2,1.0,0.0,1840,1705
2006-01-17,Morocco,Angola,2,2,0,0.5,0.5,1855,1728
2006-01-18,Saudi Arabia,Sweden,1,1,0,0.5,0.5,1823,1918
2006-01-18,United Arab Emirates,South Korea,1,0,1,1.0,0.0,1719,1864
2006-01-20,Egypt,Libya,3,0,3,1.0,0.0,1874,1660
2006-01-21,Cameroon,Angola,3,1,2,1.0,0.0,1877,1724
2006-01-21,Greece,South Korea,1,1,0,0.5,0.5,1867,1865
2006-01-21,Morocco,Ivory Coast,0,1,1,0.0,1.0,1847,1849
2006-01-21,Saudi Arabia,Finland,1,1,0,0.5,0.5,1822,1753
2006-01-21,Togo,DR Congo,0,2,2,0.0,1.0,1703,1691
2006-01-22,South Africa,Guinea,0,2,2,0.0,1.0,1771,1702
2006-01-22,Tunisia,Zambia,4,1,3,1.0,0.0,1873,1726
2006-01-22,United States,Canada,0,0,0,0.5,0.5,1942,1723
2006-01-23,Jordan,Sweden,0,0,0,0.5,0.5,1710,1914
2006-01-23,Nigeria,Ghana,1,0,1,1.0,0.0,1866,1708
2006-01-23,Zimbabwe,Senegal,0,2,2,0.0,1.0,1709,1821
2006-01-24,Egypt,Morocco,0,0,0,0.5,0.5,1874,1848
2006-01-24,Libya,Ivory Coast,1,2,1,0.0,1.0,1656,1854
2006-01-25,Angola,DR Congo,0,0,0,0.5,0.5,1724,1692
2006-01-25,Cameroon,Togo,2,0,2,1.0,0.0,1882,1699
2006-01-25,Ecuador,Honduras,1,0,1,1.0,0.0,1814,1775
2006-01-25,Finland,South Korea,0,1,1,0.0,1.0,1748,1871
2006-01-25,Mexico,Norway,2,1,1,1.0,0.0,1953,1863
2006-01-25,Saudi Arabia,Greece,1,1,0,0.5,0.5,1824,1866
2006-01-26,Tunisia,South Africa,2,0,2,1.0,0.0,1879,1766
2006-01-26,Zambia,Guinea,1,2,1,0.0,1.0,1718,1711
2006-01-27,Ghana,Senegal,1,0,1,1.0,0.0,1719,1811
2006-01-27,Nigeria,Zimbabwe,2,0,2,1.0,0.0,1871,1705
2006-01-27,Northern Cyprus,Kyrgyzstan,3,2,1,1.0,0.0,1491,1450
2006-01-27,Saudi Arabia,Lebanon,1,2,1,0.0,1.0,1812,1628
2006-01-28,Egypt,Ivory Coast,3,1,2,1.0,0.0,1882,1847
2006-01-28,Libya,Morocco,0,0,0,0.5,0.5,1661,1844
2006-01-29,Angola,Togo,3,2,1,1.0,0.0,1732,1692
2006-01-29,Cameroon,DR Congo,2,0,2,1.0,0.0,1887,1688
2006-01-29,South Korea,Croatia,2,0,2,1.0,0.0,1880,1886
2006-01-29,United States,Norway,5,0,5,1.0,0.0,1949,1857
2006-01-30,Bahrain,Syria,1,1,0,0.5,0.5,1730,1671
2006-01-30,Tunisia,Guinea,0,3,3,0.0,1.0,1868,1723
2006-01-30,Zambia,South Africa,1,0,1,1.0,0.0,1728,1757
2006-01-31,Ghana,Zimbabwe,1,2,1,0.0,1.0,1711,1714
2006-01-31,Nigeria,Senegal,2,1,1,1.0,0.0,1878,1805
2006-02-01,Hong Kong,Croatia,0,4,4,0.0,1.0,1557,1889
2006-02-01,Thailand,Jordan,0,0,0,0.5,0.5,1673,1710
2006-02-03,Egypt,DR Congo,4,1,3,1.0,0.0,1886,1685
2006-02-03,Guinea,Senegal,2,3,1,0.0,1.0,1717,1812
2006-02-04,Cameroon,Ivory Coast,1,1,0,0.5,0.5,1887,1848
2006-02-04,Nigeria,Tunisia,1,1,0,0.5,0.5,1878,1869
2006-02-06,Oman,Singapore,1,0,1,1.0,0.0,1755,1630
2006-02-07,Egypt,Senegal,2,1,1,1.0,0.0,1893,1806
2006-02-07,Kuwait,Jordan,2,1,1,1.0,0.0,1743,1703
2006-02-07,Nigeria,Ivory Coast,0,1,1,0.0,1.0,1870,1857
2006-02-07,Syria,Palestine,3,0,3,1.0,0.0,1676,1488
2006-02-09,Senegal,Nigeria,0,1,1,0.0,1.0,1800,1877
2006-02-10,Egypt,Ivory Coast,0,0,0,0.5,0.5,1893,1858
2006-02-10,United States,Japan,3,2,1,1.0,0.0,1957,1909
2006-02-11,Costa Rica,South Korea,1,0,1,1.0,0.0,1822,1871
2006-02-12,China PR,Honduras,0,1,1,0.0,1.0,1799,1784
2006-02-13,Oman,Iraq,1,0,1,1.0,0.0,1763,1743
2006-02-14,Jordan,Kazakhstan,2,0,2,1.0,0.0,1708,1527
2006-02-14,Qatar,Tajikistan,2,0,2,1.0,0.0,1760,1563
2006-02-14,Saudi Arabia,Syria,1,1,0,0.5,0.5,1810,1679
2006-02-15,Hong Kong,Singapore,1,1,0,0.5,0.5,1559,1629
2006-02-15,Mexico,South Korea,0,1,1,0.0,1.0,1944,1881
2006-02-16,Bahrain,Palestine,0,2,2,0.0,1.0,1718,1501
2006-02-16,Thailand,Iraq,4,3,1,1.0,0.0,1683,1734
2006-02-18,Hong Kong,India,2,2,0,0.5,0.5,1559,1559
2006-02-18,Japan,Finland,2,0,2,1.0,0.0,1914,1744
2006-02-18,Pakistan,Palestine,0,3,3,0.0,1.0,1380,1507
2006-02-18,Monaco,Chechnya,13,1,12,1.0,0.0,1512,1487
2006-02-19,New Zealand,Malaysia,1,0,1,1.0,0.0,1707,1567
2006-02-19,United States,Guatemala,4,0,4,1.0,0.0,1961,1733
2006-02-22,Bahrain,Australia,1,3,2,0.0,1.0,1714,1910
2006-02-22,China PR,Palestine,2,0,2,1.0,0.0,1802,1505
2006-02-22,Hong Kong,Qatar,0,3,3,0.0,1.0,1556,1764
2006-02-22,Iran,Taiwan,4,0,4,1.0,0.0,1906,1406
2006-02-22,Japan,India,6,0,6,1.0,0.0,1916,1558
2006-02-22,Jordan,Pakistan,3,0,3,1.0,0.0,1711,1378
2006-02-22,Lebanon,Kuwait,1,1,0,0.5,0.5,1631,1741
2006-02-22,Singapore,Iraq,2,0,2,1.0,0.0,1640,1724
2006-02-22,Syria,South Korea,1,2,1,0.0,1.0,1676,1885
2006-02-22,United Arab Emirates,Oman,1,0,1,1.0,0.0,1729,1754
2006-02-22,Uzbekistan,Bangladesh,5,0,5,1.0,0.0,1732,1483
2006-02-22,Yemen,Saudi Arabia,0,4,4,0.0,1.0,1496,1813
2006-02-23,New Zealand,Malaysia,2,1,1,1.0,0.0,1712,1563
2006-02-24,Guyana,Antigua and Barbuda,2,1,1,1.0,0.0,1490,1469
2006-02-24,Kazakhstan,North Korea,0,0,0,0.5,0.5,1531,1696
2006-02-25,Saint Kitts and Nevis,Saint Martin,6,1,5,1.0,0.0,1592,1493
2006-02-26,Guyana,Antigua and Barbuda,4,1,3,1.0,0.0,1498,1462
2006-02-28,Algeria,Burkina Faso,0,0,0,0.5,0.5,1696,1623
2006-02-28,Azerbaijan,Ukraine,0,0,0,0.5,0.5,1506,1763
2006-02-28,Bosnia and Herzegovina,Japan,2,2,0,0.5,0.5,1689,1912
2006-02-28,Cyprus,Slovenia,0,1,1,0.0,1.0,1625,1722
2006-02-28,Finland,Kazakhstan,0,0,0,0.5,0.5,1740,1536
2006-02-28,Greece,Belarus,1,0,1,1.0,0.0,1870,1656
2006-02-28,Iceland,Trinidad and Tobago,0,2,2,0.0,1.0,1665,1749
2006-02-28,Romania,Armenia,2,0,2,1.0,0.0,1877,1555
2006-03-01,Albania,Lithuania,1,2,1,0.0,1.0,1595,1574
2006-03-01,Argentina,Croatia,2,3,1,0.0,1.0,2003,1900
2006-03-01,Austria,Canada,0,2,2,0.0,1.0,1756,1732
2006-03-01,Bangladesh,Hong Kong,0,1,1,0.0,1.0,1477,1563
2006-03-01,Cyprus,Armenia,2,0,2,1.0,0.0,1632,1549
2006-03-01,England,Uruguay,2,1,1,1.0,0.0,1998,1852
2006-03-01,Finland,Belarus,2,2,0,0.5,0.5,1739,1658
2006-03-01,France,Slovakia,1,2,1,0.0,1.0,2034,1770
2006-03-01,India,Yemen,0,3,3,0.0,1.0,1549,1506
2006-03-01,Iran,Costa Rica,3,2,1,1.0,0.0,1913,1816
2006-03-01,Iraq,China PR,2,1,1,1.0,0.0,1734,1793
2006-03-01,Republic of Ireland,Sweden,3,0,3,1.0,0.0,1933,1907
2006-03-01,Israel,Denmark,0,2,2,0.0,1.0,1764,1937
2006-03-01,Italy,Germany,4,1,3,1.0,0.0,1994,1963
2006-03-01,Kazakhstan,Greece,0,2,2,0.0,1.0,1534,1873
2006-03-01,South Korea,Angola,1,0,1,1.0,0.0,1890,1728
2006-03-01,Kuwait,Bahrain,0,0,0,0.5,0.5,1741,1715
2006-03-01,Luxembourg,Belgium,0,2,2,0.0,1.0,1312,1852
2006-03-01,North Macedonia,Bulgaria,0,1,1,0.0,1.0,1615,1834
2006-03-01,Malta,Georgia,0,2,2,0.0,1.0,1459,1608
2006-03-01,Mexico,Ghana,1,0,1,1.0,0.0,1948,1708
2006-03-01,Netherlands,Ecuador,1,0,1,1.0,0.0,2000,1810
2006-03-01,Northern Ireland,Estonia,1,0,1,1.0,0.0,1666,1588
2006-03-01,Oman,Jordan,3,0,3,1.0,0.0,1762,1704
2006-03-01,Pakistan,United Arab Emirates,1,4,3,0.0,1.0,1377,1731
2006-03-01,Palestine,Singapore,1,0,1,1.0,0.0,1516,1630
2006-03-01,Poland,United States,0,1,1,0.0,1.0,1879,1968
2006-03-01,Qatar,Uzbekistan,2,1,1,1.0,0.0,1772,1725
2006-03-01,Russia,Brazil,0,1,1,0.0,1.0,1829,2031
2006-03-01,Saudi Arabia,Portugal,0,3,3,0.0,1.0,1809,1969
2006-03-01,Scotland,Switzerland,1,3,2,0.0,1.0,1770,1831
2006-03-01,Senegal,Norway,2,1,1,1.0,0.0,1810,1848
2006-03-01,Slovenia,Romania,0,2,2,0.0,1.0,1718,1882
2006-03-01,Spain,Ivory Coast,3,2,1,1.0,0.0,2016,1854
2006-03-01,Tunisia,Serbia,0,1,1,0.0,1.0,1860,1819
2006-03-01,Turkey,Czech Republic,2,2,0,0.5,0.5,1868,1952
2006-03-01,Venezuela,Colombia,1,1,0,0.5,0.5,1680,1851
2006-03-01,Wales,Paraguay,0,0,0,0.5,0.5,1723,1864
2006-03-15,Saudi Arabia,Iraq,2,2,0,0.5,0.5,1808,1736
2006-03-18,Alderney,Jersey,1,4,3,0.0,1.0,1282,1702
2006-03-22,Albania,Georgia,0,0,0,0.5,0.5,1596,1608
2006-03-22,Germany,United States,4,1,3,1.0,0.0,1972,1960
2006-03-26,Thailand,Philippines,5,0,5,1.0,0.0,1685,1253
2006-03-28,Saudi Arabia,Poland,1,2,1,0.0,1.0,1802,1886
2006-03-29,Equatorial Guinea,Benin,2,0,2,1.0,0.0,1451,1515
2006-03-29,Mexico,Paraguay,2,1,1,1.0,0.0,1955,1858
2006-03-30,Japan,Ecuador,1,0,1,1.0,0.0,1918,1805
2006-04-01,Bangladesh,Cambodia,2,1,1,1.0,0.0,1483,1341
2006-04-01,Palestine,Guam,11,0,11,1.0,0.0,1521,1365
2006-04-01,Tanzania,Zanzibar,2,2,0,0.5,0.5,1503,1436
2006-04-02,Kyrgyzstan,Pakistan,0,1,1,0.0,1.0,1441,1387
2006-04-02,Nepal,Bhutan,2,0,2,1.0,0.0,1367,1343
2006-04-02,Sri Lanka,Brunei,1,0,1,1.0,0.0,1405,1296
2006-04-02,Tajikistan,Macau,4,0,4,1.0,0.0,1567,1362
2006-04-03,Afghanistan,Taiwan,2,2,0,0.5,0.5,1381,1406
2006-04-03,Bangladesh,Guam,3,0,3,1.0,0.0,1489,1360
2006-04-03,Cambodia,Palestine,0,4,4,0.0,1.0,1337,1526
2006-04-04,Bhutan,Sri Lanka,0,1,1,0.0,1.0,1337,1412
2006-04-04,Brunei,Nepal,2,1,1,1.0,0.0,1306,1358
2006-04-04,Pakistan,Tajikistan,0,2,2,0.0,1.0,1383,1572
2006-04-05,Bangladesh,Palestine,1,1,0,0.5,0.5,1490,1526
2006-04-05,Philippines,Afghanistan,1,1,0,0.5,0.5,1256,1379
2006-04-06,Bhutan,Brunei,0,0,0,0.5,0.5,1337,1307
2006-04-06,Cambodia,Guam,3,0,3,1.0,0.0,1346,1352
2006-04-06,Pakistan,Macau,2,2,0,0.5,0.5,1383,1363
2006-04-06,Sri Lanka,Nepal,1,1,0,0.5,0.5,1411,1360
2006-04-06,Tajikistan,Kyrgyzstan,0,1,1,0.0,1.0,1562,1452
2006-04-07,Macau,Kyrgyzstan,0,2,2,0.0,1.0,1358,1458
2006-04-08,Sri Lanka,Taiwan,3,0,3,1.0,0.0,1419,1399
2006-04-09,Palestine,Kyrgyzstan,0,1,1,0.0,1.0,1517,1468
2006-04-10,Bangladesh,Tajikistan,1,6,5,0.0,1.0,1484,1569
2006-04-11,United States,Jamaica,1,1,0,0.5,0.5,1957,1786
2006-04-12,Azerbaijan,Turkey,1,1,0,0.5,0.5,1513,1862
2006-04-12,Sri Lanka,Nepal,1,1,0,0.5,0.5,1418,1362
2006-04-13,Tajikistan,Kyrgyzstan,2,0,2,1.0,0.0,1575,1463
2006-04-14,Lesotho,Eswatini,5,0,5,1.0,0.0,1467,1488
2006-04-16,Lesotho,Eswatini,2,2,0,0.5,0.5,1468,1488
2006-04-16,Sri Lanka,Tajikistan,0,4,4,0.0,1.0,1414,1580
2006-04-22,Kosovo,Monaco,7,1,6,1.0,0.0,1509,1504
2006-04-25,Chile,New Zealand,4,1,3,1.0,0.0,1780,1706
2006-04-27,Chile,New Zealand,1,0,1,1.0,0.0,1787,1700
2006-04-29,Angola,Mauritius,5,1,4,1.0,0.0,1733,1558
2006-04-29,Lesotho,Mozambique,0,0,0,0.5,0.5,1471,1579
2006-04-30,Lesotho,Angola,1,3,2,0.0,1.0,1469,1736
2006-04-30,Mauritius,Mozambique,0,0,0,0.5,0.5,1559,1579
2006-05-01,Jersey,Guernsey,3,2,1,1.0,0.0,1710,1672
2006-05-02,Poland,Lithuania,0,1,1,0.0,1.0,1873,1588
2006-05-02,United Arab Emirates,Syria,2,1,1,1.0,0.0,1738,1670
2006-05-05,Mexico,Venezuela,1,0,1,1.0,0.0,1958,1678
2006-05-09,Japan,Bulgaria,1,2,1,0.0,1.0,1909,1844
2006-05-10,Lesotho,South Africa,0,0,0,0.5,0.5,1475,1752
2006-05-10,Trinidad and Tobago,Peru,1,1,0,0.5,0.5,1750,1777
2006-05-11,Belgium,Saudi Arabia,2,1,1,1.0,0.0,1859,1796
2006-05-11,Bulgaria,Scotland,1,5,4,0.0,1.0,1835,1780
2006-05-12,Mexico,DR Congo,2,1,1,1.0,0.0,1961,1683
2006-05-13,Japan,Scotland,0,0,0,0.5,0.5,1907,1783
2006-05-14,Botswana,Zambia,0,0,0,0.5,0.5,1549,1725
2006-05-14,Poland,Faroe Islands,4,0,4,1.0,0.0,1875,1479
2006-05-14,Saudi Arabia,Togo,1,0,1,1.0,0.0,1802,1687
2006-05-18,Moldova,Azerbaijan,0,0,0,0.5,0.5,1550,1514
2006-05-20,Botswana,Madagascar,2,0,2,1.0,0.0,1558,1577
2006-05-20,Guadeloupe,Saint Lucia,2,1,1,1.0,0.0,1577,1546
2006-05-20,Slovakia,Belgium,1,1,0,0.5,0.5,1773,1857
2006-05-20,South Africa,Eswatini,1,0,1,1.0,0.0,1755,1486
2006-05-21,Botswana,South Africa,0,0,0,0.5,0.5,1563,1751
2006-05-21,Madagascar,Eswatini,0,2,2,0.0,1.0,1567,1497
2006-05-21,Northern Ireland,Uruguay,0,1,1,0.0,1.0,1662,1857
2006-05-21,Basque Country,Wales,0,1,1,0.0,1.0,1706,1731
2006-05-23,Austria,Croatia,1,4,3,0.0,1.0,1752,1905
2006-05-23,South Korea,Senegal,1,1,0,0.5,0.5,1889,1812
2006-05-23,Romania,Uruguay,0,2,2,0.0,1.0,1874,1866
2006-05-23,United States,Morocco,0,1,1,0.0,1.0,1947,1855
2006-05-24,Belgium,Turkey,3,3,0,0.5,0.5,1858,1862
2006-05-24,Colombia,Ecuador,1,1,0,0.5,0.5,1850,1807
2006-05-24,Hungary,New Zealand,2,0,2,1.0,0.0,1729,1693
2006-05-24,Republic of Ireland,Chile,0,1,1,0.0,1.0,1922,1799
2006-05-24,Norway,Paraguay,2,2,0,0.5,0.5,1849,1858
2006-05-24,Catalonia,Costa Rica,2,0,2,1.0,0.0,1604,1804
2006-05-25,Australia,Greece,1,0,1,1.0,0.0,1918,1866
2006-05-25,Sweden,Finland,0,0,0,0.5,0.5,1904,1743
2006-05-26,Czech Republic,Saudi Arabia,2,0,2,1.0,0.0,1957,1798
2006-05-26,South Korea,Bosnia and Herzegovina,2,0,2,1.0,0.0,1893,1686
2006-05-26,Romania,Northern Ireland,2,0,2,1.0,0.0,1878,1659
2006-05-26,Turkey,Ghana,1,1,0,0.5,0.5,1859,1712
2006-05-26,United States,Venezuela,2,0,2,1.0,0.0,1950,1676
2006-05-27,Denmark,Paraguay,1,1,0,0.5,0.5,1936,1860
2006-05-27,France,Mexico,1,0,1,1.0,0.0,2041,1955
2006-05-27,Georgia,New Zealand,1,3,2,0.0,1.0,1602,1700
2006-05-27,Germany,Luxembourg,7,0,7,1.0,0.0,1973,1312
2006-05-27,Netherlands,Cameroon,1,0,1,1.0,0.0,2006,1882
2006-05-27,Portugal,Cape Verde,4,1,3,1.0,0.0,1971,1545
2006-05-27,Romania,Colombia,0,0,0,0.5,0.5,1878,1851
2006-05-27,Serbia,Uruguay,1,1,0,0.5,0.5,1821,1865
2006-05-27,Spain,Russia,0,0,0,0.5,0.5,2013,1833
2006-05-27,Switzerland,Ivory Coast,1,1,0,0.5,0.5,1832,1854
2006-05-27,Wales,Trinidad and Tobago,2,1,1,1.0,0.0,1740,1742
2006-05-28,Croatia,Iran,2,2,0,0.5,0.5,1906,1913
2006-05-28,North Macedonia,Ecuador,2,1,1,1.0,0.0,1628,1795
2006-05-28,Morocco,Mali,0,1,1,0.0,1.0,1845,1736
2006-05-28,Turkey,Estonia,1,1,0,0.5,0.5,1854,1594
2006-05-28,Ukraine,Costa Rica,4,0,4,1.0,0.0,1772,1796
2006-05-28,United States,Latvia,1,0,1,1.0,0.0,1953,1610
2006-05-29,Jamaica,Ghana,1,4,3,0.0,1.0,1777,1722
2006-05-29,Northern Cyprus,Greenland,1,0,1,1.0,0.0,1499,1470
2006-05-29,Republic of St. Pauli,Gibraltar,1,1,0,0.5,0.5,1501,1541
2006-05-30,Argentina,Angola,2,0,2,1.0,0.0,2006,1734
2006-05-30,Chile,Ivory Coast,1,1,0,0.5,0.5,1801,1853
2006-05-30,Czech Republic,Costa Rica,1,0,1,1.0,0.0,1962,1792
2006-05-30,England,Hungary,3,1,2,1.0,0.0,2001,1727
2006-05-30,Germany,Japan,2,2,0,0.5,0.5,1972,1909
2006-05-30,Libya,Uruguay,1,2,1,0.0,1.0,1658,1869
2006-05-30,Poland,Colombia,1,2,1,0.0,1.0,1867,1860
2006-05-30,Tunisia,Belarus,3,0,3,1.0,0.0,1864,1655
2006-05-30,Zanzibar,Northern Cyprus,1,3,2,0.0,1.0,1430,1506
2006-05-30,Republic of St. Pauli,Tibet,7,0,7,1.0,0.0,1509,1477
2006-05-31,Estonia,New Zealand,1,1,0,0.5,0.5,1597,1698
2006-05-31,France,Denmark,2,0,2,1.0,0.0,2047,1931
2006-05-31,Georgia,Paraguay,0,1,1,0.0,1.0,1600,1863
2006-05-31,Gibraltar,Tibet,5,0,5,1.0,0.0,1548,1471
2006-05-31,Greenland,Zanzibar,2,4,2,0.0,1.0,1462,1439
2006-05-31,Iran,Bosnia and Herzegovina,5,2,3,1.0,0.0,1917,1683
2006-05-31,Saudi Arabia,Turkey,0,1,1,0.0,1.0,1792,1861
2006-05-31,Singapore,Malaysia,0,0,0,0.5,0.5,1629,1565
2006-05-31,Slovenia,Trinidad and Tobago,3,1,2,1.0,0.0,1727,1734
2006-05-31,Switzerland,Italy,1,1,0,0.5,0.5,1836,1991
2006-06-01,Netherlands,Mexico,2,1,1,1.0,0.0,2013,1949
2006-06-01,Northern Cyprus,Gibraltar,2,0,2,1.0,0.0,1515,1540
2006-06-01,Republic of St. Pauli,Zanzibar,1,2,1,0.0,1.0,1500,1449
2006-06-01,Norway,South Korea,0,0,0,0.5,0.5,1851,1892
2006-06-02,Angola,Turkey,2,3,1,0.0,1.0,1729,1867
2006-06-02,Germany,Colombia,3,0,3,1.0,0.0,1978,1855
2006-06-02,Italy,Ukraine,0,0,0,0.5,0.5,1987,1777
2006-06-02,Libya,Belarus,1,1,0,0.5,0.5,1658,1656
2006-06-02,Liechtenstein,Togo,0,1,1,0.0,1.0,1406,1690
2006-06-02,Sweden,Chile,1,1,0,0.5,0.5,1902,1804
2006-06-02,Tunisia,Uruguay,0,0,0,0.5,0.5,1865,1869
2006-06-03,Croatia,Poland,0,1,1,0.0,1.0,1898,1876
2006-06-03,Czech Republic,Trinidad and Tobago,3,0,3,1.0,0.0,1966,1731
2006-06-03,England,Jamaica,6,0,6,1.0,0.0,2005,1774
2006-06-03,Luxembourg,Portugal,0,3,3,0.0,1.0,1312,1972
2006-06-03,Macau,Hong Kong,0,0,0,0.5,0.5,1363,1559
2006-06-03,Malaysia,Singapore,0,0,0,0.5,0.5,1567,1628
2006-06-03,Republic of St. Pauli,Gibraltar,1,2,1,0.0,1.0,1493,1548
2006-06-03,Northern Cyprus,Zanzibar,0,0,0,0.5,0.5,1514,1451
2006-06-03,Spain,Egypt,2,0,2,1.0,0.0,2019,1888
2006-06-03,Switzerland,China PR,4,1,3,1.0,0.0,1844,1786
2006-06-04,Algeria,Sudan,1,0,1,1.0,0.0,1703,1602
2006-06-04,Brazil,New Zealand,4,0,4,1.0,0.0,2034,1696
2006-06-04,Colombia,Morocco,2,0,2,1.0,0.0,1863,1838
2006-06-04,Ghana,South Korea,3,1,2,1.0,0.0,1734,1881
2006-06-04,Japan,Malta,1,0,1,1.0,0.0,1911,1458
2006-06-04,Netherlands,Australia,1,1,0,0.5,0.5,2011,1921
2006-06-04,Slovenia,Ivory Coast,0,3,3,0.0,1.0,1722,1859
2006-06-04,Turkey,North Macedonia,0,1,1,0.0,1.0,1855,1641
2006-06-05,Ukraine,Libya,3,0,3,1.0,0.0,1783,1653
2006-06-07,Australia,Liechtenstein,3,1,2,1.0,0.0,1922,1406
2006-06-07,France,China PR,3,1,2,1.0,0.0,2050,1784
2006-06-07,Spain,Croatia,2,1,1,1.0,0.0,2025,1893
2006-06-08,Luxembourg,Ukraine,0,3,3,0.0,1.0,1312,1784
2006-06-09,Germany,Costa Rica,4,2,2,1.0,0.0,1983,1788
2006-06-09,Poland,Ecuador,0,2,2,0.0,1.0,1867,1805
2006-06-10,Argentina,Ivory Coast,2,1,1,1.0,0.0,2011,1855
2006-06-10,England,Paraguay,1,0,1,1.0,0.0,2010,1859
2006-06-10,Trinidad and Tobago,Sweden,0,0,0,0.5,0.5,1735,1899
2006-06-11,Angola,Portugal,0,1,1,0.0,1.0,1726,1976
2006-06-11,Mexico,Iran,3,1,2,1.0,0.0,1957,1910
2006-06-11,Serbia,Netherlands,0,1,1,0.0,1.0,1817,2016
2006-06-12,Australia,Japan,3,1,2,1.0,0.0,1930,1904
2006-06-12,Italy,Ghana,2,0,2,1.0,0.0,1991,1731
2006-06-12,United States,Czech Republic,0,3,3,0.0,1.0,1946,1974
2006-06-13,Brazil,Croatia,1,0,1,1.0,0.0,2039,1889
2006-06-13,France,Switzerland,0,0,0,0.5,0.5,2046,1849
2006-06-13,South Korea,Togo,2,1,1,1.0,0.0,1885,1687
2006-06-14,Germany,Poland,1,0,1,1.0,0.0,1989,1862
2006-06-14,Spain,Ukraine,4,0,4,1.0,0.0,2029,1781
2006-06-14,Tunisia,Saudi Arabia,2,2,0,0.5,0.5,1864,1794
2006-06-15,Ecuador,Costa Rica,3,0,3,1.0,0.0,1813,1781
2006-06-15,England,Trinidad and Tobago,2,0,2,1.0,0.0,2013,1733
2006-06-15,Sweden,Paraguay,1,0,1,1.0,0.0,1907,1852
2006-06-16,Argentina,Serbia,6,0,6,1.0,0.0,2015,1814
2006-06-16,Mexico,Angola,0,0,0,0.5,0.5,1953,1731
2006-06-16,Netherlands,Ivory Coast,2,1,1,1.0,0.0,2021,1851
2006-06-17,Czech Republic,Ghana,0,2,2,0.0,1.0,1962,1744
2006-06-17,Italy,United States,1,1,0,0.5,0.5,1990,1948
2006-06-17,Portugal,Iran,2,0,2,1.0,0.0,1983,1904
2006-06-18,Brazil,Australia,2,0,2,1.0,0.0,2045,1925
2006-06-18,France,South Korea,1,1,0,0.5,0.5,2043,1889
2006-06-18,Japan,Croatia,0,0,0,0.5,0.5,1904,1890
2006-06-19,Saudi Arabia,Ukraine,0,4,4,0.0,1.0,1786,1790
2006-06-19,Spain,Tunisia,3,1,2,1.0,0.0,2034,1860
2006-06-19,Togo,Switzerland,0,2,2,0.0,1.0,1683,1854
2006-06-20,Costa Rica,Poland,1,2,1,0.0,1.0,1775,1869
2006-06-20,Germany,Ecuador,3,0,3,1.0,0.0,1994,1809
2006-06-20,Paraguay,Trinidad and Tobago,2,0,2,1.0,0.0,1858,1728
2006-06-20,Sweden,England,2,2,0,0.5,0.5,1910,2011
2006-06-21,Iran,Angola,1,1,0,0.5,0.5,1901,1735
2006-06-21,Ivory Coast,Serbia,3,2,1,1.0,0.0,1859,1807
2006-06-21,Netherlands,Argentina,0,0,0,0.5,0.5,2021,2016
2006-06-21,Portugal,Mexico,2,1,1,1.0,0.0,1991,1946
2006-06-22,Croatia,Australia,2,2,0,0.5,0.5,1891,1925
2006-06-22,Czech Republic,Italy,0,2,2,0.0,1.0,1955,1998
2006-06-22,Ghana,United States,2,1,1,1.0,0.0,1757,1936
2006-06-22,Japan,Brazil,1,4,3,0.0,1.0,1900,2050
2006-06-23,Saudi Arabia,Spain,0,1,1,0.0,1.0,1783,2038
2006-06-23,Switzerland,South Korea,2,0,2,1.0,0.0,1863,1881
2006-06-23,Togo,France,0,2,2,0.0,1.0,1682,2045
2006-06-23,Ukraine,Tunisia,1,0,1,1.0,0.0,1800,1851
2006-06-24,Argentina,Mexico,2,1,1,1.0,0.0,2023,1940
2006-06-24,Germany,Sweden,2,0,2,1.0,0.0,2001,1904
2006-06-24,Malawi,Zimbabwe,1,1,0,0.5,0.5,1600,1712
2006-06-24,Mozambique,Eswatini,4,0,4,1.0,0.0,1586,1491
2006-06-25,England,Ecuador,1,0,1,1.0,0.0,2015,1806
2006-06-25,Mozambique,Malawi,1,2,1,0.0,1.0,1579,1608
2006-06-25,Portugal,Netherlands,1,0,1,1.0,0.0,2000,2013
2006-06-25,Eswatini,Zimbabwe,1,2,1,0.0,1.0,1488,1716
2006-06-26,Italy,Australia,1,0,1,1.0,0.0,2005,1919
2006-06-26,Mauritius,Tanzania,1,2,1,0.0,1.0,1550,1513
2006-06-26,Switzerland,Ukraine,0,0,0,0.5,0.5,1862,1802
2006-06-27,Brazil,Ghana,3,0,3,1.0,0.0,2053,1755
2006-06-27,Spain,France,1,3,2,0.0,1.0,2031,2053
2006-06-28,Seychelles,Mauritius,2,1,1,1.0,0.0,1450,1540
2006-06-30,Germany,Argentina,1,1,0,0.5,0.5,2002,2023
2006-06-30,Italy,Ukraine,3,0,3,1.0,0.0,2009,1799
2006-06-30,Seychelles,Tanzania,2,1,1,1.0,0.0,1460,1504
2006-07-01,Brazil,France,0,1,1,0.0,1.0,2045,2061
2006-07-01,England,Portugal,0,0,0,0.5,0.5,2015,2001
2006-07-02,Kazakhstan,Tajikistan,4,1,3,1.0,0.0,1544,1571
2006-07-04,Germany,Italy,0,2,2,0.0,1.0,1995,2017
2006-07-05,Kazakhstan,Kyrgyzstan,1,0,1,1.0,0.0,1551,1457
2006-07-05,Portugal,France,0,1,1,0.0,1.0,1995,2068
2006-07-06,Malawi,Botswana,2,1,1,1.0,0.0,1615,1557
2006-07-08,Germany,Portugal,3,1,2,1.0,0.0,2003,1987
2006-07-08,Malawi,Botswana,0,0,0,0.5,0.5,1614,1559
2006-07-09,Italy,France,1,1,0,0.5,0.5,2019,2067
2006-07-15,Syria,Iraq,1,3,2,0.0,1.0,1664,1743
2006-07-15,Zambia,Zimbabwe,0,0,0,0.5,0.5,1725,1717
2006-07-17,Ethiopia,Yemen,1,0,1,1.0,0.0,1638,1501
2006-07-21,Jordan,Iraq,2,1,1,1.0,0.0,1713,1735
2006-07-22,Malawi,Zambia,1,3,2,0.0,1.0,1609,1731
2006-07-22,Namibia,Seychelles,1,1,0,0.5,0.5,1492,1461
2006-07-23,Namibia,Malawi,3,2,1,1.0,0.0,1503,1599
2006-07-23,Seychelles,Zambia,0,2,2,0.0,1.0,1459,1734
2006-07-25,Syria,Iraq,1,2,1,0.0,1.0,1658,1742
2006-07-26,Rwanda,Uganda,1,1,0,0.5,0.5,1608,1623
2006-07-28,Guyana,Saint Lucia,3,2,1,1.0,0.0,1508,1537
2006-07-30,Guyana,Saint Lucia,2,0,2,1.0,0.0,1517,1529
2006-07-30,Jordan,Syria,3,0,3,1.0,0.0,1720,1652
2006-07-30,Tanzania,Rwanda,1,0,1,1.0,0.0,1515,1598
2006-08-05,Syria,Libya,2,1,1,1.0,0.0,1661,1645
2006-08-05,Uganda,Botswana,0,0,0,0.5,0.5,1622,1561
2006-08-08,Iran,United Arab Emirates,1,0,1,1.0,0.0,1906,1734
2006-08-09,Japan,Trinidad and Tobago,2,0,2,1.0,0.0,1905,1724
2006-08-09,Jordan,Iraq,0,1,1,0.0,1.0,1713,1750
2006-08-09,Macau,Taiwan,0,1,1,0.0,1.0,1356,1407
2006-08-09,Saudi Arabia,Bahrain,1,0,1,1.0,0.0,1790,1709
2006-08-11,Ethiopia,Kenya,1,0,1,1.0,0.0,1647,1641
2006-08-12,Hong Kong,Singapore,1,2,1,0.0,1.0,1553,1635
2006-08-13,Ethiopia,Kenya,1,0,1,1.0,0.0,1655,1634
2006-08-15,Algeria,Gabon,0,2,2,0.0,1.0,1695,1673
2006-08-15,Ghana,Togo,2,0,2,1.0,0.0,1762,1676
2006-08-15,Iceland,Spain,0,0,0,0.5,0.5,1672,2025
2006-08-15,Slovakia,Malta,3,0,3,1.0,0.0,1776,1456
2006-08-15,Slovenia,Israel,1,1,0,0.5,0.5,1723,1764
2006-08-15,Ukraine,Azerbaijan,6,0,6,1.0,0.0,1802,1512
2006-08-15,Wales,Bulgaria,0,0,0,0.5,0.5,1743,1833
2006-08-16,Australia,Kuwait,2,0,2,1.0,0.0,1924,1737
2006-08-16,Austria,Hungary,1,2,1,0.0,1.0,1744,1736
2006-08-16,Bangladesh,Qatar,1,4,3,0.0,1.0,1482,1775
2006-08-16,Belarus,Andorra,3,0,3,1.0,0.0,1660,1413
2006-08-16,Belgium,Kazakhstan,0,0,0,0.5,0.5,1853,1557
2006-08-16,Bosnia and Herzegovina,France,1,2,1,0.0,1.0,1682,2069
2006-08-16,Cameroon,Guinea,1,1,0,0.5,0.5,1879,1721
2006-08-16,Chile,Colombia,1,2,1,0.0,1.0,1798,1870
2006-08-16,China PR,Singapore,1,0,1,1.0,0.0,1789,1631
2006-08-16,Czech Republic,Serbia,1,3,2,0.0,1.0,1944,1819
2006-08-16,Denmark,Poland,2,0,2,1.0,0.0,1938,1863
2006-08-16,Egypt,Uruguay,0,2,2,0.0,1.0,1880,1878
2006-08-16,England,Greece,4,0,4,1.0,0.0,2020,1862
2006-08-16,Estonia,North Macedonia,0,1,1,0.0,1.0,1591,1648
2006-08-16,Faroe Islands,Georgia,0,6,6,0.0,1.0,1474,1606
2006-08-16,Finland,Northern Ireland,1,2,1,0.0,1.0,1734,1669
2006-08-16,Germany,Sweden,3,0,3,1.0,0.0,2009,1899
2006-08-16,Guatemala,Haiti,1,1,0,0.5,0.5,1732,1656
2006-08-16,India,Saudi Arabia,0,3,3,0.0,1.0,1546,1794
2006-08-16,Iran,Syria,1,1,0,0.5,0.5,1902,1666
2006-08-16,Republic of Ireland,Netherlands,0,4,4,0.0,1.0,1917,2019
2006-08-16,Italy,Croatia,0,2,2,0.0,1.0,2009,1902
2006-08-16,Ivory Coast,Senegal,0,1,1,0.0,1.0,1850,1822
2006-08-16,Japan,Yemen,2,0,2,1.0,0.0,1907,1500
2006-08-16,Jordan,United Arab Emirates,1,2,1,0.0,1.0,1706,1742
2006-08-16,Libya,Uganda,3,2,1,1.0,0.0,1653,1615
2006-08-16,Liechtenstein,Switzerland,0,3,3,0.0,1.0,1405,1864
2006-08-16,Luxembourg,Turkey,0,1,1,0.0,1.0,1312,1856
2006-08-16,Moldova,Lithuania,3,2,1,1.0,0.0,1559,1580
2006-08-16,Morocco,Burkina Faso,1,0,1,1.0,0.0,1842,1620
2006-08-16,Namibia,South Africa,0,1,1,0.0,1.0,1500,1755
2006-08-16,Norway,Brazil,1,1,0,0.5,0.5,1856,2041
2006-08-16,Pakistan,Oman,1,4,3,0.0,1.0,1382,1764
2006-08-16,Peru,Panama,0,2,2,0.0,1.0,1766,1651
2006-08-16,Romania,Cyprus,2,0,2,1.0,0.0,1882,1629
2006-08-16,Russia,Latvia,1,0,1,1.0,0.0,1837,1607
2006-08-16,San Marino,Albania,0,3,3,0.0,1.0,1374,1600
2006-08-16,Tunisia,Mali,0,1,1,0.0,1.0,1841,1747
2006-08-16,Uzbekistan,Hong Kong,2,2,0,0.5,0.5,1722,1557
2006-08-16,Venezuela,Honduras,0,0,0,0.5,0.5,1679,1782
2006-08-17,Palestine,Iraq,0,3,3,0.0,1.0,1514,1754
2006-08-19,Zambia,Botswana,1,0,1,1.0,0.0,1739,1557
2006-08-23,Malaysia,Indonesia,1,1,0,0.5,0.5,1569,1614
2006-08-25,Indonesia,Myanmar,0,0,0,0.5,0.5,1612,1526
2006-08-26,Eswatini,Lesotho,3,1,2,1.0,0.0,1496,1468
2006-08-26,Tanzania,Zanzibar,1,0,1,1.0,0.0,1522,1445
2006-08-26,Yemen,Libya,0,1,1,0.0,1.0,1496,1658
2006-08-27,Malaysia,Myanmar,1,2,1,0.0,1.0,1561,1535
2006-08-27,Saudi Arabia,United Arab Emirates,1,0,1,1.0,0.0,1801,1736
2006-08-29,Myanmar,Indonesia,2,1,1,1.0,0.0,1545,1603
2006-08-29,Togo,Niger,1,1,0,0.5,0.5,1674,1544
2006-08-29,Uganda,Burkina Faso,0,0,0,0.5,0.5,1616,1620
2006-08-29,Yemen,Libya,1,1,0,0.5,0.5,1500,1655
2006-09-01,Denmark,Portugal,4,2,2,1.0,0.0,1948,1978
2006-09-01,Oman,Syria,3,0,3,1.0,0.0,1770,1661
2006-09-02,Austria,Costa Rica,2,2,0,0.5,0.5,1745,1775
2006-09-02,Bahamas,Cayman Islands,3,1,2,1.0,0.0,1470,1453
2006-09-02,Bahrain,Jordan,0,2,2,0.0,1.0,1701,1715
2006-09-02,Belarus,Albania,2,2,0,0.5,0.5,1659,1602
2006-09-02,Cuba,Turks and Caicos Islands,6,0,6,1.0,0.0,1701,1461
2006-09-02,Czech Republic,Wales,2,1,1,1.0,0.0,1948,1740
2006-09-02,Egypt,Burundi,4,1,3,1.0,0.0,1882,1529
2006-09-02,England,Andorra,5,0,5,1.0,0.0,2021,1413
2006-09-02,Estonia,Israel,0,1,1,0.0,1.0,1587,1769
2006-09-02,Gabon,Madagascar,4,0,4,1.0,0.0,1679,1562
2006-09-02,Georgia,France,0,3,3,0.0,1.0,1605,2071
2006-09-02,Germany,Republic of Ireland,1,0,1,1.0,0.0,2015,1912
2006-09-02,Hungary,Norway,1,4,3,0.0,1.0,1731,1862
2006-09-02,Italy,Lithuania,1,1,0,0.5,0.5,2003,1587
2006-09-02,Kenya,Eritrea,1,2,1,0.0,1.0,1623,1466
2006-09-02,South Korea,Iran,1,1,0,0.5,0.5,1882,1902
2006-09-02,Latvia,Sweden,0,1,1,0.0,1.0,1605,1902
2006-09-02,Luxembourg,Netherlands,0,1,1,0.0,1.0,1312,2020
2006-09-02,Malta,Bosnia and Herzegovina,2,5,3,0.0,1.0,1453,1686
2006-09-02,Moldova,Greece,0,1,1,0.0,1.0,1557,1865
2006-09-02,Nigeria,Niger,2,0,2,1.0,0.0,1880,1542
2006-09-02,Northern Ireland,Iceland,0,3,3,0.0,1.0,1662,1680
2006-09-02,Poland,Finland,1,3,2,0.0,1.0,1853,1745
2006-09-02,Romania,Bulgaria,2,2,0,0.5,0.5,1881,1835
2006-09-02,Scotland,Faroe Islands,6,0,6,1.0,0.0,1786,1472
2006-09-02,Senegal,Mozambique,2,0,2,1.0,0.0,1826,1576
2006-09-02,Serbia,Azerbaijan,1,0,1,1.0,0.0,1822,1510
2006-09-02,Slovakia,Cyprus,6,1,5,1.0,0.0,1781,1625
2006-09-02,South Africa,Congo,0,0,0,0.5,0.5,1752,1615
2006-09-02,Spain,Liechtenstein,4,0,4,1.0,0.0,2026,1405
2006-09-02,Switzerland,Venezuela,1,0,1,1.0,0.0,1869,1675
2006-09-02,Tanzania,Burkina Faso,2,1,1,1.0,0.0,1533,1610
2006-09-02,Uganda,Lesotho,3,0,3,1.0,0.0,1621,1464
2006-09-03,Antigua and Barbuda,Dominica,1,0,1,1.0,0.0,1470,1424
2006-09-03,Argentina,Brazil,0,3,3,0.0,1.0,2016,2049
2006-09-03,Chad,Zambia,0,2,2,0.0,1.0,1510,1743
2006-09-03,DR Congo,Namibia,3,2,1,1.0,0.0,1688,1496
2006-09-03,Equatorial Guinea,Liberia,2,1,1,1.0,0.0,1462,1558
2006-09-03,Ethiopia,Libya,1,0,1,1.0,0.0,1663,1647
2006-09-03,Gambia,Cape Verde,2,0,2,1.0,0.0,1548,1537
2006-09-03,Guinea,Algeria,0,0,0,0.5,0.5,1721,1696
2006-09-03,Mauritius,Tunisia,0,0,0,0.5,0.5,1546,1836
2006-09-03,Rwanda,Cameroon,0,3,3,0.0,1.0,1596,1882
2006-09-03,Saudi Arabia,Japan,1,0,1,1.0,0.0,1812,1897
2006-09-03,Sierra Leone,Mali,0,0,0,0.5,0.5,1619,1745
2006-09-03,Sudan,Seychelles,3,0,3,1.0,0.0,1607,1455
2006-09-03,Eswatini,Angola,0,2,2,0.0,1.0,1493,1739
2006-09-03,Togo,Benin,2,1,1,1.0,0.0,1679,1511
2006-09-04,Canada,Jamaica,1,0,1,1.0,0.0,1741,1766
2006-09-04,Cayman Islands,Turks and Caicos Islands,0,2,2,0.0,1.0,1446,1469
2006-09-04,Cuba,Bahamas,6,0,6,1.0,0.0,1705,1467
2006-09-05,Wales,Brazil,0,2,2,0.0,1.0,1738,2052
2006-09-06,Albania,Romania,0,2,2,0.0,1.0,1600,1884
2006-09-06,Armenia,Belgium,0,1,1,0.0,1.0,1547,1856
2006-09-06,Austria,Venezuela,0,1,1,0.0,1.0,1736,1685
2006-09-06,Azerbaijan,Kazakhstan,1,1,0,0.5,0.5,1512,1556
2006-09-06,Bosnia and Herzegovina,Hungary,1,3,2,0.0,1.0,1680,1738
2006-09-06,Bulgaria,Slovenia,3,0,3,1.0,0.0,1841,1718
2006-09-06,Cuba,Cayman Islands,7,0,7,1.0,0.0,1708,1444
2006-09-06,Curaçao,Grenada,1,1,0,0.5,0.5,1540,1556
2006-09-06,Ecuador,Peru,1,1,0,0.5,0.5,1806,1767
2006-09-06,Finland,Portugal,1,1,0,0.5,0.5,1750,1974
2006-09-06,France,Italy,3,1,2,1.0,0.0,2078,1997
2006-09-06,Guatemala,Panama,1,2,1,0.0,1.0,1723,1661
2006-09-06,Honduras,El Salvador,2,0,2,1.0,0.0,1787,1603
2006-09-06,Hong Kong,Uzbekistan,0,0,0,0.5,0.5,1561,1719
2006-09-06,Iceland,Denmark,0,2,2,0.0,1.0,1678,1951
2006-09-06,Iraq,Palestine,2,2,0,0.5,0.5,1750,1519
2006-09-06,Israel,Andorra,4,1,3,1.0,0.0,1771,1412
2006-09-06,South Korea,Taiwan,8,0,8,1.0,0.0,1883,1407
2006-09-06,Kuwait,Australia,2,0,2,1.0,0.0,1749,1913
2006-09-06,Lithuania,Scotland,1,2,1,0.0,1.0,1584,1790
2006-09-06,Luxembourg,Latvia,0,0,0,0.5,0.5,1318,1600
2006-09-06,North Macedonia,England,0,1,1,0.0,1.0,1647,2023
2006-09-06,Netherlands,Belarus,3,0,3,1.0,0.0,2022,1658
2006-09-06,Northern Ireland,Spain,3,2,1,1.0,0.0,1677,2012
2006-09-06,Norway,Moldova,2,0,2,1.0,0.0,1865,1555
2006-09-06,Oman,Pakistan,5,0,5,1.0,0.0,1772,1381
2006-09-06,Poland,Serbia,1,1,0,0.5,0.5,1853,1823
2006-09-06,Qatar,Bangladesh,3,0,3,1.0,0.0,1778,1480
2006-09-06,Russia,Croatia,0,0,0,0.5,0.5,1839,1901
2006-09-06,San Marino,Germany,0,13,13,0.0,1.0,1374,2016
2006-09-06,Saudi Arabia,India,7,1,6,1.0,0.0,1815,1544
2006-09-06,Singapore,China PR,0,0,0,0.5,0.5,1635,1786
2006-09-06,Slovakia,Czech Republic,0,3,3,0.0,1.0,1777,1953
2006-09-06,Suriname,Guyana,0,5,5,0.0,1.0,1555,1527
2006-09-06,Sweden,Liechtenstein,3,1,2,1.0,0.0,1903,1405
2006-09-06,Switzerland,Costa Rica,2,0,2,1.0,0.0,1875,1770
2006-09-06,Turkey,Malta,2,0,2,1.0,0.0,1858,1452
2006-09-06,Turks and Caicos Islands,Bahamas,2,3,1,0.0,1.0,1461,1476
2006-09-06,Ukraine,Georgia,3,2,1,1.0,0.0,1806,1602
2006-09-06,United Arab Emirates,Jordan,0,0,0,0.5,0.5,1736,1716
2006-09-06,Yemen,Japan,0,1,1,0.0,1.0,1499,1899
2006-09-08,Curaçao,Guyana,0,5,5,0.0,1.0,1532,1536
2006-09-08,Suriname,Grenada,1,0,1,1.0,0.0,1564,1548
2006-09-10,Curaçao,Suriname,0,1,1,0.0,1.0,1525,1572
2006-09-10,Grenada,Guyana,0,1,1,0.0,1.0,1540,1545
2006-09-15,Haiti,Dominican Republic,3,1,2,1.0,0.0,1661,1481
2006-09-17,Dominica,Barbados,0,5,5,0.0,1.0,1420,1595
2006-09-17,Haiti,Dominican Republic,2,1,1,1.0,0.0,1666,1477
2006-09-17,Zimbabwe,Angola,1,2,1,0.0,1.0,1710,1747
2006-09-20,Antigua and Barbuda,Anguilla,5,3,2,1.0,0.0,1476,1363
2006-09-20,Barbados,Saint Kitts and Nevis,1,1,0,0.5,0.5,1595,1593
2006-09-20,Dominica,Martinique,0,4,4,0.0,1.0,1417,1658
2006-09-20,Guadeloupe,Saint Martin,1,0,1,1.0,0.0,1584,1487
2006-09-22,Anguilla,Saint Kitts and Nevis,1,6,5,0.0,1.0,1360,1597
2006-09-22,Antigua and Barbuda,Barbados,1,3,2,0.0,1.0,1471,1601
2006-09-22,Guadeloupe,Dominica,1,0,1,1.0,0.0,1589,1413
2006-09-22,Martinique,Saint Martin,1,0,1,1.0,0.0,1663,1483
2006-09-24,Antigua and Barbuda,Saint Kitts and Nevis,1,0,1,1.0,0.0,1482,1587
2006-09-24,Barbados,Anguilla,7,1,6,1.0,0.0,1605,1357
2006-09-24,Dominica,Saint Martin,0,0,0,0.5,0.5,1415,1482
2006-09-24,Guadeloupe,Martinique,4,0,4,1.0,0.0,1599,1654
2006-09-27,Jamaica,Saint Lucia,4,0,4,1.0,0.0,1770,1526
2006-09-27,Venezuela,Uruguay,1,0,1,1.0,0.0,1698,1866
2006-09-27,United States Virgin Islands,Bermuda,0,6,6,0.0,1.0,1404,1505
2006-09-29,Bermuda,Dominican Republic,3,1,2,1.0,0.0,1513,1470
2006-09-29,Saint Lucia,Haiti,1,7,6,0.0,1.0,1522,1671
2006-09-30,Tanzania,Kenya,0,0,0,0.5,0.5,1536,1621
2006-10-01,Jamaica,Haiti,2,0,2,1.0,0.0,1776,1666
2006-10-01,Libya,Sudan,1,0,1,1.0,0.0,1655,1600
2006-10-01,Saint Vincent and the Grenadines,Saint Lucia,8,0,8,1.0,0.0,1589,1516
2006-10-01,United States Virgin Islands,Dominican Republic,1,6,5,0.0,1.0,1398,1477
2006-10-03,Botswana,Lesotho,1,0,1,1.0,0.0,1563,1459
2006-10-04,Ethiopia,Eswatini,2,0,2,1.0,0.0,1668,1489
2006-10-04,Iran,Iraq,2,0,2,1.0,0.0,1907,1746
2006-10-04,Japan,Ghana,0,1,1,0.0,1.0,1888,1774
2006-10-06,Jordan,Iran,0,0,0,0.5,0.5,1721,1903
2006-10-06,Liechtenstein,Austria,1,2,1,0.0,1.0,1403,1739
2006-10-07,Algeria,Gambia,1,0,1,1.0,0.0,1701,1544
2006-10-07,Armenia,Finland,0,0,0,0.5,0.5,1552,1746
2006-10-07,Australia,Paraguay,1,1,0,0.5,0.5,1912,1860
2006-10-07,Botswana,Egypt,0,0,0,0.5,0.5,1569,1877
2006-10-07,Bulgaria,Netherlands,1,1,0,0.5,0.5,1845,2019
2006-10-07,Burkina Faso,Senegal,1,0,1,1.0,0.0,1623,1814
2006-10-07,Cameroon,Equatorial Guinea,3,0,3,1.0,0.0,1884,1461
2006-10-07,Cape Verde,Guinea,1,0,1,1.0,0.0,1549,1710
2006-10-07,Chile,Peru,3,2,1,1.0,0.0,1806,1760
2006-10-07,Croatia,Andorra,7,0,7,1.0,0.0,1902,1412
2006-10-07,Cyprus,Republic of Ireland,5,2,3,1.0,0.0,1639,1899
2006-10-07,Czech Republic,San Marino,7,0,7,1.0,0.0,1954,1374
2006-10-07,Denmark,Northern Ireland,0,0,0,0.5,0.5,1946,1683
2006-10-07,England,North Macedonia,0,0,0,0.5,0.5,2017,1654
2006-10-07,Eritrea,Eswatini,0,0,0,0.5,0.5,1467,1489
2006-10-07,Faroe Islands,Lithuania,0,1,1,0.0,1.0,1467,1590
2006-10-07,Germany,Georgia,2,0,2,1.0,0.0,2018,1601
2006-10-07,Greece,Norway,1,0,1,1.0,0.0,1873,1857
2006-10-07,Guatemala,Honduras,2,3,1,0.0,1.0,1717,1794
2006-10-07,Hungary,Turkey,0,1,1,0.0,1.0,1733,1864
2006-10-07,Italy,Ukraine,2,0,2,1.0,0.0,2001,1803
2006-10-07,Kazakhstan,Poland,0,1,1,0.0,1.0,1554,1856
2006-10-07,Latvia,Iceland,4,0,4,1.0,0.0,1610,1669
2006-10-07,Malawi,Zimbabwe,1,0,1,1.0,0.0,1610,1700
2006-10-07,Moldova,Bosnia and Herzegovina,2,2,0,0.5,0.5,1558,1678
2006-10-07,Namibia,Ethiopia,1,0,1,1.0,0.0,1508,1657
2006-10-07,Panama,El Salvador,1,0,1,1.0,0.0,1668,1597
2006-10-07,Portugal,Azerbaijan,3,0,3,1.0,0.0,1976,1511
2006-10-07,Romania,Belarus,3,1,2,1.0,0.0,1888,1655
2006-10-07,Russia,Israel,1,1,0,0.5,0.5,1838,1773
2006-10-07,Scotland,France,1,0,1,1.0,0.0,1804,2065
2006-10-07,Serbia,Belgium,1,0,1,1.0,0.0,1832,1848
2006-10-07,Seychelles,Mauritius,2,1,1,1.0,0.0,1466,1536
2006-10-07,Slovenia,Luxembourg,2,0,2,1.0,0.0,1720,1317
2006-10-07,Sweden,Spain,2,0,2,1.0,0.0,1914,2002
2006-10-07,Tunisia,Sudan,1,0,1,1.0,0.0,1840,1597
2006-10-07,Wales,Slovakia,1,5,4,0.0,1.0,1731,1785
2006-10-08,Angola,Kenya,3,1,2,1.0,0.0,1753,1616
2006-10-08,Benin,Sierra Leone,2,0,2,1.0,0.0,1522,1609
2006-10-08,Burundi,Mauritania,3,1,2,1.0,0.0,1535,1417
2006-10-08,Congo,Chad,3,1,2,1.0,0.0,1621,1505
2006-10-08,Ivory Coast,Gabon,5,0,5,1.0,0.0,1855,1675
2006-10-08,Jamaica,Canada,2,1,1,1.0,0.0,1784,1734
2006-10-08,South Korea,Ghana,1,3,2,0.0,1.0,1873,1785
2006-10-08,Lesotho,Nigeria,0,1,1,0.0,1.0,1458,1882
2006-10-08,Liberia,Rwanda,3,2,1,1.0,0.0,1567,1588
2006-10-08,Libya,DR Congo,1,1,0,0.5,0.5,1656,1688
2006-10-08,Mali,Togo,1,0,1,1.0,0.0,1752,1673
2006-10-08,Mozambique,Tanzania,0,0,0,0.5,0.5,1576,1537
2006-10-08,Niger,Uganda,0,0,0,0.5,0.5,1544,1620
2006-10-08,Zambia,South Africa,0,1,1,0.0,1.0,1736,1760
2006-10-08,Catalonia,Basque Country,2,2,0,0.5,0.5,1607,1704
2006-10-10,Brazil,Ecuador,2,1,1,1.0,0.0,2056,1803
2006-10-10,Honduras,Guatemala,2,1,1,1.0,0.0,1801,1711
2006-10-11,Andorra,North Macedonia,0,3,3,0.0,1.0,1409,1658
2006-10-11,Australia,Bahrain,2,0,2,1.0,0.0,1916,1698
2006-10-11,Austria,Switzerland,2,1,1,1.0,0.0,1750,1865
2006-10-11,Bangladesh,Uzbekistan,0,4,4,0.0,1.0,1477,1723
2006-10-11,Belarus,Slovenia,4,2,2,1.0,0.0,1665,1711
2006-10-11,Belgium,Azerbaijan,3,0,3,1.0,0.0,1851,1509
2006-10-11,Bosnia and Herzegovina,Greece,0,4,4,0.0,1.0,1675,1877
2006-10-11,Croatia,England,2,0,2,1.0,0.0,1913,2007
2006-10-11,France,Faroe Islands,5,0,5,1.0,0.0,2066,1467
2006-10-11,Georgia,Italy,1,3,2,0.0,1.0,1600,2003
2006-10-11,Iceland,Sweden,1,2,1,0.0,1.0,1666,1918
2006-10-11,India,Japan,0,3,3,0.0,1.0,1543,1890
2006-10-11,Iraq,Singapore,4,2,2,1.0,0.0,1752,1630
2006-10-11,Republic of Ireland,Czech Republic,1,1,0,0.5,0.5,1901,1953
2006-10-11,Kazakhstan,Finland,0,2,2,0.0,1.0,1551,1750
2006-10-11,South Korea,Syria,1,1,0,0.5,0.5,1869,1666
2006-10-11,Kuwait,Lithuania,1,0,1,1.0,0.0,1754,1586
2006-10-11,Liechtenstein,Denmark,0,4,4,0.0,1.0,1403,1947
2006-10-11,Luxembourg,Bulgaria,0,1,1,0.0,1.0,1317,1846
2006-10-11,Malta,Hungary,2,1,1,1.0,0.0,1466,1720
2006-10-11,Netherlands,Albania,2,1,1,1.0,0.0,2021,1599
2006-10-11,Northern Ireland,Latvia,1,0,1,1.0,0.0,1690,1604
2006-10-11,Oman,United Arab Emirates,2,1,1,1.0,0.0,1780,1729
2006-10-11,Pakistan,Jordan,0,3,3,0.0,1.0,1380,1723
2006-10-11,Palestine,China PR,0,2,2,0.0,1.0,1517,1789
2006-10-11,Peru,Chile,0,1,1,0.0,1.0,1754,1813
2006-10-11,Poland,Portugal,2,1,1,1.0,0.0,1867,1966
2006-10-11,Qatar,Hong Kong,2,0,2,1.0,0.0,1782,1558
2006-10-11,Russia,Estonia,2,0,2,1.0,0.0,1842,1584
2006-10-11,Saudi Arabia,Yemen,5,0,5,1.0,0.0,1818,1497
2006-10-11,Serbia,Armenia,3,0,3,1.0,0.0,1835,1550
2006-10-11,Slovakia,Germany,1,4,3,0.0,1.0,1782,2022
2006-10-11,Spain,Argentina,2,1,1,1.0,0.0,2011,2008
2006-10-11,Trinidad and Tobago,Panama,2,1,1,1.0,0.0,1731,1662
2006-10-11,Turkey,Moldova,5,0,5,1.0,0.0,1867,1556
2006-10-11,Ukraine,Scotland,2,0,2,1.0,0.0,1812,1796
2006-10-11,Wales,Cyprus,3,1,2,1.0,0.0,1737,1634
2006-10-17,Haiti,Cuba,0,0,0,0.5,0.5,1667,1708
2006-10-18,Uruguay,Venezuela,4,0,4,1.0,0.0,1871,1694
2006-10-19,Haiti,Cuba,0,1,1,0.0,1.0,1660,1716
2006-10-21,Zambia,Angola,2,0,2,1.0,0.0,1745,1745
2006-10-22,Saint Vincent and the Grenadines,Martinique,1,1,0,0.5,0.5,1591,1653
2006-11-03,Antigua and Barbuda,Grenada,1,1,0,0.5,0.5,1484,1539
2006-11-05,Barbados,Grenada,2,2,0,0.5,0.5,1604,1541
2006-11-08,Haiti,Cuba,1,2,1,0.0,1.0,1654,1723
2006-11-08,Martinique,Suriname,1,0,1,1.0,0.0,1660,1566
2006-11-08,Oman,Bahrain,1,1,0,0.5,0.5,1779,1700
2006-11-08,Saudi Arabia,Jordan,2,1,1,1.0,0.0,1824,1718
2006-11-09,Kuwait,Taiwan,10,0,10,1.0,0.0,1756,1406
2006-11-10,Cuba,Suriname,3,1,2,1.0,0.0,1728,1562
2006-11-10,Martinique,Haiti,1,0,1,1.0,0.0,1668,1647
2006-11-11,Singapore,Indonesia,1,2,1,0.0,1.0,1622,1612
2006-11-12,Haiti,Suriname,1,1,0,0.5,0.5,1646,1564
2006-11-12,Martinique,Cuba,0,0,0,0.5,0.5,1670,1727
2006-11-12,Philippines,Laos,1,2,1,0.0,1.0,1251,1385
2006-11-12,Timor-Leste,Brunei,2,3,1,0.0,1.0,1453,1319
2006-11-14,Australia,Ghana,1,1,0,0.5,0.5,1914,1788
2006-11-14,Cambodia,Laos,2,2,0,0.5,0.5,1347,1385
2006-11-14,Mali,Congo,1,0,1,1.0,0.0,1758,1616
2006-11-14,Philippines,Timor-Leste,7,0,7,1.0,0.0,1264,1441
2006-11-14,Wales,Liechtenstein,4,0,4,1.0,0.0,1740,1401
2006-11-15,Algeria,Burkina Faso,1,2,1,0.0,1.0,1692,1633
2006-11-15,Austria,Trinidad and Tobago,4,1,3,1.0,0.0,1758,1724
2006-11-15,Bahrain,Kuwait,2,1,1,1.0,0.0,1710,1747
2006-11-15,Belgium,Poland,0,1,1,0.0,1.0,1844,1875
2006-11-15,Bolivia,El Salvador,5,1,4,1.0,0.0,1691,1591
2006-11-15,Botswana,Eswatini,1,0,1,1.0,0.0,1576,1483
2006-11-15,Chile,Paraguay,3,2,1,1.0,0.0,1823,1851
2006-11-15,China PR,Iraq,1,1,0,0.5,0.5,1789,1753
2006-11-15,Cyprus,Germany,1,1,0,0.5,0.5,1641,2016
2006-11-15,Czech Republic,Denmark,1,1,0,0.5,0.5,1953,1948
2006-11-15,Egypt,South Africa,1,0,1,1.0,0.0,1883,1755
2006-11-15,Estonia,Belarus,2,1,1,1.0,0.0,1594,1656
2006-11-15,Finland,Armenia,1,0,1,1.0,0.0,1754,1547
2006-11-15,France,Greece,1,0,1,1.0,0.0,2071,1873
2006-11-15,Georgia,Uruguay,2,0,2,1.0,0.0,1614,1858
2006-11-15,Hong Kong,Bangladesh,2,0,2,1.0,0.0,1565,1471
2006-11-15,Hungary,Canada,1,0,1,1.0,0.0,1729,1726
2006-11-15,Iran,South Korea,2,0,2,1.0,0.0,1911,1862
2006-11-15,Republic of Ireland,San Marino,5,0,5,1.0,0.0,1902,1374
2006-11-15,Israel,Croatia,3,4,1,0.0,1.0,1769,1918
2006-11-15,Italy,Turkey,1,1,0,0.5,0.5,2001,1870
2006-11-15,Ivory Coast,Sweden,1,0,1,1.0,0.0,1865,1909
2006-11-15,Jamaica,Peru,1,1,0,0.5,0.5,1784,1755
2006-11-15,Japan,Saudi Arabia,3,1,2,1.0,0.0,1897,1818
2006-11-15,Jordan,Oman,3,0,3,1.0,0.0,1728,1770
2006-11-15,Luxembourg,Togo,0,0,0,0.5,0.5,1324,1667
2006-11-15,North Macedonia,Russia,0,2,2,0.0,1.0,1654,1847
2006-11-15,Malta,Lithuania,1,4,3,0.0,1.0,1461,1592
2006-11-15,Morocco,Gabon,6,0,6,1.0,0.0,1847,1671
2006-11-15,Netherlands,England,1,1,0,0.5,0.5,2021,2008
2006-11-15,Portugal,Kazakhstan,3,0,3,1.0,0.0,1968,1550
2006-11-15,Serbia,Norway,1,1,0,0.5,0.5,1836,1857
2006-11-15,Slovakia,Bulgaria,3,1,2,1.0,0.0,1792,1837
2006-11-15,Spain,Romania,0,1,1,0.0,1.0,2001,1899
2006-11-15,Switzerland,Brazil,1,2,1,0.0,1.0,1862,2060
2006-11-15,Syria,Taiwan,3,0,3,1.0,0.0,1669,1404
2006-11-15,Tunisia,Libya,2,0,2,1.0,0.0,1845,1652
2006-11-15,United Arab Emirates,Pakistan,3,2,1,1.0,0.0,1731,1379
2006-11-15,Uzbekistan,Qatar,2,0,2,1.0,0.0,1733,1773
2006-11-15,Venezuela,Guatemala,2,1,1,1.0,0.0,1703,1703
2006-11-15,Yemen,India,2,1,1,1.0,0.0,1507,1534
2006-11-15,Zimbabwe,Namibia,3,2,1,1.0,0.0,1704,1505
2006-11-16,Laos,Timor-Leste,3,2,1,1.0,0.0,1395,1432
2006-11-16,Brunei,Cambodia,1,1,0,0.5,0.5,1320,1347
2006-11-18,Philippines,Cambodia,1,0,1,1.0,0.0,1274,1338
2006-11-18,Brunei,Laos,1,4,3,0.0,1.0,1314,1402
2006-11-18,Tanzania,Angola,1,1,0,0.5,0.5,1542,1741
2006-11-19,Barbados,Bahamas,2,1,1,1.0,0.0,1610,1471
2006-11-19,Panama,Peru,1,2,1,0.0,1.0,1657,1761
2006-11-19,Găgăuzia,Greenland,0,2,2,0.0,1.0,1492,1471
2006-11-19,Kyrgyzstan,Zanzibar,0,1,1,0.0,1.0,1449,1454
2006-11-19,Tibet,Tajikistan,0,3,3,0.0,1.0,1466,1577
2006-11-19,Northern Cyprus,Crimea,5,0,5,1.0,0.0,1522,1493
2006-11-20,Cambodia,Timor-Leste,4,1,3,1.0,0.0,1349,1422
2006-11-20,Philippines,Brunei,4,1,3,1.0,0.0,1283,1306
2006-11-20,Monaco,Ambazonia,3,0,3,1.0,0.0,1512,1493
2006-11-20,Occitania,Sápmi,0,7,7,0.0,1.0,1493,1509
2006-11-20,Găgăuzia,Kyrgyzstan,1,6,5,0.0,1.0,1484,1458
2006-11-20,Greenland,Zanzibar,1,1,0,0.5,0.5,1471,1455
2006-11-20,Tibet,Crimea,0,1,1,0.0,1.0,1459,1501
2006-11-20,Northern Cyprus,Tajikistan,5,1,4,1.0,0.0,1532,1568
2006-11-21,Bahamas,Bermuda,0,4,4,0.0,1.0,1464,1521
2006-11-21,Sápmi,Ambazonia,3,0,3,1.0,0.0,1517,1486
2006-11-21,Occitania,Monaco,2,3,1,0.0,1.0,1486,1520
2006-11-21,Greenland,Kyrgyzstan,0,1,1,0.0,1.0,1463,1467
2006-11-21,Găgăuzia,Zanzibar,1,1,0,0.5,0.5,1484,1456
2006-11-21,Tajikistan,Crimea,1,2,1,0.0,1.0,1559,1511
2006-11-21,Northern Cyprus,Tibet,10,0,10,1.0,0.0,1539,1453
2006-11-23,Barbados,Bermuda,1,1,0,0.5,0.5,1608,1524
2006-11-23,Occitania,Ambazonia,3,0,3,1.0,0.0,1494,1478
2006-11-23,Sápmi,Monaco,14,0,14,1.0,0.0,1526,1512
2006-11-23,Kyrgyzstan,Crimea,2,3,1,0.0,1.0,1461,1518
2006-11-23,Northern Cyprus,Zanzibar,5,0,5,1.0,0.0,1546,1450
2006-11-24,Dominican Republic,Guadeloupe,0,3,3,0.0,1.0,1472,1605
2006-11-24,Guyana,Antigua and Barbuda,6,0,6,1.0,0.0,1552,1478
2006-11-24,Occitania,Ambazonia,3,0,3,1.0,0.0,1502,1471
2006-11-24,Sápmi,Monaco,21,1,20,1.0,0.0,1534,1505
2006-11-25,Ethiopia,Tanzania,1,2,1,0.0,1.0,1647,1553
2006-11-25,Kyrgyzstan,Zanzibar,2,2,0,0.5,0.5,1461,1451
2006-11-25,Northern Cyprus,Crimea,3,1,2,1.0,0.0,1554,1511
2006-11-26,Burundi,Zambia,3,2,1,1.0,0.0,1548,1733
2006-11-26,Djibouti,Malawi,0,3,3,0.0,1.0,1357,1614
2006-11-26,Dominican Republic,Antigua and Barbuda,2,0,2,1.0,0.0,1481,1470
2006-11-26,Guyana,Guadeloupe,3,2,1,1.0,0.0,1562,1596
2006-11-27,Somalia,Rwanda,0,3,3,0.0,1.0,1387,1592
2006-11-27,Sudan,Uganda,1,2,1,0.0,1.0,1590,1628
2006-11-28,Antigua and Barbuda,Guadeloupe,1,3,2,0.0,1.0,1465,1602
2006-11-28,Ethiopia,Djibouti,4,0,4,1.0,0.0,1650,1355
2006-11-28,Guyana,Dominican Republic,4,0,4,1.0,0.0,1569,1475
2006-11-28,Malawi,Tanzania,1,2,1,0.0,1.0,1605,1563
2006-11-29,El Salvador,Panama,0,0,0,0.5,0.5,1593,1656
2006-11-29,Zanzibar,Burundi,0,0,0,0.5,0.5,1454,1546
2006-11-30,Rwanda,Uganda,0,1,1,0.0,1.0,1585,1636
2006-11-30,Somalia,Sudan,0,3,3,0.0,1.0,1384,1594
2006-12-01,Ethiopia,Malawi,1,0,1,1.0,0.0,1657,1599
2006-12-01,Tanzania,Djibouti,3,0,3,1.0,0.0,1567,1352
2006-12-02,Zambia,Zanzibar,4,0,4,1.0,0.0,1736,1452
2006-12-03,Sudan,Rwanda,0,0,0,0.5,0.5,1594,1586
2006-12-03,Uganda,Somalia,2,0,2,1.0,0.0,1640,1381
2006-12-05,Ethiopia,Zambia,0,1,1,0.0,1.0,1651,1743
2006-12-05,Tanzania,Rwanda,1,2,1,0.0,1.0,1560,1594
2006-12-06,Burundi,Sudan,0,1,1,0.0,1.0,1540,1601
2006-12-06,Uganda,Malawi,0,0,0,0.5,0.5,1640,1600
2006-12-06,United Arab Emirates,Poland,2,5,3,0.0,1.0,1727,1880
2006-12-08,Rwanda,Zambia,0,1,1,0.0,1.0,1590,1748
2006-12-08,Uganda,Sudan,2,2,0,0.5,0.5,1640,1602
2006-12-09,Tanzania,DR Congo,2,0,2,1.0,0.0,1571,1678
2006-12-09,Silesia,Poland,1,1,0,0.5,0.5,1520,1874
2006-12-10,Rwanda,Uganda,0,0,0,0.5,0.5,1592,1639
2006-12-10,United Arab Emirates,Slovakia,1,2,1,0.0,1.0,1721,1799
2006-12-10,Zambia,Sudan,0,0,0,0.5,0.5,1745,1606
2006-12-14,Yemen,Comoros,2,0,2,1.0,0.0,1514,1417
2006-12-15,Réunion,Mayotte,3,1,2,1.0,0.0,1559,1491
2006-12-17,Djibouti,Comoros,2,4,2,0.0,1.0,1346,1424
2006-12-20,Yemen,Djibouti,4,1,3,1.0,0.0,1519,1342
2006-12-21,Lebanon,Mauritania,0,0,0,0.5,0.5,1627,1422
2006-12-21,Sudan,Somalia,6,1,5,1.0,0.0,1610,1378
2006-12-24,Lebanon,Somalia,4,0,4,1.0,0.0,1631,1375
2006-12-24,Singapore,Kazakhstan,0,0,0,0.5,0.5,1621,1552
2006-12-24,Sudan,Mauritania,2,0,2,1.0,0.0,1615,1418
2006-12-24,Thailand,Vietnam,2,1,1,1.0,0.0,1691,1584
2006-12-26,Thailand,Singapore,2,0,2,1.0,0.0,1698,1615
2006-12-26,Vietnam,Kazakhstan,2,1,1,1.0,0.0,1592,1545
2006-12-27,Lebanon,Sudan,0,0,0,0.5,0.5,1631,1616
2006-12-27,Somalia,Mauritania,2,8,6,0.0,1.0,1368,1426
2006-12-27,Basque Country,Serbia,4,0,4,1.0,0.0,1715,1826
2006-12-28,Martinique,Saint Vincent and the Grenadines,2,2,0,0.5,0.5,1669,1593
2006-12-28,Singapore,Vietnam,2,3,1,0.0,1.0,1607,1601
2006-12-28,Thailand,Kazakhstan,2,2,0,0.5,0.5,1695,1549
2006-12-28,Galicia,Ecuador,1,1,0,0.5,0.5,1521,1798
2006-12-30,Martinique,Saint Vincent and the Grenadines,1,1,0,0.5,0.5,1668,1595
2006-12-30,Thailand,Vietnam,3,1,2,1.0,0.0,1701,1596
2007-01-06,Martinique,Guadeloupe,3,0,3,1.0,0.0,1675,1596
2007-01-07,Haiti,Bermuda,2,0,2,1.0,0.0,1652,1519
2007-01-07,Singapore,Philippines,4,1,3,1.0,0.0,1610,1281
2007-01-07,Yemen,Eritrea,4,1,3,1.0,0.0,1526,1461
2007-01-08,Saudi Arabia,Gambia,3,0,3,1.0,0.0,1821,1542
2007-01-09,Bermuda,Haiti,0,3,3,0.0,1.0,1514,1658
2007-01-11,Costa Rica,Nicaragua,2,0,2,1.0,0.0,1772,1360
2007-01-11,Saudi Arabia,Syria,2,1,1,1.0,0.0,1826,1665
2007-01-12,Haiti,Martinique,1,0,1,1.0,0.0,1667,1667
2007-01-12,Malaysia,Philippines,4,0,4,1.0,0.0,1564,1279
2007-01-12,Thailand,Myanmar,1,1,0,0.5,0.5,1698,1549
2007-01-12,Trinidad and Tobago,Barbados,1,1,0,0.5,0.5,1722,1611
2007-01-13,Indonesia,Laos,3,1,2,1.0,0.0,1616,1399
2007-01-13,Qatar,Oman,1,1,0,0.5,0.5,1773,1771
2007-01-13,Singapore,Vietnam,0,0,0,0.5,0.5,1610,1597
2007-01-14,Cuba,Guadeloupe,1,2,1,0.0,1.0,1717,1607
2007-01-14,Malaysia,Myanmar,0,0,0,0.5,0.5,1564,1550
2007-01-14,Panama,Armenia,1,1,0,0.5,0.5,1654,1550
2007-01-14,Thailand,Philippines,4,0,4,1.0,0.0,1700,1278
2007-01-14,Venezuela,Sweden,2,0,2,1.0,0.0,1716,1897
2007-01-15,Haiti,Barbados,2,0,2,1.0,0.0,1674,1605
2007-01-15,Singapore,Laos,11,0,11,1.0,0.0,1614,1396
2007-01-15,Trinidad and Tobago,Martinique,5,1,4,1.0,0.0,1729,1661
2007-01-15,Vietnam,Indonesia,1,1,0,0.5,0.5,1598,1616
2007-01-16,Myanmar,Philippines,0,0,0,0.5,0.5,1545,1284
2007-01-16,Guadeloupe,Guyana,3,4,1,0.0,1.0,1599,1578
2007-01-16,Thailand,Malaysia,1,0,1,1.0,0.0,1706,1559
2007-01-17,Barbados,Martinique,2,3,1,0.0,1.0,1599,1668
2007-01-17,Kuwait,Yemen,1,1,0,0.5,0.5,1743,1531
2007-01-17,Singapore,Indonesia,2,2,0,0.5,0.5,1615,1616
2007-01-17,Trinidad and Tobago,Haiti,3,1,2,1.0,0.0,1736,1668
2007-01-17,United Arab Emirates,Oman,1,2,1,0.0,1.0,1715,1778
2007-01-17,Vietnam,Laos,9,0,9,1.0,0.0,1602,1393
2007-01-18,Cuba,Guyana,0,0,0,0.5,0.5,1714,1582
2007-01-18,Ecuador,Sweden,2,1,1,1.0,0.0,1809,1887
2007-01-18,Qatar,Iraq,0,1,1,0.0,1.0,1765,1762
2007-01-18,Saudi Arabia,Bahrain,2,1,1,1.0,0.0,1832,1705
2007-01-18,Saint Vincent and the Grenadines,Guadeloupe,0,1,1,0.0,1.0,1588,1607
2007-01-20,Guadeloupe,Haiti,1,3,2,0.0,1.0,1601,1675
2007-01-20,Kuwait,Oman,1,2,1,0.0,1.0,1736,1786
2007-01-20,Trinidad and Tobago,Cuba,3,1,2,1.0,0.0,1744,1707
2007-01-20,United Arab Emirates,Yemen,2,1,1,1.0,0.0,1720,1527
2007-01-21,Bahrain,Iraq,1,1,0,0.5,0.5,1707,1761
2007-01-21,Ecuador,Sweden,1,1,0,0.5,0.5,1811,1886
2007-01-21,Saudi Arabia,Qatar,1,1,0,0.5,0.5,1831,1767
2007-01-23,Cuba,Guadeloupe,2,1,1,1.0,0.0,1713,1596
2007-01-23,Malaysia,Singapore,1,1,0,0.5,0.5,1561,1614
2007-01-23,Oman,Yemen,2,1,1,1.0,0.0,1789,1525
2007-01-23,Trinidad and Tobago,Haiti,1,2,1,0.0,1.0,1735,1685
2007-01-23,United Arab Emirates,Kuwait,3,2,1,1.0,0.0,1729,1728
2007-01-24,Qatar,Bahrain,1,2,1,0.0,1.0,1758,1717
2007-01-24,Saudi Arabia,Iraq,1,0,1,1.0,0.0,1838,1755
2007-01-24,Vietnam,Thailand,0,2,2,0.0,1.0,1597,1712
2007-01-24,Zanzibar,Northern Cyprus,2,1,1,1.0,0.0,1463,1544
2007-01-27,Oman,Bahrain,1,0,1,1.0,0.0,1796,1711
2007-01-27,Singapore,Malaysia,1,1,0,0.5,0.5,1613,1563
2007-01-27,United Arab Emirates,Saudi Arabia,1,0,1,1.0,0.0,1740,1828
2007-01-28,Thailand,Vietnam,0,0,0,0.5,0.5,1710,1600
2007-01-30,United Arab Emirates,Oman,1,0,1,1.0,0.0,1750,1787
2007-01-31,Panama,Trinidad and Tobago,2,1,1,1.0,0.0,1664,1726
2007-01-31,Singapore,Thailand,2,1,1,1.0,0.0,1624,1700
2007-02-03,Poland,Estonia,4,0,4,1.0,0.0,1877,1592
2007-02-04,Costa Rica,Trinidad and Tobago,4,0,4,1.0,0.0,1779,1720
2007-02-04,Thailand,Singapore,1,1,0,0.5,0.5,1699,1626
2007-02-06,Australia,Denmark,1,3,2,0.0,1.0,1907,1956
2007-02-06,Botswana,Namibia,1,0,1,1.0,0.0,1583,1499
2007-02-06,Cyprus,Hungary,2,1,1,1.0,0.0,1651,1720
2007-02-06,Greece,South Korea,0,1,1,0.0,1.0,1865,1871
2007-02-06,Ivory Coast,Guinea,1,0,1,1.0,0.0,1870,1706
2007-02-06,Latvia,Bulgaria,0,2,2,0.0,1.0,1601,1841
2007-02-06,Lithuania,Mali,1,3,2,0.0,1.0,1588,1763
2007-02-06,Nigeria,Ghana,1,4,3,0.0,1.0,1872,1799
2007-02-06,Northern Ireland,Wales,0,0,0,0.5,0.5,1692,1739
2007-02-06,Portugal,Brazil,2,0,2,1.0,0.0,1979,2050
2007-02-07,Albania,North Macedonia,0,1,1,0.0,1.0,1593,1661
2007-02-07,Algeria,Libya,2,1,1,1.0,0.0,1700,1645
2007-02-07,Andorra,Armenia,0,0,0,0.5,0.5,1413,1547
2007-02-07,Belgium,Czech Republic,0,2,2,0.0,1.0,1839,1959
2007-02-07,China PR,Kazakhstan,2,1,1,1.0,0.0,1793,1546
2007-02-07,Colombia,Uruguay,1,3,2,0.0,1.0,1862,1867
2007-02-07,Croatia,Norway,2,1,1,1.0,0.0,1925,1851
2007-02-07,Cyprus,Bulgaria,0,3,3,0.0,1.0,1647,1846
2007-02-07,Egypt,Sweden,2,0,2,1.0,0.0,1892,1878
2007-02-07,England,Spain,0,1,1,0.0,1.0,2000,2010
2007-02-07,France,Argentina,0,1,1,0.0,1.0,2062,2018
2007-02-07,Georgia,Turkey,1,0,1,1.0,0.0,1628,1857
2007-02-07,Germany,Switzerland,3,1,2,1.0,0.0,2021,1858
2007-02-07,Iran,Belarus,2,2,0,0.5,0.5,1906,1662
2007-02-07,Israel,Ukraine,1,1,0,0.5,0.5,1770,1812
2007-02-07,Latvia,Hungary,0,2,2,0.0,1.0,1596,1726
2007-02-07,Luxembourg,Gambia,2,1,1,1.0,0.0,1337,1530
2007-02-07,Malta,Austria,1,1,0,0.5,0.5,1467,1753
2007-02-07,Morocco,Tunisia,1,1,0,0.5,0.5,1847,1846
2007-02-07,Netherlands,Russia,4,1,3,1.0,0.0,2026,1843
2007-02-07,Poland,Slovakia,2,2,0,0.5,0.5,1876,1801
2007-02-07,Romania,Moldova,2,0,2,1.0,0.0,1901,1555
2007-02-07,San Marino,Republic of Ireland,1,2,1,0.0,1.0,1374,1903
2007-02-07,Senegal,Benin,2,1,1,1.0,0.0,1817,1520
2007-02-07,Slovenia,Estonia,1,0,1,1.0,0.0,1717,1587
2007-02-07,Togo,Cameroon,2,2,0,0.5,0.5,1672,1880
2007-02-07,United States,Mexico,2,0,2,1.0,0.0,1945,1932
2007-02-07,Uzbekistan,Azerbaijan,0,0,0,0.5,0.5,1729,1514
2007-02-07,Venezuela,Chile,0,1,1,0.0,1.0,1711,1829
2007-02-08,El Salvador,Belize,2,1,1,1.0,0.0,1599,1468
2007-02-08,Guatemala,Nicaragua,1,0,1,1.0,0.0,1705,1359
2007-02-09,Costa Rica,Honduras,3,1,2,1.0,0.0,1788,1793
2007-02-10,El Salvador,Nicaragua,2,1,1,1.0,0.0,1603,1356
2007-02-10,Guatemala,Belize,1,0,1,1.0,0.0,1709,1465
2007-02-11,Honduras,Panama,1,1,0,0.5,0.5,1791,1667
2007-02-12,El Salvador,Guatemala,0,0,0,0.5,0.5,1606,1707
2007-02-12,Nicaragua,Belize,4,2,2,1.0,0.0,1367,1455
2007-02-13,Lesotho,Eswatini,0,1,1,0.0,1.0,1451,1491
2007-02-13,Panama,Costa Rica,1,0,1,1.0,0.0,1678,1778
2007-02-15,Nicaragua,Honduras,1,9,8,0.0,1.0,1366,1793
2007-02-16,El Salvador,Costa Rica,0,2,2,0.0,1.0,1602,1783
2007-02-16,Panama,Guatemala,2,0,2,1.0,0.0,1687,1699
2007-02-18,Costa Rica,Panama,1,1,0,0.5,0.5,1781,1690
2007-02-18,El Salvador,Guatemala,0,1,1,0.0,1.0,1597,1705
2007-02-22,Benin,Chad,0,1,1,0.0,1.0,1512,1514
2007-02-28,Mexico,Venezuela,3,1,2,1.0,0.0,1936,1708
2007-03-07,Azerbaijan,Uzbekistan,1,0,1,1.0,0.0,1527,1717
2007-03-07,Kazakhstan,Kyrgyzstan,2,0,2,1.0,0.0,1553,1455
2007-03-09,Kazakhstan,Azerbaijan,1,0,1,1.0,0.0,1561,1520
2007-03-09,Kyrgyzstan,Uzbekistan,0,6,6,0.0,1.0,1453,1720
2007-03-11,Azerbaijan,Kyrgyzstan,1,0,1,1.0,0.0,1527,1447
2007-03-11,Kazakhstan,Uzbekistan,1,1,0,0.5,0.5,1565,1717
2007-03-17,Alderney,Guernsey,0,5,5,0.0,1.0,1281,1674
2007-03-18,Eswatini,Lesotho,0,1,1,0.0,1.0,1483,1460
2007-03-20,Libya,Mauritania,0,0,0,0.5,0.5,1641,1431
2007-03-21,Mauritius,Ivory Coast,0,3,3,0.0,1.0,1534,1873
2007-03-22,Jamaica,Switzerland,0,2,2,0.0,1.0,1778,1865
2007-03-24,Albania,Slovenia,0,0,0,0.5,0.5,1596,1715
2007-03-24,Algeria,Cape Verde,2,0,2,1.0,0.0,1705,1545
2007-03-24,Austria,Ghana,1,1,0,0.5,0.5,1755,1798
2007-03-24,Brazil,Chile,4,0,4,1.0,0.0,2054,1826
2007-03-24,Burkina Faso,Mozambique,1,1,0,0.5,0.5,1632,1578
2007-03-24,Cameroon,Liberia,3,1,2,1.0,0.0,1883,1565
2007-03-24,Chad,South Africa,0,3,3,0.0,1.0,1511,1759
2007-03-24,China PR,Australia,0,2,2,0.0,1.0,1788,1913
2007-03-24,Costa Rica,New Zealand,4,0,4,1.0,0.0,1788,1690
2007-03-24,Croatia,North Macedonia,2,1,1,1.0,0.0,1928,1659
2007-03-24,Cyprus,Slovakia,1,3,2,0.0,1.0,1643,1806
2007-03-24,Czech Republic,Germany,1,2,1,0.0,1.0,1953,2028
2007-03-24,El Salvador,Honduras,0,2,2,0.0,1.0,1594,1797
2007-03-24,Estonia,Russia,0,2,2,0.0,1.0,1585,1846
2007-03-24,Faroe Islands,Ukraine,0,2,2,0.0,1.0,1466,1814
2007-03-24,Gambia,Guinea,0,2,2,0.0,1.0,1526,1711
2007-03-24,Greece,Turkey,1,4,3,0.0,1.0,1857,1866
2007-03-24,Guadeloupe,Trinidad and Tobago,2,2,0,0.5,0.5,1599,1718
2007-03-24,Haiti,Panama,3,0,3,1.0,0.0,1694,1682
2007-03-24,Republic of Ireland,Wales,1,0,1,1.0,0.0,1908,1735
2007-03-24,Israel,England,0,0,0,0.5,0.5,1775,1996
2007-03-24,Japan,Peru,2,0,2,1.0,0.0,1903,1756
2007-03-24,Kazakhstan,Serbia,2,1,1,1.0,0.0,1579,1813
2007-03-24,South Korea,Uruguay,0,2,2,0.0,1.0,1863,1876
2007-03-24,Liechtenstein,Northern Ireland,1,4,3,0.0,1.0,1399,1695
2007-03-24,Lithuania,France,0,1,1,0.0,1.0,1588,2063
2007-03-24,Luxembourg,Belarus,1,2,1,0.0,1.0,1335,1665
2007-03-24,Moldova,Malta,1,1,0,0.5,0.5,1554,1469
2007-03-24,Montenegro,Hungary,2,1,1,1.0,0.0,1517,1714
2007-03-24,Netherlands,Romania,0,0,0,0.5,0.5,2024,1904
2007-03-24,Nigeria,Uganda,1,0,1,1.0,0.0,1876,1636
2007-03-24,Norway,Bosnia and Herzegovina,1,2,1,0.0,1.0,1840,1687
2007-03-24,Poland,Azerbaijan,5,0,5,1.0,0.0,1878,1526
2007-03-24,Portugal,Belgium,4,0,4,1.0,0.0,1984,1835
2007-03-24,Qatar,Iran,0,1,1,0.0,1.0,1754,1911
2007-03-24,Scotland,Georgia,2,1,1,1.0,0.0,1801,1624
2007-03-24,Senegal,Tanzania,4,0,4,1.0,0.0,1821,1568
2007-03-24,Seychelles,Tunisia,0,3,3,0.0,1.0,1465,1848
2007-03-24,Spain,Denmark,2,1,1,1.0,0.0,2017,1950
2007-03-24,Togo,Sierra Leone,3,1,2,1.0,0.0,1679,1603
2007-03-24,Venezuela,Cuba,3,1,2,1.0,0.0,1717,1705
2007-03-24,Kernow,Guernsey,1,1,0,0.5,0.5,1554,1672
2007-03-25,Angola,Eritrea,6,1,5,1.0,0.0,1744,1459
2007-03-25,Barbados,Guatemala,0,0,0,0.5,0.5,1602,1703
2007-03-25,Bermuda,Canada,0,3,3,0.0,1.0,1511,1730
2007-03-25,Botswana,Burundi,1,0,1,1.0,0.0,1591,1533
2007-03-25,Colombia,Switzerland,3,1,2,1.0,0.0,1871,1857
2007-03-25,Congo,Zambia,0,0,0,0.5,0.5,1619,1743
2007-03-25,Egypt,Mauritania,3,0,3,1.0,0.0,1894,1430
2007-03-25,Equatorial Guinea,Rwanda,3,1,2,1.0,0.0,1472,1582
2007-03-25,Kenya,Eswatini,2,0,2,1.0,0.0,1622,1478
2007-03-25,Lesotho,Niger,3,1,2,1.0,0.0,1470,1535
2007-03-25,Libya,Namibia,2,1,1,1.0,0.0,1646,1495
2007-03-25,Madagascar,Ivory Coast,0,3,3,0.0,1.0,1560,1876
2007-03-25,Mali,Benin,1,1,0,0.5,0.5,1759,1517
2007-03-25,Mauritius,Sudan,1,2,1,0.0,1.0,1528,1623
2007-03-25,Mexico,Paraguay,2,1,1,1.0,0.0,1943,1845
2007-03-25,Northern Mariana Islands,Guam,2,3,1,0.0,1.0,1479,1364
2007-03-25,United States,Ecuador,3,1,2,1.0,0.0,1951,1806
2007-03-25,Zimbabwe,Morocco,1,1,0,0.5,0.5,1708,1844
2007-03-26,Jamaica,Panama,1,1,0,0.5,0.5,1776,1685
2007-03-27,Brazil,Ghana,1,0,1,1.0,0.0,2057,1796
2007-03-27,China PR,Uzbekistan,3,1,2,1.0,0.0,1795,1711
2007-03-27,El Salvador,Honduras,0,2,2,0.0,1.0,1591,1801
2007-03-28,Andorra,England,0,3,3,0.0,1.0,1413,1997
2007-03-28,Azerbaijan,Finland,1,0,1,1.0,0.0,1539,1742
2007-03-28,Bulgaria,Albania,0,0,0,0.5,0.5,1842,1601
2007-03-28,Chile,Costa Rica,1,1,0,0.5,0.5,1826,1789
2007-03-28,Colombia,Paraguay,2,0,2,1.0,0.0,1879,1838
2007-03-28,Czech Republic,Cyprus,1,0,1,1.0,0.0,1956,1641
2007-03-28,France,Austria,1,0,1,1.0,0.0,2066,1753
2007-03-28,Georgia,Faroe Islands,3,1,2,1.0,0.0,1629,1462
2007-03-28,Germany,Denmark,0,1,1,0.0,1.0,2019,1960
2007-03-28,Hungary,Moldova,2,0,2,1.0,0.0,1719,1550
2007-03-28,Republic of Ireland,Slovakia,1,0,1,1.0,0.0,1914,1801
2007-03-28,Israel,Estonia,4,0,4,1.0,0.0,1780,1581
2007-03-28,Italy,Scotland,2,0,2,1.0,0.0,2005,1798
2007-03-28,Liechtenstein,Latvia,1,0,1,1.0,0.0,1412,1584
2007-03-28,Malta,Greece,0,1,1,0.0,1.0,1468,1859
2007-03-28,Mexico,Ecuador,4,2,2,1.0,0.0,1948,1802
2007-03-28,Northern Ireland,Sweden,2,1,1,1.0,0.0,1707,1867
2007-03-28,Poland,Armenia,1,0,1,1.0,0.0,1881,1545
2007-03-28,Romania,Luxembourg,3,0,3,1.0,0.0,1905,1335
2007-03-28,Serbia,Portugal,1,1,0,0.5,0.5,1817,1981
2007-03-28,Slovenia,Netherlands,0,1,1,0.0,1.0,1713,2027
2007-03-28,South Africa,Bolivia,0,1,1,0.0,1.0,1750,1701
2007-03-28,Spain,Iceland,1,0,1,1.0,0.0,2019,1665
2007-03-28,Turkey,Norway,2,2,0,0.5,0.5,1866,1841
2007-03-28,Ukraine,Lithuania,1,0,1,1.0,0.0,1818,1585
2007-03-28,United States,Guatemala,0,0,0,0.5,0.5,1947,1708
2007-03-28,Venezuela,New Zealand,5,0,5,1.0,0.0,1725,1683
2007-03-28,Wales,San Marino,3,0,3,1.0,0.0,1737,1373
2007-04-01,Guam,Northern Mariana Islands,9,0,9,1.0,0.0,1375,1469
2007-04-04,Angola,Congo,0,0,0,0.5,0.5,1742,1622
2007-04-17,El Salvador,Haiti,0,1,1,0.0,1.0,1586,1700
2007-04-18,Argentina,Chile,0,0,0,0.5,0.5,2014,1831
2007-04-19,Honduras,Haiti,1,3,2,0.0,1.0,1791,1711
2007-04-24,Seychelles,Réunion,2,0,2,1.0,0.0,1476,1549
2007-04-26,Mauritius,Réunion,1,1,0,0.5,0.5,1529,1549
2007-04-28,Madagascar,Zimbabwe,0,1,1,0.0,1.0,1556,1713
2007-04-28,Mozambique,Seychelles,2,0,2,1.0,0.0,1584,1471
2007-04-29,DR Congo,Ethiopia,2,0,2,1.0,0.0,1686,1644
2007-04-29,Madagascar,Seychelles,5,0,5,1.0,0.0,1563,1465
2007-04-29,Mozambique,Zimbabwe,0,0,0,0.5,0.5,1587,1711
2007-05-06,Guernsey,Jersey,0,0,0,0.5,0.5,1673,1710
2007-05-09,Chile,Cuba,3,0,3,1.0,0.0,1837,1700
2007-05-09,Panama,Colombia,0,4,4,0.0,1.0,1682,1883
2007-05-16,Chile,Cuba,2,0,2,1.0,0.0,1842,1696
2007-05-16,Thailand,China PR,1,0,1,1.0,0.0,1710,1785
2007-05-17,Guadeloupe,Dominica,2,0,2,1.0,0.0,1604,1411
2007-05-20,Guadeloupe,Dominica,1,1,0,0.5,0.5,1600,1416
2007-05-21,Eritrea,Sudan,1,0,1,1.0,0.0,1471,1612
2007-05-23,Ecuador,Republic of Ireland,1,1,0,0.5,0.5,1805,1912
2007-05-23,Haiti,Chile,0,0,0,0.5,0.5,1714,1840
2007-05-25,Venezuela,Honduras,2,1,1,1.0,0.0,1735,1782
2007-05-25,Zimbabwe,Lesotho,1,1,0,0.5,0.5,1707,1475
2007-05-26,Bolivia,Republic of Ireland,1,1,0,0.5,0.5,1706,1908
2007-05-26,Eritrea,Sudan,1,1,0,0.5,0.5,1475,1609
2007-05-26,Malawi,South Africa,0,0,0,0.5,0.5,1604,1747
2007-05-26,Namibia,Zambia,1,2,1,0.0,1.0,1492,1747
2007-05-26,Eswatini,Mauritius,0,0,0,0.5,0.5,1480,1528
2007-05-26,Uganda,Tanzania,1,1,0,0.5,0.5,1635,1570
2007-05-26,Wales,New Zealand,2,2,0,0.5,0.5,1736,1685
2007-05-27,Botswana,Libya,0,0,0,0.5,0.5,1593,1645
2007-05-27,Kenya,Nigeria,0,1,1,0.0,1.0,1619,1880
2007-05-27,Mauritius,South Africa,0,2,2,0.0,1.0,1525,1751
2007-05-27,Rwanda,Burundi,1,0,1,1.0,0.0,1589,1527
2007-05-27,Eswatini,Malawi,1,0,1,1.0,0.0,1491,1594
2007-05-28,Congo,DR Congo,2,1,1,1.0,0.0,1632,1677
2007-05-28,Trinidad and Tobago,Haiti,1,0,1,1.0,0.0,1726,1707
2007-05-29,Zimbabwe,Burkina Faso,1,1,0,0.5,0.5,1706,1634
2007-05-30,Austria,Scotland,0,1,1,0.0,1.0,1747,1805
2007-05-30,Saint Vincent and the Grenadines,Haiti,0,3,3,0.0,1.0,1583,1713
2007-06-01,England,Brazil,1,1,0,0.5,0.5,1999,2056
2007-06-01,Ethiopia,DR Congo,1,0,1,1.0,0.0,1653,1669
2007-06-01,Indonesia,Hong Kong,3,0,3,1.0,0.0,1623,1559
2007-06-01,Japan,Montenegro,2,0,2,1.0,0.0,1905,1516
2007-06-01,Venezuela,Canada,2,2,0,0.5,0.5,1735,1731
2007-06-02,Albania,Luxembourg,2,0,2,1.0,0.0,1604,1333
2007-06-02,Australia,Uruguay,1,2,1,0.0,1.0,1905,1885
2007-06-02,Austria,Paraguay,0,0,0,0.5,0.5,1750,1836
2007-06-02,Azerbaijan,Poland,1,3,2,0.0,1.0,1538,1883
2007-06-02,Belarus,Bulgaria,0,2,2,0.0,1.0,1661,1847
2007-06-02,Belgium,Portugal,1,2,1,0.0,1.0,1831,1986
2007-06-02,Bosnia and Herzegovina,Turkey,3,2,1,1.0,0.0,1699,1855
2007-06-02,Cape Verde,Algeria,2,2,0,0.5,0.5,1549,1702
2007-06-02,Costa Rica,Chile,2,0,2,1.0,0.0,1799,1831
2007-06-02,Denmark,Sweden,0,3,3,0.0,1.0,1950,1878
2007-06-02,Eritrea,Angola,1,1,0,0.5,0.5,1481,1737
2007-06-02,Estonia,Croatia,0,1,1,0.0,1.0,1580,1930
2007-06-02,Faroe Islands,Italy,1,2,1,0.0,1.0,1462,2006
2007-06-02,Finland,Serbia,0,2,2,0.0,1.0,1736,1824
2007-06-02,France,Ukraine,2,0,2,1.0,0.0,2070,1815
2007-06-02,Germany,San Marino,6,0,6,1.0,0.0,2020,1373
2007-06-02,Greece,Hungary,2,0,2,1.0,0.0,1864,1715
2007-06-02,Honduras,Trinidad and Tobago,3,1,2,1.0,0.0,1789,1720
2007-06-02,Iceland,Liechtenstein,1,1,0,0.5,0.5,1661,1417
2007-06-02,Kazakhstan,Armenia,1,2,1,0.0,1.0,1571,1554
2007-06-02,South Korea,Netherlands,0,2,2,0.0,1.0,1859,2032
2007-06-02,Latvia,Spain,0,2,2,0.0,1.0,1583,2021
2007-06-02,Lithuania,Georgia,1,0,1,1.0,0.0,1595,1620
2007-06-02,North Macedonia,Israel,1,2,1,0.0,1.0,1654,1786
2007-06-02,Mexico,Iran,4,0,4,1.0,0.0,1956,1904
2007-06-02,Morocco,Zimbabwe,2,0,2,1.0,0.0,1849,1702
2007-06-02,Namibia,Libya,1,0,1,1.0,0.0,1504,1634
2007-06-02,Norway,Malta,4,0,4,1.0,0.0,1843,1467
2007-06-02,Russia,Andorra,4,0,4,1.0,0.0,1848,1412
2007-06-02,Rwanda,Equatorial Guinea,2,0,2,1.0,0.0,1595,1467
2007-06-02,Slovenia,Romania,1,2,1,0.0,1.0,1710,1909
2007-06-02,South Africa,Chad,4,0,4,1.0,0.0,1755,1508
2007-06-02,Sudan,Mauritius,3,0,3,1.0,0.0,1616,1519
2007-06-02,Switzerland,Argentina,1,1,0,0.5,0.5,1861,2011
2007-06-02,Tanzania,Senegal,1,1,0,0.5,0.5,1575,1817
2007-06-02,Tunisia,Seychelles,4,0,4,1.0,0.0,1850,1464
2007-06-02,Uganda,Nigeria,2,1,1,1.0,0.0,1648,1868
2007-06-02,United States,China PR,4,1,3,1.0,0.0,1952,1781
2007-06-02,Wales,Czech Republic,0,0,0,0.5,0.5,1741,1952
2007-06-02,Zambia,Congo,3,0,3,1.0,0.0,1753,1627
2007-06-03,Benin,Mali,0,0,0,0.5,0.5,1522,1755
2007-06-03,Burundi,Botswana,1,0,1,1.0,0.0,1537,1584
2007-06-03,Colombia,Montenegro,1,0,1,1.0,0.0,1885,1515
2007-06-03,Ecuador,Peru,1,2,1,0.0,1.0,1796,1766
2007-06-03,Guinea,Gambia,2,2,0,0.5,0.5,1708,1530
2007-06-03,Ivory Coast,Madagascar,5,0,5,1.0,0.0,1879,1561
2007-06-03,Liberia,Cameroon,1,2,1,0.0,1.0,1563,1886
2007-06-03,Mauritania,Egypt,1,1,0,0.5,0.5,1437,1888
2007-06-03,Mozambique,Burkina Faso,3,0,3,1.0,0.0,1597,1625
2007-06-03,Niger,Lesotho,2,0,2,1.0,0.0,1542,1469
2007-06-03,Sierra Leone,Togo,0,1,1,0.0,1.0,1597,1686
2007-06-03,Eswatini,Kenya,0,0,0,0.5,0.5,1494,1617
2007-06-05,Algeria,Argentina,3,4,1,0.0,1.0,1700,2014
2007-06-05,Jamaica,Chile,0,1,1,0.0,1.0,1770,1838
2007-06-05,Japan,Colombia,0,0,0,0.5,0.5,1905,1886
2007-06-05,Kuwait,Portugal,1,1,0,0.5,0.5,1734,1981
2007-06-05,Mexico,Paraguay,0,1,1,0.0,1.0,1946,1847
2007-06-05,Turkey,Brazil,0,0,0,0.5,0.5,1860,2052
2007-06-06,Andorra,Israel,0,2,2,0.0,1.0,1411,1788
2007-06-06,Armenia,Poland,1,0,1,1.0,0.0,1568,1870
2007-06-06,Bosnia and Herzegovina,Malta,1,0,1,1.0,0.0,1703,1464
2007-06-06,Bulgaria,Belarus,2,1,1,1.0,0.0,1852,1657
2007-06-06,Costa Rica,Canada,1,2,1,0.0,1.0,1790,1741
2007-06-06,Croatia,Russia,0,0,0,0.5,0.5,1929,1850
2007-06-06,Ecuador,Peru,2,0,2,1.0,0.0,1804,1759
2007-06-06,Estonia,England,0,3,3,0.0,1.0,1579,2001
2007-06-06,Faroe Islands,Scotland,0,2,2,0.0,1.0,1461,1807
2007-06-06,Finland,Belgium,2,0,2,1.0,0.0,1747,1821
2007-06-06,France,Georgia,1,0,1,1.0,0.0,2072,1619
2007-06-06,Germany,Slovakia,2,1,1,1.0,0.0,2024,1798
2007-06-06,Greece,Moldova,2,1,1,1.0,0.0,1867,1548
2007-06-06,Guadeloupe,Haiti,1,1,0,0.5,0.5,1603,1711
2007-06-06,Kazakhstan,Azerbaijan,1,1,0,0.5,0.5,1571,1539
2007-06-06,Latvia,Denmark,0,2,2,0.0,1.0,1582,1952
2007-06-06,Liechtenstein,Spain,0,2,2,0.0,1.0,1417,2022
2007-06-06,Lithuania,Italy,0,2,2,0.0,1.0,1594,2008
2007-06-06,Luxembourg,Albania,0,3,3,0.0,1.0,1331,1607
2007-06-06,Norway,Hungary,4,0,4,1.0,0.0,1849,1710
2007-06-06,Romania,Slovenia,2,0,2,1.0,0.0,1913,1707
2007-06-06,Sweden,Iceland,5,0,5,1.0,0.0,1882,1658
2007-06-06,Thailand,Netherlands,1,3,2,0.0,1.0,1708,2035
2007-06-07,El Salvador,Trinidad and Tobago,2,1,1,1.0,0.0,1597,1710
2007-06-07,United States,Guatemala,1,0,1,1.0,0.0,1956,1705
2007-06-07,Romani people,Ambazonia,3,1,2,1.0,0.0,1508,1464
2007-06-08,Jordan,Iraq,1,1,0,0.5,0.5,1729,1755
2007-06-08,Mexico,Cuba,2,1,1,1.0,0.0,1950,1693
2007-06-08,Panama,Honduras,3,2,1,1.0,0.0,1693,1779
2007-06-09,Burkina Faso,Mali,0,1,1,0.0,1.0,1620,1761
2007-06-09,Canada,Guadeloupe,1,2,1,0.0,1.0,1730,1615
2007-06-09,Guatemala,El Salvador,1,0,1,1.0,0.0,1711,1592
2007-06-09,Haiti,Costa Rica,1,1,0,0.5,0.5,1713,1789
2007-06-09,Tanzania,Zambia,1,1,0,0.5,0.5,1579,1750
2007-06-09,United States,Trinidad and Tobago,2,0,2,1.0,0.0,1960,1707
2007-06-10,Honduras,Mexico,2,1,1,1.0,0.0,1791,1939
2007-06-10,Hong Kong,Macau,2,1,1,1.0,0.0,1563,1353
2007-06-10,Kenya,Rwanda,2,0,2,1.0,0.0,1625,1588
2007-06-10,Malawi,Senegal,2,3,1,0.0,1.0,1591,1821
2007-06-10,Panama,Cuba,2,2,0,0.5,0.5,1693,1693
2007-06-11,Costa Rica,Guadeloupe,1,0,1,1.0,0.0,1794,1611
2007-06-11,Haiti,Canada,0,2,2,0.0,1.0,1706,1738
2007-06-12,Jordan,Iraq,0,0,0,0.5,0.5,1730,1755
2007-06-12,Kuwait,Egypt,1,1,0,0.5,0.5,1738,1885
2007-06-12,Réunion,Gabon,0,3,3,0.0,1.0,1544,1677
2007-06-12,Trinidad and Tobago,Guatemala,1,1,0,0.5,0.5,1708,1711
2007-06-12,United States,El Salvador,4,0,4,1.0,0.0,1962,1591
2007-06-13,Cuba,Honduras,0,5,5,0.0,1.0,1688,1797
2007-06-13,Mexico,Panama,1,0,1,1.0,0.0,1943,1690
2007-06-16,Algeria,Guinea,0,2,2,0.0,1.0,1693,1716
2007-06-16,Botswana,Mauritania,2,1,1,1.0,0.0,1589,1433
2007-06-16,Burkina Faso,Tanzania,0,1,1,0.0,1.0,1612,1588
2007-06-16,Canada,Guatemala,3,0,3,1.0,0.0,1746,1704
2007-06-16,Cape Verde,Gambia,0,0,0,0.5,0.5,1549,1531
2007-06-16,Eritrea,Kenya,1,0,1,1.0,0.0,1493,1614
2007-06-16,Iran,Iraq,0,0,0,0.5,0.5,1901,1759
2007-06-16,Lebanon,Syria,0,1,1,0.0,1.0,1624,1673
2007-06-16,Malawi,Morocco,0,1,1,0.0,1.0,1589,1852
2007-06-16,Namibia,DR Congo,1,1,0,0.5,0.5,1508,1666
2007-06-16,Seychelles,Sudan,0,2,2,0.0,1.0,1460,1621
2007-06-16,Tunisia,Mauritius,2,0,2,1.0,0.0,1853,1517
2007-06-16,United States,Panama,2,1,1,1.0,0.0,1965,1688
2007-06-16,Zambia,Chad,1,1,0,0.5,0.5,1746,1513
2007-06-17,Angola,Eswatini,3,0,3,1.0,0.0,1741,1491
2007-06-17,Benin,Togo,4,1,3,1.0,0.0,1534,1675
2007-06-17,Cameroon,Rwanda,2,1,1,1.0,0.0,1889,1586
2007-06-17,Congo,South Africa,1,1,0,0.5,0.5,1630,1753
2007-06-17,Guam,Taiwan,0,10,10,0.0,1.0,1368,1412
2007-06-17,Honduras,Guadeloupe,1,2,1,0.0,1.0,1786,1623
2007-06-17,Liberia,Equatorial Guinea,0,0,0,0.5,0.5,1561,1470
2007-06-17,Libya,Ethiopia,3,1,2,1.0,0.0,1643,1645
2007-06-17,Macau,Mongolia,0,0,0,0.5,0.5,1355,1415
2007-06-17,Madagascar,Gabon,0,2,2,0.0,1.0,1556,1683
2007-06-17,Mali,Sierra Leone,6,0,6,1.0,0.0,1766,1593
2007-06-17,Mexico,Costa Rica,1,0,1,1.0,0.0,1948,1790
2007-06-17,Mozambique,Senegal,0,0,0,0.5,0.5,1602,1817
2007-06-17,Niger,Nigeria,1,3,2,0.0,1.0,1540,1871
2007-06-18,Jordan,Syria,0,1,1,0.0,1.0,1721,1683
2007-06-18,Malaysia,Cambodia,6,0,6,1.0,0.0,1567,1346
2007-06-18,Palestine,Iraq,0,1,1,0.0,1.0,1514,1763
2007-06-19,Hong Kong,Taiwan,1,1,0,0.5,0.5,1560,1416
2007-06-19,North Korea,Mongolia,7,0,7,1.0,0.0,1699,1413
2007-06-19,Lesotho,Uganda,0,0,0,0.5,0.5,1473,1645
2007-06-20,Bolivia,Paraguay,0,0,0,0.5,0.5,1710,1844
2007-06-20,Iran,Palestine,2,0,2,1.0,0.0,1903,1513
2007-06-20,Jordan,Lebanon,3,0,3,1.0,0.0,1727,1619
2007-06-20,Venezuela,Basque Country,3,4,1,0.0,1.0,1727,1724
2007-06-21,Hong Kong,Guam,15,1,14,1.0,0.0,1564,1365
2007-06-21,Indonesia,Jamaica,2,1,1,1.0,0.0,1635,1759
2007-06-21,Macau,North Korea,1,7,6,0.0,1.0,1354,1701
2007-06-21,Malaysia,United Arab Emirates,1,3,2,0.0,1.0,1563,1755
2007-06-21,Mexico,Guadeloupe,1,0,1,1.0,0.0,1951,1621
2007-06-21,United States,Canada,2,1,1,1.0,0.0,1969,1743
2007-06-22,Jordan,Iran,0,1,1,0.0,1.0,1723,1908
2007-06-22,Syria,Iraq,0,3,3,0.0,1.0,1677,1770
2007-06-23,Colombia,Ecuador,3,1,2,1.0,0.0,1893,1798
2007-06-23,Mongolia,Guam,5,2,3,1.0,0.0,1420,1359
2007-06-24,Indonesia,Oman,0,1,1,0.0,1.0,1631,1792
2007-06-24,Iraq,Iran,1,2,1,0.0,1.0,1766,1913
2007-06-24,North Korea,Hong Kong,1,0,1,1.0,0.0,1706,1560
2007-06-24,United Arab Emirates,Saudi Arabia,0,2,2,0.0,1.0,1749,1835
2007-06-24,United States,Mexico,2,1,1,1.0,0.0,1977,1944
2007-06-24,Vietnam,Jamaica,3,0,3,1.0,0.0,1612,1748
2007-06-25,Qatar,Turkmenistan,1,0,1,1.0,0.0,1759,1586
2007-06-26,Uruguay,Peru,0,3,3,0.0,1.0,1875,1770
2007-06-26,Venezuela,Bolivia,2,2,0,0.5,0.5,1727,1711
2007-06-27,Brazil,Mexico,0,2,2,0.0,1.0,2042,1955
2007-06-27,Ecuador,Chile,2,3,1,0.0,1.0,1791,1846
2007-06-27,Singapore,Saudi Arabia,1,2,1,0.0,1.0,1623,1839
2007-06-27,United Arab Emirates,Bahrain,2,2,0,0.5,0.5,1749,1712
2007-06-28,Argentina,United States,4,1,3,1.0,0.0,2022,1970
2007-06-28,Malaysia,Jamaica,0,2,2,0.0,1.0,1559,1753
2007-06-28,Oman,North Korea,2,2,0,0.5,0.5,1791,1708
2007-06-28,Paraguay,Colombia,5,0,5,1.0,0.0,1854,1884
2007-06-29,South Korea,Iraq,3,0,3,1.0,0.0,1865,1761
2007-06-30,Bolivia,Uruguay,0,1,1,0.0,1.0,1707,1880
2007-06-30,Singapore,Australia,0,3,3,0.0,1.0,1621,1908
2007-06-30,Thailand,Qatar,1,1,0,0.5,0.5,1710,1758
2007-06-30,Venezuela,Peru,2,0,2,1.0,0.0,1736,1762
2007-06-30,Vietnam,Bahrain,5,3,2,1.0,0.0,1623,1702
2007-06-30,Menorca,Jersey,0,1,1,0.0,1.0,1497,1714
2007-06-30,Bermuda,Ynys Môn,1,2,1,0.0,1.0,1505,1591
2007-06-30,Rhodes,Saare County,2,0,2,1.0,0.0,1528,1428
2007-07-01,Brazil,Chile,3,0,3,1.0,0.0,2046,1843
2007-07-01,Mexico,Ecuador,2,1,1,1.0,0.0,1960,1787
2007-07-01,Oman,Saudi Arabia,1,1,0,0.5,0.5,1793,1838
2007-07-01,United Arab Emirates,North Korea,1,0,1,1.0,0.0,1757,1701
2007-07-01,Jersey,Gibraltar,1,1,0,0.5,0.5,1711,1552
2007-07-01,Åland Islands,Bermuda,0,2,2,0.0,1.0,1513,1514
2007-07-01,Rhodes,Frøya,3,1,2,1.0,0.0,1535,1475
2007-07-01,Western Isles,Gotland,2,1,1,1.0,0.0,1524,1527
2007-07-02,Argentina,Colombia,4,2,2,1.0,0.0,2027,1880
2007-07-02,Iran,Jamaica,8,1,7,1.0,0.0,1918,1749
2007-07-02,Iraq,Uzbekistan,0,2,2,0.0,1.0,1752,1721
2007-07-02,Thailand,Qatar,2,0,2,1.0,0.0,1720,1749
2007-07-02,United States,Paraguay,1,3,2,0.0,1.0,1960,1865
2007-07-02,Gibraltar,Menorca,2,1,1,1.0,0.0,1559,1491
2007-07-02,Ynys Môn,Åland Islands,0,2,2,0.0,1.0,1582,1523
2007-07-02,Saare County,Frøya,2,3,1,0.0,1.0,1422,1482
2007-07-02,Gotland,Western Isles,1,3,2,0.0,1.0,1519,1533
2007-07-03,Peru,Bolivia,2,2,0,0.5,0.5,1761,1709
2007-07-03,Venezuela,Uruguay,0,0,0,0.5,0.5,1740,1877
2007-07-04,Brazil,Ecuador,1,0,1,1.0,0.0,2049,1785
2007-07-04,Mexico,Chile,0,0,0,0.5,0.5,1958,1846
2007-07-04,Saudi Arabia,North Korea,1,1,0,0.5,0.5,1835,1705
2007-07-04,Menorca,Ynys Môn,6,1,5,1.0,0.0,1502,1572
2007-07-04,Jersey,Åland Islands,1,0,1,1.0,0.0,1716,1519
2007-07-04,Frøya,Gotland,0,3,3,0.0,1.0,1475,1527
2007-07-04,Gibraltar,Bermuda,2,0,2,1.0,0.0,1566,1508
2007-07-04,Rhodes,Western Isles,1,0,1,1.0,0.0,1543,1526
2007-07-05,Argentina,Paraguay,1,0,1,1.0,0.0,2032,1861
2007-07-05,Colombia,United States,1,0,1,1.0,0.0,1890,1951
2007-07-05,South Korea,Uzbekistan,2,1,1,1.0,0.0,1870,1717
2007-07-05,Menorca,Saare County,4,1,3,1.0,0.0,1509,1416
2007-07-05,Åland Islands,Frøya,3,1,2,1.0,0.0,1526,1469
2007-07-05,Jersey,Gotland,1,0,1,1.0,0.0,1721,1523
2007-07-05,Bermuda,Western Isles,0,1,1,0.0,1.0,1501,1534
2007-07-05,Rhodes,Gibraltar,0,4,4,0.0,1.0,1536,1574
2007-07-06,Malawi,Namibia,1,2,1,0.0,1.0,1580,1518
2007-07-07,Chile,Brazil,1,6,5,0.0,1.0,1843,2053
2007-07-07,Thailand,Iraq,1,1,0,0.5,0.5,1721,1752
2007-07-07,Venezuela,Uruguay,1,4,3,0.0,1.0,1736,1882
2007-07-08,Argentina,Peru,4,0,4,1.0,0.0,2035,1759
2007-07-08,Australia,Oman,1,1,0,0.5,0.5,1906,1796
2007-07-08,Mexico,Paraguay,6,0,6,1.0,0.0,1964,1856
2007-07-08,Vietnam,United Arab Emirates,2,0,2,1.0,0.0,1634,1747
2007-07-09,Japan,Qatar,1,1,0,0.5,0.5,1902,1753
2007-07-10,Indonesia,Bahrain,2,1,1,1.0,0.0,1641,1693
2007-07-10,Malaysia,China PR,1,5,4,0.0,1.0,1556,1785
2007-07-10,Uruguay,Brazil,2,2,0,0.5,0.5,1886,2050
2007-07-11,Iran,Uzbekistan,2,1,1,1.0,0.0,1922,1714
2007-07-11,South Korea,Saudi Arabia,1,1,0,0.5,0.5,1870,1836
2007-07-11,Mexico,Argentina,0,3,3,0.0,1.0,1958,2042
2007-07-12,Thailand,Oman,2,0,2,1.0,0.0,1731,1787
2007-07-12,Vietnam,Qatar,1,1,0,0.5,0.5,1637,1751
2007-07-13,Iraq,Australia,3,1,2,1.0,0.0,1764,1895
2007-07-13,Solomon Islands,Papua New Guinea,2,1,1,1.0,0.0,1658,1506
2007-07-13,United Arab Emirates,Japan,1,3,2,0.0,1.0,1743,1907
2007-07-14,Indonesia,Saudi Arabia,1,2,1,0.0,1.0,1638,1840
2007-07-14,Malaysia,Uzbekistan,0,5,5,0.0,1.0,1552,1719
2007-07-14,Mexico,Uruguay,3,1,2,1.0,0.0,1965,1880
2007-07-15,Bahrain,South Korea,2,1,1,1.0,0.0,1705,1859
2007-07-15,Brazil,Argentina,3,0,3,1.0,0.0,2058,2035
2007-07-15,China PR,Iran,2,2,0,0.5,0.5,1789,1919
2007-07-16,Oman,Iraq,0,0,0,0.5,0.5,1787,1765
2007-07-16,Qatar,United Arab Emirates,1,2,1,0.0,1.0,1743,1752
2007-07-16,Thailand,Australia,0,4,4,0.0,1.0,1727,1900
2007-07-16,Vietnam,Japan,1,4,3,0.0,1.0,1635,1910
2007-07-17,New Caledonia,Vanuatu,5,3,2,1.0,0.0,1603,1529
2007-07-18,Indonesia,South Korea,0,1,1,0.0,1.0,1635,1863
2007-07-18,Malaysia,Iran,0,2,2,0.0,1.0,1551,1921
2007-07-18,Saudi Arabia,Bahrain,4,0,4,1.0,0.0,1846,1700
2007-07-18,Uzbekistan,China PR,3,0,3,1.0,0.0,1729,1780
2007-07-19,Madagascar,Mayotte,2,2,0,0.5,0.5,1555,1493
2007-07-19,New Caledonia,Vanuatu,0,2,2,0.0,1.0,1594,1539
2007-07-21,Iraq,Vietnam,2,0,2,1.0,0.0,1771,1630
2007-07-21,Japan,Australia,1,1,0,0.5,0.5,1910,1901
2007-07-22,Iran,South Korea,0,0,0,0.5,0.5,1920,1865
2007-07-22,Saudi Arabia,Uzbekistan,2,1,1,1.0,0.0,1852,1724
2007-07-23,Botswana,Zambia,0,0,0,0.5,0.5,1593,1743
2007-07-25,Iraq,South Korea,0,0,0,0.5,0.5,1774,1863
2007-07-25,Japan,Saudi Arabia,2,3,1,0.0,1.0,1901,1862
2007-07-28,Angola,Lesotho,2,0,2,1.0,0.0,1744,1471
2007-07-28,Botswana,Namibia,1,0,1,1.0,0.0,1600,1512
2007-07-28,South Korea,Japan,0,0,0,0.5,0.5,1864,1901
2007-07-29,Botswana,Angola,0,0,0,0.5,0.5,1604,1741
2007-07-29,Iraq,Saudi Arabia,1,0,1,1.0,0.0,1784,1853
2007-07-29,Lesotho,Namibia,2,3,1,0.0,1.0,1464,1520
2007-07-29,Madagascar,DR Congo,0,0,0,0.5,0.5,1558,1664
2007-08-10,Seychelles,Mayotte,2,1,1,1.0,0.0,1469,1485
2007-08-10,Comoros,Réunion,1,1,0,0.5,0.5,1427,1542
2007-08-12,Mauritius,Mayotte,0,1,1,0.0,1.0,1509,1494
2007-08-12,Madagascar,Réunion,0,0,0,0.5,0.5,1558,1543
2007-08-14,Mauritius,Seychelles,3,0,3,1.0,0.0,1517,1462
2007-08-14,Madagascar,Comoros,3,0,3,1.0,0.0,1564,1422
2007-08-16,Mauritius,Réunion,0,1,1,0.0,1.0,1510,1551
2007-08-16,Madagascar,Mayotte,4,0,4,1.0,0.0,1571,1488
2007-08-17,India,Cambodia,6,0,6,1.0,0.0,1539,1342
2007-08-18,Bangladesh,Syria,0,2,2,0.0,1.0,1468,1681
2007-08-18,Mauritius,Mayotte,1,1,0,0.5,0.5,1510,1489
2007-08-18,Madagascar,Réunion,0,0,0,0.5,0.5,1571,1552
2007-08-19,Kyrgyzstan,Cambodia,4,3,1,1.0,0.0,1453,1337
2007-08-20,Myanmar,Lesotho,1,0,1,1.0,0.0,1552,1458
2007-08-20,India,Bangladesh,1,0,1,1.0,0.0,1546,1462
2007-08-20,Mozambique,Zimbabwe,0,0,0,0.5,0.5,1605,1700
2007-08-21,Singapore,Zimbabwe,4,2,2,1.0,0.0,1631,1691
2007-08-21,Benin,Gabon,2,2,0,0.5,0.5,1538,1680
2007-08-21,Ghana,Senegal,1,1,0,0.5,0.5,1797,1817
2007-08-21,Syria,Kyrgyzstan,4,1,3,1.0,0.0,1685,1450
2007-08-22,Albania,Malta,3,0,3,1.0,0.0,1612,1460
2007-08-22,Algeria,Brazil,0,2,2,0.0,1.0,1692,2060
2007-08-22,Armenia,Portugal,1,1,0,0.5,0.5,1575,1975
2007-08-22,Austria,Czech Republic,1,1,0,0.5,0.5,1755,1948
2007-08-22,Bangladesh,Cambodia,1,1,0,0.5,0.5,1460,1340
2007-08-22,Belarus,Israel,2,1,1,1.0,0.0,1668,1778
2007-08-22,Belgium,Serbia,3,2,1,1.0,0.0,1830,1816
2007-08-22,Bosnia and Herzegovina,Croatia,3,5,2,0.0,1.0,1700,1933
2007-08-22,Bulgaria,Wales,0,1,1,0.0,1.0,1842,1752
2007-08-22,DR Congo,Angola,3,1,2,1.0,0.0,1674,1732
2007-08-22,Costa Rica,Peru,1,1,0,0.5,0.5,1790,1760
2007-08-22,Denmark,Republic of Ireland,0,4,4,0.0,1.0,1943,1918
2007-08-22,Ecuador,Bolivia,1,0,1,1.0,0.0,1792,1703
2007-08-22,El Salvador,Honduras,2,0,2,1.0,0.0,1604,1774
2007-08-22,England,Germany,1,2,1,0.0,1.0,1994,2032
2007-08-22,Estonia,Andorra,2,1,1,1.0,0.0,1584,1407
2007-08-22,Finland,Kazakhstan,2,1,1,1.0,0.0,1752,1567
2007-08-22,Greece,Spain,2,3,1,0.0,1.0,1863,2027
2007-08-22,Hungary,Italy,3,1,2,1.0,0.0,1724,1995
2007-08-22,Iceland,Canada,1,1,0,0.5,0.5,1660,1742
2007-08-22,Ivory Coast,Egypt,0,0,0,0.5,0.5,1880,1885
2007-08-22,Japan,Cameroon,2,0,2,1.0,0.0,1909,1882
2007-08-22,Latvia,Moldova,1,2,1,0.0,1.0,1574,1557
2007-08-22,Lesotho,Laos,3,1,2,1.0,0.0,1465,1387
2007-08-22,Lithuania,Turkmenistan,2,1,1,1.0,0.0,1602,1579
2007-08-22,Luxembourg,Georgia,0,0,0,0.5,0.5,1337,1614
2007-08-22,North Macedonia,Nigeria,0,0,0,0.5,0.5,1659,1867
2007-08-22,Mali,Burkina Faso,3,2,1,1.0,0.0,1771,1608
2007-08-22,Mexico,Colombia,0,1,1,0.0,1.0,1956,1900
2007-08-22,Montenegro,Slovenia,1,1,0,0.5,0.5,1520,1703
2007-08-22,Northern Ireland,Liechtenstein,3,1,2,1.0,0.0,1710,1415
2007-08-22,Norway,Argentina,2,1,1,1.0,0.0,1861,2024
2007-08-22,Panama,Guatemala,2,1,1,1.0,0.0,1697,1696
2007-08-22,Paraguay,Venezuela,1,1,0,0.5,0.5,1854,1739
2007-08-22,Romania,Turkey,2,0,2,1.0,0.0,1920,1854
2007-08-22,Russia,Poland,2,2,0,0.5,0.5,1851,1870
2007-08-22,San Marino,Cyprus,0,1,1,0.0,1.0,1371,1644
2007-08-22,Scotland,South Africa,1,0,1,1.0,0.0,1814,1747
2007-08-22,Slovakia,France,0,1,1,0.0,1.0,1796,2075
2007-08-22,Sudan,Libya,1,0,1,1.0,0.0,1630,1635
2007-08-22,Sweden,United States,1,0,1,1.0,0.0,1892,1942
2007-08-22,Switzerland,Netherlands,2,1,1,1.0,0.0,1873,2024
2007-08-22,Tajikistan,Azerbaijan,2,3,1,0.0,1.0,1551,1548
2007-08-22,Togo,Zambia,3,1,2,1.0,0.0,1685,1734
2007-08-22,Tunisia,Guinea,1,1,0,0.5,0.5,1850,1720
2007-08-22,Ukraine,Uzbekistan,2,1,1,1.0,0.0,1821,1719
2007-08-23,India,Syria,2,3,1,0.0,1.0,1542,1690
2007-08-23,Singapore,Bangladesh,4,2,2,1.0,0.0,1636,1456
2007-08-24,Bangladesh,Kyrgyzstan,0,3,3,0.0,1.0,1448,1459
2007-08-25,Zimbabwe,Bangladesh,2,1,1,1.0,0.0,1695,1445
2007-08-25,Myanmar,Laos,1,0,1,1.0,0.0,1557,1383
2007-08-25,Cambodia,Syria,1,5,4,0.0,1.0,1339,1692
2007-08-25,Fiji,Tuvalu,16,0,16,1.0,0.0,1707,1474
2007-08-25,Samoa,Vanuatu,0,4,4,0.0,1.0,1464,1546
2007-08-25,Solomon Islands,American Samoa,12,1,11,1.0,0.0,1661,1367
2007-08-25,Tahiti,New Caledonia,0,1,1,0.0,1.0,1681,1605
2007-08-26,India,Kyrgyzstan,3,0,3,1.0,0.0,1549,1453
2007-08-27,Zimbabwe,Myanmar,1,3,2,0.0,1.0,1684,1569
2007-08-27,Fiji,Cook Islands,4,0,4,1.0,0.0,1710,1436
2007-08-27,Samoa,American Samoa,7,0,7,1.0,0.0,1470,1362
2007-08-27,Solomon Islands,Tonga,4,0,4,1.0,0.0,1666,1468
2007-08-27,Tuvalu,New Caledonia,0,1,1,0.0,1.0,1469,1611
2007-08-29,American Samoa,Vanuatu,0,15,15,0.0,1.0,1358,1551
2007-08-29,India,Syria,1,0,1,1.0,0.0,1561,1681
2007-08-29,New Caledonia,Cook Islands,3,0,3,1.0,0.0,1616,1432
2007-08-29,Samoa,Tonga,2,1,1,1.0,0.0,1478,1461
2007-08-29,Tuvalu,Tahiti,1,1,0,0.5,0.5,1474,1677
2007-09-01,Cook Islands,Tuvalu,4,1,3,1.0,0.0,1441,1466
2007-09-01,Tahiti,Fiji,0,4,4,0.0,1.0,1670,1718
2007-09-01,Tanzania,Uganda,1,0,1,1.0,0.0,1598,1636
2007-09-01,Tonga,American Samoa,4,0,4,1.0,0.0,1467,1353
2007-09-01,Vanuatu,Solomon Islands,0,2,2,0.0,1.0,1546,1672
2007-09-03,Cook Islands,Tahiti,0,1,1,0.0,1.0,1438,1674
2007-09-03,New Caledonia,Fiji,1,1,0,0.5,0.5,1619,1716
2007-09-03,Samoa,Solomon Islands,0,3,3,0.0,1.0,1475,1676
2007-09-03,Tonga,Vanuatu,1,4,3,0.0,1.0,1461,1553
2007-09-05,Fiji,Vanuatu,3,0,3,1.0,0.0,1721,1549
2007-09-05,Solomon Islands,New Caledonia,2,3,1,0.0,1.0,1667,1629
2007-09-07,Austria,Japan,0,0,0,0.5,0.5,1759,1906
2007-09-07,Bahrain,Jordan,1,3,2,0.0,1.0,1693,1731
2007-09-07,New Caledonia,Fiji,1,0,1,1.0,0.0,1640,1711
2007-09-07,Solomon Islands,Vanuatu,0,2,2,0.0,1.0,1657,1560
2007-09-07,Switzerland,Chile,2,1,1,1.0,0.0,1881,1836
2007-09-08,Belarus,Romania,1,3,2,0.0,1.0,1665,1924
2007-09-08,DR Congo,Libya,1,1,0,0.5,0.5,1674,1636
2007-09-08,Croatia,Estonia,2,0,2,1.0,0.0,1935,1583
2007-09-08,Cyprus,Armenia,3,1,2,1.0,0.0,1651,1569
2007-09-08,Ecuador,El Salvador,5,1,4,1.0,0.0,1797,1600
2007-09-08,England,Israel,3,0,3,1.0,0.0,1998,1775
2007-09-08,Ethiopia,Namibia,2,3,1,0.0,1.0,1635,1531
2007-09-08,Gabon,Ivory Coast,0,0,0,0.5,0.5,1685,1876
2007-09-08,Georgia,Ukraine,1,1,0,0.5,0.5,1619,1817
2007-09-08,Hungary,Bosnia and Herzegovina,1,0,1,1.0,0.0,1732,1693
2007-09-08,Iceland,Spain,1,1,0,0.5,0.5,1667,2021
2007-09-08,Italy,France,0,0,0,0.5,0.5,1997,2074
2007-09-08,Kazakhstan,Tajikistan,1,1,0,0.5,0.5,1567,1552
2007-09-08,Kenya,Angola,2,1,1,1.0,0.0,1625,1722
2007-09-08,Latvia,Northern Ireland,1,0,1,1.0,0.0,1585,1700
2007-09-08,Luxembourg,Slovenia,0,3,3,0.0,1.0,1336,1705
2007-09-08,Malta,Turkey,2,2,0,0.5,0.5,1467,1848
2007-09-08,Moldova,Norway,0,1,1,0.0,1.0,1555,1864
2007-09-08,Morocco,Ghana,0,2,2,0.0,1.0,1843,1807
2007-09-08,Netherlands,Bulgaria,2,0,2,1.0,0.0,2029,1838
2007-09-08,Nigeria,Lesotho,2,0,2,1.0,0.0,1869,1464
2007-09-08,Peru,Colombia,2,2,0,0.5,0.5,1764,1897
2007-09-08,Portugal,Poland,2,2,0,0.5,0.5,1973,1873
2007-09-08,Russia,North Macedonia,3,0,3,1.0,0.0,1855,1656
2007-09-08,Rwanda,Liberia,4,0,4,1.0,0.0,1594,1554
2007-09-08,San Marino,Czech Republic,0,3,3,0.0,1.0,1371,1949
2007-09-08,Scotland,Lithuania,3,1,2,1.0,0.0,1818,1599
2007-09-08,Senegal,Burkina Faso,5,1,4,1.0,0.0,1821,1605
2007-09-08,Serbia,Finland,0,0,0,0.5,0.5,1815,1754
2007-09-08,Slovakia,Republic of Ireland,2,2,0,0.5,0.5,1799,1916
2007-09-08,Sweden,Denmark,0,0,0,0.5,0.5,1894,1942
2007-09-08,Tanzania,Mozambique,0,1,1,0.0,1.0,1591,1613
2007-09-08,Uganda,Niger,3,1,2,1.0,0.0,1642,1535
2007-09-08,Venezuela,Paraguay,3,2,1,1.0,0.0,1750,1844
2007-09-08,Wales,Germany,0,2,2,0.0,1.0,1750,2035
2007-09-09,Burundi,Egypt,0,0,0,0.5,0.5,1544,1879
2007-09-09,Chad,Congo,1,1,0,0.5,0.5,1516,1628
2007-09-09,Costa Rica,Honduras,0,0,0,0.5,0.5,1790,1775
2007-09-09,Equatorial Guinea,Cameroon,1,0,1,1.0,0.0,1485,1868
2007-09-09,Gambia,Algeria,2,1,1,1.0,0.0,1543,1681
2007-09-09,Guinea,Cape Verde,4,0,4,1.0,0.0,1725,1545
2007-09-09,Mauritius,Seychelles,1,1,0,0.5,0.5,1509,1464
2007-09-09,Mexico,Panama,1,0,1,1.0,0.0,1959,1695
2007-09-09,South Africa,Zambia,1,3,2,0.0,1.0,1739,1743
2007-09-09,Sudan,Tunisia,3,2,1,1.0,0.0,1643,1838
2007-09-09,Eswatini,Eritrea,0,0,0,0.5,0.5,1492,1493
2007-09-09,United States,Brazil,2,4,2,0.0,1.0,1937,2066
2007-09-09,Zimbabwe,Malawi,3,1,2,1.0,0.0,1690,1575
2007-09-11,Australia,Argentina,0,1,1,0.0,1.0,1896,2030
2007-09-11,Austria,Chile,0,2,2,0.0,1.0,1753,1843
2007-09-11,Saudi Arabia,Ghana,5,0,5,1.0,0.0,1860,1801
2007-09-11,Switzerland,Japan,3,4,1,0.0,1.0,1874,1914
2007-09-12,Albania,Netherlands,0,1,1,0.0,1.0,1611,2031
2007-09-12,Andorra,Croatia,0,6,6,0.0,1.0,1407,1936
2007-09-12,Azerbaijan,Georgia,1,1,0,0.5,0.5,1550,1618
2007-09-12,Bosnia and Herzegovina,Moldova,0,1,1,0.0,1.0,1682,1567
2007-09-12,Bulgaria,Luxembourg,3,0,3,1.0,0.0,1839,1336
2007-09-12,Canada,Costa Rica,1,1,0,0.5,0.5,1744,1789
2007-09-12,Colombia,Paraguay,1,0,1,1.0,0.0,1904,1838
2007-09-12,Cyprus,San Marino,3,0,3,1.0,0.0,1654,1369
2007-09-12,Czech Republic,Republic of Ireland,1,0,1,1.0,0.0,1957,1909
2007-09-12,Denmark,Liechtenstein,4,0,4,1.0,0.0,1943,1415
2007-09-12,England,Russia,3,0,3,1.0,0.0,2003,1851
2007-09-12,Finland,Poland,0,0,0,0.5,0.5,1757,1871
2007-09-12,France,Scotland,0,1,1,0.0,1.0,2061,1832
2007-09-12,Germany,Romania,3,1,2,1.0,0.0,2041,1919
2007-09-12,Honduras,Ecuador,2,1,1,1.0,0.0,1784,1789
2007-09-12,Iceland,Northern Ireland,2,1,1,1.0,0.0,1676,1692
2007-09-12,Kazakhstan,Belgium,2,2,0,0.5,0.5,1573,1825
2007-09-12,Lithuania,Faroe Islands,2,1,1,1.0,0.0,1604,1457
2007-09-12,North Macedonia,Estonia,1,1,0,0.5,0.5,1655,1585
2007-09-12,Malta,Armenia,0,1,1,0.0,1.0,1462,1575
2007-09-12,Mexico,Brazil,1,3,2,0.0,1.0,1954,2072
2007-09-12,Montenegro,Sweden,1,2,1,0.0,1.0,1519,1896
2007-09-12,Norway,Greece,2,2,0,0.5,0.5,1864,1864
2007-09-12,Peru,Bolivia,2,0,2,1.0,0.0,1771,1697
2007-09-12,Portugal,Serbia,1,1,0,0.5,0.5,1970,1819
2007-09-12,Singapore,United Arab Emirates,1,1,0,0.5,0.5,1639,1750
2007-09-12,Slovakia,Wales,2,5,3,0.0,1.0,1790,1760
2007-09-12,Slovenia,Belarus,1,0,1,1.0,0.0,1713,1658
2007-09-12,South Africa,Uruguay,0,0,0,0.5,0.5,1743,1877
2007-09-12,Spain,Latvia,2,0,2,1.0,0.0,2023,1584
2007-09-12,Turkey,Hungary,3,0,3,1.0,0.0,1854,1727
2007-09-12,Ukraine,Italy,1,2,1,0.0,1.0,1813,2002
2007-09-12,Venezuela,Panama,1,1,0,0.5,0.5,1749,1697
2007-09-17,Qatar,Oman,1,1,0,0.5,0.5,1745,1786
2007-09-23,United Arab Emirates,Lebanon,1,1,0,0.5,0.5,1748,1622
2007-09-29,Mozambique,Zambia,0,3,3,0.0,1.0,1608,1749
2007-09-29,South Africa,Botswana,1,0,1,1.0,0.0,1748,1600
2007-10-02,Oman,Maldives,1,0,1,1.0,0.0,1788,1417
2007-10-03,Thailand,United Arab Emirates,1,1,0,0.5,0.5,1728,1748
2007-10-04,Bahrain,Singapore,3,1,2,1.0,0.0,1700,1633
2007-10-08,Bangladesh,Tajikistan,1,1,0,0.5,0.5,1448,1550
2007-10-08,Lebanon,India,4,1,3,1.0,0.0,1629,1555
2007-10-08,Oman,Nepal,2,0,2,1.0,0.0,1790,1361
2007-10-08,Palestine,Singapore,0,4,4,0.0,1.0,1508,1639
2007-10-08,Syria,Afghanistan,3,0,3,1.0,0.0,1684,1377
2007-10-08,Thailand,Macau,6,1,5,1.0,0.0,1730,1353
2007-10-08,Vietnam,United Arab Emirates,0,1,1,0.0,1.0,1625,1754
2007-10-08,Yemen,Maldives,3,0,3,1.0,0.0,1531,1412
2007-10-11,Cambodia,Turkmenistan,0,1,1,0.0,1.0,1336,1583
2007-10-12,Sierra Leone,Benin,0,2,2,0.0,1.0,1584,1548
2007-10-12,Togo,Mali,0,2,2,0.0,1.0,1679,1778
2007-10-13,Argentina,Chile,2,0,2,1.0,0.0,2035,1839
2007-10-13,Armenia,Serbia,0,0,0,0.5,0.5,1580,1815
2007-10-13,Azerbaijan,Portugal,0,2,2,0.0,1.0,1549,1972
2007-10-13,Belarus,Luxembourg,0,1,1,0.0,1.0,1645,1350
2007-10-13,Belgium,Finland,0,0,0,0.5,0.5,1824,1759
2007-10-13,Croatia,Israel,1,0,1,1.0,0.0,1941,1771
2007-10-13,Cyprus,Wales,3,1,2,1.0,0.0,1665,1750
2007-10-13,Denmark,Spain,1,3,2,0.0,1.0,1937,2030
2007-10-13,Ecuador,Venezuela,0,1,1,0.0,1.0,1781,1758
2007-10-13,Egypt,Botswana,1,0,1,1.0,0.0,1882,1598
2007-10-13,El Salvador,Costa Rica,2,2,0,0.5,0.5,1604,1786
2007-10-13,England,Estonia,3,0,3,1.0,0.0,2005,1584
2007-10-13,Faroe Islands,France,0,6,6,0.0,1.0,1457,2062
2007-10-13,Greece,Bosnia and Herzegovina,3,2,1,1.0,0.0,1869,1678
2007-10-13,Hungary,Malta,2,0,2,1.0,0.0,1730,1460
2007-10-13,Iceland,Latvia,2,4,2,0.0,1.0,1666,1595
2007-10-13,Republic of Ireland,Germany,0,0,0,0.5,0.5,1912,2039
2007-10-13,Italy,Georgia,2,0,2,1.0,0.0,2004,1617
2007-10-13,Liechtenstein,Sweden,0,3,3,0.0,1.0,1415,1897
2007-10-13,Mauritania,Burundi,2,1,1,1.0,0.0,1444,1534
2007-10-13,Moldova,Turkey,1,1,0,0.5,0.5,1573,1849
2007-10-13,Peru,Paraguay,0,0,0,0.5,0.5,1773,1837
2007-10-13,Poland,Kazakhstan,3,1,2,1.0,0.0,1874,1571
2007-10-13,Romania,Netherlands,1,0,1,1.0,0.0,1930,2021
2007-10-13,Scotland,Ukraine,3,1,2,1.0,0.0,1840,1806
2007-10-13,Slovakia,San Marino,7,0,7,1.0,0.0,1792,1368
2007-10-13,Slovenia,Albania,0,0,0,0.5,0.5,1711,1614
2007-10-13,Switzerland,Austria,3,1,2,1.0,0.0,1880,1748
2007-10-13,Uruguay,Bolivia,5,0,5,1.0,0.0,1882,1693
2007-10-13,Uzbekistan,Taiwan,9,0,9,1.0,0.0,1722,1414
2007-10-14,Colombia,Brazil,0,0,0,0.5,0.5,1908,2069
2007-10-14,Honduras,Panama,1,0,1,1.0,0.0,1791,1691
2007-10-14,Madagascar,Comoros,6,2,4,1.0,0.0,1576,1418
2007-10-14,Mexico,Nigeria,2,2,0,0.5,0.5,1953,1871
2007-10-14,Senegal,Guinea,3,1,2,1.0,0.0,1827,1720
2007-10-15,Macau,Thailand,1,7,6,0.0,1.0,1352,1732
2007-10-16,Bahrain,Libya,2,0,2,1.0,0.0,1707,1630
2007-10-16,Croatia,Slovakia,3,0,3,1.0,0.0,1946,1788
2007-10-16,Qatar,Iraq,3,2,1,1.0,0.0,1754,1776
2007-10-16,Venezuela,Argentina,0,2,2,0.0,1.0,1756,2038
2007-10-17,Albania,Bulgaria,1,1,0,0.5,0.5,1619,1835
2007-10-17,Austria,Ivory Coast,3,2,1,1.0,0.0,1759,1866
2007-10-17,Azerbaijan,Serbia,1,6,5,0.0,1.0,1547,1818
2007-10-17,Belgium,Armenia,3,0,3,1.0,0.0,1828,1577
2007-10-17,Bolivia,Colombia,0,0,0,0.5,0.5,1698,1904
2007-10-17,Bosnia and Herzegovina,Norway,0,2,2,0.0,1.0,1674,1869
2007-10-17,Brazil,Ecuador,5,0,5,1.0,0.0,2072,1779
2007-10-17,Chile,Peru,2,0,2,1.0,0.0,1846,1767
2007-10-17,Costa Rica,Haiti,1,1,0,0.5,0.5,1785,1708
2007-10-17,Denmark,Latvia,3,1,2,1.0,0.0,1939,1594
2007-10-17,El Salvador,Trinidad and Tobago,0,0,0,0.5,0.5,1607,1706
2007-10-17,Estonia,Montenegro,0,1,1,0.0,1.0,1575,1529
2007-10-17,Fiji,New Zealand,0,2,2,0.0,1.0,1703,1694
2007-10-17,Finland,Spain,0,0,0,0.5,0.5,1765,2025
2007-10-17,France,Lithuania,2,0,2,1.0,0.0,2064,1603
2007-10-17,Georgia,Scotland,2,0,2,1.0,0.0,1630,1828
2007-10-17,Germany,Czech Republic,0,3,3,0.0,1.0,2030,1967
2007-10-17,Republic of Ireland,Cyprus,1,1,0,0.5,0.5,1908,1670
2007-10-17,Israel,Belarus,2,1,1,1.0,0.0,1777,1640
2007-10-17,Italy,South Africa,2,0,2,1.0,0.0,2007,1746
2007-10-17,Japan,Egypt,4,1,3,1.0,0.0,1922,1875
2007-10-17,Kazakhstan,Portugal,1,2,1,0.0,1.0,1570,1974
2007-10-17,Liechtenstein,Iceland,3,0,3,1.0,0.0,1428,1654
2007-10-17,Luxembourg,Romania,0,2,2,0.0,1.0,1350,1931
2007-10-17,North Macedonia,Andorra,3,0,3,1.0,0.0,1659,1404
2007-10-17,Malta,Moldova,2,3,1,0.0,1.0,1455,1579
2007-10-17,Mexico,Guatemala,2,3,1,0.0,1.0,1940,1710
2007-10-17,Morocco,Namibia,2,0,2,1.0,0.0,1846,1529
2007-10-17,Netherlands,Slovenia,2,0,2,1.0,0.0,2024,1709
2007-10-17,Paraguay,Uruguay,1,0,1,1.0,0.0,1847,1873
2007-10-17,Poland,Hungary,0,1,1,0.0,1.0,1863,1742
2007-10-17,Russia,England,2,1,1,1.0,0.0,1863,1994
2007-10-17,San Marino,Wales,1,2,1,0.0,1.0,1367,1752
2007-10-17,Sierra Leone,Guinea-Bissau,1,0,1,1.0,0.0,1591,1499
2007-10-17,Sweden,Northern Ireland,1,1,0,0.5,0.5,1893,1697
2007-10-17,Switzerland,United States,0,1,1,0.0,1.0,1874,1944
2007-10-17,Turkey,Greece,0,1,1,0.0,1.0,1842,1877
2007-10-17,Ukraine,Faroe Islands,5,0,5,1.0,0.0,1808,1456
2007-10-17,United Arab Emirates,Tunisia,0,1,1,0.0,1.0,1748,1845
2007-10-18,Kyrgyzstan,Jordan,2,0,2,1.0,0.0,1467,1718
2007-10-21,Bahrain,Malaysia,4,1,3,1.0,0.0,1712,1547
2007-10-21,China PR,Myanmar,7,0,7,1.0,0.0,1784,1566
2007-10-21,Timor-Leste,Hong Kong,2,3,1,0.0,1.0,1418,1565
2007-10-21,Mongolia,North Korea,1,4,3,0.0,1.0,1418,1708
2007-10-21,Sri Lanka,Qatar,0,1,1,0.0,1.0,1413,1756
2007-10-22,Pakistan,Iraq,0,7,7,0.0,1.0,1378,1778
2007-10-24,South Africa,Zambia,0,0,0,0.5,0.5,1747,1749
2007-10-26,Afghanistan,Syria,1,2,1,0.0,1.0,1375,1687
2007-10-28,Myanmar,China PR,0,4,4,0.0,1.0,1563,1788
2007-10-28,Hong Kong,Timor-Leste,8,1,7,1.0,0.0,1570,1414
2007-10-28,Iraq,Pakistan,0,0,0,0.5,0.5,1772,1385
2007-10-28,Jordan,Kyrgyzstan,2,0,2,1.0,0.0,1722,1464
2007-10-28,North Korea,Mongolia,5,1,4,1.0,0.0,1711,1416
2007-10-28,Malaysia,Bahrain,0,0,0,0.5,0.5,1551,1709
2007-10-28,Maldives,Yemen,2,0,2,1.0,0.0,1423,1521
2007-10-28,Nepal,Oman,0,2,2,0.0,1.0,1360,1792
2007-10-28,Qatar,Sri Lanka,5,0,5,1.0,0.0,1758,1412
2007-10-28,Tajikistan,Bangladesh,5,0,5,1.0,0.0,1556,1443
2007-10-28,Turkmenistan,Cambodia,4,1,3,1.0,0.0,1587,1333
2007-10-28,United Arab Emirates,Vietnam,5,0,5,1.0,0.0,1754,1620
2007-10-28,Taiwan,Uzbekistan,0,2,2,0.0,1.0,1412,1725
2007-10-30,India,Lebanon,2,2,0,0.5,0.5,1557,1628
2007-11-02,Bhutan,Tibet,3,0,3,1.0,0.0,1348,1443
2007-11-02,Saudi Arabia,Namibia,1,0,1,1.0,0.0,1863,1527
2007-11-09,Indonesia,Syria,1,4,3,0.0,1.0,1629,1694
2007-11-09,Saudi Arabia,Estonia,2,0,2,1.0,0.0,1866,1573
2007-11-09,Singapore,Tajikistan,2,0,2,1.0,0.0,1646,1550
2007-11-09,Yemen,Thailand,1,1,0,0.5,0.5,1526,1728
2007-11-10,Hong Kong,Turkmenistan,0,0,0,0.5,0.5,1571,1587
2007-11-11,Saint Martin,British Virgin Islands,0,1,1,0.0,1.0,1473,1423
2007-11-14,French Guiana,Guadeloupe,2,3,1,0.0,1.0,1469,1626
2007-11-16,Austria,England,0,1,1,0.0,1.0,1756,1998
2007-11-16,Djibouti,Somalia,1,0,1,1.0,0.0,1351,1360
2007-11-16,France,Morocco,2,2,0,0.5,0.5,2060,1851
2007-11-16,Qatar,Georgia,1,2,1,0.0,1.0,1748,1641
2007-11-17,Albania,Belarus,2,4,2,0.0,1.0,1612,1648
2007-11-17,Andorra,Estonia,0,2,2,0.0,1.0,1400,1578
2007-11-17,Angola,Ivory Coast,2,1,1,1.0,0.0,1734,1855
2007-11-17,Argentina,Bolivia,3,0,3,1.0,0.0,2040,1697
2007-11-17,Australia,Nigeria,1,0,1,1.0,0.0,1904,1864
2007-11-17,Benin,United Arab Emirates,1,0,1,1.0,0.0,1561,1742
2007-11-17,Bulgaria,Romania,1,0,1,1.0,0.0,1846,1921
2007-11-17,Colombia,Venezuela,1,0,1,1.0,0.0,1909,1752
2007-11-17,Comoros,Madagascar,0,4,4,0.0,1.0,1414,1581
2007-11-17,Czech Republic,Slovakia,3,1,2,1.0,0.0,1972,1784
2007-11-17,Fiji,New Caledonia,3,3,0,0.5,0.5,1702,1642
2007-11-17,Finland,Azerbaijan,2,1,1,1.0,0.0,1769,1544
2007-11-17,Germany,Cyprus,4,0,4,1.0,0.0,2032,1669
2007-11-17,Greece,Malta,5,0,5,1.0,0.0,1879,1454
2007-11-17,Guatemala,Honduras,0,1,1,0.0,1.0,1704,1798
2007-11-17,Guinea-Bissau,Sierra Leone,0,0,0,0.5,0.5,1502,1589
2007-11-17,Israel,Russia,2,1,1,1.0,0.0,1787,1854
2007-11-17,Latvia,Liechtenstein,4,1,3,1.0,0.0,1599,1424
2007-11-17,Lithuania,Ukraine,2,0,2,1.0,0.0,1616,1796
2007-11-17,North Macedonia,Croatia,2,0,2,1.0,0.0,1673,1933
2007-11-17,Moldova,Hungary,3,0,3,1.0,0.0,1591,1731
2007-11-17,Netherlands,Luxembourg,1,0,1,1.0,0.0,2025,1350
2007-11-17,Northern Ireland,Denmark,2,1,1,1.0,0.0,1710,1927
2007-11-17,Norway,Turkey,1,2,1,0.0,1.0,1861,1851
2007-11-17,Paraguay,Ecuador,5,1,4,1.0,0.0,1854,1773
2007-11-17,Poland,Belgium,2,0,2,1.0,0.0,1871,1821
2007-11-17,Portugal,Armenia,1,0,1,1.0,0.0,1976,1576
2007-11-17,Scotland,Italy,1,2,1,0.0,1.0,1824,2012
2007-11-17,Senegal,Mali,3,2,1,1.0,0.0,1834,1772
2007-11-17,South Africa,United States,0,1,1,0.0,1.0,1744,1948
2007-11-17,Spain,Sweden,3,0,3,1.0,0.0,2031,1888
2007-11-17,Tunisia,Namibia,2,0,2,1.0,0.0,1848,1525
2007-11-17,Vanuatu,New Zealand,1,2,1,0.0,1.0,1555,1700
2007-11-17,Wales,Republic of Ireland,2,2,0,0.5,0.5,1756,1905
2007-11-18,Ghana,Togo,2,0,2,1.0,0.0,1807,1674
2007-11-18,Jamaica,El Salvador,3,0,3,1.0,0.0,1754,1603
2007-11-18,Peru,Brazil,1,1,0,0.5,0.5,1773,2067
2007-11-18,Saint Kitts and Nevis,Antigua and Barbuda,3,0,3,1.0,0.0,1593,1460
2007-11-18,Eswatini,Malawi,0,3,3,0.0,1.0,1486,1582
2007-11-18,Syria,Indonesia,7,0,7,1.0,0.0,1701,1623
2007-11-18,Tajikistan,Singapore,1,1,0,0.5,0.5,1553,1644
2007-11-18,Thailand,Yemen,1,0,1,1.0,0.0,1732,1523
2007-11-18,Turkmenistan,Hong Kong,3,0,3,1.0,0.0,1595,1564
2007-11-18,Uruguay,Chile,2,2,0,0.5,0.5,1873,1847
2007-11-20,Algeria,Mali,3,2,1,1.0,0.0,1692,1762
2007-11-20,Angola,Guinea,0,3,3,0.0,1.0,1726,1729
2007-11-20,Colombia,Argentina,2,1,1,1.0,0.0,1920,2030
2007-11-20,South Africa,Canada,2,0,2,1.0,0.0,1752,1736
2007-11-20,Switzerland,Nigeria,0,1,1,0.0,1.0,1866,1873
2007-11-20,Venezuela,Bolivia,5,3,2,1.0,0.0,1759,1691
2007-11-21,Andorra,Russia,0,1,1,0.0,1.0,1399,1856
2007-11-21,Armenia,Kazakhstan,0,1,1,0.0,1.0,1568,1579
2007-11-21,Austria,Tunisia,0,0,0,0.5,0.5,1759,1846
2007-11-21,Azerbaijan,Belgium,0,1,1,0.0,1.0,1542,1824
2007-11-21,Belarus,Netherlands,2,1,1,1.0,0.0,1663,2011
2007-11-21,Brazil,Uruguay,2,1,1,1.0,0.0,2071,1870
2007-11-21,Chile,Paraguay,0,3,3,0.0,1.0,1840,1862
2007-11-21,Cyprus,Czech Republic,0,2,2,0.0,1.0,1667,1975
2007-11-21,Denmark,Iceland,3,0,3,1.0,0.0,1930,1652
2007-11-21,Ecuador,Peru,5,1,4,1.0,0.0,1781,1765
2007-11-21,England,Croatia,2,3,1,0.0,1.0,1989,1943
2007-11-21,Equatorial Guinea,Niger,1,1,0,0.5,0.5,1487,1534
2007-11-21,Georgia,Lithuania,0,2,2,0.0,1.0,1633,1625
2007-11-21,Germany,Wales,0,0,0,0.5,0.5,2027,1762
2007-11-21,Ghana,Benin,4,2,2,1.0,0.0,1811,1558
2007-11-21,Hungary,Greece,1,2,1,0.0,1.0,1727,1884
2007-11-21,Israel,North Macedonia,1,0,1,1.0,0.0,1793,1668
2007-11-21,Italy,Faroe Islands,3,1,2,1.0,0.0,2013,1456
2007-11-21,Jamaica,Guatemala,2,0,2,1.0,0.0,1761,1698
2007-11-21,Malta,Norway,1,4,3,0.0,1.0,1453,1863
2007-11-21,Morocco,Senegal,3,0,3,1.0,0.0,1859,1827
2007-11-21,New Caledonia,Fiji,4,0,4,1.0,0.0,1652,1693
2007-11-21,New Zealand,Vanuatu,4,1,3,1.0,0.0,1705,1551
2007-11-21,Oman,Kenya,2,2,0,0.5,0.5,1789,1629
2007-11-21,Panama,Costa Rica,1,1,0,0.5,0.5,1694,1783
2007-11-21,Portugal,Finland,0,0,0,0.5,0.5,1972,1774
2007-11-21,Qatar,Ivory Coast,1,6,5,0.0,1.0,1743,1861
2007-11-21,Romania,Albania,6,1,5,1.0,0.0,1924,1610
2007-11-21,San Marino,Slovakia,0,5,5,0.0,1.0,1366,1786
2007-11-21,Serbia,Poland,2,2,0,0.5,0.5,1820,1870
2007-11-21,Slovenia,Bulgaria,0,2,2,0.0,1.0,1705,1851
2007-11-21,Spain,Northern Ireland,1,0,1,1.0,0.0,2034,1708
2007-11-21,Sweden,Latvia,2,1,1,1.0,0.0,1891,1597
2007-11-21,Tanzania,Zambia,1,0,1,1.0,0.0,1603,1738
2007-11-21,Turkey,Bosnia and Herzegovina,1,0,1,1.0,0.0,1856,1670
2007-11-21,Ukraine,France,2,2,0,0.5,0.5,1802,2055
2007-11-21,United Arab Emirates,Togo,0,5,5,0.0,1.0,1733,1684
2007-11-21,Uzbekistan,Estonia,0,0,0,0.5,0.5,1722,1582
2007-11-22,Oman,Kenya,1,1,0,0.5,0.5,1786,1633
2007-11-24,Serbia,Kazakhstan,1,0,1,1.0,0.0,1824,1576
2007-11-30,Sudan,Eritrea,1,0,1,1.0,0.0,1648,1489
2007-12-01,Antigua and Barbuda,Saint Kitts and Nevis,2,0,2,1.0,0.0,1471,1583
2007-12-02,Guinea-Bissau,Sierra Leone,2,0,2,1.0,0.0,1512,1580
2007-12-03,Cape Verde,Gambia,0,0,0,0.5,0.5,1545,1544
2007-12-03,Sudan,Eritrea,1,0,1,1.0,0.0,1653,1485
2007-12-07,Guinea-Bissau,Cape Verde,1,1,0,0.5,0.5,1513,1545
2007-12-08,Tanzania,Kenya,2,1,1,1.0,0.0,1612,1625
2007-12-09,Rwanda,Eritrea,2,1,1,1.0,0.0,1600,1480
2007-12-09,Sudan,Zanzibar,2,2,0,0.5,0.5,1650,1467
2007-12-09,Uganda,Djibouti,7,0,7,1.0,0.0,1645,1349
2007-12-10,Somalia,Burundi,0,3,3,0.0,1.0,1356,1539
2007-12-11,Djibouti,Eritrea,2,3,1,0.0,1.0,1344,1486
2007-12-11,Oman,Jordan,0,3,3,0.0,1.0,1777,1732
2007-12-11,Rwanda,Uganda,0,2,2,0.0,1.0,1594,1652
2007-12-12,Kenya,Burundi,0,1,1,0.0,1.0,1616,1549
2007-12-12,Tanzania,Somalia,1,0,1,1.0,0.0,1615,1354
2007-12-13,Djibouti,Rwanda,0,9,9,0.0,1.0,1341,1598
2007-12-13,Zanzibar,Ethiopia,3,1,2,1.0,0.0,1479,1624
2007-12-14,Bermuda,Saint Kitts and Nevis,1,2,1,0.0,1.0,1495,1590
2007-12-14,Eritrea,Uganda,3,2,1,1.0,0.0,1498,1641
2007-12-14,Kenya,Somalia,2,0,2,1.0,0.0,1619,1352
2007-12-15,Ethiopia,Sudan,0,0,0,0.5,0.5,1625,1650
2007-12-15,Tanzania,Burundi,0,0,0,0.5,0.5,1614,1551
2007-12-16,Bermuda,Saint Kitts and Nevis,4,2,2,1.0,0.0,1506,1580
2007-12-16,Oman,Tajikistan,4,2,2,1.0,0.0,1781,1550
2007-12-17,Burundi,Eritrea,2,1,1,1.0,0.0,1558,1492
2007-12-17,Tanzania,Sudan,1,2,1,0.0,1.0,1607,1658
2007-12-18,Uganda,Kenya,1,1,0,0.5,0.5,1641,1620
2007-12-18,Zanzibar,Rwanda,0,0,0,0.5,0.5,1482,1596
2007-12-19,Burundi,Sudan,1,2,1,0.0,1.0,1553,1664
2007-12-20,Uganda,Rwanda,0,1,1,0.0,1.0,1632,1606
2007-12-22,Burundi,Uganda,0,2,2,0.0,1.0,1547,1639
2007-12-22,Sudan,Rwanda,2,2,0,0.5,0.5,1663,1608
2007-12-22,Thailand,Uzbekistan,3,2,1,1.0,0.0,1740,1715
2007-12-23,Gambia,Sierra Leone,2,1,1,1.0,0.0,1553,1572
2007-12-24,North Korea,Uzbekistan,2,2,0,0.5,0.5,1712,1715
2007-12-26,Thailand,North Korea,1,0,1,1.0,0.0,1748,1705
2007-12-27,Galicia,Cameroon,1,1,0,0.5,0.5,1528,1862
2007-12-27,Andalusia,Zambia,4,1,3,1.0,0.0,1591,1727
2007-12-29,Basque Country,Catalonia,1,1,0,0.5,0.5,1722,1610
2007-12-29,Canary Islands,Angola,2,0,2,1.0,0.0,1524,1714
2008-01-02,Kuwait,Lebanon,3,2,1,1.0,0.0,1744,1623
2008-01-05,Egypt,Namibia,3,0,3,1.0,0.0,1877,1524
2008-01-06,Tunisia,Zambia,1,2,1,0.0,1.0,1836,1738
2008-01-08,Tunisia,Zambia,1,0,1,1.0,0.0,1842,1733
2008-01-09,Nigeria,Sudan,2,0,2,1.0,0.0,1877,1660
2008-01-10,Egypt,Mali,1,0,1,1.0,0.0,1883,1757
2008-01-10,Qatar,Iran,0,0,0,0.5,0.5,1747,1917
2008-01-10,United Arab Emirates,China PR,0,0,0,0.5,0.5,1735,1787
2008-01-11,Guinea,Sudan,6,0,6,1.0,0.0,1736,1654
2008-01-12,Kuwait,Ivory Coast,0,2,2,0.0,1.0,1739,1867
2008-01-12,Morocco,Zambia,2,0,2,1.0,0.0,1865,1728
2008-01-12,Senegal,Namibia,3,1,2,1.0,0.0,1830,1522
2008-01-13,Angola,Egypt,3,3,0,0.5,0.5,1718,1880
2008-01-13,Barbados,Antigua and Barbuda,3,2,1,1.0,0.0,1608,1466
2008-01-13,Costa Rica,Sweden,0,1,1,0.0,1.0,1778,1897
2008-01-13,South Africa,Mozambique,2,0,2,1.0,0.0,1757,1604
2008-01-13,Syria,Qatar,0,0,0,0.5,0.5,1703,1746
2008-01-16,Bahrain,Kuwait,1,0,1,1.0,0.0,1718,1731
2008-01-16,Benin,Senegal,1,2,1,0.0,1.0,1556,1833
2008-01-16,Bermuda,Puerto Rico,0,2,2,0.0,1.0,1495,1361
2008-01-16,Morocco,Angola,2,1,1,1.0,0.0,1870,1714
2008-01-16,South Africa,Botswana,2,1,1,1.0,0.0,1762,1594
2008-01-18,Bermuda,Puerto Rico,0,1,1,0.0,1.0,1485,1372
2008-01-18,Dominica,Guadeloupe,0,3,3,0.0,1.0,1413,1630
2008-01-19,United States,Sweden,2,0,2,1.0,0.0,1955,1891
2008-01-20,China PR,Lebanon,0,0,0,0.5,0.5,1784,1627
2008-01-20,Ghana,Guinea,2,1,1,1.0,0.0,1818,1730
2008-01-20,Guyana,Grenada,1,2,1,0.0,1.0,1574,1550
2008-01-21,Mali,Benin,1,0,1,1.0,0.0,1761,1553
2008-01-21,Namibia,Morocco,1,5,4,0.0,1.0,1521,1872
2008-01-21,Nigeria,Ivory Coast,0,1,1,0.0,1.0,1869,1876
2008-01-22,Belize,El Salvador,0,1,1,0.0,1.0,1451,1608
2008-01-22,Egypt,Cameroon,4,2,2,1.0,0.0,1888,1855
2008-01-22,Sudan,Zambia,0,3,3,0.0,1.0,1648,1735
2008-01-23,Bahrain,Syria,1,2,1,0.0,1.0,1710,1712
2008-01-23,South Africa,Angola,1,1,0,0.5,0.5,1761,1716
2008-01-23,Tunisia,Senegal,2,2,0,0.5,0.5,1842,1834
2008-01-24,Ghana,Namibia,1,0,1,1.0,0.0,1821,1519
2008-01-24,Guinea,Morocco,3,2,1,1.0,0.0,1742,1861
2008-01-24,Iraq,Jordan,1,1,0,0.5,0.5,1772,1733
2008-01-24,Kuwait,Singapore,0,2,2,0.0,1.0,1722,1654
2008-01-25,Ivory Coast,Benin,4,1,3,1.0,0.0,1879,1551
2008-01-25,Nigeria,Mali,0,0,0,0.5,0.5,1867,1764
2008-01-26,Bahrain,Yemen,2,1,1,1.0,0.0,1715,1519
2008-01-26,Cameroon,Zambia,5,1,4,1.0,0.0,1861,1730
2008-01-26,Egypt,Sudan,3,0,3,1.0,0.0,1892,1645
2008-01-26,Haiti,El Salvador,0,0,0,0.5,0.5,1706,1611
2008-01-26,Japan,Chile,0,0,0,0.5,0.5,1921,1842
2008-01-26,Puerto Rico,Trinidad and Tobago,2,2,0,0.5,0.5,1378,1701
2008-01-27,China PR,Syria,2,1,1,1.0,0.0,1791,1706
2008-01-27,Oman,Singapore,2,0,2,1.0,0.0,1787,1649
2008-01-27,Senegal,Angola,1,3,2,0.0,1.0,1824,1727
2008-01-27,Tunisia,South Africa,3,1,2,1.0,0.0,1849,1755
2008-01-28,Ghana,Morocco,2,0,2,1.0,0.0,1830,1853
2008-01-28,Guinea,Namibia,1,1,0,0.5,0.5,1738,1524
2008-01-28,Jordan,Lebanon,4,1,3,1.0,0.0,1739,1622
2008-01-29,Haiti,El Salvador,0,0,0,0.5,0.5,1704,1614
2008-01-29,Ivory Coast,Mali,3,0,3,1.0,0.0,1885,1759
2008-01-29,Nigeria,Benin,2,0,2,1.0,0.0,1870,1549
2008-01-29,Trinidad and Tobago,Guyana,2,1,1,1.0,0.0,1707,1569
2008-01-30,Cameroon,Sudan,3,0,3,1.0,0.0,1865,1642
2008-01-30,Egypt,Zambia,1,1,0,0.5,0.5,1889,1734
2008-01-30,Iran,Costa Rica,0,0,0,0.5,0.5,1914,1782
2008-01-30,Japan,Bosnia and Herzegovina,3,0,3,1.0,0.0,1925,1667
2008-01-30,South Korea,Chile,0,1,1,0.0,1.0,1856,1851
2008-01-30,Martinique,Canada,0,1,1,0.0,1.0,1662,1743
2008-01-30,Oman,Kuwait,1,1,0,0.5,0.5,1786,1724
2008-01-30,Saudi Arabia,Luxembourg,2,1,1,1.0,0.0,1867,1350
2008-01-31,Jordan,Singapore,2,1,1,1.0,0.0,1745,1644
2008-01-31,Senegal,South Africa,1,1,0,0.5,0.5,1823,1757
2008-01-31,Tunisia,Angola,0,0,0,0.5,0.5,1847,1730
2008-01-31,United Arab Emirates,Iraq,0,1,1,0.0,1.0,1728,1780
2008-02-02,Belarus,Iceland,2,0,2,1.0,0.0,1671,1645
2008-02-02,Malta,Armenia,0,1,1,0.0,1.0,1448,1574
2008-02-03,Azerbaijan,Kazakhstan,0,0,0,0.5,0.5,1543,1576
2008-02-03,Bermuda,Cayman Islands,1,1,0,0.5,0.5,1485,1445
2008-02-03,Ghana,Nigeria,2,1,1,1.0,0.0,1839,1862
2008-02-03,Ivory Coast,Guinea,5,0,5,1.0,0.0,1890,1734
2008-02-03,Venezuela,Haiti,1,0,1,1.0,0.0,1766,1698
2008-02-04,Armenia,Belarus,2,1,1,1.0,0.0,1585,1661
2008-02-04,Egypt,Angola,2,1,1,1.0,0.0,1894,1726
2008-02-04,Malta,Iceland,1,0,1,1.0,0.0,1461,1633
2008-02-04,Tunisia,Cameroon,2,3,1,0.0,1.0,1840,1873
2008-02-06,Armenia,Iceland,0,2,2,0.0,1.0,1579,1640
2008-02-06,Aruba,Antigua and Barbuda,0,3,3,0.0,1.0,1391,1473
2008-02-06,Australia,Qatar,3,0,3,1.0,0.0,1909,1742
2008-02-06,Austria,Germany,0,3,3,0.0,1.0,1757,2030
2008-02-06,Belize,Saint Kitts and Nevis,3,1,2,1.0,0.0,1462,1570
2008-02-06,Bolivia,Peru,2,1,1,1.0,0.0,1701,1756
2008-02-06,Burundi,Rwanda,0,0,0,0.5,0.5,1549,1607
2008-02-06,Croatia,Netherlands,0,3,3,0.0,1.0,1937,2018
2008-02-06,Cyprus,Ukraine,1,1,0,0.5,0.5,1670,1800
2008-02-06,Czech Republic,Poland,0,2,2,0.0,1.0,1965,1881
2008-02-06,Dominica,Barbados,1,1,0,0.5,0.5,1418,1604
2008-02-06,El Salvador,Anguilla,12,0,12,1.0,0.0,1617,1355
2008-02-06,England,Switzerland,2,1,1,1.0,0.0,1995,1861
2008-02-06,Georgia,Latvia,1,3,2,0.0,1.0,1625,1606
2008-02-06,Greece,Finland,2,1,1,1.0,0.0,1890,1769
2008-02-06,Honduras,Paraguay,2,0,2,1.0,0.0,1808,1853
2008-02-06,Hungary,Slovakia,1,1,0,0.5,0.5,1729,1785
2008-02-06,Iran,Syria,0,0,0,0.5,0.5,1910,1711
2008-02-06,Iraq,China PR,1,1,0,0.5,0.5,1781,1791
2008-02-06,Republic of Ireland,Brazil,0,1,1,0.0,1.0,1901,2076
2008-02-06,Israel,Romania,1,0,1,1.0,0.0,1804,1914
2008-02-06,Italy,Portugal,3,1,2,1.0,0.0,2021,1965
2008-02-06,Jamaica,Costa Rica,1,1,0,0.5,0.5,1762,1782
2008-02-06,Japan,Thailand,4,1,3,1.0,0.0,1930,1744
2008-02-06,Jordan,North Korea,0,1,1,0.0,1.0,1737,1714
2008-02-06,Kazakhstan,Moldova,0,1,1,0.0,1.0,1569,1599
2008-02-06,South Korea,Turkmenistan,4,0,4,1.0,0.0,1859,1593
2008-02-06,Lebanon,Uzbekistan,0,1,1,0.0,1.0,1617,1721
2008-02-06,North Macedonia,Serbia,1,1,0,0.5,0.5,1672,1821
2008-02-06,Malta,Belarus,0,1,1,0.0,1.0,1458,1665
2008-02-06,Nicaragua,Curaçao,0,1,1,0.0,1.0,1362,1530
2008-02-06,Northern Ireland,Bulgaria,0,1,1,0.0,1.0,1704,1856
2008-02-06,Oman,Bahrain,0,1,1,0.0,1.0,1777,1725
2008-02-06,Saudi Arabia,Singapore,2,0,2,1.0,0.0,1871,1641
2008-02-06,Slovenia,Denmark,1,2,1,0.0,1.0,1702,1934
2008-02-06,Spain,France,1,0,1,1.0,0.0,2043,2047
2008-02-06,Trinidad and Tobago,Guadeloupe,0,0,0,0.5,0.5,1706,1632
2008-02-06,Turkey,Sweden,0,0,0,0.5,0.5,1857,1891
2008-02-06,Turks and Caicos Islands,Saint Lucia,2,1,1,1.0,0.0,1471,1507
2008-02-06,United Arab Emirates,Kuwait,2,0,2,1.0,0.0,1736,1717
2008-02-06,Uruguay,Colombia,2,2,0,0.5,0.5,1872,1919
2008-02-06,United States,Mexico,2,2,0,0.5,0.5,1955,1941
2008-02-06,Venezuela,Haiti,1,1,0,0.5,0.5,1765,1700
2008-02-06,Wales,Norway,3,0,3,1.0,0.0,1773,1853
2008-02-07,Ghana,Cameroon,0,1,1,0.0,1.0,1832,1881
2008-02-07,Ivory Coast,Egypt,1,4,3,0.0,1.0,1883,1902
2008-02-09,Ghana,Ivory Coast,4,2,2,1.0,0.0,1842,1874
2008-02-09,Lesotho,Mozambique,0,1,1,0.0,1.0,1460,1609
2008-02-09,Eswatini,Botswana,1,4,3,0.0,1.0,1481,1600
2008-02-10,Botswana,Mozambique,1,0,1,1.0,0.0,1609,1601
2008-02-10,Cameroon,Egypt,0,1,1,0.0,1.0,1874,1910
2008-02-10,Eswatini,Lesotho,2,2,0,0.5,0.5,1481,1461
2008-02-17,China PR,South Korea,2,3,1,0.0,1.0,1785,1866
2008-02-17,Japan,North Korea,1,1,0,0.5,0.5,1926,1719
2008-02-20,China PR,Japan,0,1,1,0.0,1.0,1781,1931
2008-02-20,South Korea,North Korea,1,1,0,0.5,0.5,1863,1723
2008-02-23,China PR,North Korea,3,1,2,1.0,0.0,1788,1717
2008-02-23,Japan,South Korea,1,1,0,0.5,0.5,1930,1865
2008-02-24,Guyana,Cuba,0,0,0,0.5,0.5,1572,1686
2008-02-27,Dominican Republic,Haiti,1,2,1,0.0,1.0,1472,1704
2008-02-27,Poland,Estonia,2,0,2,1.0,0.0,1884,1580
2008-02-28,Dominican Republic,Haiti,0,2,2,0.0,1.0,1469,1708
2008-03-04,Qatar,Bahrain,1,2,1,0.0,1.0,1734,1734
2008-03-08,Alderney,Jersey,0,7,7,0.0,1.0,1280,1723
2008-03-09,Mauritius,Madagascar,1,2,1,0.0,1.0,1503,1588
2008-03-11,South Africa,Zimbabwe,2,1,1,1.0,0.0,1764,1684
2008-03-14,British Virgin Islands,United States Virgin Islands,0,0,0,0.5,0.5,1423,1399
2008-03-15,British Virgin Islands,United States Virgin Islands,1,1,0,0.5,0.5,1423,1400
2008-03-15,China PR,Thailand,3,3,0,0.5,0.5,1787,1746
2008-03-16,Iceland,Faroe Islands,3,0,3,1.0,0.0,1645,1452
2008-03-16,Qatar,Jordan,2,1,1,1.0,0.0,1743,1729
2008-03-19,Oman,United Arab Emirates,1,1,0,0.5,0.5,1777,1737
2008-03-19,Trinidad and Tobago,El Salvador,1,0,1,1.0,0.0,1712,1612
2008-03-21,Bahrain,Iran,1,0,1,1.0,0.0,1746,1899
2008-03-21,Kuwait,Iraq,0,0,0,0.5,0.5,1719,1780
2008-03-22,Singapore,Australia,0,0,0,0.5,0.5,1647,1904
2008-03-22,Uzbekistan,Jordan,4,1,3,1.0,0.0,1730,1721
2008-03-23,Venezuela,El Salvador,1,0,1,1.0,0.0,1770,1608
2008-03-25,Gabon,DR Congo,0,0,0,0.5,0.5,1685,1675
2008-03-25,Nepal,Pakistan,2,1,1,1.0,0.0,1369,1377
2008-03-25,Togo,Guinea,0,2,2,0.0,1.0,1678,1741
2008-03-26,Algeria,DR Congo,1,1,0,0.5,0.5,1692,1676
2008-03-26,Andorra,Latvia,0,3,3,0.0,1.0,1396,1610
2008-03-26,Anguilla,El Salvador,0,4,4,0.0,1.0,1352,1612
2008-03-26,Antigua and Barbuda,Aruba,1,0,1,1.0,0.0,1480,1385
2008-03-26,Armenia,Kazakhstan,1,0,1,1.0,0.0,1587,1562
2008-03-26,Austria,Netherlands,3,4,1,0.0,1.0,1755,2021
2008-03-26,Bahamas,British Virgin Islands,1,1,0,0.5,0.5,1464,1424
2008-03-26,Bahrain,Japan,1,0,1,1.0,0.0,1758,1919
2008-03-26,Barbados,Dominica,1,0,1,1.0,0.0,1609,1414
2008-03-26,Belarus,Turkey,2,2,0,0.5,0.5,1670,1853
2008-03-26,Belgium,Morocco,1,4,3,0.0,1.0,1817,1861
2008-03-26,Bosnia and Herzegovina,North Macedonia,2,2,0,0.5,0.5,1668,1672
2008-03-26,Botswana,Zimbabwe,0,1,1,0.0,1.0,1603,1691
2008-03-26,Brazil,Sweden,1,0,1,1.0,0.0,2081,1887
2008-03-26,Bulgaria,Finland,2,1,1,1.0,0.0,1863,1763
2008-03-26,China PR,Australia,0,0,0,0.5,0.5,1790,1902
2008-03-26,Curaçao,Nicaragua,2,0,2,1.0,0.0,1535,1358
2008-03-26,Denmark,Czech Republic,1,1,0,0.5,0.5,1935,1965
2008-03-26,Ecuador,Haiti,3,1,2,1.0,0.0,1788,1702
2008-03-26,Egypt,Argentina,0,2,2,0.0,1.0,1905,2036
2008-03-26,Estonia,Canada,2,0,2,1.0,0.0,1592,1732
2008-03-26,France,England,1,0,1,1.0,0.0,2054,1989
2008-03-26,Ghana,Mexico,1,2,1,0.0,1.0,1837,1947
2008-03-26,Grenada,United States Virgin Islands,10,0,10,1.0,0.0,1555,1396
2008-03-26,Honduras,Colombia,2,1,1,1.0,0.0,1819,1909
2008-03-26,Hungary,Slovenia,0,1,1,0.0,1.0,1721,1711
2008-03-26,Israel,Chile,1,0,1,1.0,0.0,1814,1842
2008-03-26,Ivory Coast,Tunisia,0,2,2,0.0,1.0,1866,1849
2008-03-26,Jamaica,Trinidad and Tobago,2,2,0,0.5,0.5,1761,1714
2008-03-26,North Korea,South Korea,0,0,0,0.5,0.5,1721,1862
2008-03-26,Kuwait,Iran,2,2,0,0.5,0.5,1723,1896
2008-03-26,Lithuania,Azerbaijan,1,0,1,1.0,0.0,1632,1537
2008-03-26,Luxembourg,Wales,0,2,2,0.0,1.0,1349,1775
2008-03-26,Malta,Liechtenstein,7,1,6,1.0,0.0,1466,1417
2008-03-26,Montenegro,Norway,3,1,2,1.0,0.0,1543,1840
2008-03-26,Montserrat,Suriname,1,7,6,0.0,1.0,1399,1569
2008-03-26,Namibia,Malawi,1,3,2,0.0,1.0,1518,1589
2008-03-26,Northern Ireland,Georgia,4,1,3,1.0,0.0,1711,1619
2008-03-26,Peru,Costa Rica,3,1,2,1.0,0.0,1765,1774
2008-03-26,Poland,United States,0,3,3,0.0,1.0,1878,1962
2008-03-26,Portugal,Greece,1,2,1,0.0,1.0,1956,1900
2008-03-26,Puerto Rico,Dominican Republic,1,0,1,1.0,0.0,1389,1459
2008-03-26,Qatar,Iraq,2,0,2,1.0,0.0,1752,1772
2008-03-26,Romania,Russia,3,0,3,1.0,0.0,1921,1850
2008-03-26,Scotland,Croatia,1,1,0,0.5,0.5,1827,1935
2008-03-26,Singapore,Lebanon,2,0,2,1.0,0.0,1655,1610
2008-03-26,Slovakia,Iceland,1,2,1,0.0,1.0,1774,1657
2008-03-26,South Africa,Paraguay,3,0,3,1.0,0.0,1775,1843
2008-03-26,Spain,Italy,1,0,1,1.0,0.0,2051,2014
2008-03-26,Saint Kitts and Nevis,Belize,1,1,0,0.5,0.5,1568,1465
2008-03-26,Saint Lucia,Turks and Caicos Islands,2,0,2,1.0,0.0,1515,1464
2008-03-26,Sudan,Liberia,0,2,2,0.0,1.0,1633,1564
2008-03-26,Switzerland,Germany,0,4,4,0.0,1.0,1857,2035
2008-03-26,Syria,United Arab Emirates,1,1,0,0.5,0.5,1712,1737
2008-03-26,Thailand,Oman,0,1,1,0.0,1.0,1739,1785
2008-03-26,Turkmenistan,Jordan,0,2,2,0.0,1.0,1588,1727
2008-03-26,Uganda,Libya,1,1,0,0.5,0.5,1639,1631
2008-03-26,Ukraine,Serbia,2,0,2,1.0,0.0,1809,1813
2008-03-26,Uzbekistan,Saudi Arabia,3,0,3,1.0,0.0,1742,1860
2008-03-26,Venezuela,Bolivia,0,1,1,0.0,1.0,1761,1711
2008-03-27,Nepal,Pakistan,0,2,2,0.0,1.0,1362,1385
2008-03-30,Bahamas,British Virgin Islands,2,2,0,0.5,0.5,1464,1425
2008-03-30,Cayman Islands,Bermuda,1,3,2,0.0,1.0,1438,1493
2008-04-02,Sri Lanka,Guam,5,1,4,1.0,0.0,1419,1353
2008-04-04,Pakistan,Sri Lanka,1,7,6,0.0,1.0,1378,1427
2008-04-04,Taiwan,Guam,4,1,3,1.0,0.0,1419,1347
2008-04-04,Yemen,Tanzania,2,1,1,1.0,0.0,1529,1598
2008-04-06,Pakistan,Guam,9,2,7,1.0,0.0,1386,1340
2008-04-06,Taiwan,Sri Lanka,2,2,0,0.5,0.5,1420,1427
2008-04-09,Lebanon,Maldives,4,0,4,1.0,0.0,1615,1419
2008-04-16,Mexico,China PR,1,0,1,1.0,0.0,1952,1786
2008-04-23,El Salvador,China PR,2,2,0,0.5,0.5,1616,1783
2008-04-23,Guatemala,Haiti,1,0,1,1.0,0.0,1707,1694
2008-04-23,Maldives,Lebanon,1,2,1,0.0,1.0,1416,1619
2008-04-24,Oman,Liberia,1,0,1,1.0,0.0,1789,1561
2008-04-25,Indonesia,Yemen,1,0,1,1.0,0.0,1629,1524
2008-04-27,Northern Mariana Islands,Guam,2,3,1,0.0,1.0,1459,1351
2008-04-27,Oman,Kyrgyzstan,2,0,2,1.0,0.0,1792,1462
2008-04-27,Trinidad and Tobago,Grenada,2,0,2,1.0,0.0,1719,1551
2008-04-30,Colombia,Venezuela,5,2,3,1.0,0.0,1914,1757
2008-04-30,Liberia,Sierra Leone,3,1,2,1.0,0.0,1570,1564
2008-05-03,Oman,Yemen,0,0,0,0.5,0.5,1787,1530
2008-05-05,Bangladesh,Afghanistan,0,0,0,0.5,0.5,1442,1377
2008-05-05,Jersey,Guernsey,1,1,0,0.5,0.5,1722,1675
2008-05-07,Kyrgyzstan,Afghanistan,0,1,1,0.0,1.0,1453,1387
2008-05-09,Kyrgyzstan,Bangladesh,2,1,1,1.0,0.0,1461,1435
2008-05-10,Syria,Oman,2,1,1,1.0,0.0,1722,1778
2008-05-11,Trinidad and Tobago,Barbados,3,0,3,1.0,0.0,1725,1604
2008-05-13,Philippines,Brunei,1,0,1,1.0,0.0,1293,1298
2008-05-13,Tajikistan,Bhutan,3,1,2,1.0,0.0,1554,1345
2008-05-15,Bhutan,Brunei,1,1,0,0.5,0.5,1344,1300
2008-05-15,Philippines,Tajikistan,0,0,0,0.5,0.5,1299,1549
2008-05-17,Philippines,Bhutan,3,0,3,1.0,0.0,1309,1335
2008-05-17,Syria,Iraq,2,1,1,1.0,0.0,1732,1763
2008-05-17,Tajikistan,Brunei,4,0,4,1.0,0.0,1553,1297
2008-05-18,Antigua and Barbuda,Saint Lucia,6,1,5,1.0,0.0,1489,1507
2008-05-18,Oman,Turkmenistan,2,1,1,1.0,0.0,1783,1584
2008-05-19,Greece,Cyprus,2,0,2,1.0,0.0,1904,1667
2008-05-20,Thailand,Nepal,7,0,7,1.0,0.0,1741,1361
2008-05-20,Turkey,Slovakia,1,0,1,1.0,0.0,1860,1768
2008-05-20,Brittany,Congo,3,1,2,1.0,0.0,1531,1618
2008-05-21,Curaçao,Suriname,2,1,1,1.0,0.0,1544,1561
2008-05-21,Mozambique,Lesotho,2,3,1,0.0,1.0,1590,1473
2008-05-22,Ivory Coast,Paraguay,1,1,0,0.5,0.5,1866,1844
2008-05-22,Libya,Zambia,2,2,0,0.5,0.5,1634,1732
2008-05-22,Yemen,Sudan,1,1,0,0.5,0.5,1533,1631
2008-05-23,Australia,Ghana,1,0,1,1.0,0.0,1909,1831
2008-05-23,Honduras,Belize,2,0,2,1.0,0.0,1821,1464
2008-05-23,Qatar,Kuwait,1,1,0,0.5,0.5,1752,1724
2008-05-23,Russia,Kazakhstan,6,0,6,1.0,0.0,1853,1560
2008-05-23,Eswatini,Lesotho,1,1,0,0.5,0.5,1481,1474
2008-05-24,Burkina Faso,Cape Verde,0,1,1,0.0,1.0,1596,1555
2008-05-24,Croatia,Moldova,1,0,1,1.0,0.0,1938,1597
2008-05-24,Hungary,Greece,3,2,1,1.0,0.0,1733,1893
2008-05-24,India,Taiwan,3,0,3,1.0,0.0,1562,1416
2008-05-24,Republic of Ireland,Serbia,1,1,0,0.5,0.5,1900,1815
2008-05-24,Japan,Ivory Coast,1,0,1,1.0,0.0,1926,1860
2008-05-24,Nepal,Macau,3,2,1,1.0,0.0,1369,1345
2008-05-24,Netherlands,Ukraine,3,0,3,1.0,0.0,2025,1806
2008-05-24,Saudi Arabia,Syria,1,0,1,1.0,0.0,1866,1727
2008-05-24,Switzerland,Slovakia,2,0,2,1.0,0.0,1863,1763
2008-05-24,Catalonia,Argentina,0,1,1,0.0,1.0,1609,2038
2008-05-25,China PR,Jordan,2,0,2,1.0,0.0,1790,1721
2008-05-25,Iran,Zambia,3,2,1,1.0,0.0,1901,1728
2008-05-25,Tanzania,Malawi,1,1,0,0.5,0.5,1598,1590
2008-05-25,Thailand,Iraq,2,1,1,1.0,0.0,1750,1755
2008-05-25,Turkey,Uruguay,2,3,1,0.0,1.0,1853,1880
2008-05-26,Cambodia,Nepal,0,1,1,0.0,1.0,1326,1377
2008-05-26,North Macedonia,Poland,1,1,0,0.5,0.5,1677,1874
2008-05-26,Sweden,Slovenia,1,0,1,1.0,0.0,1892,1707
2008-05-27,Albania,Poland,0,1,1,0.0,1.0,1608,1877
2008-05-27,Austria,Nigeria,1,1,0,0.5,0.5,1758,1860
2008-05-27,Czech Republic,Lithuania,2,0,2,1.0,0.0,1968,1630
2008-05-27,Estonia,Georgia,1,1,0,0.5,0.5,1593,1619
2008-05-27,France,Ecuador,2,0,2,1.0,0.0,2057,1786
2008-05-27,Germany,Belarus,2,2,0,0.5,0.5,2029,1677
2008-05-27,India,Taiwan,2,2,0,0.5,0.5,1559,1420
2008-05-27,Japan,Paraguay,0,0,0,0.5,0.5,1925,1846
2008-05-27,Libya,Liberia,4,2,2,1.0,0.0,1641,1564
2008-05-27,Luxembourg,Cape Verde,1,1,0,0.5,0.5,1354,1551
2008-05-27,Montenegro,Kazakhstan,3,0,3,1.0,0.0,1552,1552
2008-05-27,Qatar,Lebanon,2,1,1,1.0,0.0,1758,1614
2008-05-27,Saudi Arabia,Kuwait,2,1,1,1.0,0.0,1871,1720
2008-05-28,Cambodia,Macau,3,1,2,1.0,0.0,1335,1337
2008-05-28,England,United States,2,0,2,1.0,0.0,1997,1955
2008-05-28,Iceland,Wales,0,1,1,0.0,1.0,1652,1781
2008-05-28,Moldova,Armenia,2,2,0,0.5,0.5,1597,1588
2008-05-28,Norway,Uruguay,2,2,0,0.5,0.5,1841,1880
2008-05-28,Russia,Serbia,2,1,1,1.0,0.0,1861,1808
2008-05-28,Singapore,Bahrain,0,1,1,0.0,1.0,1650,1764
2008-05-29,Finland,Turkey,0,2,2,0.0,1.0,1758,1859
2008-05-29,Republic of Ireland,Colombia,1,0,1,1.0,0.0,1909,1906
2008-05-29,Netherlands,Denmark,1,1,0,0.5,0.5,2023,1938
2008-05-30,Austria,Malta,5,1,4,1.0,0.0,1761,1464
2008-05-30,Czech Republic,Scotland,3,1,2,1.0,0.0,1973,1823
2008-05-30,Guatemala,El Salvador,0,0,0,0.5,0.5,1705,1619
2008-05-30,Italy,Belgium,3,1,2,1.0,0.0,2018,1814
2008-05-30,Latvia,Estonia,1,0,1,1.0,0.0,1618,1586
2008-05-30,Switzerland,Liechtenstein,3,0,3,1.0,0.0,1865,1416
2008-05-30,Venezuela,Honduras,1,1,0,0.5,0.5,1759,1820
2008-05-31,Botswana,Madagascar,0,0,0,0.5,0.5,1603,1589
2008-05-31,Brazil,Canada,3,2,1,1.0,0.0,2083,1731
2008-05-31,Cameroon,Cape Verde,2,0,2,1.0,0.0,1877,1549
2008-05-31,Estonia,Lithuania,0,1,1,0.0,1.0,1580,1637
2008-05-31,France,Paraguay,0,0,0,0.5,0.5,2053,1851
2008-05-31,Germany,Serbia,2,1,1,1.0,0.0,2033,1805
2008-05-31,Hungary,Croatia,1,1,0,0.5,0.5,1738,1934
2008-05-31,South Korea,Jordan,2,2,0,0.5,0.5,1859,1725
2008-05-31,Malawi,Djibouti,8,1,7,1.0,0.0,1594,1338
2008-05-31,Namibia,Kenya,2,1,1,1.0,0.0,1529,1610
2008-05-31,Portugal,Georgia,2,0,2,1.0,0.0,1959,1617
2008-05-31,Romania,Montenegro,4,0,4,1.0,0.0,1923,1551
2008-05-31,Rwanda,Mauritania,3,0,3,1.0,0.0,1612,1440
2008-05-31,Senegal,Algeria,1,0,1,1.0,0.0,1829,1687
2008-05-31,Spain,Peru,2,1,1,1.0,0.0,2054,1763
2008-05-31,Tanzania,Mauritius,1,1,0,0.5,0.5,1596,1506
2008-05-31,Togo,Zambia,1,0,1,1.0,0.0,1688,1719
2008-05-31,Uganda,Niger,1,0,1,1.0,0.0,1645,1529
2008-06-01,Angola,Benin,3,0,3,1.0,0.0,1731,1545
2008-06-01,Armenia,Greece,0,0,0,0.5,0.5,1594,1888
2008-06-01,Australia,Iraq,1,0,1,1.0,0.0,1914,1751
2008-06-01,Bosnia and Herzegovina,Azerbaijan,1,0,1,1.0,0.0,1674,1532
2008-06-01,Burundi,Seychelles,1,0,1,1.0,0.0,1556,1458
2008-06-01,Egypt,DR Congo,2,1,1,1.0,0.0,1909,1673
2008-06-01,Equatorial Guinea,Sierra Leone,2,0,2,1.0,0.0,1497,1555
2008-06-01,Ghana,Libya,3,0,3,1.0,0.0,1836,1637
2008-06-01,Guatemala,Panama,0,1,1,0.0,1.0,1697,1703
2008-06-01,Guinea,Zimbabwe,0,0,0,0.5,0.5,1740,1693
2008-06-01,Ivory Coast,Mozambique,1,0,1,1.0,0.0,1863,1588
2008-06-01,Latvia,Lithuania,2,1,1,1.0,0.0,1627,1629
2008-06-01,Liberia,Gambia,1,1,0,0.5,0.5,1564,1554
2008-06-01,Mali,Congo,4,2,2,1.0,0.0,1764,1614
2008-06-01,Netherlands,Wales,2,0,2,1.0,0.0,2027,1778
2008-06-01,Nigeria,South Africa,2,0,2,1.0,0.0,1867,1769
2008-06-01,Poland,Denmark,1,1,0,0.5,0.5,1879,1937
2008-06-01,Sweden,Ukraine,0,1,1,0.0,1.0,1883,1816
2008-06-01,Trinidad and Tobago,England,0,3,3,0.0,1.0,1723,2000
2008-06-01,Tunisia,Burkina Faso,1,2,1,0.0,1.0,1837,1609
2008-06-02,Finland,Belarus,1,1,0,0.5,0.5,1757,1679
2008-06-02,Iran,United Arab Emirates,0,0,0,0.5,0.5,1898,1741
2008-06-02,Japan,Oman,3,0,3,1.0,0.0,1930,1779
2008-06-02,Qatar,China PR,0,0,0,0.5,0.5,1759,1790
2008-06-02,Saudi Arabia,Lebanon,4,1,3,1.0,0.0,1874,1612
2008-06-02,Singapore,Uzbekistan,3,7,4,0.0,1.0,1645,1748
2008-06-02,Syria,Kuwait,1,0,1,1.0,0.0,1735,1713
2008-06-02,Thailand,Bahrain,2,3,1,0.0,1.0,1743,1772
2008-06-02,Turkmenistan,North Korea,0,0,0,0.5,0.5,1588,1718
2008-06-03,France,Colombia,1,0,1,1.0,0.0,2058,1902
2008-06-03,India,Nepal,4,0,4,1.0,0.0,1564,1373
2008-06-03,Maldives,Pakistan,3,0,3,1.0,0.0,1424,1379
2008-06-04,Andorra,Azerbaijan,1,2,1,0.0,1.0,1391,1538
2008-06-04,Bangladesh,Bhutan,1,1,0,0.5,0.5,1433,1338
2008-06-04,Chile,Guatemala,2,0,2,1.0,0.0,1847,1693
2008-06-04,Estonia,Faroe Islands,4,3,1,1.0,0.0,1586,1447
2008-06-04,Honduras,Puerto Rico,4,0,4,1.0,0.0,1822,1388
2008-06-04,Lithuania,Russia,1,4,3,0.0,1.0,1626,1865
2008-06-04,Mexico,Argentina,1,4,3,0.0,1.0,1946,2045
2008-06-04,Panama,Canada,2,2,0,0.5,0.5,1704,1731
2008-06-04,Spain,United States,1,0,1,1.0,0.0,2060,1950
2008-06-04,Sri Lanka,Afghanistan,2,2,0,0.5,0.5,1427,1388
2008-06-05,India,Pakistan,2,1,1,1.0,0.0,1569,1375
2008-06-05,Maldives,Nepal,4,1,3,1.0,0.0,1431,1367
2008-06-06,Algeria,Liberia,3,0,3,1.0,0.0,1693,1559
2008-06-06,Bangladesh,Afghanistan,2,2,0,0.5,0.5,1432,1390
2008-06-06,Bermuda,Barbados,2,1,1,1.0,0.0,1504,1594
2008-06-06,Brazil,Venezuela,0,2,2,0.0,1.0,2070,1773
2008-06-06,Indonesia,Malaysia,1,1,0,0.5,0.5,1628,1553
2008-06-06,Sri Lanka,Bhutan,2,0,2,1.0,0.0,1433,1333
2008-06-06,Djibouti,Egypt,0,4,4,0.0,1.0,1338,1910
2008-06-07,Bahrain,Thailand,1,1,0,0.5,0.5,1772,1744
2008-06-07,Burkina Faso,Burundi,2,0,2,1.0,0.0,1616,1550
2008-06-07,Cape Verde,Tanzania,1,0,1,1.0,0.0,1559,1587
2008-06-07,Chad,Mali,1,2,1,0.0,1.0,1513,1768
2008-06-07,Chile,Panama,0,0,0,0.5,0.5,1844,1708
2008-06-07,China PR,Qatar,0,1,1,0.0,1.0,1782,1768
2008-06-07,Cuba,Saint Vincent and the Grenadines,1,0,1,1.0,0.0,1692,1578
2008-06-07,Honduras,Haiti,3,1,2,1.0,0.0,1828,1689
2008-06-07,Iraq,Australia,1,0,1,1.0,0.0,1763,1903
2008-06-07,Jordan,South Korea,0,1,1,0.0,1.0,1720,1865
2008-06-07,Kenya,Guinea,2,0,2,1.0,0.0,1621,1730
2008-06-07,North Korea,Turkmenistan,1,0,1,1.0,0.0,1724,1583
2008-06-07,Libya,Gabon,1,0,1,1.0,0.0,1647,1676
2008-06-07,Maldives,India,0,1,1,0.0,1.0,1427,1574
2008-06-07,Mauritania,Morocco,1,4,3,0.0,1.0,1439,1863
2008-06-07,Oman,Japan,1,1,0,0.5,0.5,1783,1927
2008-06-07,Pakistan,Nepal,1,4,3,0.0,1.0,1367,1376
2008-06-07,Portugal,Turkey,2,0,2,1.0,0.0,1965,1854
2008-06-07,Saudi Arabia,Lebanon,2,1,1,1.0,0.0,1877,1610
2008-06-07,Seychelles,Tunisia,0,2,2,0.0,1.0,1457,1839
2008-06-07,Sierra Leone,Nigeria,0,1,1,0.0,1.0,1553,1870
2008-06-07,Switzerland,Czech Republic,0,1,1,0.0,1.0,1860,1979
2008-06-07,Trinidad and Tobago,Jamaica,1,1,0,0.5,0.5,1724,1761
2008-06-07,United Arab Emirates,Iran,0,1,1,0.0,1.0,1737,1903
2008-06-07,Uzbekistan,Singapore,3,0,3,1.0,0.0,1754,1640
2008-06-07,South Africa,Equatorial Guinea,4,1,3,1.0,0.0,1772,1495
2008-06-08,Afghanistan,Bhutan,1,3,2,0.0,1.0,1381,1343
2008-06-08,Antigua and Barbuda,Saint Kitts and Nevis,2,0,2,1.0,0.0,1499,1559
2008-06-08,Austria,Croatia,0,1,1,0.0,1.0,1757,1939
2008-06-08,Benin,Uganda,4,1,3,1.0,0.0,1556,1635
2008-06-08,Congo,Sudan,1,0,1,1.0,0.0,1623,1623
2008-06-08,DR Congo,Malawi,1,0,1,1.0,0.0,1680,1588
2008-06-08,Gambia,Senegal,0,0,0,0.5,0.5,1560,1824
2008-06-08,Germany,Poland,2,0,2,1.0,0.0,2038,1875
2008-06-08,Kuwait,Syria,4,2,2,1.0,0.0,1722,1727
2008-06-08,Lesotho,Ghana,2,3,1,0.0,1.0,1473,1838
2008-06-08,Madagascar,Ivory Coast,0,0,0,0.5,0.5,1595,1858
2008-06-08,Mauritius,Cameroon,0,3,3,0.0,1.0,1505,1879
2008-06-08,Mexico,Peru,4,0,4,1.0,0.0,1951,1759
2008-06-08,Mozambique,Botswana,1,2,1,0.0,1.0,1581,1611
2008-06-08,Niger,Angola,1,2,1,0.0,1.0,1526,1735
2008-06-08,Sri Lanka,Bangladesh,1,0,1,1.0,0.0,1441,1425
2008-06-08,Eswatini,Togo,2,1,1,1.0,0.0,1494,1676
2008-06-08,United States,Argentina,0,0,0,0.5,0.5,1953,2043
2008-06-08,Zimbabwe,Namibia,2,0,2,1.0,0.0,1698,1525
2008-06-09,Bermuda,Barbados,3,0,3,1.0,0.0,1515,1584
2008-06-09,Curaçao,Venezuela,0,1,1,0.0,1.0,1541,1777
2008-06-09,Netherlands,Italy,3,0,3,1.0,0.0,2035,2011
2008-06-09,Romania,France,0,0,0,0.5,0.5,1926,2056
2008-06-10,Greece,Sweden,0,2,2,0.0,1.0,1880,1892
2008-06-10,Grenada,Jamaica,2,1,1,1.0,0.0,1564,1749
2008-06-10,Spain,Russia,4,1,3,1.0,0.0,2064,1862
2008-06-11,Czech Republic,Portugal,1,3,2,0.0,1.0,1971,1974
2008-06-11,India,Bhutan,2,1,1,1.0,0.0,1578,1340
2008-06-11,Indonesia,Vietnam,1,0,1,1.0,0.0,1636,1613
2008-06-11,Sri Lanka,Maldives,0,1,1,0.0,1.0,1433,1436
2008-06-11,Switzerland,Turkey,1,2,1,0.0,1.0,1852,1863
2008-06-12,Austria,Poland,1,1,0,0.5,0.5,1760,1873
2008-06-12,Croatia,Germany,2,1,1,1.0,0.0,1950,2028
2008-06-13,Djibouti,DR Congo,0,6,6,0.0,1.0,1337,1682
2008-06-13,Italy,Romania,1,1,0,0.5,0.5,2010,1928
2008-06-13,Netherlands,France,4,1,3,1.0,0.0,2044,2048
2008-06-14,Bahrain,Oman,1,1,0,0.5,0.5,1773,1783
2008-06-14,Botswana,Ivory Coast,1,1,0,0.5,0.5,1616,1854
2008-06-14,Chad,Congo,2,1,1,1.0,0.0,1524,1613
2008-06-14,China PR,Iraq,1,2,1,0.0,1.0,1774,1772
2008-06-14,Gabon,Ghana,2,0,2,1.0,0.0,1688,1827
2008-06-14,Gambia,Algeria,1,0,1,1.0,0.0,1571,1683
2008-06-14,Greece,Russia,0,1,1,0.0,1.0,1872,1871
2008-06-14,Grenada,Costa Rica,2,2,0,0.5,0.5,1569,1770
2008-06-14,Guatemala,Saint Lucia,6,0,6,1.0,0.0,1698,1503
2008-06-14,India,Maldives,0,1,1,0.0,1.0,1567,1448
2008-06-14,Kenya,Zimbabwe,2,0,2,1.0,0.0,1631,1689
2008-06-14,North Korea,Jordan,2,0,2,1.0,0.0,1732,1713
2008-06-14,Kuwait,United Arab Emirates,2,3,1,0.0,1.0,1715,1745
2008-06-14,Malawi,Egypt,1,0,1,1.0,0.0,1602,1897
2008-06-14,Namibia,Guinea,1,2,1,0.0,1.0,1522,1734
2008-06-14,Niger,Benin,0,2,2,0.0,1.0,1519,1564
2008-06-14,Peru,Colombia,1,1,0,0.5,0.5,1763,1899
2008-06-14,Puerto Rico,Honduras,2,2,0,0.5,0.5,1395,1822
2008-06-14,Qatar,Australia,1,3,2,0.0,1.0,1763,1909
2008-06-14,Rwanda,Morocco,3,1,2,1.0,0.0,1625,1851
2008-06-14,Seychelles,Burkina Faso,2,3,1,0.0,1.0,1453,1621
2008-06-14,Sierra Leone,South Africa,1,0,1,1.0,0.0,1566,1760
2008-06-14,Singapore,Saudi Arabia,0,3,3,0.0,1.0,1637,1881
2008-06-14,Sudan,Mali,3,2,1,1.0,0.0,1635,1757
2008-06-14,Suriname,Guyana,1,0,1,1.0,0.0,1570,1564
2008-06-14,Sweden,Spain,1,2,1,0.0,1.0,1888,2069
2008-06-14,Syria,Iran,0,2,2,0.0,1.0,1723,1908
2008-06-14,Tanzania,Cameroon,0,0,0,0.5,0.5,1593,1874
2008-06-14,Thailand,Japan,0,3,3,0.0,1.0,1740,1932
2008-06-14,Turkmenistan,South Korea,1,3,2,0.0,1.0,1581,1868
2008-06-14,Uganda,Angola,3,1,2,1.0,0.0,1646,1725
2008-06-14,Uruguay,Venezuela,1,1,0,0.5,0.5,1878,1780
2008-06-14,Uzbekistan,Lebanon,3,0,3,1.0,0.0,1759,1606
2008-06-14,Vanuatu,New Caledonia,1,1,0,0.5,0.5,1554,1650
2008-06-15,Argentina,Ecuador,1,1,0,0.5,0.5,2038,1792
2008-06-15,Belize,Mexico,0,2,2,0.0,1.0,1464,1952
2008-06-15,Bolivia,Chile,0,2,2,0.0,1.0,1706,1850
2008-06-15,Burundi,Tunisia,0,1,1,0.0,1.0,1548,1842
2008-06-15,Equatorial Guinea,Nigeria,0,1,1,0.0,1.0,1494,1872
2008-06-15,Haiti,Curaçao,0,0,0,0.5,0.5,1686,1545
2008-06-15,Jamaica,Bahamas,7,0,7,1.0,0.0,1752,1462
2008-06-15,Lesotho,Libya,0,1,1,0.0,1.0,1469,1652
2008-06-15,Liberia,Senegal,2,2,0,0.5,0.5,1565,1819
2008-06-15,Macau,Hong Kong,0,1,1,0.0,1.0,1334,1568
2008-06-15,Madagascar,Mozambique,1,1,0,0.5,0.5,1595,1582
2008-06-15,Mauritius,Cape Verde,0,1,1,0.0,1.0,1499,1566
2008-06-15,Panama,El Salvador,1,0,1,1.0,0.0,1714,1614
2008-06-15,Paraguay,Brazil,2,0,2,1.0,0.0,1864,2058
2008-06-15,Eswatini,Zambia,0,0,0,0.5,0.5,1499,1715
2008-06-15,Switzerland,Portugal,2,0,2,1.0,0.0,1863,1964
2008-06-15,Trinidad and Tobago,Bermuda,1,2,1,0.0,1.0,1712,1528
2008-06-15,Turkey,Czech Republic,3,2,1,1.0,0.0,1874,1961
2008-06-15,United States,Barbados,8,0,8,1.0,0.0,1955,1583
2008-06-15,Saint Vincent and the Grenadines,Canada,0,3,3,0.0,1.0,1574,1736
2008-06-16,Austria,Germany,0,1,1,0.0,1.0,1758,2031
2008-06-16,Poland,Croatia,0,1,1,0.0,1.0,1867,1957
2008-06-17,Antigua and Barbuda,Cuba,3,4,1,0.0,1.0,1496,1696
2008-06-17,France,Italy,0,2,2,0.0,1.0,2040,2019
2008-06-17,Netherlands,Romania,2,0,2,1.0,0.0,2050,1923
2008-06-17,Uruguay,Peru,6,0,6,1.0,0.0,1884,1758
2008-06-18,Bolivia,Paraguay,4,2,2,1.0,0.0,1718,1853
2008-06-18,Ecuador,Colombia,0,0,0,0.5,0.5,1795,1897
2008-06-18,Greece,Spain,1,2,1,0.0,1.0,1869,2073
2008-06-18,Jamaica,Bahamas,6,0,6,1.0,0.0,1755,1460
2008-06-18,Russia,Sweden,2,0,2,1.0,0.0,1880,1880
2008-06-18,Brazil,Argentina,0,0,0,0.5,0.5,2058,2039
2008-06-19,Portugal,Germany,2,3,1,0.0,1.0,1958,2038
2008-06-19,Venezuela,Chile,2,3,1,0.0,1.0,1774,1857
2008-06-20,Algeria,Gambia,1,0,1,1.0,0.0,1689,1566
2008-06-20,Canada,Saint Vincent and the Grenadines,4,1,3,1.0,0.0,1741,1570
2008-06-20,Croatia,Turkey,1,1,0,0.5,0.5,1956,1876
2008-06-20,Libya,Lesotho,4,0,4,1.0,0.0,1657,1465
2008-06-21,Burkina Faso,Seychelles,4,1,3,1.0,0.0,1626,1449
2008-06-21,Cameroon,Tanzania,2,1,1,1.0,0.0,1877,1591
2008-06-21,Costa Rica,Grenada,3,0,3,1.0,0.0,1774,1566
2008-06-21,Mexico,Belize,7,0,7,1.0,0.0,1953,1464
2008-06-21,Morocco,Rwanda,2,0,2,1.0,0.0,1855,1622
2008-06-21,Netherlands,Russia,1,3,2,0.0,1.0,2039,1892
2008-06-21,New Caledonia,Vanuatu,3,0,3,1.0,0.0,1656,1549
2008-06-21,Nigeria,Equatorial Guinea,2,0,2,1.0,0.0,1874,1493
2008-06-21,Senegal,Liberia,3,1,2,1.0,0.0,1823,1562
2008-06-21,South Africa,Sierra Leone,0,0,0,0.5,0.5,1756,1571
2008-06-21,Saint Lucia,Guatemala,1,3,2,0.0,1.0,1500,1702
2008-06-21,Tunisia,Burundi,2,1,1,1.0,0.0,1845,1546
2008-06-21,Zambia,Eswatini,1,0,1,1.0,0.0,1719,1496
2008-06-22,Australia,China PR,0,1,1,0.0,1.0,1899,1785
2008-06-22,Barbados,United States,0,1,1,0.0,1.0,1582,1957
2008-06-22,Benin,Niger,2,0,2,1.0,0.0,1571,1513
2008-06-22,Bermuda,Trinidad and Tobago,0,2,2,0.0,1.0,1524,1717
2008-06-22,Cape Verde,Mauritius,3,1,2,1.0,0.0,1573,1493
2008-06-22,Congo,Chad,2,0,2,1.0,0.0,1619,1519
2008-06-22,DR Congo,Djibouti,5,1,4,1.0,0.0,1684,1336
2008-06-22,Cuba,Antigua and Barbuda,4,0,4,1.0,0.0,1700,1493
2008-06-22,Curaçao,Haiti,0,1,1,0.0,1.0,1541,1691
2008-06-22,Egypt,Malawi,2,0,2,1.0,0.0,1900,1600
2008-06-22,El Salvador,Panama,3,1,2,1.0,0.0,1625,1704
2008-06-22,Ghana,Gabon,2,0,2,1.0,0.0,1832,1684
2008-06-22,Guinea,Namibia,4,0,4,1.0,0.0,1738,1519
2008-06-22,Guyana,Suriname,1,2,1,0.0,1.0,1557,1578
2008-06-22,Iran,Kuwait,2,0,2,1.0,0.0,1912,1712
2008-06-22,Iraq,Qatar,0,1,1,0.0,1.0,1764,1772
2008-06-22,Ivory Coast,Botswana,4,0,4,1.0,0.0,1858,1613
2008-06-22,Japan,Bahrain,1,0,1,1.0,0.0,1937,1769
2008-06-22,Jordan,Turkmenistan,2,0,2,1.0,0.0,1719,1576
2008-06-22,South Korea,North Korea,0,0,0,0.5,0.5,1866,1735
2008-06-22,Lebanon,Singapore,1,2,1,0.0,1.0,1599,1645
2008-06-22,Mali,Sudan,3,0,3,1.0,0.0,1763,1630
2008-06-22,Mozambique,Madagascar,3,0,3,1.0,0.0,1591,1587
2008-06-22,Oman,Thailand,2,1,1,1.0,0.0,1791,1733
2008-06-22,Saudi Arabia,Uzbekistan,4,0,4,1.0,0.0,1887,1754
2008-06-22,Spain,Italy,0,0,0,0.5,0.5,2072,2021
2008-06-22,United Arab Emirates,Syria,1,3,2,0.0,1.0,1737,1732
2008-06-22,Zimbabwe,Kenya,0,0,0,0.5,0.5,1688,1633
2008-06-23,Angola,Uganda,0,0,0,0.5,0.5,1724,1648
2008-06-25,Germany,Turkey,3,2,1,1.0,0.0,2043,1872
2008-06-26,Russia,Spain,0,3,3,0.0,1.0,1888,2077
2008-06-28,Gabon,Lesotho,2,0,2,1.0,0.0,1688,1462
2008-06-29,Germany,Spain,0,1,1,0.0,1.0,2036,2085
2008-07-07,Solomon Islands,Vanuatu,1,2,1,0.0,1.0,1647,1560
2008-07-07,Sápmi,Iraqi Kurdistan,2,2,0,0.5,0.5,1534,1501
2008-07-08,Trinidad and Tobago,Guyana,2,0,2,1.0,0.0,1722,1553
2008-07-08,Provence,Padania,1,6,5,0.0,1.0,1477,1508
2008-07-09,Provence,Iraqi Kurdistan,0,3,3,0.0,1.0,1470,1509
2008-07-09,Sápmi,Arameans Suryoye,0,1,1,0.0,1.0,1526,1509
2008-07-10,Arameans Suryoye,Provence,5,0,5,1.0,0.0,1517,1463
2008-07-10,Padania,Iraqi Kurdistan,2,1,1,1.0,0.0,1517,1501
2008-07-11,Sápmi,Padania,0,2,2,0.0,1.0,1518,1526
2008-07-11,Iraqi Kurdistan,Arameans Suryoye,0,0,0,0.5,0.5,1502,1517
2008-07-12,Padania,Arameans Suryoye,4,1,3,1.0,0.0,1534,1510
2008-07-12,Sápmi,Provence,4,2,2,1.0,0.0,1525,1457
2008-07-13,Sápmi,Iraqi Kurdistan,3,1,2,1.0,0.0,1533,1495
2008-07-13,Padania,Arameans Suryoye,2,0,2,1.0,0.0,1542,1503
2008-07-17,Trinidad and Tobago,Curaçao,2,0,2,1.0,0.0,1727,1537
2008-07-19,Madagascar,Eswatini,1,1,0,0.5,0.5,1585,1499
2008-07-19,Mauritius,Seychelles,0,7,7,0.0,1.0,1484,1459
2008-07-20,Comoros,Namibia,0,3,3,0.0,1.0,1409,1525
2008-07-20,El Salvador,Guatemala,0,0,0,0.5,0.5,1627,1701
2008-07-20,Lesotho,Malawi,0,1,1,0.0,1.0,1458,1605
2008-07-21,Madagascar,Seychelles,1,1,0,0.5,0.5,1583,1462
2008-07-21,Mauritius,Eswatini,1,1,0,0.5,0.5,1485,1499
2008-07-22,Comoros,Malawi,0,1,1,0.0,1.0,1406,1609
2008-07-22,India,Malaysia,1,1,0,0.5,0.5,1567,1554
2008-07-22,Lesotho,Namibia,1,1,0,0.5,0.5,1460,1524
2008-07-23,Madagascar,Mauritius,2,1,1,1.0,0.0,1589,1480
2008-07-23,Seychelles,Eswatini,0,1,1,0.0,1.0,1455,1507
2008-07-24,Comoros,Lesotho,0,1,1,0.0,1.0,1400,1467
2008-07-24,Malawi,Namibia,0,1,1,0.0,1.0,1600,1534
2008-07-26,El Salvador,Jamaica,0,0,0,0.5,0.5,1630,1753
2008-07-26,South Africa,Namibia,1,0,1,1.0,0.0,1760,1531
2008-07-27,Botswana,Mozambique,0,2,2,0.0,1.0,1605,1600
2008-07-27,Curaçao,Aruba,0,0,0,0.5,0.5,1534,1389
2008-07-27,Zambia,Zimbabwe,0,0,0,0.5,0.5,1719,1689
2008-07-29,Grenada,Aruba,3,1,2,1.0,0.0,1571,1385
2008-07-30,India,Afghanistan,1,0,1,1.0,0.0,1572,1377
2008-07-30,Madagascar,Mozambique,1,2,1,0.0,1.0,1582,1608
2008-07-30,South Africa,Zambia,1,0,1,1.0,0.0,1768,1712
2008-07-30,Trinidad and Tobago,Haiti,2,0,2,1.0,0.0,1735,1684
2008-07-30,Turkmenistan,Tajikistan,0,0,0,0.5,0.5,1576,1554
2008-07-31,Myanmar,Nepal,3,0,3,1.0,0.0,1568,1372
2008-07-31,Curaçao,Grenada,2,0,2,1.0,0.0,1543,1563
2008-07-31,North Korea,Sri Lanka,3,0,3,1.0,0.0,1738,1431
2008-08-01,Afghanistan,Turkmenistan,0,5,5,0.0,1.0,1374,1580
2008-08-01,India,Tajikistan,1,1,0,0.5,0.5,1572,1555
2008-08-02,Nepal,North Korea,0,1,1,0.0,1.0,1371,1740
2008-08-02,Sri Lanka,Myanmar,1,3,2,0.0,1.0,1427,1573
2008-08-03,Afghanistan,Tajikistan,0,4,4,0.0,1.0,1370,1560
2008-08-03,India,Turkmenistan,2,1,1,1.0,0.0,1581,1572
2008-08-03,Madagascar,Zambia,0,2,2,0.0,1.0,1577,1718
2008-08-03,South Africa,Mozambique,2,1,1,1.0,0.0,1773,1604
2008-08-04,North Korea,Myanmar,1,0,1,1.0,0.0,1745,1569
2008-08-04,Nepal,Sri Lanka,3,0,3,1.0,0.0,1381,1418
2008-08-06,Guatemala,Bolivia,3,0,3,1.0,0.0,1710,1710
2008-08-07,India,Myanmar,1,0,1,1.0,0.0,1589,1562
2008-08-07,Iran,Palestine,3,0,3,1.0,0.0,1914,1507
2008-08-07,North Korea,Tajikistan,0,1,1,0.0,1.0,1734,1572
2008-08-07,Syria,Jordan,0,0,0,0.5,0.5,1732,1720
2008-08-08,Guyana,Dominica,3,0,3,1.0,0.0,1558,1410
2008-08-09,Dominica,Suriname,1,3,2,0.0,1.0,1406,1583
2008-08-09,Oman,Syria,1,2,1,0.0,1.0,1782,1742
2008-08-09,Palestine,Qatar,0,1,1,0.0,1.0,1505,1775
2008-08-10,Guyana,Suriname,1,1,0,0.5,0.5,1559,1583
2008-08-10,Haiti,Trinidad and Tobago,1,0,1,1.0,0.0,1694,1726
2008-08-11,Iran,Qatar,6,1,5,1.0,0.0,1919,1771
2008-08-13,Myanmar,North Korea,0,4,4,0.0,1.0,1558,1739
2008-08-13,India,Tajikistan,4,1,3,1.0,0.0,1597,1565
2008-08-13,Iran,Syria,2,0,2,1.0,0.0,1924,1738
2008-08-13,Jordan,Qatar,3,0,3,1.0,0.0,1730,1762
2008-08-14,El Salvador,Trinidad and Tobago,1,3,2,0.0,1.0,1625,1732
2008-08-15,Iran,Jordan,2,1,1,1.0,0.0,1928,1727
2008-08-19,Australia,South Africa,2,2,0,0.5,0.5,1897,1776
2008-08-19,Gabon,Mali,1,0,1,1.0,0.0,1698,1754
2008-08-20,Albania,Liechtenstein,2,0,2,1.0,0.0,1612,1413
2008-08-20,Algeria,United Arab Emirates,1,0,1,1.0,0.0,1699,1728
2008-08-20,Bahrain,Burkina Faso,3,1,2,1.0,0.0,1774,1622
2008-08-20,Belarus,Argentina,0,0,0,0.5,0.5,1686,2033
2008-08-20,Bolivia,Panama,1,0,1,1.0,0.0,1718,1697
2008-08-20,Bosnia and Herzegovina,Bulgaria,1,2,1,0.0,1.0,1670,1868
2008-08-20,Canada,Jamaica,1,1,0,0.5,0.5,1742,1753
2008-08-20,Colombia,Ecuador,0,1,1,0.0,1.0,1887,1806
2008-08-20,DR Congo,Togo,2,1,1,1.0,0.0,1692,1669
2008-08-20,Costa Rica,El Salvador,1,0,1,1.0,0.0,1779,1621
2008-08-20,Cuba,Trinidad and Tobago,1,3,2,0.0,1.0,1693,1740
2008-08-20,Denmark,Spain,0,3,3,0.0,1.0,1933,2090
2008-08-20,England,Czech Republic,2,2,0,0.5,0.5,2000,1962
2008-08-20,Estonia,Malta,2,1,1,1.0,0.0,1592,1459
2008-08-20,Finland,Israel,2,0,2,1.0,0.0,1767,1805
2008-08-20,Germany,Belgium,2,0,2,1.0,0.0,2040,1811
2008-08-20,Guatemala,United States,0,1,1,0.0,1.0,1707,1961
2008-08-20,Guinea,Ivory Coast,1,2,1,0.0,1.0,1733,1864
2008-08-20,Haiti,Suriname,2,2,0,0.5,0.5,1692,1586
2008-08-20,Hungary,Montenegro,3,3,0,0.5,0.5,1735,1555
2008-08-20,Iceland,Azerbaijan,1,1,0,0.5,0.5,1650,1541
2008-08-20,Italy,Austria,2,2,0,0.5,0.5,2016,1764
2008-08-20,Japan,Uruguay,1,3,2,0.0,1.0,1928,1894
2008-08-20,Kazakhstan,Andorra,3,0,3,1.0,0.0,1557,1387
2008-08-20,Libya,Senegal,0,0,0,0.5,0.5,1661,1820
2008-08-20,Lithuania,Moldova,3,0,3,1.0,0.0,1634,1590
2008-08-20,Luxembourg,North Macedonia,1,4,3,0.0,1.0,1352,1680
2008-08-20,Mexico,Honduras,2,1,1,1.0,0.0,1959,1817
2008-08-20,Morocco,Benin,3,1,2,1.0,0.0,1858,1569
2008-08-20,Mozambique,Eswatini,3,0,3,1.0,0.0,1610,1502
2008-08-20,Norway,Republic of Ireland,1,1,0,0.5,0.5,1843,1908
2008-08-20,Oman,Uzbekistan,2,0,2,1.0,0.0,1790,1747
2008-08-20,Portugal,Faroe Islands,5,0,5,1.0,0.0,1959,1447
2008-08-20,Qatar,Tajikistan,5,0,5,1.0,0.0,1766,1562
2008-08-20,Romania,Latvia,1,0,1,1.0,0.0,1926,1625
2008-08-20,Russia,Netherlands,1,1,0,0.5,0.5,1892,2036
2008-08-20,Saudi Arabia,Paraguay,1,1,0,0.5,0.5,1887,1854
2008-08-20,Scotland,Northern Ireland,0,0,0,0.5,0.5,1821,1714
2008-08-20,Slovakia,Greece,0,2,2,0.0,1.0,1758,1875
2008-08-20,Slovenia,Croatia,2,3,1,0.0,1.0,1704,1960
2008-08-20,Sudan,Egypt,4,0,4,1.0,0.0,1644,1887
2008-08-20,Sweden,France,2,3,1,0.0,1.0,1876,2045
2008-08-20,Switzerland,Cyprus,4,1,3,1.0,0.0,1867,1664
2008-08-20,Tanzania,Ghana,1,1,0,0.5,0.5,1596,1828
2008-08-20,Tunisia,Angola,1,1,0,0.5,0.5,1843,1727
2008-08-20,Turkey,Chile,1,0,1,1.0,0.0,1880,1850
2008-08-20,Ukraine,Poland,1,0,1,1.0,0.0,1826,1858
2008-08-20,Venezuela,Syria,4,1,3,1.0,0.0,1782,1731
2008-08-20,Wales,Georgia,1,2,1,0.0,1.0,1767,1629
2008-08-20,Zimbabwe,Botswana,1,0,1,1.0,0.0,1696,1599
2008-08-21,Indonesia,Cambodia,7,0,7,1.0,0.0,1639,1333
2008-08-22,Cambodia,Myanmar,1,7,6,0.0,1.0,1330,1562
2008-08-24,Libya,Chad,3,0,3,1.0,0.0,1666,1515
2008-08-24,Qatar,North Korea,2,1,1,1.0,0.0,1774,1732
2008-08-25,Indonesia,Myanmar,4,0,4,1.0,0.0,1646,1556
2008-08-27,Bermuda,Antigua and Barbuda,0,4,4,0.0,1.0,1516,1502
2008-08-27,Cayman Islands,Saint Martin,3,0,3,1.0,0.0,1447,1465
2008-08-27,Iran,Azerbaijan,1,0,1,1.0,0.0,1930,1540
2008-08-28,Libya,Niger,6,2,4,1.0,0.0,1671,1509
2008-08-29,United Arab Emirates,Bahrain,2,3,1,0.0,1.0,1722,1781
2008-08-29,Uzbekistan,North Korea,0,0,0,0.5,0.5,1747,1733
2008-08-30,Cayman Islands,Antigua and Barbuda,1,1,0,0.5,0.5,1449,1501
2008-08-30,Saudi Arabia,Qatar,2,1,1,1.0,0.0,1893,1769
2008-08-30,Saint Martin,Bermuda,0,7,7,0.0,1.0,1459,1523
2008-08-30,Suriname,French Guiana,2,1,1,1.0,0.0,1592,1464
2008-08-31,Antigua and Barbuda,Saint Martin,3,2,1,1.0,0.0,1509,1452
2008-08-31,Cayman Islands,Bermuda,0,0,0,0.5,0.5,1451,1522
2008-09-03,Trinidad and Tobago,Guyana,3,0,3,1.0,0.0,1745,1555
2008-09-05,Algeria,Senegal,3,2,1,1.0,0.0,1710,1810
2008-09-05,Djibouti,Malawi,0,3,3,0.0,1.0,1334,1603
2008-09-05,South Korea,Jordan,1,0,1,1.0,0.0,1871,1723
2008-09-05,Libya,Ghana,1,0,1,1.0,0.0,1683,1817
2008-09-06,Albania,Sweden,0,0,0,0.5,0.5,1618,1871
2008-09-06,Andorra,England,0,2,2,0.0,1.0,1387,2001
2008-09-06,Argentina,Paraguay,1,1,0,0.5,0.5,2030,1858
2008-09-06,Armenia,Turkey,0,2,2,0.0,1.0,1592,1883
2008-09-06,Austria,France,3,1,2,1.0,0.0,1778,2032
2008-09-06,Bahrain,Japan,2,3,1,0.0,1.0,1777,1933
2008-09-06,Belgium,Estonia,3,2,1,1.0,0.0,1815,1589
2008-09-06,Burkina Faso,Tunisia,0,0,0,0.5,0.5,1627,1839
2008-09-06,Cape Verde,Cameroon,1,2,1,0.0,1.0,1571,1880
2008-09-06,Colombia,Uruguay,0,1,1,0.0,1.0,1880,1902
2008-09-06,Croatia,Kazakhstan,3,0,3,1.0,0.0,1962,1556
2008-09-06,Cuba,United States,0,1,1,0.0,1.0,1691,1964
2008-09-06,Cyprus,Italy,1,2,1,0.0,1.0,1663,2018
2008-09-06,Ecuador,Bolivia,3,1,2,1.0,0.0,1813,1712
2008-09-06,Fiji,Vanuatu,2,0,2,1.0,0.0,1699,1555
2008-09-06,Gambia,Liberia,3,0,3,1.0,0.0,1574,1555
2008-09-06,Georgia,Republic of Ireland,1,2,1,0.0,1.0,1627,1911
2008-09-06,Hungary,Denmark,0,0,0,0.5,0.5,1740,1929
2008-09-06,Israel,Switzerland,2,2,0,0.5,0.5,1807,1866
2008-09-06,Kenya,Namibia,1,0,1,1.0,0.0,1639,1526
2008-09-06,Liechtenstein,Germany,0,6,6,0.0,1.0,1413,2041
2008-09-06,Luxembourg,Greece,0,3,3,0.0,1.0,1352,1876
2008-09-06,North Macedonia,Scotland,1,0,1,1.0,0.0,1692,1810
2008-09-06,Malta,Portugal,0,4,4,0.0,1.0,1459,1960
2008-09-06,Martinique,French Guiana,2,1,1,1.0,0.0,1666,1461
2008-09-06,Mauritania,Rwanda,0,1,1,0.0,1.0,1435,1627
2008-09-06,Mauritius,Tanzania,1,4,3,0.0,1.0,1475,1602
2008-09-06,Moldova,Latvia,1,2,1,0.0,1.0,1583,1633
2008-09-06,Montenegro,Bulgaria,2,2,0,0.5,0.5,1561,1863
2008-09-06,Netherlands,Australia,1,2,1,0.0,1.0,2025,1909
2008-09-06,New Caledonia,New Zealand,1,3,2,0.0,1.0,1650,1712
2008-09-06,Norway,Iceland,2,2,0,0.5,0.5,1839,1655
2008-09-06,Oman,Morocco,0,0,0,0.5,0.5,1792,1857
2008-09-06,Peru,Venezuela,1,0,1,1.0,0.0,1767,1774
2008-09-06,Poland,Slovenia,1,1,0,0.5,0.5,1855,1708
2008-09-06,Qatar,Uzbekistan,3,0,3,1.0,0.0,1777,1740
2008-09-06,Romania,Lithuania,0,3,3,0.0,1.0,1913,1648
2008-09-06,Saudi Arabia,Iran,1,1,0,0.5,0.5,1894,1930
2008-09-06,Serbia,Faroe Islands,2,0,2,1.0,0.0,1807,1446
2008-09-06,Seychelles,Burundi,1,2,1,0.0,1.0,1450,1552
2008-09-06,Sierra Leone,Equatorial Guinea,2,1,1,1.0,0.0,1578,1487
2008-09-06,Slovakia,Northern Ireland,2,1,1,1.0,0.0,1765,1708
2008-09-06,South Africa,Nigeria,0,1,1,0.0,1.0,1771,1880
2008-09-06,Spain,Bosnia and Herzegovina,1,0,1,1.0,0.0,2092,1669
2008-09-06,Sudan,Chad,1,2,1,0.0,1.0,1634,1526
2008-09-06,Trinidad and Tobago,Guatemala,1,1,0,0.5,0.5,1745,1708
2008-09-06,Ukraine,Belarus,1,0,1,1.0,0.0,1831,1682
2008-09-06,United Arab Emirates,North Korea,1,2,1,0.0,1.0,1715,1741
2008-09-06,Wales,Azerbaijan,1,0,1,1.0,0.0,1771,1537
2008-09-06,Canada,Honduras,1,2,1,0.0,1.0,1736,1824
2008-09-06,Costa Rica,Suriname,7,0,7,1.0,0.0,1784,1588
2008-09-06,El Salvador,Haiti,5,0,5,1.0,0.0,1631,1683
2008-09-06,Mexico,Jamaica,3,0,3,1.0,0.0,1963,1750
2008-09-07,Benin,Angola,3,2,1,1.0,0.0,1581,1716
2008-09-07,Chile,Brazil,0,3,3,0.0,1.0,1847,2062
2008-09-07,Congo,Mali,1,0,1,1.0,0.0,1630,1744
2008-09-07,DR Congo,Egypt,0,1,1,0.0,1.0,1689,1891
2008-09-07,Lesotho,Gabon,0,3,3,0.0,1.0,1464,1702
2008-09-07,Madagascar,Botswana,1,0,1,1.0,0.0,1586,1591
2008-09-07,Mozambique,Ivory Coast,1,1,0,0.5,0.5,1615,1860
2008-09-07,Niger,Uganda,3,1,2,1.0,0.0,1521,1637
2008-09-07,Zimbabwe,Guinea,0,0,0,0.5,0.5,1697,1733
2008-09-09,Paraguay,Venezuela,2,0,2,1.0,0.0,1865,1768
2008-09-09,South Africa,Guinea,0,1,1,0.0,1.0,1763,1742
2008-09-10,Albania,Malta,3,0,3,1.0,0.0,1623,1455
2008-09-10,Andorra,Belarus,1,3,2,0.0,1.0,1385,1685
2008-09-10,Azerbaijan,Liechtenstein,0,0,0,0.5,0.5,1535,1416
2008-09-10,Bosnia and Herzegovina,Estonia,7,0,7,1.0,0.0,1676,1583
2008-09-10,Brazil,Bolivia,0,0,0,0.5,0.5,2056,1719
2008-09-10,Chad,Sudan,1,3,2,0.0,1.0,1521,1640
2008-09-10,Chile,Colombia,4,0,4,1.0,0.0,1856,1872
2008-09-10,Croatia,England,1,4,3,0.0,1.0,1955,2009
2008-09-10,Faroe Islands,Romania,0,1,1,0.0,1.0,1445,1915
2008-09-10,Finland,Germany,3,3,0,0.5,0.5,1773,2036
2008-09-10,France,Serbia,2,1,1,1.0,0.0,2036,1804
2008-09-10,Guatemala,Cuba,4,1,3,1.0,0.0,1716,1684
2008-09-10,Haiti,Costa Rica,1,3,2,0.0,1.0,1678,1790
2008-09-10,Honduras,Jamaica,2,0,2,1.0,0.0,1831,1744
2008-09-10,Iceland,Scotland,1,2,1,0.0,1.0,1651,1815
2008-09-10,Italy,Georgia,2,0,2,1.0,0.0,2020,1626
2008-09-10,Kazakhstan,Ukraine,1,3,2,0.0,1.0,1554,1834
2008-09-10,North Korea,South Korea,1,1,0,0.5,0.5,1744,1869
2008-09-10,Latvia,Greece,0,2,2,0.0,1.0,1630,1880
2008-09-10,Lithuania,Austria,2,0,2,1.0,0.0,1659,1768
2008-09-10,North Macedonia,Netherlands,1,2,1,0.0,1.0,1690,2028
2008-09-10,Mexico,Canada,2,1,1,1.0,0.0,1967,1733
2008-09-10,Moldova,Israel,1,2,1,0.0,1.0,1580,1811
2008-09-10,Montenegro,Republic of Ireland,0,0,0,0.5,0.5,1568,1905
2008-09-10,New Zealand,New Caledonia,3,0,3,1.0,0.0,1719,1644
2008-09-10,Northern Ireland,Czech Republic,0,0,0,0.5,0.5,1713,1958
2008-09-10,Oman,Zimbabwe,3,2,1,1.0,0.0,1798,1692
2008-09-10,Peru,Argentina,1,1,0,0.5,0.5,1773,2025
2008-09-10,Portugal,Denmark,2,3,1,0.0,1.0,1952,1938
2008-09-10,Qatar,Bahrain,1,1,0,0.5,0.5,1777,1777
2008-09-10,Russia,Wales,2,1,1,1.0,0.0,1898,1766
2008-09-10,San Marino,Poland,0,2,2,0.0,1.0,1366,1856
2008-09-10,Slovenia,Slovakia,2,1,1,1.0,0.0,1718,1756
2008-09-10,Spain,Armenia,4,0,4,1.0,0.0,2093,1592
2008-09-10,Suriname,El Salvador,0,2,2,0.0,1.0,1581,1639
2008-09-10,Sweden,Hungary,2,1,1,1.0,0.0,1877,1735
2008-09-10,Switzerland,Luxembourg,1,2,1,0.0,1.0,1851,1368
2008-09-10,Turkey,Belgium,1,1,0,0.5,0.5,1882,1817
2008-09-10,United Arab Emirates,Saudi Arabia,1,2,1,0.0,1.0,1711,1899
2008-09-10,Uruguay,Ecuador,0,0,0,0.5,0.5,1900,1816
2008-09-10,United States,Trinidad and Tobago,3,0,3,1.0,0.0,1968,1742
2008-09-10,Uzbekistan,Australia,0,1,1,0.0,1.0,1736,1914
2008-09-10,Vanuatu,Fiji,2,1,1,1.0,0.0,1567,1688
2008-09-10,Zambia,Togo,1,0,1,1.0,0.0,1725,1663
2008-09-19,Martinique,Anguilla,3,1,2,1.0,0.0,1669,1350
2008-09-21,Antigua and Barbuda,Guyana,3,0,3,1.0,0.0,1519,1546
2008-09-24,Mexico,Chile,0,1,1,0.0,1.0,1957,1867
2008-09-24,Saint Kitts and Nevis,British Virgin Islands,4,0,4,1.0,0.0,1565,1420
2008-09-24,Tahiti,New Caledonia,0,1,1,0.0,1.0,1666,1653
2008-09-24,Guadeloupe,Martinique,0,1,1,0.0,1.0,1625,1677
2008-09-25,Mayotte,Réunion,1,6,5,0.0,1.0,1483,1559
2008-09-26,British Virgin Islands,Barbados,1,2,1,0.0,1.0,1416,1587
2008-09-27,New Caledonia,Guadeloupe,0,4,4,0.0,1.0,1645,1634
2008-09-27,Tahiti,Martinique,0,1,1,0.0,1.0,1659,1685
2008-09-28,Saint Kitts and Nevis,Barbados,1,3,2,0.0,1.0,1558,1595
2008-09-28,French Guiana,Mayotte,4,2,2,1.0,0.0,1470,1475
2008-09-30,South Africa,Malawi,3,0,3,1.0,0.0,1768,1599
2008-09-30,Tahiti,Guadeloupe,0,1,1,0.0,1.0,1651,1643
2008-09-30,New Caledonia,Martinique,1,1,0,0.5,0.5,1646,1685
2008-10-01,Vietnam,Myanmar,2,3,1,0.0,1.0,1604,1566
2008-10-01,French Guiana,Réunion,0,2,2,0.0,1.0,1465,1565
2008-10-03,Myanmar,Turkmenistan,1,2,1,0.0,1.0,1559,1580
2008-10-03,New Caledonia,Mayotte,3,2,1,1.0,0.0,1651,1471
2008-10-03,Guadeloupe,French Guiana,4,0,4,1.0,0.0,1648,1461
2008-10-04,Martinique,Réunion,0,1,1,0.0,1.0,1675,1576
2008-10-08,Trinidad and Tobago,Dominican Republic,9,0,9,1.0,0.0,1745,1457
2008-10-09,Japan,United Arab Emirates,1,1,0,0.5,0.5,1929,1716
2008-10-10,Malaysia,Pakistan,4,1,3,1.0,0.0,1559,1363
2008-10-11,Argentina,Uruguay,2,1,1,1.0,0.0,2031,1895
2008-10-11,Belgium,Armenia,2,0,2,1.0,0.0,1821,1589
2008-10-11,Bolivia,Peru,3,0,3,1.0,0.0,1729,1764
2008-10-11,Botswana,Mozambique,0,1,1,0.0,1.0,1584,1623
2008-10-11,Bulgaria,Italy,0,0,0,0.5,0.5,1867,2017
2008-10-11,Cameroon,Mauritius,5,0,5,1.0,0.0,1882,1474
2008-10-11,Colombia,Paraguay,0,1,1,0.0,1.0,1864,1874
2008-10-11,Denmark,Malta,3,0,3,1.0,0.0,1939,1455
2008-10-11,England,Kazakhstan,5,1,4,1.0,0.0,2011,1553
2008-10-11,Equatorial Guinea,South Africa,0,1,1,0.0,1.0,1485,1771
2008-10-11,Estonia,Spain,0,3,3,0.0,1.0,1583,2094
2008-10-11,Faroe Islands,Austria,1,1,0,0.5,0.5,1451,1763
2008-10-11,Finland,Azerbaijan,1,0,1,1.0,0.0,1777,1532
2008-10-11,Gabon,Libya,1,0,1,1.0,0.0,1710,1676
2008-10-11,Georgia,Cyprus,1,1,0,0.5,0.5,1627,1663
2008-10-11,Germany,Russia,2,1,1,1.0,0.0,2041,1894
2008-10-11,Ghana,Lesotho,3,0,3,1.0,0.0,1819,1463
2008-10-11,Greece,Moldova,3,0,3,1.0,0.0,1883,1578
2008-10-11,Guadeloupe,Cayman Islands,7,1,6,1.0,0.0,1652,1448
2008-10-11,Guatemala,Trinidad and Tobago,0,0,0,0.5,0.5,1717,1745
2008-10-11,Haiti,El Salvador,0,0,0,0.5,0.5,1678,1640
2008-10-11,Honduras,Canada,3,1,2,1.0,0.0,1837,1728
2008-10-11,Hungary,Albania,2,0,2,1.0,0.0,1741,1618
2008-10-11,Ivory Coast,Madagascar,3,0,3,1.0,0.0,1863,1584
2008-10-11,Jamaica,Mexico,1,0,1,1.0,0.0,1757,1945
2008-10-11,South Korea,Uzbekistan,3,0,3,1.0,0.0,1875,1731
2008-10-11,Liberia,Algeria,0,0,0,0.5,0.5,1559,1707
2008-10-11,Luxembourg,Israel,1,3,2,0.0,1.0,1367,1813
2008-10-11,Malawi,DR Congo,2,1,1,1.0,0.0,1610,1679
2008-10-11,Mali,Chad,2,1,1,1.0,0.0,1748,1518
2008-10-11,Martinique,Grenada,2,2,0,0.5,0.5,1673,1566
2008-10-11,Morocco,Mauritania,4,1,3,1.0,0.0,1859,1434
2008-10-11,Namibia,Zimbabwe,4,2,2,1.0,0.0,1538,1681
2008-10-11,Netherlands,Iceland,2,0,2,1.0,0.0,2030,1650
2008-10-11,Nigeria,Sierra Leone,4,1,3,1.0,0.0,1883,1576
2008-10-11,Poland,Czech Republic,2,1,1,1.0,0.0,1867,1948
2008-10-11,Romania,France,2,2,0,0.5,0.5,1918,2034
2008-10-11,San Marino,Slovakia,1,3,2,0.0,1.0,1365,1758
2008-10-11,Scotland,Norway,0,0,0,0.5,0.5,1816,1839
2008-10-11,Senegal,Gambia,1,1,0,0.5,0.5,1806,1579
2008-10-11,Serbia,Lithuania,3,0,3,1.0,0.0,1809,1655
2008-10-11,Slovenia,Northern Ireland,2,0,2,1.0,0.0,1726,1706
2008-10-11,Sudan,Congo,2,0,2,1.0,0.0,1648,1623
2008-10-11,Suriname,Costa Rica,1,4,3,0.0,1.0,1578,1794
2008-10-11,Sweden,Portugal,0,0,0,0.5,0.5,1879,1951
2008-10-11,Switzerland,Latvia,2,1,1,1.0,0.0,1855,1627
2008-10-11,Tanzania,Cape Verde,3,1,2,1.0,0.0,1610,1564
2008-10-11,Togo,Eswatini,6,0,6,1.0,0.0,1668,1498
2008-10-11,Tunisia,Seychelles,5,0,5,1.0,0.0,1841,1449
2008-10-11,Turkey,Bosnia and Herzegovina,2,1,1,1.0,0.0,1886,1673
2008-10-11,Ukraine,Croatia,0,0,0,0.5,0.5,1837,1953
2008-10-11,United States,Cuba,6,1,5,1.0,0.0,1971,1682
2008-10-11,Wales,Liechtenstein,2,0,2,1.0,0.0,1768,1415
2008-10-12,Angola,Niger,3,1,2,1.0,0.0,1720,1518
2008-10-12,Burundi,Burkina Faso,1,3,2,0.0,1.0,1546,1634
2008-10-12,Ecuador,Chile,1,0,1,1.0,0.0,1826,1858
2008-10-12,Egypt,Djibouti,4,0,4,1.0,0.0,1892,1334
2008-10-12,Guinea,Kenya,3,2,1,1.0,0.0,1748,1634
2008-10-12,Uganda,Benin,2,1,1,1.0,0.0,1644,1575
2008-10-12,Venezuela,Brazil,0,4,4,0.0,1.0,1766,2059
2008-10-13,Cayman Islands,Martinique,0,1,1,0.0,1.0,1445,1677
2008-10-13,Guadeloupe,Grenada,2,1,1,1.0,0.0,1659,1560
2008-10-14,Bolivia,Uruguay,2,2,0,0.5,0.5,1733,1892
2008-10-14,France,Tunisia,3,1,2,1.0,0.0,2038,1838
2008-10-14,Vietnam,Singapore,0,0,0,0.5,0.5,1605,1645
2008-10-15,Australia,Qatar,4,0,4,1.0,0.0,1919,1773
2008-10-15,Austria,Serbia,1,3,2,0.0,1.0,1757,1816
2008-10-15,Bahrain,Azerbaijan,1,2,1,0.0,1.0,1765,1545
2008-10-15,Belarus,England,1,3,2,0.0,1.0,1683,2014
2008-10-15,Belgium,Spain,1,2,1,0.0,1.0,1819,2097
2008-10-15,Bosnia and Herzegovina,Armenia,4,1,3,1.0,0.0,1680,1583
2008-10-15,Brazil,Colombia,0,0,0,0.5,0.5,2055,1869
2008-10-15,Canada,Mexico,2,2,0,0.5,0.5,1733,1941
2008-10-15,Chile,Argentina,1,0,1,1.0,0.0,1870,2020
2008-10-15,Costa Rica,Haiti,2,0,2,1.0,0.0,1800,1673
2008-10-15,Croatia,Andorra,4,0,4,1.0,0.0,1954,1385
2008-10-15,Cuba,Guatemala,2,1,1,1.0,0.0,1691,1709
2008-10-15,Czech Republic,Slovenia,1,0,1,1.0,0.0,1952,1723
2008-10-15,El Salvador,Suriname,3,0,3,1.0,0.0,1647,1572
2008-10-15,Estonia,Turkey,0,0,0,0.5,0.5,1589,1881
2008-10-15,Georgia,Bulgaria,0,0,0,0.5,0.5,1632,1863
2008-10-15,Germany,Wales,1,0,1,1.0,0.0,2044,1766
2008-10-15,Greece,Switzerland,1,2,1,0.0,1.0,1875,1864
2008-10-15,Grenada,Cayman Islands,4,2,2,1.0,0.0,1566,1440
2008-10-15,Guadeloupe,Martinique,3,1,2,1.0,0.0,1668,1669
2008-10-15,Iceland,North Macedonia,1,0,1,1.0,0.0,1659,1682
2008-10-15,Iran,North Korea,2,1,1,1.0,0.0,1935,1740
2008-10-15,Republic of Ireland,Cyprus,1,0,1,1.0,0.0,1909,1660
2008-10-15,Italy,Montenegro,2,1,1,1.0,0.0,2019,1567
2008-10-15,Jamaica,Honduras,1,0,1,1.0,0.0,1767,1828
2008-10-15,Japan,Uzbekistan,1,1,0,0.5,0.5,1925,1736
2008-10-15,South Korea,United Arab Emirates,4,1,3,1.0,0.0,1880,1712
2008-10-15,Latvia,Israel,1,1,0,0.5,0.5,1631,1810
2008-10-15,Lithuania,Faroe Islands,1,0,1,1.0,0.0,1659,1448
2008-10-15,Luxembourg,Moldova,0,0,0,0.5,0.5,1372,1574
2008-10-15,Malaysia,Nepal,4,0,4,1.0,0.0,1564,1377
2008-10-15,Malta,Hungary,0,1,1,0.0,1.0,1453,1744
2008-10-15,Northern Ireland,San Marino,4,0,4,1.0,0.0,1708,1364
2008-10-15,Norway,Netherlands,0,1,1,0.0,1.0,1836,2034
2008-10-15,Paraguay,Peru,1,0,1,1.0,0.0,1880,1759
2008-10-15,Portugal,Albania,0,0,0,0.5,0.5,1946,1624
2008-10-15,Russia,Finland,3,0,3,1.0,0.0,1900,1772
2008-10-15,Slovakia,Poland,2,1,1,1.0,0.0,1769,1857
2008-10-15,South Africa,Ghana,2,1,1,1.0,0.0,1781,1810
2008-10-15,Trinidad and Tobago,United States,2,1,1,1.0,0.0,1758,1959
2008-10-15,Venezuela,Ecuador,3,1,2,1.0,0.0,1776,1817
2008-10-17,Cambodia,Laos,3,2,1,1.0,0.0,1340,1374
2008-10-17,Nepal,Afghanistan,2,2,0,0.5,0.5,1377,1371
2008-10-17,Philippines,Timor-Leste,1,0,1,1.0,0.0,1320,1404
2008-10-18,Bangladesh,Myanmar,0,1,1,0.0,1.0,1420,1565
2008-10-19,Brunei,Philippines,1,1,0,0.5,0.5,1298,1320
2008-10-19,Cambodia,Timor-Leste,2,2,0,0.5,0.5,1342,1403
2008-10-20,Malaysia,Afghanistan,6,0,6,1.0,0.0,1568,1368
2008-10-21,Timor-Leste,Brunei,1,4,3,0.0,1.0,1393,1309
2008-10-21,Philippines,Laos,1,2,1,0.0,1.0,1314,1381
2008-10-22,Bolivia,El Salvador,0,2,2,0.0,1.0,1724,1657
2008-10-23,Barbados,Suriname,3,2,1,1.0,0.0,1603,1565
2008-10-23,Cambodia,Philippines,2,3,1,0.0,1.0,1334,1323
2008-10-23,Cuba,Curaçao,7,1,6,1.0,0.0,1696,1539
2008-10-23,Laos,Brunei,3,2,1,1.0,0.0,1388,1303
2008-10-23,Malaysia,Myanmar,4,0,4,1.0,0.0,1576,1558
2008-10-25,Cambodia,Brunei,2,1,1,1.0,0.0,1342,1296
2008-10-25,Cuba,Barbados,1,1,0,0.5,0.5,1694,1606
2008-10-25,Laos,Timor-Leste,2,1,1,1.0,0.0,1397,1385
2008-10-25,Suriname,Curaçao,2,1,1,1.0,0.0,1573,1532
2008-10-26,Palestine,Jordan,1,1,0,0.5,0.5,1510,1719
2008-10-27,Cuba,Suriname,6,0,6,1.0,0.0,1700,1568
2008-10-27,Curaçao,Barbados,1,2,1,0.0,1.0,1526,1613
2008-10-28,Thailand,North Korea,1,0,1,1.0,0.0,1742,1732
2008-10-30,Vietnam,North Korea,0,0,0,0.5,0.5,1608,1730
2008-11-05,Guyana,Saint Kitts and Nevis,1,1,0,0.5,0.5,1547,1558
2008-11-05,Trinidad and Tobago,Antigua and Barbuda,3,2,1,1.0,0.0,1762,1516
2008-11-07,Antigua and Barbuda,Guyana,2,1,1,1.0,0.0,1525,1539
2008-11-07,Trinidad and Tobago,Saint Kitts and Nevis,3,1,2,1.0,0.0,1766,1555
2008-11-08,Jersey,Gibraltar,2,1,1,1.0,0.0,1727,1570
2008-11-08,Saudi Arabia,Thailand,1,0,1,1.0,0.0,1904,1738
2008-11-08,Occitania,Monaco,2,2,0,0.5,0.5,1503,1505
2008-11-09,Cayman Islands,Jamaica,0,2,2,0.0,1.0,1438,1770
2008-11-09,Qatar,Iran,0,1,1,0.0,1.0,1769,1940
2008-11-09,Saint Kitts and Nevis,Antigua and Barbuda,3,4,1,0.0,1.0,1547,1534
2008-11-09,Trinidad and Tobago,Guyana,1,1,0,0.5,0.5,1762,1544
2008-11-11,Myanmar,Bangladesh,0,0,0,0.5,0.5,1555,1424
2008-11-12,Estonia,Latvia,1,1,0,0.5,0.5,1590,1631
2008-11-12,Mexico,Ecuador,2,1,1,1.0,0.0,1947,1812
2008-11-12,Saudi Arabia,Bahrain,4,0,4,1.0,0.0,1909,1761
2008-11-13,Bangladesh,Indonesia,0,2,2,0.0,1.0,1421,1650
2008-11-13,Japan,Syria,3,1,2,1.0,0.0,1929,1728
2008-11-15,Myanmar,Indonesia,2,1,1,1.0,0.0,1566,1640
2008-11-16,Vietnam,Thailand,2,2,0,0.5,0.5,1611,1736
2008-11-18,Algeria,Mali,1,1,0,0.5,0.5,1708,1748
2008-11-18,Myanmar,Malaysia,4,1,3,1.0,0.0,1575,1568
2008-11-18,Estonia,Moldova,1,0,1,1.0,0.0,1598,1567
2008-11-18,Gabon,Guinea,3,3,0,0.5,0.5,1711,1748
2008-11-19,Austria,Turkey,2,4,2,0.0,1.0,1752,1887
2008-11-19,Azerbaijan,Albania,1,1,0,0.5,0.5,1547,1623
2008-11-19,Bahrain,Australia,0,1,1,0.0,1.0,1757,1924
2008-11-19,Brazil,Portugal,6,2,4,1.0,0.0,2061,1941
2008-11-19,Colombia,Nigeria,1,0,1,1.0,0.0,1878,1875
2008-11-19,Cyprus,Belarus,2,1,1,1.0,0.0,1669,1675
2008-11-19,Denmark,Wales,0,1,1,0.0,1.0,1928,1778
2008-11-19,Egypt,Benin,5,1,4,1.0,0.0,1895,1573
2008-11-19,El Salvador,Costa Rica,1,3,2,0.0,1.0,1653,1805
2008-11-19,Fiji,New Zealand,2,0,2,1.0,0.0,1697,1711
2008-11-19,France,Uruguay,0,0,0,0.5,0.5,2035,1896
2008-11-19,Germany,England,1,2,1,0.0,1.0,2036,2023
2008-11-19,Ghana,Tunisia,0,0,0,0.5,0.5,1811,1838
2008-11-19,Greece,Italy,1,1,0,0.5,0.5,1879,2016
2008-11-19,Honduras,Mexico,1,0,1,1.0,0.0,1839,1937
2008-11-19,Republic of Ireland,Poland,2,3,1,0.0,1.0,1900,1867
2008-11-19,Israel,Ivory Coast,2,2,0,0.5,0.5,1812,1862
2008-11-19,Jamaica,Canada,3,0,3,1.0,0.0,1778,1726
2008-11-19,Luxembourg,Belgium,1,1,0,0.5,0.5,1379,1813
2008-11-19,Macau,Hong Kong,1,9,8,0.0,1.0,1331,1572
2008-11-19,Malta,Iceland,0,1,1,0.0,1.0,1450,1663
2008-11-19,Moldova,Lithuania,1,1,0,0.5,0.5,1570,1657
2008-11-19,Montenegro,North Macedonia,2,1,1,1.0,0.0,1578,1672
2008-11-19,Morocco,Zambia,3,0,3,1.0,0.0,1865,1720
2008-11-19,Netherlands,Sweden,3,1,2,1.0,0.0,2039,1875
2008-11-19,Northern Ireland,Hungary,0,2,2,0.0,1.0,1701,1752
2008-11-19,Oman,Paraguay,0,1,1,0.0,1.0,1792,1887
2008-11-19,Qatar,Japan,0,3,3,0.0,1.0,1765,1934
2008-11-19,Romania,Georgia,2,1,1,1.0,0.0,1921,1630
2008-11-19,San Marino,Czech Republic,0,3,3,0.0,1.0,1364,1953
2008-11-19,Saudi Arabia,South Korea,0,2,2,0.0,1.0,1901,1889
2008-11-19,Scotland,Argentina,0,1,1,0.0,1.0,1813,2024
2008-11-19,Serbia,Bulgaria,6,1,5,1.0,0.0,1826,1854
2008-11-19,Slovakia,Liechtenstein,4,0,4,1.0,0.0,1771,1414
2008-11-19,Slovenia,Bosnia and Herzegovina,3,4,1,0.0,1.0,1715,1689
2008-11-19,South Africa,Cameroon,3,2,1,1.0,0.0,1792,1872
2008-11-19,Spain,Chile,3,0,3,1.0,0.0,2101,1867
2008-11-19,Suriname,Haiti,1,1,0,0.5,0.5,1571,1671
2008-11-19,Switzerland,Finland,1,0,1,1.0,0.0,1870,1767
2008-11-19,Tanzania,Mozambique,1,0,1,1.0,0.0,1619,1615
2008-11-19,Togo,Rwanda,1,0,1,1.0,0.0,1676,1620
2008-11-19,Trinidad and Tobago,Cuba,3,0,3,1.0,0.0,1769,1694
2008-11-19,Ukraine,Norway,1,0,1,1.0,0.0,1845,1829
2008-11-19,United Arab Emirates,Iran,1,1,0,0.5,0.5,1717,1936
2008-11-19,United States,Guatemala,2,0,2,1.0,0.0,1963,1706
2008-11-19,Venezuela,Angola,0,0,0,0.5,0.5,1775,1722
2008-11-21,Myanmar,Indonesia,2,1,1,1.0,0.0,1585,1631
2008-11-22,Estonia,Lithuania,1,1,0,0.5,0.5,1600,1656
2008-11-29,Malaysia,Singapore,2,2,0,0.5,0.5,1570,1644
2008-12-03,Jamaica,Barbados,2,1,1,1.0,0.0,1783,1609
2008-12-03,Trinidad and Tobago,Grenada,1,2,1,0.0,1.0,1757,1579
2008-12-04,Guadeloupe,Cuba,1,2,1,0.0,1.0,1661,1702
2008-12-04,Haiti,Antigua and Barbuda,1,1,0,0.5,0.5,1668,1538
2008-12-05,Barbados,Trinidad and Tobago,1,2,1,0.0,1.0,1605,1762
2008-12-05,Indonesia,Myanmar,3,0,3,1.0,0.0,1638,1579
2008-12-05,Jamaica,Grenada,4,0,4,1.0,0.0,1787,1576
2008-12-05,Singapore,Cambodia,5,0,5,1.0,0.0,1647,1340
2008-12-06,Cuba,Antigua and Barbuda,3,0,3,1.0,0.0,1707,1534
2008-12-06,Haiti,Guadeloupe,2,3,1,0.0,1.0,1660,1670
2008-12-06,Malaysia,Laos,3,0,3,1.0,0.0,1575,1393
2008-12-06,Thailand,Vietnam,2,0,2,1.0,0.0,1742,1606
2008-12-07,Grenada,Barbados,4,2,2,1.0,0.0,1585,1597
2008-12-07,Indonesia,Cambodia,4,0,4,1.0,0.0,1641,1338
2008-12-07,Jamaica,Trinidad and Tobago,1,1,0,0.5,0.5,1787,1763
2008-12-07,Singapore,Myanmar,3,1,2,1.0,0.0,1654,1573
2008-12-08,Antigua and Barbuda,Guadeloupe,2,2,0,0.5,0.5,1537,1668
2008-12-08,Cuba,Haiti,0,1,1,0.0,1.0,1698,1670
2008-12-08,Malaysia,Vietnam,2,3,1,0.0,1.0,1568,1614
2008-12-08,Thailand,Laos,6,0,6,1.0,0.0,1744,1392
2008-12-09,Myanmar,Cambodia,3,2,1,1.0,0.0,1577,1335
2008-12-09,Indonesia,Singapore,0,2,2,0.0,1.0,1634,1662
2008-12-10,Thailand,Malaysia,3,0,3,1.0,0.0,1749,1564
2008-12-10,Vietnam,Laos,4,0,4,1.0,0.0,1618,1389
2008-12-11,Cuba,Grenada,2,2,0,0.5,0.5,1696,1588
2008-12-11,Jamaica,Guadeloupe,2,0,2,1.0,0.0,1793,1663
2008-12-14,Cuba,Guadeloupe,0,0,0,0.5,0.5,1696,1664
2008-12-14,Jamaica,Grenada,2,0,2,1.0,0.0,1797,1585
2008-12-14,Serbia,Poland,0,1,1,0.0,1.0,1819,1875
2008-12-16,Indonesia,Thailand,0,1,1,0.0,1.0,1629,1755
2008-12-17,Iran,Ecuador,0,1,1,0.0,1.0,1926,1823
2008-12-17,Oman,China PR,3,1,2,1.0,0.0,1800,1778
2008-12-17,Vietnam,Singapore,0,0,0,0.5,0.5,1620,1661
2008-12-19,Iran,China PR,2,0,2,1.0,0.0,1931,1774
2008-12-19,Oman,Ecuador,2,0,2,1.0,0.0,1809,1815
2008-12-20,Monaco,Provence,2,3,1,0.0,1.0,1496,1467
2008-12-21,Jordan,China PR,0,1,1,0.0,1.0,1713,1781
2008-12-23,Bahrain,Saudi Arabia,1,0,1,1.0,0.0,1769,1890
2008-12-23,Djibouti,Somalia,2,3,1,0.0,1.0,1327,1360
2008-12-24,Thailand,Vietnam,1,2,1,0.0,1.0,1745,1631
2008-12-27,Saudi Arabia,Syria,1,1,0,0.5,0.5,1887,1732
2008-12-27,United Arab Emirates,Iraq,2,2,0,0.5,0.5,1719,1763
2008-12-27,Galicia,Iran,3,2,1,1.0,0.0,1543,1917
2008-12-28,Vietnam,Thailand,1,1,0,0.5,0.5,1634,1743
2008-12-28,Catalonia,Colombia,2,1,1,1.0,0.0,1623,1865
2008-12-29,Bahrain,Syria,2,2,0,0.5,0.5,1769,1733
2008-12-30,United Arab Emirates,Kuwait,0,0,0,0.5,0.5,1719,1713
2008-12-31,Sudan,Kenya,0,0,0,0.5,0.5,1648,1635
2008-12-31,Zambia,Djibouti,3,0,3,1.0,0.0,1722,1326
2009-01-01,Uganda,Rwanda,4,0,4,1.0,0.0,1652,1613
2009-01-01,Zanzibar,Somalia,2,0,2,1.0,0.0,1488,1355
2009-01-02,Djibouti,Burundi,0,4,4,0.0,1.0,1323,1550
2009-01-02,Kenya,Zambia,0,0,0,0.5,0.5,1637,1721
2009-01-03,Somalia,Tanzania,1,0,1,1.0,0.0,1369,1606
2009-01-03,Uganda,Zanzibar,0,0,0,0.5,0.5,1649,1492
2009-01-04,Bahrain,Iraq,3,1,2,1.0,0.0,1777,1756
2009-01-04,Djibouti,Sudan,1,1,0,0.5,0.5,1329,1643
2009-01-04,Oman,Kuwait,0,0,0,0.5,0.5,1807,1716
2009-01-04,Zambia,Burundi,1,1,0,0.5,0.5,1718,1554
2009-01-05,Rwanda,Somalia,3,0,3,1.0,0.0,1617,1366
2009-01-05,Saudi Arabia,Qatar,0,0,0,0.5,0.5,1885,1768
2009-01-05,Tanzania,Zanzibar,2,1,1,1.0,0.0,1612,1487
2009-01-05,United Arab Emirates,Yemen,3,1,2,1.0,0.0,1724,1529
2009-01-06,Burundi,Sudan,1,0,1,1.0,0.0,1565,1633
2009-01-06,Kenya,Djibouti,5,1,4,1.0,0.0,1640,1327
2009-01-07,Bahrain,Kuwait,0,1,1,0.0,1.0,1768,1726
2009-01-07,Oman,Iraq,4,0,4,1.0,0.0,1814,1750
2009-01-07,Rwanda,Tanzania,0,2,2,0.0,1.0,1609,1621
2009-01-07,Uganda,Somalia,4,0,4,1.0,0.0,1652,1364
2009-01-08,Burundi,Kenya,0,1,1,0.0,1.0,1559,1647
2009-01-08,Qatar,United Arab Emirates,0,0,0,0.5,0.5,1767,1726
2009-01-08,Saudi Arabia,Yemen,6,0,6,1.0,0.0,1887,1528
2009-01-08,Sudan,Zambia,2,0,2,1.0,0.0,1643,1709
2009-01-09,Iran,China PR,3,1,2,1.0,0.0,1923,1776
2009-01-09,Uganda,Tanzania,2,1,1,1.0,0.0,1660,1614
2009-01-09,Zanzibar,Rwanda,0,3,3,0.0,1.0,1482,1615
2009-01-10,Iraq,Kuwait,1,1,0,0.5,0.5,1750,1727
2009-01-10,Oman,Bahrain,2,0,2,1.0,0.0,1821,1762
2009-01-11,Kenya,Tanzania,2,1,1,1.0,0.0,1655,1607
2009-01-11,Qatar,Yemen,2,1,1,1.0,0.0,1771,1525
2009-01-11,Uganda,Burundi,5,0,5,1.0,0.0,1666,1554
2009-01-11,United Arab Emirates,Saudi Arabia,0,3,3,0.0,1.0,1722,1892
2009-01-13,Tanzania,Burundi,3,2,1,1.0,0.0,1614,1548
2009-01-13,Uganda,Kenya,1,0,1,1.0,0.0,1674,1648
2009-01-14,Hong Kong,India,2,1,1,1.0,0.0,1581,1589
2009-01-14,Iran,Singapore,6,0,6,1.0,0.0,1926,1659
2009-01-14,Jordan,Thailand,0,0,0,0.5,0.5,1714,1743
2009-01-14,Kuwait,Saudi Arabia,0,1,1,0.0,1.0,1723,1897
2009-01-14,Oman,Qatar,1,0,1,1.0,0.0,1828,1765
2009-01-14,Syria,China PR,3,2,1,1.0,0.0,1742,1768
2009-01-14,Vietnam,Lebanon,3,1,2,1.0,0.0,1642,1592
2009-01-17,Guatemala,Haiti,1,0,1,1.0,0.0,1714,1663
2009-01-17,Oman,Saudi Arabia,0,0,0,0.5,0.5,1830,1896
2009-01-18,Honduras,Chile,2,0,2,1.0,0.0,1848,1859
2009-01-18,Syria,Turkmenistan,5,1,4,1.0,0.0,1747,1576
2009-01-19,Oman,Indonesia,0,0,0,0.5,0.5,1826,1634
2009-01-20,Japan,Yemen,2,1,1,1.0,0.0,1936,1524
2009-01-20,Kuwait,Turkmenistan,2,0,2,1.0,0.0,1728,1572
2009-01-21,China PR,Vietnam,6,1,5,1.0,0.0,1774,1637
2009-01-21,Hong Kong,Bahrain,1,3,2,0.0,1.0,1577,1767
2009-01-21,Malaysia,United Arab Emirates,0,5,5,0.0,1.0,1560,1727
2009-01-21,Thailand,Lebanon,2,1,1,1.0,0.0,1748,1588
2009-01-22,El Salvador,Nicaragua,1,1,0,0.5,0.5,1648,1364
2009-01-22,Honduras,Belize,2,1,1,1.0,0.0,1850,1463
2009-01-23,Costa Rica,Panama,3,0,3,1.0,0.0,1811,1692
2009-01-23,Egypt,Kenya,1,0,1,1.0,0.0,1899,1645
2009-01-23,North Korea,Lebanon,0,1,1,0.0,1.0,1719,1600
2009-01-23,Kuwait,Syria,2,3,1,0.0,1.0,1721,1755
2009-01-24,Belize,El Salvador,1,4,3,0.0,1.0,1459,1653
2009-01-24,Honduras,Nicaragua,4,1,3,1.0,0.0,1851,1364
2009-01-24,United States,Sweden,3,2,1,1.0,0.0,1970,1869
2009-01-25,Guatemala,Costa Rica,1,3,2,0.0,1.0,1709,1817
2009-01-26,Honduras,El Salvador,2,0,2,1.0,0.0,1855,1650
2009-01-26,Nicaragua,Belize,1,1,0,0.5,0.5,1367,1457
2009-01-27,Panama,Guatemala,1,0,1,1.0,0.0,1701,1701
2009-01-27,South Africa,Zambia,1,0,1,1.0,0.0,1799,1703
2009-01-28,Bahrain,Japan,1,0,1,1.0,0.0,1779,1925
2009-01-28,Indonesia,Australia,0,0,0,0.5,0.5,1640,1919
2009-01-28,Kuwait,Oman,0,1,1,0.0,1.0,1716,1832
2009-01-28,Lebanon,Syria,0,2,2,0.0,1.0,1596,1760
2009-01-28,Mexico,Sweden,0,1,1,0.0,1.0,1928,1879
2009-01-28,Singapore,Jordan,2,1,1,1.0,0.0,1669,1705
2009-01-28,Thailand,Iran,0,0,0,0.5,0.5,1752,1923
2009-01-28,United Arab Emirates,Uzbekistan,0,1,1,0.0,1.0,1720,1744
2009-01-28,Yemen,Hong Kong,1,0,1,1.0,0.0,1534,1568
2009-01-29,Nicaragua,Guatemala,2,0,2,1.0,0.0,1381,1688
2009-01-30,Costa Rica,El Salvador,3,0,3,1.0,0.0,1822,1646
2009-01-30,Honduras,Panama,0,1,1,0.0,1.0,1844,1713
2009-02-01,Azerbaijan,Uzbekistan,1,1,0,0.5,0.5,1552,1740
2009-02-01,Costa Rica,Panama,0,0,0,0.5,0.5,1820,1716
2009-02-01,Honduras,El Salvador,1,0,1,1.0,0.0,1848,1643
2009-02-01,Syria,South Korea,1,1,0,0.5,0.5,1763,1887
2009-02-04,Bahrain,South Korea,2,2,0,0.5,0.5,1782,1885
2009-02-04,Japan,Finland,5,1,4,1.0,0.0,1930,1763
2009-02-05,Saudi Arabia,Thailand,2,1,1,1.0,0.0,1901,1748
2009-02-06,El Salvador,Peru,1,0,1,1.0,0.0,1654,1749
2009-02-07,Lithuania,Poland,1,1,0,0.5,0.5,1661,1871
2009-02-08,Barbados,Grenada,5,0,5,1.0,0.0,1605,1578
2009-02-10,Brazil,Italy,2,0,2,1.0,0.0,2068,2010
2009-02-10,Cyprus,Serbia,0,2,2,0.0,1.0,1665,1824
2009-02-10,Slovakia,Ukraine,2,3,1,0.0,1.0,1765,1852
2009-02-11,Algeria,Benin,2,1,1,1.0,0.0,1714,1568
2009-02-11,Andorra,Lithuania,1,3,2,0.0,1.0,1383,1664
2009-02-11,Angola,Mali,0,4,4,0.0,1.0,1715,1756
2009-02-11,Austria,Sweden,0,2,2,0.0,1.0,1747,1885
2009-02-11,Belgium,Slovenia,2,0,2,1.0,0.0,1819,1710
2009-02-11,Burkina Faso,Togo,1,1,0,0.5,0.5,1635,1676
2009-02-11,Cameroon,Guinea,3,1,2,1.0,0.0,1878,1743
2009-02-11,Colombia,Haiti,2,0,2,1.0,0.0,1869,1660
2009-02-11,Costa Rica,Honduras,2,0,2,1.0,0.0,1829,1840
2009-02-11,Cyprus,Slovakia,3,2,1,1.0,0.0,1676,1755
2009-02-11,Egypt,Ghana,2,2,0,0.5,0.5,1898,1813
2009-02-11,El Salvador,Trinidad and Tobago,2,2,0,0.5,0.5,1657,1761
2009-02-11,Estonia,Kazakhstan,0,2,2,0.0,1.0,1591,1563
2009-02-11,France,Argentina,0,2,2,0.0,1.0,2027,2033
2009-02-11,Germany,Norway,0,1,1,0.0,1.0,2024,1842
2009-02-11,Greece,Denmark,1,1,0,0.5,0.5,1881,1927
2009-02-11,Iran,South Korea,1,1,0,0.5,0.5,1923,1886
2009-02-11,Republic of Ireland,Georgia,2,1,1,1.0,0.0,1903,1628
2009-02-11,Israel,Hungary,1,0,1,1.0,0.0,1819,1746
2009-02-11,Japan,Australia,0,0,0,0.5,0.5,1930,1920
2009-02-11,North Korea,Saudi Arabia,1,0,1,1.0,0.0,1731,1890
2009-02-11,Kuwait,Azerbaijan,1,1,0,0.5,0.5,1713,1556
2009-02-11,Latvia,Armenia,0,0,0,0.5,0.5,1630,1585
2009-02-11,Libya,Uruguay,2,3,1,0.0,1.0,1673,1900
2009-02-11,Liechtenstein,Iceland,0,2,2,0.0,1.0,1411,1667
2009-02-11,North Macedonia,Moldova,1,1,0,0.5,0.5,1670,1573
2009-02-11,Malta,Albania,0,0,0,0.5,0.5,1454,1620
2009-02-11,Morocco,Czech Republic,0,0,0,0.5,0.5,1867,1952
2009-02-11,Mozambique,Malawi,2,0,2,1.0,0.0,1623,1603
2009-02-11,Nigeria,Jamaica,0,0,0,0.5,0.5,1874,1799
2009-02-11,Peru,Paraguay,0,1,1,0.0,1.0,1745,1892
2009-02-11,Portugal,Finland,1,0,1,1.0,0.0,1946,1759
2009-02-11,Romania,Croatia,1,2,1,0.0,1.0,1914,1962
2009-02-11,San Marino,Northern Ireland,0,3,3,0.0,1.0,1362,1704
2009-02-11,Serbia,Ukraine,0,1,1,0.0,1.0,1817,1860
2009-02-11,South Africa,Chile,0,2,2,0.0,1.0,1793,1866
2009-02-11,Spain,England,2,0,2,1.0,0.0,2108,2017
2009-02-11,Switzerland,Bulgaria,1,1,0,0.5,0.5,1870,1855
2009-02-11,Tanzania,Zimbabwe,0,0,0,0.5,0.5,1616,1680
2009-02-11,Tunisia,Netherlands,1,1,0,0.5,0.5,1843,2035
2009-02-11,Turkey,Ivory Coast,1,1,0,0.5,0.5,1887,1863
2009-02-11,United States,Mexico,2,0,2,1.0,0.0,1978,1921
2009-02-11,Uzbekistan,Bahrain,0,1,1,0.0,1.0,1733,1790
2009-02-11,Venezuela,Guatemala,2,1,1,1.0,0.0,1782,1682
2009-02-11,Wales,Poland,0,1,1,0.0,1.0,1773,1877
2009-03-05,Australia,Kuwait,0,1,1,0.0,1.0,1908,1726
2009-03-07,Sudan,Uganda,0,2,2,0.0,1.0,1636,1682
2009-03-11,Guam,Mongolia,1,0,1,1.0,0.0,1361,1407
2009-03-11,Macau,Northern Mariana Islands,6,1,5,1.0,0.0,1342,1449
2009-03-11,Mexico,Bolivia,5,1,4,1.0,0.0,1925,1721
2009-03-11,Nepal,Pakistan,1,0,1,1.0,0.0,1385,1356
2009-03-13,Guam,Northern Mariana Islands,2,1,1,1.0,0.0,1371,1440
2009-03-13,Macau,Mongolia,1,2,1,0.0,1.0,1336,1414
2009-03-14,Iran,Kenya,1,0,1,1.0,0.0,1926,1643
2009-03-14,Nepal,Sri Lanka,4,2,2,1.0,0.0,1394,1410
2009-03-15,Guam,Macau,2,2,0,0.5,0.5,1371,1337
2009-03-15,Northern Mariana Islands,Mongolia,1,4,3,0.0,1.0,1432,1423
2009-03-17,Qatar,Kuwait,1,0,1,1.0,0.0,1773,1719
2009-03-18,Trinidad and Tobago,Panama,1,0,1,1.0,0.0,1768,1710
2009-03-21,Namibia,Botswana,0,0,0,0.5,0.5,1540,1583
2009-03-21,Syria,Qatar,1,2,1,0.0,1.0,1756,1781
2009-03-21,Uganda,Malawi,2,1,1,1.0,0.0,1689,1597
2009-03-21,Alderney,Guernsey,0,5,5,0.0,1.0,1279,1677
2009-03-22,Iceland,Faroe Islands,1,2,1,0.0,1.0,1655,1461
2009-03-22,Saudi Arabia,Iraq,0,0,0,0.5,0.5,1887,1754
2009-03-23,Bahrain,Zimbabwe,5,2,3,1.0,0.0,1796,1675
2009-03-23,Kuwait,Iran,0,1,1,0.0,1.0,1716,1930
2009-03-25,Angola,Cape Verde,0,1,1,0.0,1.0,1704,1576
2009-03-26,Nepal,Palestine,0,0,0,0.5,0.5,1397,1508
2009-03-28,Albania,Hungary,0,1,1,0.0,1.0,1615,1752
2009-03-28,Argentina,Venezuela,4,0,4,1.0,0.0,2037,1779
2009-03-28,Armenia,Estonia,2,2,0,0.5,0.5,1586,1591
2009-03-28,Belgium,Bosnia and Herzegovina,2,4,2,0.0,1.0,1809,1700
2009-03-28,Burkina Faso,Guinea,4,2,2,1.0,0.0,1646,1733
2009-03-28,Cape Verde,Equatorial Guinea,5,0,5,1.0,0.0,1582,1480
2009-03-28,Colombia,Bolivia,2,0,2,1.0,0.0,1874,1717
2009-03-28,Cyprus,Georgia,2,1,1,1.0,0.0,1683,1622
2009-03-28,El Salvador,United States,2,2,0,0.5,0.5,1663,1973
2009-03-28,England,Slovakia,4,0,4,1.0,0.0,2020,1753
2009-03-28,Germany,Liechtenstein,4,0,4,1.0,0.0,2025,1411
2009-03-28,Iran,Saudi Arabia,1,2,1,0.0,1.0,1922,1896
2009-03-28,Republic of Ireland,Bulgaria,1,1,0,0.5,0.5,1902,1857
2009-03-28,Israel,Greece,1,1,0,0.5,0.5,1821,1880
2009-03-28,Japan,Bahrain,1,0,1,1.0,0.0,1936,1791
2009-03-28,Kenya,Tunisia,1,2,1,0.0,1.0,1640,1847
2009-03-28,North Korea,United Arab Emirates,2,0,2,1.0,0.0,1739,1713
2009-03-28,South Korea,Iraq,2,1,1,1.0,0.0,1892,1749
2009-03-28,Lithuania,France,0,1,1,0.0,1.0,1663,2029
2009-03-28,Luxembourg,Latvia,0,4,4,0.0,1.0,1376,1634
2009-03-28,Malta,Denmark,0,3,3,0.0,1.0,1454,1928
2009-03-28,Mexico,Costa Rica,2,0,2,1.0,0.0,1931,1824
2009-03-28,Moldova,Switzerland,0,2,2,0.0,1.0,1571,1873
2009-03-28,Montenegro,Italy,0,2,2,0.0,1.0,1577,2012
2009-03-28,Morocco,Gabon,1,2,1,0.0,1.0,1856,1723
2009-03-28,Nepal,Kyrgyzstan,1,1,0,0.5,0.5,1399,1460
2009-03-28,Netherlands,Scotland,3,0,3,1.0,0.0,2039,1810
2009-03-28,Northern Ireland,Poland,3,2,1,1.0,0.0,1716,1866
2009-03-28,Oman,Senegal,2,0,2,1.0,0.0,1840,1799
2009-03-28,Portugal,Sweden,0,0,0,0.5,0.5,1945,1887
2009-03-28,Romania,Serbia,2,3,1,0.0,1.0,1904,1828
2009-03-28,Russia,Azerbaijan,2,0,2,1.0,0.0,1902,1555
2009-03-28,Rwanda,Algeria,0,0,0,0.5,0.5,1618,1712
2009-03-28,Slovenia,Czech Republic,0,0,0,0.5,0.5,1715,1948
2009-03-28,South Africa,Norway,2,1,1,1.0,0.0,1803,1833
2009-03-28,Spain,Turkey,1,0,1,1.0,0.0,2112,1884
2009-03-28,Sri Lanka,Maldives,1,1,0,0.5,0.5,1411,1448
2009-03-28,Sudan,Mali,1,1,0,0.5,0.5,1639,1754
2009-03-28,Thailand,New Zealand,3,1,2,1.0,0.0,1756,1704
2009-03-28,Togo,Cameroon,1,0,1,1.0,0.0,1689,1866
2009-03-28,Trinidad and Tobago,Honduras,1,1,0,0.5,0.5,1770,1839
2009-03-28,Uruguay,Paraguay,2,0,2,1.0,0.0,1908,1885
2009-03-28,Uzbekistan,Qatar,4,0,4,1.0,0.0,1743,1772
2009-03-28,Wales,Finland,0,2,2,0.0,1.0,1765,1768
2009-03-29,Mozambique,Nigeria,0,0,0,0.5,0.5,1628,1870
2009-03-29,Ivory Coast,Malawi,5,0,5,1.0,0.0,1866,1595
2009-03-29,Ecuador,Brazil,1,1,0,0.5,0.5,1820,2064
2009-03-29,Peru,Chile,1,3,2,0.0,1.0,1740,1872
2009-03-29,Egypt,Zambia,1,1,0,0.5,0.5,1894,1708
2009-03-29,Ghana,Benin,1,0,1,1.0,0.0,1817,1565
2009-03-30,Kyrgyzstan,Palestine,1,1,0,0.5,0.5,1462,1507
2009-03-31,Angola,Morocco,0,2,2,0.0,1.0,1700,1861
2009-03-31,Panama,Haiti,4,0,4,1.0,0.0,1717,1654
2009-03-31,Portugal,South Africa,2,0,2,1.0,0.0,1950,1799
2009-03-31,Venezuela,Colombia,2,0,2,1.0,0.0,1790,1864
2009-04-01,Andorra,Croatia,0,2,2,0.0,1.0,1383,1963
2009-04-01,Australia,Uzbekistan,2,0,2,1.0,0.0,1913,1739
2009-04-01,Austria,Romania,2,1,1,1.0,0.0,1759,1893
2009-04-01,Bahrain,Qatar,1,0,1,1.0,0.0,1799,1765
2009-04-01,Bosnia and Herzegovina,Belgium,2,1,1,1.0,0.0,1711,1799
2009-04-01,Bulgaria,Cyprus,2,0,2,1.0,0.0,1862,1679
2009-04-01,Costa Rica,El Salvador,1,0,1,1.0,0.0,1829,1659
2009-04-01,Czech Republic,Slovakia,1,2,1,0.0,1.0,1936,1766
2009-04-01,Denmark,Albania,3,0,3,1.0,0.0,1931,1613
2009-04-01,England,Ukraine,2,1,1,1.0,0.0,2025,1856
2009-04-01,Estonia,Armenia,1,0,1,1.0,0.0,1599,1579
2009-04-01,France,Lithuania,1,0,1,1.0,0.0,2031,1662
2009-04-01,Georgia,Montenegro,0,0,0,0.5,0.5,1621,1579
2009-04-01,Greece,Israel,2,1,1,1.0,0.0,1887,1815
2009-04-01,Honduras,Mexico,3,1,2,1.0,0.0,1850,1921
2009-04-01,Hungary,Malta,3,0,3,1.0,0.0,1755,1452
2009-04-01,Iran,Senegal,1,1,0,0.5,0.5,1920,1802
2009-04-01,Italy,Republic of Ireland,1,1,0,0.5,0.5,2010,1905
2009-04-01,Kazakhstan,Belarus,1,5,4,0.0,1.0,1558,1681
2009-04-01,South Korea,North Korea,1,0,1,1.0,0.0,1897,1735
2009-04-01,Latvia,Luxembourg,2,0,2,1.0,0.0,1637,1374
2009-04-01,Lebanon,Namibia,1,1,0,0.5,0.5,1595,1542
2009-04-01,Lesotho,Botswana,0,0,0,0.5,0.5,1466,1581
2009-04-01,Liechtenstein,Russia,0,1,1,0.0,1.0,1411,1903
2009-04-01,Netherlands,North Macedonia,4,0,4,1.0,0.0,2041,1669
2009-04-01,Northern Ireland,Slovenia,1,0,1,1.0,0.0,1724,1708
2009-04-01,Norway,Finland,3,2,1,1.0,0.0,1840,1762
2009-04-01,Poland,San Marino,10,0,10,1.0,0.0,1867,1362
2009-04-01,Saudi Arabia,United Arab Emirates,3,2,1,1.0,0.0,1901,1709
2009-04-01,Scotland,Iceland,2,1,1,1.0,0.0,1815,1651
2009-04-01,Serbia,Sweden,2,0,2,1.0,0.0,1838,1878
2009-04-01,Switzerland,Moldova,2,0,2,1.0,0.0,1876,1569
2009-04-01,Turkey,Spain,1,2,1,0.0,1.0,1881,2116
2009-04-01,United States,Trinidad and Tobago,3,0,3,1.0,0.0,1977,1767
2009-04-01,Wales,Germany,0,2,2,0.0,1.0,1763,2028
2009-04-01,Bolivia,Argentina,6,1,5,1.0,0.0,1731,2024
2009-04-01,Ecuador,Paraguay,1,1,0,0.5,0.5,1822,1884
2009-04-01,Chile,Uruguay,0,0,0,0.5,0.5,1873,1908
2009-04-01,Brazil,Peru,3,0,3,1.0,0.0,2067,1738
2009-04-04,Angola,Namibia,0,0,0,0.5,0.5,1697,1546
2009-04-04,Pakistan,Taiwan,1,1,0,0.5,0.5,1358,1419
2009-04-04,Sri Lanka,Brunei,5,1,4,1.0,0.0,1417,1291
2009-04-06,Brunei,Pakistan,0,6,6,0.0,1.0,1285,1365
2009-04-07,Macau,Mongolia,2,0,2,1.0,0.0,1347,1414
2009-04-08,Sri Lanka,Pakistan,2,2,0,0.5,0.5,1416,1367
2009-04-14,Maldives,Turkmenistan,1,3,2,0.0,1.0,1443,1578
2009-04-14,Mongolia,Macau,3,1,2,1.0,0.0,1421,1341
2009-04-14,Philippines,Bhutan,1,0,1,1.0,0.0,1332,1332
2009-04-16,Bhutan,Turkmenistan,0,7,7,0.0,1.0,1329,1582
2009-04-16,Maldives,Philippines,3,2,1,1.0,0.0,1449,1327
2009-04-18,Maldives,Bhutan,5,0,5,1.0,0.0,1455,1324
2009-04-18,Turkmenistan,Philippines,5,0,5,1.0,0.0,1585,1325
2009-04-22,French Guiana,Suriname,0,0,0,0.5,0.5,1464,1569
2009-04-26,Bangladesh,Cambodia,1,0,1,1.0,0.0,1428,1329
2009-04-26,Myanmar,Macau,4,0,4,1.0,0.0,1581,1338
2009-04-28,Bangladesh,Myanmar,1,2,1,0.0,1.0,1424,1586
2009-04-28,Macau,Cambodia,1,2,1,0.0,1.0,1330,1338
2009-04-30,Bangladesh,Macau,3,0,3,1.0,0.0,1430,1325
2009-04-30,Myanmar,Cambodia,1,0,1,1.0,0.0,1590,1335
2009-05-03,Guernsey,Jersey,0,1,1,0.0,1.0,1671,1734
2009-05-09,Tanzania,DR Congo,0,2,2,0.0,1.0,1610,1686
2009-05-13,Jordan,Zimbabwe,2,0,2,1.0,0.0,1713,1668
2009-05-13,Venezuela,Costa Rica,1,1,0,0.5,0.5,1791,1829
2009-05-20,Argentina,Panama,3,1,2,1.0,0.0,2027,1715
2009-05-23,Jamaica,Haiti,2,2,0,0.5,0.5,1796,1658
2009-05-26,Qatar,Saudi Arabia,2,1,1,1.0,0.0,1776,1891
2009-05-27,El Salvador,Ecuador,3,1,2,1.0,0.0,1671,1811
2009-05-27,Japan,Chile,4,0,4,1.0,0.0,1943,1867
2009-05-27,Jordan,Congo,1,1,0,0.5,0.5,1711,1626
2009-05-28,Tunisia,Sudan,4,0,4,1.0,0.0,1851,1636
2009-05-29,Belgium,Chile,1,1,0,0.5,0.5,1801,1866
2009-05-29,China PR,Germany,1,1,0,0.5,0.5,1779,2024
2009-05-29,Republic of Ireland,Nigeria,1,1,0,0.5,0.5,1905,1871
2009-05-29,Wales,Estonia,1,0,1,1.0,0.0,1768,1595
2009-05-30,Cyprus,Canada,0,1,1,0.0,1.0,1673,1733
2009-05-30,El Salvador,Jamaica,0,0,0,0.5,0.5,1674,1794
2009-05-30,Oman,Egypt,0,1,1,0.0,1.0,1834,1901
2009-05-31,Bahrain,Congo,3,1,2,1.0,0.0,1804,1622
2009-05-31,Ghana,Uganda,2,1,1,1.0,0.0,1823,1684
2009-05-31,Japan,Belgium,4,0,4,1.0,0.0,1948,1797
2009-05-31,Kuwait,Vietnam,0,1,1,0.0,1.0,1707,1647
2009-05-31,Malawi,Rwanda,2,0,2,1.0,0.0,1604,1610
2009-05-31,Qatar,Iraq,1,0,1,1.0,0.0,1784,1742
2009-06-01,China PR,Iran,1,0,1,1.0,0.0,1791,1909
2009-06-01,Uzbekistan,Bosnia and Herzegovina,0,0,0,0.5,0.5,1739,1712
2009-06-02,France,Nigeria,0,1,1,0.0,1.0,2020,1883
2009-06-02,Turkey,Azerbaijan,2,0,2,1.0,0.0,1884,1553
2009-06-02,United Arab Emirates,Germany,2,7,5,0.0,1.0,1707,2027
2009-06-03,Antigua and Barbuda,Guyana,2,1,1,1.0,0.0,1546,1536
2009-06-03,Bahrain,Jordan,4,0,4,1.0,0.0,1810,1706
2009-06-03,Costa Rica,United States,3,1,2,1.0,0.0,1841,1966
2009-06-03,Tanzania,New Zealand,2,1,1,1.0,0.0,1621,1694
2009-06-04,China PR,Saudi Arabia,1,4,3,0.0,1.0,1786,1897
2009-06-05,Antigua and Barbuda,French Guiana,1,2,1,0.0,1.0,1537,1474
2009-06-05,Czech Republic,Malta,1,0,1,1.0,0.0,1937,1452
2009-06-05,France,Turkey,1,0,1,1.0,0.0,2026,1879
2009-06-06,Albania,Portugal,1,2,1,0.0,1.0,1611,1953
2009-06-06,Argentina,Colombia,1,0,1,1.0,0.0,2032,1860
2009-06-06,Azerbaijan,Wales,0,1,1,0.0,1.0,1550,1772
2009-06-06,Belarus,Andorra,5,1,4,1.0,0.0,1684,1381
2009-06-06,Bolivia,Venezuela,0,1,1,0.0,1.0,1725,1798
2009-06-06,Botswana,New Zealand,0,0,0,0.5,0.5,1584,1692
2009-06-06,Bulgaria,Republic of Ireland,1,1,0,0.5,0.5,1863,1905
2009-06-06,Croatia,Ukraine,2,2,0,0.5,0.5,1961,1859
2009-06-06,Cyprus,Montenegro,2,2,0,0.5,0.5,1671,1582
2009-06-06,El Salvador,Mexico,2,1,1,1.0,0.0,1687,1909
2009-06-06,Estonia,Equatorial Guinea,3,0,3,1.0,0.0,1601,1475
2009-06-06,Finland,Liechtenstein,2,1,1,1.0,0.0,1764,1410
2009-06-06,Gabon,Togo,3,0,3,1.0,0.0,1731,1682
2009-06-06,Georgia,Moldova,1,2,1,0.0,1.0,1612,1579
2009-06-06,Iceland,Netherlands,1,2,1,0.0,1.0,1650,2043
2009-06-06,Italy,Northern Ireland,3,0,3,1.0,0.0,2013,1722
2009-06-06,Kazakhstan,England,0,4,4,0.0,1.0,1557,2027
2009-06-06,North Korea,Iran,0,0,0,0.5,0.5,1739,1906
2009-06-06,Lithuania,Romania,0,1,1,0.0,1.0,1659,1897
2009-06-06,North Macedonia,Norway,0,0,0,0.5,0.5,1673,1837
2009-06-06,Malawi,Burkina Faso,0,1,1,0.0,1.0,1597,1654
2009-06-06,Namibia,DR Congo,4,0,4,1.0,0.0,1558,1675
2009-06-06,Paraguay,Chile,0,2,2,0.0,1.0,1876,1875
2009-06-06,Qatar,Australia,0,0,0,0.5,0.5,1787,1911
2009-06-06,Serbia,Austria,1,0,1,1.0,0.0,1845,1753
2009-06-06,Slovakia,San Marino,7,0,7,1.0,0.0,1768,1361
2009-06-06,South Africa,Poland,1,0,1,1.0,0.0,1809,1858
2009-06-06,Sweden,Denmark,0,1,1,0.0,1.0,1872,1938
2009-06-06,Trinidad and Tobago,Costa Rica,2,3,1,0.0,1.0,1761,1848
2009-06-06,Tunisia,Mozambique,2,0,2,1.0,0.0,1855,1625
2009-06-06,United Arab Emirates,South Korea,0,2,2,0.0,1.0,1703,1902
2009-06-06,Uruguay,Brazil,0,4,4,0.0,1.0,1904,2072
2009-06-06,United States,Honduras,2,1,1,1.0,0.0,1972,1845
2009-06-06,Uzbekistan,Japan,0,1,1,0.0,1.0,1736,1952
2009-06-06,Zambia,Rwanda,1,0,1,1.0,0.0,1714,1605
2009-06-06,Corsica,Congo,1,1,0,0.5,0.5,1512,1620
2009-06-07,Cameroon,Morocco,0,0,0,0.5,0.5,1866,1862
2009-06-07,Guinea,Ivory Coast,1,2,1,0.0,1.0,1728,1872
2009-06-07,Guyana,French Guiana,2,3,1,0.0,1.0,1527,1484
2009-06-07,Jamaica,Panama,3,2,1,1.0,0.0,1801,1709
2009-06-07,Peru,Ecuador,1,2,1,0.0,1.0,1732,1818
2009-06-07,Algeria,Egypt,3,1,2,1.0,0.0,1724,1890
2009-06-07,Benin,Sudan,1,0,1,1.0,0.0,1575,1627
2009-06-07,Mali,Ghana,0,2,2,0.0,1.0,1748,1830
2009-06-07,Nigeria,Kenya,3,0,3,1.0,0.0,1887,1637
2009-06-09,Azerbaijan,Spain,0,6,6,0.0,1.0,1550,2117
2009-06-09,Bosnia and Herzegovina,Oman,2,1,1,1.0,0.0,1723,1824
2009-06-09,Iraq,Poland,1,1,0,0.5,0.5,1745,1856
2009-06-10,Albania,Georgia,1,1,0,0.5,0.5,1612,1612
2009-06-10,Australia,Bahrain,2,0,2,1.0,0.0,1917,1805
2009-06-10,Belarus,Moldova,2,2,0,0.5,0.5,1682,1582
2009-06-10,Brazil,Paraguay,2,1,1,1.0,0.0,2076,1873
2009-06-10,Chile,Bolivia,4,0,4,1.0,0.0,1880,1721
2009-06-10,Colombia,Peru,1,0,1,1.0,0.0,1866,1727
2009-06-10,Ecuador,Argentina,2,0,2,1.0,0.0,1831,2020
2009-06-10,England,Andorra,6,0,6,1.0,0.0,2028,1381
2009-06-10,Estonia,Portugal,0,0,0,0.5,0.5,1608,1947
2009-06-10,Faroe Islands,Serbia,0,2,2,0.0,1.0,1460,1847
2009-06-10,Finland,Russia,0,3,3,0.0,1.0,1760,1908
2009-06-10,Honduras,El Salvador,1,0,1,1.0,0.0,1850,1683
2009-06-10,Iran,United Arab Emirates,1,0,1,1.0,0.0,1910,1700
2009-06-10,Italy,New Zealand,4,3,1,1.0,0.0,2016,1690
2009-06-10,Japan,Qatar,1,1,0,0.5,0.5,1949,1791
2009-06-10,South Korea,Saudi Arabia,0,0,0,0.5,0.5,1902,1898
2009-06-10,North Macedonia,Iceland,2,0,2,1.0,0.0,1681,1643
2009-06-10,Mexico,Trinidad and Tobago,2,1,1,1.0,0.0,1914,1757
2009-06-10,Netherlands,Norway,2,0,2,1.0,0.0,2047,1834
2009-06-10,Sweden,Malta,4,0,4,1.0,0.0,1874,1451
2009-06-10,Ukraine,Kazakhstan,2,1,1,1.0,0.0,1862,1555
2009-06-10,Venezuela,Uruguay,2,2,0,0.5,0.5,1801,1902
2009-06-11,Tonga,Cook Islands,1,1,0,0.5,0.5,1461,1439
2009-06-13,Ivory Coast,Cameroon,2,1,1,1.0,0.0,1880,1859
2009-06-13,Tonga,Cook Islands,1,2,1,0.0,1.0,1453,1448
2009-06-14,Madagascar,Mayotte,2,0,2,1.0,0.0,1590,1466
2009-06-14,New Zealand,Spain,0,5,5,0.0,1.0,1689,2119
2009-06-14,South Africa,Iraq,0,0,0,0.5,0.5,1808,1747
2009-06-15,Brazil,Egypt,4,3,1,1.0,0.0,2081,1886
2009-06-15,United States,Italy,1,3,2,0.0,1.0,1966,2023
2009-06-17,Australia,Japan,2,1,1,1.0,0.0,1926,1941
2009-06-17,Bahrain,Uzbekistan,1,0,1,1.0,0.0,1812,1730
2009-06-17,South Korea,Iran,1,1,0,0.5,0.5,1903,1910
2009-06-17,Saudi Arabia,North Korea,0,0,0,0.5,0.5,1895,1743
2009-06-17,South Africa,New Zealand,2,0,2,1.0,0.0,1814,1684
2009-06-17,Spain,Iraq,1,0,1,1.0,0.0,2121,1746
2009-06-18,Egypt,Italy,1,0,1,1.0,0.0,1898,2012
2009-06-18,United States,Brazil,0,3,3,0.0,1.0,1961,2087
2009-06-19,Haiti,Panama,1,1,0,0.5,0.5,1660,1708
2009-06-19,Eswatini,Lesotho,1,1,0,0.5,0.5,1498,1467
2009-06-20,Burkina Faso,Ivory Coast,2,3,1,0.0,1.0,1651,1884
2009-06-20,Iraq,New Zealand,0,0,0,0.5,0.5,1745,1686
2009-06-20,Kenya,Mozambique,2,1,1,1.0,0.0,1645,1618
2009-06-20,Morocco,Togo,0,0,0,0.5,0.5,1859,1686
2009-06-20,South Africa,Spain,0,2,2,0.0,1.0,1812,2124
2009-06-20,Sudan,Ghana,0,2,2,0.0,1.0,1624,1834
2009-06-20,Tunisia,Nigeria,0,0,0,0.5,0.5,1856,1887
2009-06-20,Zambia,Algeria,0,2,2,0.0,1.0,1707,1732
2009-06-21,Egypt,United States,0,3,3,0.0,1.0,1892,1968
2009-06-21,Italy,Brazil,0,3,3,0.0,1.0,2006,2094
2009-06-21,Eswatini,Lesotho,1,1,0,0.5,0.5,1498,1468
2009-06-21,Guinea,Malawi,2,1,1,1.0,0.0,1734,1592
2009-06-21,Mali,Benin,3,1,2,1.0,0.0,1753,1571
2009-06-22,Padania,Occitania,1,0,1,1.0,0.0,1550,1496
2009-06-22,Provence,Gozo,3,1,2,1.0,0.0,1476,1492
2009-06-23,Haiti,Martinique,0,0,0,0.5,0.5,1661,1669
2009-06-23,Occitania,Iraqi Kurdistan,0,4,4,0.0,1.0,1488,1504
2009-06-23,Sápmi,Provence,1,2,1,0.0,1.0,1524,1486
2009-06-24,Mexico,Venezuela,4,0,4,1.0,0.0,1920,1796
2009-06-24,Spain,United States,0,2,2,0.0,1.0,2113,1980
2009-06-24,Padania,Iraqi Kurdistan,2,1,1,1.0,0.0,1557,1498
2009-06-24,Sápmi,Gozo,7,2,5,1.0,0.0,1532,1485
2009-06-25,South Africa,Brazil,0,1,1,0.0,1.0,1810,2097
2009-06-25,Provence,Iraqi Kurdistan,0,6,6,0.0,1.0,1479,1506
2009-06-25,Padania,Sápmi,4,0,4,1.0,0.0,1565,1525
2009-06-26,Occitania,Gozo,2,1,1,1.0,0.0,1496,1478
2009-06-26,Provence,Sápmi,4,4,0,0.5,0.5,1481,1524
2009-06-27,Costa Rica,Venezuela,1,0,1,1.0,0.0,1855,1790
2009-06-27,Haiti,Syria,1,2,1,0.0,1.0,1656,1762
2009-06-27,Padania,Iraqi Kurdistan,2,0,2,1.0,0.0,1572,1500
2009-06-28,Cayman Islands,Jamaica,1,4,3,0.0,1.0,1437,1803
2009-06-28,Grenada,Antigua and Barbuda,2,2,0,0.5,0.5,1578,1538
2009-06-28,Mexico,Guatemala,0,0,0,0.5,0.5,1916,1687
2009-06-28,Panama,Honduras,0,2,2,0.0,1.0,1704,1855
2009-06-28,South Africa,Spain,2,3,1,0.0,1.0,1808,2116
2009-06-28,United States,Brazil,2,3,1,0.0,1.0,1975,2103
2009-06-28,Åland Islands,Greenland,4,2,2,1.0,0.0,1533,1457
2009-06-28,Shetland,Menorca,2,2,0,0.5,0.5,1518,1510
2009-06-28,Gibraltar,Guernsey,0,0,0,0.5,0.5,1573,1669
2009-06-28,Ynys Môn,Frøya,3,0,3,1.0,0.0,1578,1464
2009-06-28,Rhodes,Isle of Wight,2,0,2,1.0,0.0,1545,1556
2009-06-28,Saare County,Jersey,0,1,1,0.0,1.0,1414,1737
2009-06-28,Western Isles,Gotland,2,1,1,1.0,0.0,1542,1516
2009-06-28,Falkland Islands,Isle of Man,1,2,1,0.0,1.0,1462,1546
2009-06-29,Menorca,Greenland,6,0,6,1.0,0.0,1517,1451
2009-06-29,Åland Islands,Shetland,2,1,1,1.0,0.0,1541,1511
2009-06-29,Ynys Môn,Guernsey,0,2,2,0.0,1.0,1573,1675
2009-06-29,Frøya,Gibraltar,0,8,8,0.0,1.0,1459,1579
2009-06-29,Jersey,Rhodes,1,0,1,1.0,0.0,1741,1542
2009-06-29,Isle of Wight,Saare County,5,1,4,1.0,0.0,1561,1410
2009-06-29,Isle of Man,Western Isles,5,0,5,1.0,0.0,1554,1535
2009-06-29,Gotland,Falkland Islands,2,0,2,1.0,0.0,1523,1456
2009-06-30,Guatemala,Canada,0,3,3,0.0,1.0,1681,1740
2009-06-30,Greenland,Shetland,3,1,2,1.0,0.0,1461,1502
2009-06-30,Åland Islands,Menorca,1,1,0,0.5,0.5,1541,1518
2009-06-30,Gibraltar,Ynys Môn,1,3,2,0.0,1.0,1571,1582
2009-06-30,Guernsey,Frøya,8,0,8,1.0,0.0,1679,1456
2009-06-30,Rhodes,Saare County,3,0,3,1.0,0.0,1548,1405
2009-06-30,Jersey,Isle of Wight,4,1,3,1.0,0.0,1746,1557
2009-06-30,Western Isles,Falkland Islands,7,1,6,1.0,0.0,1542,1450
2009-06-30,Isle of Man,Gotland,4,2,2,1.0,0.0,1562,1516
2009-07-02,Falkland Islands,Frøya,1,3,2,0.0,1.0,1443,1464
2009-07-02,Shetland,Saare County,3,2,1,1.0,0.0,1508,1400
2009-07-02,Gotland,Greenland,4,2,2,1.0,0.0,1523,1455
2009-07-02,Åland Islands,Isle of Man,2,1,1,1.0,0.0,1550,1554
2009-07-02,Guernsey,Jersey,0,2,2,0.0,1.0,1673,1753
2009-07-03,Canada,Jamaica,1,0,1,1.0,0.0,1750,1794
2009-07-03,Costa Rica,El Salvador,1,2,1,0.0,1.0,1844,1695
2009-07-03,Gibraltar,Isle of Wight,3,0,3,1.0,0.0,1579,1550
2009-07-03,Menorca,Western Isles,4,1,3,1.0,0.0,1527,1534
2009-07-03,Rhodes,Ynys Môn,4,0,4,1.0,0.0,1557,1574
2009-07-03,Isle of Man,Guernsey,0,5,5,0.0,1.0,1549,1679
2009-07-03,Åland Islands,Jersey,1,2,1,0.0,1.0,1547,1757
2009-07-04,Honduras,Haiti,1,0,1,1.0,0.0,1859,1653
2009-07-04,United States,Grenada,4,0,4,1.0,0.0,1977,1577
2009-07-05,Botswana,Iran,1,1,0,0.5,0.5,1590,1905
2009-07-05,Egypt,Rwanda,3,0,3,1.0,0.0,1895,1603
2009-07-05,Nicaragua,Mexico,0,2,2,0.0,1.0,1381,1917
2009-07-05,Panama,Guadeloupe,1,2,1,0.0,1.0,1696,1673
2009-07-06,Malawi,Eswatini,3,1,2,1.0,0.0,1598,1493
2009-07-07,El Salvador,Canada,0,1,1,0.0,1.0,1689,1757
2009-07-07,Jamaica,Costa Rica,0,1,1,0.0,1.0,1788,1851
2009-07-08,Haiti,Grenada,2,0,2,1.0,0.0,1660,1571
2009-07-08,United States,Honduras,2,0,2,1.0,0.0,1983,1854
2009-07-09,Guadeloupe,Nicaragua,2,0,2,1.0,0.0,1676,1379
2009-07-09,Mexico,Panama,1,1,0,0.5,0.5,1913,1701
2009-07-10,Costa Rica,Canada,2,2,0,0.5,0.5,1849,1760
2009-07-10,El Salvador,Jamaica,0,1,1,0.0,1.0,1684,1794
2009-07-10,Iraq,Palestine,3,0,3,1.0,0.0,1749,1504
2009-07-11,Honduras,Grenada,4,0,4,1.0,0.0,1857,1569
2009-07-11,United States,Haiti,2,2,0,0.5,0.5,1978,1666
2009-07-12,Mayotte,Madagascar,2,2,0,0.5,0.5,1469,1588
2009-07-12,Mexico,Guadeloupe,2,0,2,1.0,0.0,1917,1673
2009-07-12,Panama,Nicaragua,4,0,4,1.0,0.0,1704,1377
2009-07-12,Saint Kitts and Nevis,Trinidad and Tobago,2,3,1,0.0,1.0,1544,1761
2009-07-13,Iraq,Palestine,4,0,4,1.0,0.0,1753,1501
2009-07-18,Canada,Honduras,0,1,1,0.0,1.0,1755,1863
2009-07-18,China PR,Palestine,3,1,2,1.0,0.0,1789,1499
2009-07-18,United States,Panama,2,1,1,1.0,0.0,1981,1702
2009-07-19,Guadeloupe,Costa Rica,1,5,4,0.0,1.0,1669,1854
2009-07-19,Mexico,Haiti,4,0,4,1.0,0.0,1921,1663
2009-07-23,Costa Rica,Mexico,1,1,0,0.5,0.5,1856,1920
2009-07-23,United States,Honduras,2,0,2,1.0,0.0,1987,1858
2009-07-25,China PR,Kyrgyzstan,3,0,3,1.0,0.0,1792,1460
2009-07-26,United States,Mexico,0,5,5,0.0,1.0,1978,1930
2009-08-07,Colombia,El Salvador,2,1,1,1.0,0.0,1871,1680
2009-08-11,Benin,Gabon,1,1,0,0.5,0.5,1575,1728
2009-08-12,Albania,Cyprus,6,1,5,1.0,0.0,1622,1662
2009-08-12,Algeria,Uruguay,1,0,1,1.0,0.0,1744,1891
2009-08-12,Armenia,Moldova,1,4,3,0.0,1.0,1572,1590
2009-08-12,Austria,Cameroon,0,2,2,0.0,1.0,1748,1865
2009-08-12,Azerbaijan,Germany,0,2,2,0.0,1.0,1550,2028
2009-08-12,Belarus,Croatia,1,3,2,0.0,1.0,1680,1964
2009-08-12,Bosnia and Herzegovina,Iran,2,3,1,0.0,1.0,1719,1910
2009-08-12,Bulgaria,Latvia,1,0,1,1.0,0.0,1867,1634
2009-08-12,Colombia,Venezuela,1,2,1,0.0,1.0,1862,1800
2009-08-12,DR Congo,Senegal,1,2,1,0.0,1.0,1670,1808
2009-08-12,Czech Republic,Belgium,3,1,2,1.0,0.0,1942,1793
2009-08-12,Denmark,Chile,1,2,1,0.0,1.0,1929,1890
2009-08-12,Ecuador,Jamaica,0,0,0,0.5,0.5,1831,1795
2009-08-12,Egypt,Guinea,3,3,0,0.5,0.5,1892,1738
2009-08-12,Estonia,Brazil,0,1,1,0.0,1.0,1608,2104
2009-08-12,Faroe Islands,France,0,1,1,0.0,1.0,1460,2027
2009-08-12,Ghana,Zambia,4,1,3,1.0,0.0,1840,1702
2009-08-12,Honduras,Costa Rica,4,0,4,1.0,0.0,1866,1849
2009-08-12,Hungary,Romania,0,1,1,0.0,1.0,1751,1902
2009-08-12,Iceland,Slovakia,1,1,0,0.5,0.5,1646,1766
2009-08-12,Republic of Ireland,Australia,0,3,3,0.0,1.0,1898,1934
2009-08-12,South Korea,Paraguay,1,0,1,1.0,0.0,1911,1866
2009-08-12,Liechtenstein,Portugal,0,3,3,0.0,1.0,1410,1948
2009-08-12,Luxembourg,Lithuania,0,1,1,0.0,1.0,1372,1662
2009-08-12,North Macedonia,Spain,2,3,1,0.0,1.0,1680,2118
2009-08-12,Malaysia,Kenya,0,0,0,0.5,0.5,1562,1644
2009-08-12,Mali,Burkina Faso,3,0,3,1.0,0.0,1759,1646
2009-08-12,Malta,Georgia,2,0,2,1.0,0.0,1463,1601
2009-08-12,Mexico,United States,2,1,1,1.0,0.0,1940,1969
2009-08-12,Montenegro,Wales,2,1,1,1.0,0.0,1594,1761
2009-08-12,Morocco,Congo,1,1,0,0.5,0.5,1855,1625
2009-08-12,Mozambique,Eswatini,1,0,1,1.0,0.0,1624,1488
2009-08-12,Netherlands,England,2,2,0,0.5,0.5,2047,2029
2009-08-12,Northern Ireland,Israel,1,1,0,0.5,0.5,1725,1813
2009-08-12,Norway,Scotland,4,0,4,1.0,0.0,1842,1808
2009-08-12,Oman,Saudi Arabia,2,1,1,1.0,0.0,1834,1886
2009-08-12,Poland,Greece,2,0,2,1.0,0.0,1865,1879
2009-08-12,Russia,Argentina,2,3,1,0.0,1.0,1903,2026
2009-08-12,Rwanda,Tanzania,1,2,1,0.0,1.0,1596,1629
2009-08-12,Singapore,China PR,1,1,0,0.5,0.5,1672,1790
2009-08-12,Slovenia,San Marino,5,0,5,1.0,0.0,1710,1360
2009-08-12,South Africa,Serbia,1,3,2,0.0,1.0,1801,1855
2009-08-12,Sweden,Finland,1,0,1,1.0,0.0,1880,1755
2009-08-12,Switzerland,Italy,0,0,0,0.5,0.5,1879,2004
2009-08-12,Togo,Angola,0,2,2,0.0,1.0,1679,1705
2009-08-12,Trinidad and Tobago,El Salvador,1,0,1,1.0,0.0,1768,1674
2009-08-12,Tunisia,Ivory Coast,0,0,0,0.5,0.5,1857,1884
2009-08-12,Ukraine,Turkey,0,3,3,0.0,1.0,1855,1887
2009-08-12,Zimbabwe,Lesotho,1,1,0,0.5,0.5,1664,1473
2009-08-15,Malaysia,China PR,0,0,0,0.5,0.5,1567,1786
2009-08-16,Saint Kitts and Nevis,Jamaica,0,1,1,0.0,1.0,1541,1799
2009-08-19,India,Lebanon,0,1,1,0.0,1.0,1582,1603
2009-08-20,Syria,Kyrgyzstan,2,0,2,1.0,0.0,1765,1458
2009-08-22,Sri Lanka,Lebanon,4,3,1,1.0,0.0,1428,1592
2009-08-23,India,Kyrgyzstan,2,1,1,1.0,0.0,1588,1453
2009-08-23,North Korea,Guam,9,2,7,1.0,0.0,1745,1370
2009-08-24,Syria,Sri Lanka,4,0,4,1.0,0.0,1768,1426
2009-08-25,Hong Kong,North Korea,0,0,0,0.5,0.5,1572,1742
2009-08-25,Kyrgyzstan,Lebanon,1,1,0,0.5,0.5,1457,1589
2009-08-26,Bahrain,Kenya,2,1,1,1.0,0.0,1817,1640
2009-08-26,India,Sri Lanka,3,1,2,1.0,0.0,1593,1422
2009-08-27,Hong Kong,Guam,12,0,12,1.0,0.0,1576,1367
2009-08-27,Syria,Lebanon,1,0,1,1.0,0.0,1773,1585
2009-08-28,Sri Lanka,Kyrgyzstan,1,4,3,0.0,1.0,1415,1465
2009-08-29,India,Syria,0,1,1,0.0,1.0,1589,1778
2009-08-30,Saudi Arabia,Malaysia,2,1,1,1.0,0.0,1889,1565
2009-08-31,Bahrain,Iran,4,2,2,1.0,0.0,1828,1900
2009-08-31,India,Syria,1,1,0,0.5,0.5,1593,1775
2009-09-04,Malta,Cape Verde,0,2,2,0.0,1.0,1458,1588
2009-09-05,Angola,Senegal,1,1,0,0.5,0.5,1708,1806
2009-09-05,Argentina,Brazil,1,3,2,0.0,1.0,2020,2111
2009-09-05,Armenia,Bosnia and Herzegovina,0,2,2,0.0,1.0,1568,1724
2009-09-05,Austria,Faroe Islands,3,1,2,1.0,0.0,1751,1458
2009-09-05,Azerbaijan,Finland,1,2,1,0.0,1.0,1547,1759
2009-09-05,Bahrain,Saudi Arabia,0,0,0,0.5,0.5,1830,1888
2009-09-05,Bulgaria,Montenegro,4,1,3,1.0,0.0,1870,1592
2009-09-05,Chile,Venezuela,2,2,0,0.5,0.5,1888,1803
2009-09-05,Colombia,Ecuador,2,0,2,1.0,0.0,1870,1824
2009-09-05,Costa Rica,Mexico,0,3,3,0.0,1.0,1844,1946
2009-09-05,Croatia,Belarus,1,0,1,1.0,0.0,1967,1678
2009-09-05,Cyprus,Republic of Ireland,1,2,1,0.0,1.0,1659,1902
2009-09-05,Denmark,Portugal,1,1,0,0.5,0.5,1930,1948
2009-09-05,England,Slovenia,2,1,1,1.0,0.0,2032,1708
2009-09-05,France,Romania,1,1,0,0.5,0.5,2025,1905
2009-09-05,Gabon,Cameroon,0,2,2,0.0,1.0,1724,1870
2009-09-05,Georgia,Italy,0,2,2,0.0,1.0,1600,2006
2009-09-05,Germany,South Africa,2,0,2,1.0,0.0,2032,1798
2009-09-05,Honduras,Trinidad and Tobago,4,1,3,1.0,0.0,1872,1763
2009-09-05,Hungary,Sweden,1,2,1,0.0,1.0,1746,1886
2009-09-05,Iceland,Norway,1,1,0,0.5,0.5,1651,1838
2009-09-05,Israel,Latvia,0,1,1,0.0,1.0,1802,1646
2009-09-05,Ivory Coast,Burkina Faso,5,0,5,1.0,0.0,1888,1643
2009-09-05,Jordan,Malaysia,0,0,0,0.5,0.5,1703,1569
2009-09-05,South Korea,Australia,3,1,2,1.0,0.0,1920,1926
2009-09-05,Malawi,Guinea,2,1,1,1.0,0.0,1610,1727
2009-09-05,Moldova,Luxembourg,0,0,0,0.5,0.5,1586,1377
2009-09-05,Namibia,Eswatini,1,1,0,0.5,0.5,1557,1490
2009-09-05,Netherlands,Japan,3,0,3,1.0,0.0,2053,1936
2009-09-05,Paraguay,Bolivia,1,0,1,1.0,0.0,1871,1717
2009-09-05,Peru,Uruguay,1,0,1,1.0,0.0,1739,1880
2009-09-05,Poland,Northern Ireland,1,1,0,0.5,0.5,1862,1729
2009-09-05,Russia,Liechtenstein,3,0,3,1.0,0.0,1904,1410
2009-09-05,Rwanda,Egypt,0,1,1,0.0,1.0,1594,1895
2009-09-05,Scotland,North Macedonia,2,0,2,1.0,0.0,1814,1675
2009-09-05,Slovakia,Czech Republic,2,2,0,0.5,0.5,1770,1939
2009-09-05,Spain,Belgium,5,0,5,1.0,0.0,2121,1791
2009-09-05,Saint Vincent and the Grenadines,Saint Kitts and Nevis,0,3,3,0.0,1.0,1562,1550
2009-09-05,Switzerland,Greece,2,0,2,1.0,0.0,1887,1871
2009-09-05,Turkey,Estonia,4,2,2,1.0,0.0,1890,1606
2009-09-05,Ukraine,Andorra,5,0,5,1.0,0.0,1856,1381
2009-09-05,United States,El Salvador,2,1,1,1.0,0.0,1972,1672
2009-09-05,Uzbekistan,Iran,0,0,0,0.5,0.5,1734,1897
2009-09-06,Algeria,Zambia,1,0,1,1.0,0.0,1752,1695
2009-09-06,Benin,Mali,1,1,0,0.5,0.5,1579,1756
2009-09-06,Ghana,Sudan,2,0,2,1.0,0.0,1844,1621
2009-09-06,Mozambique,Kenya,1,0,1,1.0,0.0,1633,1632
2009-09-06,Nigeria,Tunisia,2,2,0,0.5,0.5,1887,1858
2009-09-06,Togo,Morocco,1,1,0,0.5,0.5,1683,1852
2009-09-08,Republic of Ireland,South Africa,1,0,1,1.0,0.0,1908,1793
2009-09-09,Albania,Denmark,1,1,0,0.5,0.5,1628,1925
2009-09-09,Andorra,Kazakhstan,1,3,2,0.0,1.0,1377,1560
2009-09-09,Angola,Cape Verde,1,1,0,0.5,0.5,1706,1591
2009-09-09,Armenia,Belgium,2,1,1,1.0,0.0,1581,1779
2009-09-09,Belarus,Ukraine,0,0,0,0.5,0.5,1682,1853
2009-09-09,Bolivia,Ecuador,1,3,2,0.0,1.0,1712,1830
2009-09-09,Bosnia and Herzegovina,Turkey,1,1,0,0.5,0.5,1728,1887
2009-09-09,Cameroon,Gabon,2,1,1,1.0,0.0,1875,1720
2009-09-09,Czech Republic,San Marino,7,0,7,1.0,0.0,1940,1360
2009-09-09,El Salvador,Costa Rica,1,0,1,1.0,0.0,1684,1833
2009-09-09,England,Croatia,5,1,4,1.0,0.0,2039,1961
2009-09-09,Faroe Islands,Lithuania,2,1,1,1.0,0.0,1471,1650
2009-09-09,Germany,Azerbaijan,4,0,4,1.0,0.0,2033,1547
2009-09-09,Hungary,Portugal,0,1,1,0.0,1.0,1743,1952
2009-09-09,Iceland,Georgia,3,1,2,1.0,0.0,1658,1594
2009-09-09,Israel,Luxembourg,7,0,7,1.0,0.0,1804,1376
2009-09-09,Italy,Bulgaria,2,0,2,1.0,0.0,2012,1865
2009-09-09,Japan,Ghana,4,3,1,1.0,0.0,1942,1839
2009-09-09,Jordan,New Zealand,1,3,2,0.0,1.0,1695,1695
2009-09-09,Latvia,Switzerland,2,2,0,0.5,0.5,1651,1883
2009-09-09,Liechtenstein,Finland,1,1,0,0.5,0.5,1417,1753
2009-09-09,Malta,Sweden,0,1,1,0.0,1.0,1457,1888
2009-09-09,Mexico,Honduras,1,0,1,1.0,0.0,1953,1866
2009-09-09,Moldova,Greece,1,1,0,0.5,0.5,1592,1866
2009-09-09,Montenegro,Cyprus,1,1,0,0.5,0.5,1594,1658
2009-09-09,Northern Ireland,Slovakia,0,2,2,0.0,1.0,1722,1778
2009-09-09,Norway,North Macedonia,2,1,1,1.0,0.0,1843,1671
2009-09-09,Qatar,Oman,1,1,0,0.5,0.5,1792,1834
2009-09-09,Romania,Austria,1,1,0,0.5,0.5,1902,1755
2009-09-09,Saudi Arabia,Bahrain,2,2,0,0.5,0.5,1887,1832
2009-09-09,Scotland,Netherlands,0,1,1,0.0,1.0,1811,2057
2009-09-09,Serbia,France,1,1,0,0.5,0.5,1859,2022
2009-09-09,Slovenia,Poland,3,0,3,1.0,0.0,1720,1851
2009-09-09,Spain,Estonia,3,0,3,1.0,0.0,2122,1606
2009-09-09,Trinidad and Tobago,United States,0,1,1,0.0,1.0,1760,1976
2009-09-09,Wales,Russia,1,3,2,0.0,1.0,1757,1909
2009-09-09,Uruguay,Colombia,3,1,2,1.0,0.0,1888,1863
2009-09-09,Paraguay,Argentina,1,0,1,1.0,0.0,1883,2009
2009-09-09,Brazil,Chile,4,2,2,1.0,0.0,2115,1885
2009-09-09,Venezuela,Peru,3,1,2,1.0,0.0,1810,1733
2009-09-11,Malaysia,Lesotho,5,0,5,1.0,0.0,1575,1468
2009-09-19,South Africa,Madagascar,1,0,1,1.0,0.0,1797,1585
2009-09-20,Saint Kitts and Nevis,Saint Vincent and the Grenadines,1,1,0,0.5,0.5,1551,1562
2009-09-30,Argentina,Ghana,2,0,2,1.0,0.0,2014,1835
2009-09-30,China PR,Botswana,4,1,3,1.0,0.0,1790,1587
2009-09-30,Mexico,Colombia,1,2,1,0.0,1.0,1943,1874
2009-10-02,Egypt,Mauritius,4,0,4,1.0,0.0,1897,1473
2009-10-05,Kuwait,Libya,1,1,0,0.5,0.5,1707,1674
2009-10-08,Croatia,Qatar,3,2,1,1.0,0.0,1966,1788
2009-10-08,Japan,Hong Kong,6,0,6,1.0,0.0,1944,1575
2009-10-10,Argentina,Peru,2,1,1,1.0,0.0,2017,1731
2009-10-10,Armenia,Spain,1,2,1,0.0,1.0,1581,2123
2009-10-10,Australia,Netherlands,0,0,0,0.5,0.5,1929,2055
2009-10-10,Austria,Lithuania,2,1,1,1.0,0.0,1761,1645
2009-10-10,Bahrain,New Zealand,0,0,0,0.5,0.5,1829,1699
2009-10-10,Belarus,Kazakhstan,4,0,4,1.0,0.0,1688,1555
2009-10-10,Belgium,Turkey,2,0,2,1.0,0.0,1790,1877
2009-10-10,Cameroon,Togo,3,0,3,1.0,0.0,1879,1680
2009-10-10,Colombia,Chile,2,4,2,0.0,1.0,1867,1893
2009-10-10,Costa Rica,Trinidad and Tobago,4,0,4,1.0,0.0,1840,1754
2009-10-10,Cyprus,Bulgaria,4,1,3,1.0,0.0,1671,1853
2009-10-10,Czech Republic,Poland,2,0,2,1.0,0.0,1946,1846
2009-10-10,Denmark,Sweden,1,0,1,1.0,0.0,1933,1881
2009-10-10,Ecuador,Uruguay,1,2,1,0.0,1.0,1824,1895
2009-10-10,Estonia,Bosnia and Herzegovina,0,2,2,0.0,1.0,1601,1734
2009-10-10,Finland,Wales,2,1,1,1.0,0.0,1762,1749
2009-10-10,France,Faroe Islands,5,0,5,1.0,0.0,2023,1471
2009-10-10,Gabon,Morocco,3,1,2,1.0,0.0,1731,1842
2009-10-10,Greece,Latvia,5,2,3,1.0,0.0,1870,1648
2009-10-10,Honduras,United States,2,3,1,0.0,1.0,1861,1982
2009-10-10,Republic of Ireland,Italy,2,2,0,0.5,0.5,1911,2010
2009-10-10,Israel,Moldova,3,1,2,1.0,0.0,1808,1589
2009-10-10,Japan,Scotland,2,0,2,1.0,0.0,1950,1806
2009-10-10,Kuwait,Jordan,2,1,1,1.0,0.0,1715,1688
2009-10-10,Liechtenstein,Azerbaijan,0,2,2,0.0,1.0,1412,1553
2009-10-10,Luxembourg,Switzerland,0,3,3,0.0,1.0,1376,1884
2009-10-10,Malawi,Ivory Coast,1,1,0,0.5,0.5,1616,1883
2009-10-10,Malta,Angola,1,2,1,0.0,1.0,1454,1710
2009-10-10,Mexico,El Salvador,4,1,3,1.0,0.0,1946,1682
2009-10-10,Montenegro,Georgia,2,1,1,1.0,0.0,1602,1586
2009-10-10,Norway,South Africa,1,0,1,1.0,0.0,1850,1791
2009-10-10,Portugal,Hungary,3,0,3,1.0,0.0,1956,1740
2009-10-10,Russia,Germany,0,1,1,0.0,1.0,1904,2039
2009-10-10,Serbia,Romania,5,0,5,1.0,0.0,1868,1894
2009-10-10,Slovakia,Slovenia,0,2,2,0.0,1.0,1769,1730
2009-10-10,Ukraine,England,1,0,1,1.0,0.0,1865,2028
2009-10-10,United Arab Emirates,Palestine,1,1,0,0.5,0.5,1696,1504
2009-10-10,Venezuela,Paraguay,1,2,1,0.0,1.0,1804,1890
2009-10-10,Zambia,Egypt,0,1,1,0.0,1.0,1692,1901
2009-10-11,Algeria,Rwanda,3,1,2,1.0,0.0,1757,1590
2009-10-11,Benin,Ghana,1,0,1,1.0,0.0,1593,1822
2009-10-11,Guinea,Burkina Faso,1,2,1,0.0,1.0,1718,1653
2009-10-11,North Macedonia,Qatar,2,1,1,1.0,0.0,1682,1778
2009-10-11,Mali,Sudan,1,0,1,1.0,0.0,1762,1616
2009-10-11,Nigeria,Mozambique,1,0,1,1.0,0.0,1891,1630
2009-10-11,Bolivia,Brazil,2,1,1,1.0,0.0,1727,2101
2009-10-11,Tunisia,Kenya,1,0,1,1.0,0.0,1862,1629
2009-10-13,Congo,North Korea,0,0,0,0.5,0.5,1628,1740
2009-10-13,Iceland,South Africa,1,0,1,1.0,0.0,1669,1781
2009-10-14,Andorra,Ukraine,0,6,6,0.0,1.0,1377,1866
2009-10-14,Angola,Cameroon,0,0,0,0.5,0.5,1714,1876
2009-10-14,Australia,Oman,1,0,1,1.0,0.0,1935,1829
2009-10-14,Azerbaijan,Russia,1,1,0,0.5,0.5,1560,1898
2009-10-14,Bosnia and Herzegovina,Spain,2,5,3,0.0,1.0,1733,2125
2009-10-14,Brazil,Venezuela,0,0,0,0.5,0.5,2096,1810
2009-10-14,Bulgaria,Georgia,6,2,4,1.0,0.0,1856,1584
2009-10-14,Chile,Ecuador,1,0,1,1.0,0.0,1900,1818
2009-10-14,Czech Republic,Northern Ireland,0,0,0,0.5,0.5,1942,1727
2009-10-14,Denmark,Hungary,0,1,1,0.0,1.0,1921,1753
2009-10-14,El Salvador,Honduras,0,1,1,0.0,1.0,1678,1866
2009-10-14,England,Belarus,3,0,3,1.0,0.0,2030,1687
2009-10-14,Estonia,Belgium,2,0,2,1.0,0.0,1613,1779
2009-10-14,France,Austria,3,1,2,1.0,0.0,2026,1759
2009-10-14,Germany,Finland,1,1,0,0.5,0.5,2034,1768
2009-10-14,Greece,Luxembourg,2,1,1,1.0,0.0,1871,1376
2009-10-14,Republic of Ireland,Montenegro,0,0,0,0.5,0.5,1906,1608
2009-10-14,Italy,Cyprus,3,2,1,1.0,0.0,2012,1670
2009-10-14,Japan,Togo,5,0,5,1.0,0.0,1953,1678
2009-10-14,Kazakhstan,Croatia,1,2,1,0.0,1.0,1554,1968
2009-10-14,South Korea,Senegal,2,0,2,1.0,0.0,1926,1801
2009-10-14,Latvia,Moldova,3,2,1,1.0,0.0,1655,1583
2009-10-14,Liechtenstein,Wales,0,2,2,0.0,1.0,1410,1752
2009-10-14,Lithuania,Serbia,2,1,1,1.0,0.0,1658,1856
2009-10-14,Paraguay,Colombia,0,2,2,0.0,1.0,1882,1876
2009-10-14,Peru,Bolivia,1,0,1,1.0,0.0,1739,1720
2009-10-14,Poland,Slovakia,0,1,1,0.0,1.0,1837,1779
2009-10-14,Portugal,Malta,4,0,4,1.0,0.0,1957,1454
2009-10-14,Qatar,DR Congo,2,2,0,0.5,0.5,1776,1673
2009-10-14,Romania,Faroe Islands,3,1,2,1.0,0.0,1896,1470
2009-10-14,San Marino,Slovenia,0,3,3,0.0,1.0,1359,1732
2009-10-14,Sweden,Albania,4,1,3,1.0,0.0,1885,1625
2009-10-14,Switzerland,Israel,0,0,0,0.5,0.5,1883,1810
2009-10-14,Trinidad and Tobago,Mexico,2,2,0,0.5,0.5,1759,1942
2009-10-14,Tunisia,Saudi Arabia,0,1,1,0.0,1.0,1855,1895
2009-10-14,Turkey,Armenia,2,0,2,1.0,0.0,1880,1579
2009-10-14,United Arab Emirates,Jordan,3,1,2,1.0,0.0,1704,1681
2009-10-14,Uruguay,Argentina,0,1,1,0.0,1.0,1890,2023
2009-10-14,United States,Costa Rica,2,2,0,0.5,0.5,1979,1844
2009-10-17,Zimbabwe,Mauritius,3,0,3,1.0,0.0,1668,1470
2009-10-18,Comoros,Botswana,0,0,0,0.5,0.5,1404,1584
2009-10-18,Eswatini,Seychelles,2,1,1,1.0,0.0,1498,1442
2009-10-19,Zimbabwe,Lesotho,2,2,0,0.5,0.5,1664,1473
2009-10-20,Botswana,Eswatini,1,0,1,1.0,0.0,1591,1492
2009-10-20,Seychelles,Comoros,1,2,1,0.0,1.0,1434,1413
2009-10-20,Vietnam,Turkmenistan,1,0,1,1.0,0.0,1654,1579
2009-10-21,Mauritius,Lesotho,0,1,1,0.0,1.0,1463,1481
2009-10-22,Seychelles,Botswana,0,2,2,0.0,1.0,1430,1596
2009-10-22,Singapore,Turkmenistan,4,2,2,1.0,0.0,1678,1574
2009-10-22,Eswatini,Comoros,3,0,3,1.0,0.0,1499,1407
2009-10-24,Vietnam,Singapore,2,2,0,0.5,0.5,1655,1678
2009-10-25,Malawi,Mozambique,0,1,1,0.0,1.0,1609,1638
2009-10-25,Namibia,Zambia,0,1,1,0.0,1.0,1552,1698
2009-10-26,Kuwait,Syria,1,0,1,1.0,0.0,1725,1766
2009-10-26,Zimbabwe,Botswana,1,0,1,1.0,0.0,1671,1590
2009-10-26,South Africa,Angola,2,0,2,1.0,0.0,1788,1708
2009-10-28,Curaçao,French Guiana,1,4,3,0.0,1.0,1518,1493
2009-10-28,Zimbabwe,South Africa,1,1,0,0.5,0.5,1674,1786
2009-10-29,Mozambique,Zambia,0,2,2,0.0,1.0,1632,1705
2009-10-30,Guyana,Curaçao,1,0,1,1.0,0.0,1535,1511
2009-10-30,Suriname,French Guiana,4,0,4,1.0,0.0,1576,1487
2009-10-31,South Africa,Mozambique,0,1,1,0.0,1.0,1775,1644
2009-11-01,French Guiana,Guyana,0,1,1,0.0,1.0,1481,1542
2009-11-01,Suriname,Curaçao,1,1,0,0.5,0.5,1575,1513
2009-11-01,Zimbabwe,Zambia,3,1,2,1.0,0.0,1683,1697
2009-11-03,Kenya,Kuwait,0,5,5,0.0,1.0,1624,1731
2009-11-04,Chile,Paraguay,2,1,1,1.0,0.0,1908,1875
2009-11-04,Singapore,Indonesia,3,1,2,1.0,0.0,1686,1633
2009-11-05,Egypt,Tanzania,5,1,4,1.0,0.0,1904,1627
2009-11-06,Bahrain,Togo,5,1,4,1.0,0.0,1834,1674
2009-11-08,Kuwait,China PR,2,2,0,0.5,0.5,1733,1789
2009-11-08,Thailand,Syria,1,1,0,0.5,0.5,1757,1766
2009-11-08,Yemen,Tanzania,1,1,0,0.5,0.5,1537,1625
2009-11-10,Iran,Iceland,1,0,1,1.0,0.0,1901,1666
2009-11-11,Yemen,Tanzania,2,1,1,1.0,0.0,1547,1616
2009-11-13,Paraguay,Qatar,0,2,2,0.0,1.0,1865,1787
2009-11-14,Angola,Congo,1,1,0,0.5,0.5,1707,1630
2009-11-14,Belgium,Hungary,3,0,3,1.0,0.0,1787,1746
2009-11-14,Brazil,England,1,0,1,1.0,0.0,2103,2024
2009-11-14,Burkina Faso,Malawi,1,0,1,1.0,0.0,1660,1603
2009-11-14,Costa Rica,Uruguay,0,1,1,0.0,1.0,1838,1897
2009-11-14,Croatia,Liechtenstein,5,0,5,1.0,0.0,1969,1410
2009-11-14,Denmark,South Korea,0,0,0,0.5,0.5,1922,1926
2009-11-14,Egypt,Algeria,2,0,2,1.0,0.0,1909,1753
2009-11-14,Estonia,Albania,0,0,0,0.5,0.5,1614,1625
2009-11-14,Greece,Ukraine,0,0,0,0.5,0.5,1871,1867
2009-11-14,Honduras,Latvia,2,1,1,1.0,0.0,1870,1652
2009-11-14,Iran,Jordan,1,0,1,1.0,0.0,1905,1678
2009-11-14,Republic of Ireland,France,0,1,1,0.0,1.0,1901,2032
2009-11-14,Italy,Netherlands,0,0,0,0.5,0.5,2013,2055
2009-11-14,Ivory Coast,Guinea,3,0,3,1.0,0.0,1888,1714
2009-11-14,Kenya,Nigeria,2,3,1,0.0,1.0,1622,1894
2009-11-14,Kuwait,Indonesia,2,1,1,1.0,0.0,1739,1628
2009-11-14,Lebanon,China PR,0,2,2,0.0,1.0,1582,1793
2009-11-14,Luxembourg,Iceland,1,1,0,0.5,0.5,1382,1661
2009-11-14,North Macedonia,Canada,3,0,3,1.0,0.0,1692,1746
2009-11-14,Morocco,Cameroon,0,2,2,0.0,1.0,1835,1884
2009-11-14,Mozambique,Tunisia,1,0,1,1.0,0.0,1657,1843
2009-11-14,New Zealand,Bahrain,1,0,1,1.0,0.0,1710,1824
2009-11-14,Northern Ireland,Serbia,0,1,1,0.0,1.0,1722,1862
2009-11-14,Oman,Australia,1,2,1,0.0,1.0,1824,1941
2009-11-14,Poland,Romania,0,1,1,0.0,1.0,1831,1903
2009-11-14,Portugal,Bosnia and Herzegovina,1,0,1,1.0,0.0,1961,1730
2009-11-14,Russia,Slovenia,2,1,1,1.0,0.0,1903,1728
2009-11-14,Rwanda,Zambia,0,0,0,0.5,0.5,1593,1695
2009-11-14,Saudi Arabia,Belarus,1,1,0,0.5,0.5,1891,1692
2009-11-14,Singapore,Thailand,1,3,2,0.0,1.0,1680,1764
2009-11-14,Slovakia,United States,1,0,1,1.0,0.0,1792,1967
2009-11-14,South Africa,Japan,0,0,0,0.5,0.5,1779,1950
2009-11-14,Spain,Argentina,2,1,1,1.0,0.0,2131,2018
2009-11-14,Sudan,Benin,1,2,1,0.0,1.0,1608,1602
2009-11-14,Switzerland,Norway,0,1,1,0.0,1.0,1875,1859
2009-11-14,Togo,Gabon,1,0,1,1.0,0.0,1684,1722
2009-11-14,Uzbekistan,Malaysia,3,1,2,1.0,0.0,1739,1571
2009-11-14,Vietnam,Syria,0,1,1,0.0,1.0,1650,1772
2009-11-14,Wales,Scotland,3,0,3,1.0,0.0,1762,1797
2009-11-15,Ghana,Mali,2,2,0,0.5,0.5,1821,1764
2009-11-15,Iraq,Azerbaijan,1,0,1,1.0,0.0,1757,1557
2009-11-15,United Arab Emirates,Czech Republic,0,0,0,0.5,0.5,1709,1938
2009-11-17,Belgium,Qatar,2,0,2,1.0,0.0,1795,1779
2009-11-17,Oman,Brazil,0,2,2,0.0,1.0,1822,2106
2009-11-17,Slovakia,Chile,1,2,1,0.0,1.0,1787,1914
2009-11-17,South Africa,Jamaica,0,0,0,0.5,0.5,1780,1799
2009-11-18,Algeria,Egypt,1,0,1,1.0,0.0,1765,1898
2009-11-18,Angola,Ghana,0,0,0,0.5,0.5,1710,1819
2009-11-18,Austria,Spain,1,5,4,0.0,1.0,1758,2133
2009-11-18,Azerbaijan,Czech Republic,2,0,2,1.0,0.0,1572,1924
2009-11-18,Bahrain,Yemen,4,0,4,1.0,0.0,1827,1545
2009-11-18,Bosnia and Herzegovina,Portugal,0,1,1,0.0,1.0,1727,1965
2009-11-18,Denmark,United States,3,1,2,1.0,0.0,1932,1958
2009-11-18,France,Republic of Ireland,1,1,0,0.5,0.5,2030,1904
2009-11-18,Germany,Ivory Coast,2,2,0,0.5,0.5,2031,1892
2009-11-18,Honduras,Peru,1,2,1,0.0,1.0,1860,1750
2009-11-18,Hong Kong,Japan,0,4,4,0.0,1.0,1574,1952
2009-11-18,Indonesia,Kuwait,1,1,0,0.5,0.5,1631,1737
2009-11-18,Iran,North Macedonia,1,1,0,0.5,0.5,1901,1697
2009-11-18,Italy,Sweden,1,0,1,1.0,0.0,2019,1880
2009-11-18,South Korea,Serbia,0,1,1,0.0,1.0,1917,1872
2009-11-18,Malaysia,Uzbekistan,1,3,2,0.0,1.0,1567,1744
2009-11-18,Malta,Bulgaria,1,4,3,0.0,1.0,1453,1858
2009-11-18,Montenegro,Belarus,1,0,1,1.0,0.0,1618,1683
2009-11-18,Netherlands,Paraguay,0,0,0,0.5,0.5,2052,1869
2009-11-18,Poland,Canada,1,0,1,1.0,0.0,1838,1740
2009-11-18,Slovenia,Russia,1,0,1,1.0,0.0,1740,1892
2009-11-18,Syria,Vietnam,0,0,0,0.5,0.5,1770,1653
2009-11-18,Thailand,Singapore,0,1,1,0.0,1.0,1755,1690
2009-11-18,Ukraine,Greece,0,1,1,0.0,1.0,1860,1879
2009-11-18,United Arab Emirates,Iraq,0,1,1,0.0,1.0,1703,1764
2009-11-18,Uruguay,Costa Rica,1,1,0,0.5,0.5,1896,1840
2009-11-21,Zambia,North Korea,4,1,3,1.0,0.0,1705,1731
2009-11-22,China PR,Lebanon,1,0,1,1.0,0.0,1797,1579
2009-11-22,Jordan,Iran,1,0,1,1.0,0.0,1691,1889
2009-11-28,Kenya,Zambia,0,2,2,0.0,1.0,1616,1712
2009-11-29,Burundi,Zanzibar,0,4,4,0.0,1.0,1539,1492
2009-11-29,Rwanda,Somalia,1,0,1,1.0,0.0,1597,1361
2009-11-29,Uganda,Tanzania,2,0,2,1.0,0.0,1691,1610
2009-11-30,Ethiopia,Djibouti,5,0,5,1.0,0.0,1628,1325
2009-12-01,Zanzibar,Tanzania,0,1,1,0.0,1.0,1487,1616
2009-12-02,Burundi,Uganda,0,2,2,0.0,1.0,1535,1696
2009-12-02,Ethiopia,Zambia,0,1,1,0.0,1.0,1622,1719
2009-12-02,Kenya,Djibouti,2,0,2,1.0,0.0,1619,1323
2009-12-03,Rwanda,Eritrea,2,1,1,1.0,0.0,1603,1487
2009-12-04,Bangladesh,Bhutan,4,1,3,1.0,0.0,1436,1319
2009-12-04,Djibouti,Zambia,0,6,6,0.0,1.0,1322,1721
2009-12-04,Sri Lanka,Pakistan,1,0,1,1.0,0.0,1422,1361
2009-12-04,Tanzania,Burundi,1,0,1,1.0,0.0,1623,1529
2009-12-04,North Korea,Macau,8,0,8,1.0,0.0,1733,1324
2009-12-05,Dominica,British Virgin Islands,4,0,4,1.0,0.0,1415,1408
2009-12-05,Kenya,Ethiopia,2,0,2,1.0,0.0,1628,1614
2009-12-05,Maldives,Nepal,1,1,0,0.5,0.5,1454,1401
2009-12-05,Somalia,Eritrea,1,3,2,0.0,1.0,1356,1493
2009-12-05,Uganda,Zanzibar,0,0,0,0.5,0.5,1692,1492
2009-12-06,Bangladesh,Pakistan,0,0,0,0.5,0.5,1435,1363
2009-12-06,Sri Lanka,Bhutan,6,0,6,1.0,0.0,1428,1314
2009-12-07,Kenya,Uganda,0,1,1,0.0,1.0,1622,1699
2009-12-07,Maldives,Afghanistan,3,1,2,1.0,0.0,1461,1362
2009-12-07,Zambia,Zanzibar,0,0,0,0.5,0.5,1717,1497
2009-12-08,Bangladesh,Sri Lanka,2,1,1,1.0,0.0,1443,1421
2009-12-08,Pakistan,Bhutan,7,0,7,1.0,0.0,1370,1308
2009-12-08,Tanzania,Eritrea,4,0,4,1.0,0.0,1629,1488
2009-12-09,Afghanistan,Nepal,0,3,3,0.0,1.0,1355,1409
2009-12-09,Zanzibar,Uganda,1,2,1,0.0,1.0,1494,1703
2009-12-10,Tanzania,Rwanda,1,2,1,0.0,1.0,1621,1612
2009-12-11,Maldives,Sri Lanka,5,1,4,1.0,0.0,1469,1414
2009-12-13,Uganda,Rwanda,2,0,2,1.0,0.0,1709,1607
2009-12-13,Zanzibar,Tanzania,1,0,1,1.0,0.0,1505,1611
2009-12-16,Kuwait,United Arab Emirates,0,0,0,0.5,0.5,1737,1704
2009-12-19,Mozambique,Malawi,0,1,1,0.0,1.0,1648,1613
2009-12-22,Catalonia,Argentina,4,2,2,1.0,0.0,1638,2004
2009-12-27,North Korea,Mali,1,0,1,1.0,0.0,1742,1756
2009-12-28,Qatar,Iran,3,2,1,1.0,0.0,1790,1879
2009-12-29,Egypt,Malawi,1,1,0,0.5,0.5,1893,1619
2009-12-29,Thailand,Zimbabwe,3,0,3,1.0,0.0,1762,1677
2009-12-30,Angola,Estonia,0,1,1,0.0,1.0,1700,1625
2009-12-30,China PR,Jordan,2,2,0,0.5,0.5,1795,1694
2009-12-30,Malaysia,Syria,4,1,3,1.0,0.0,1580,1758
2009-12-30,Mali,Iran,2,1,1,1.0,0.0,1767,1869
2009-12-30,Qatar,North Korea,0,1,1,0.0,1.0,1781,1752
2009-12-30,Yemen,Tajikistan,2,1,1,1.0,0.0,1554,1554
2009-12-31,Singapore,Oman,1,4,3,0.0,1.0,1685,1828
2010-01-02,Iran,North Korea,1,0,1,1.0,0.0,1875,1747
2010-01-02,Qatar,Mali,0,0,0,0.5,0.5,1781,1768
2010-01-02,Syria,Zimbabwe,6,0,6,1.0,0.0,1765,1671
2010-01-02,Yemen,Tajikistan,0,1,1,0.0,1.0,1546,1562
2010-01-03,Angola,Gambia,1,1,0,0.5,0.5,1698,1582
2010-01-04,Egypt,Mali,1,0,1,1.0,0.0,1899,1763
2010-01-04,Tanzania,Ivory Coast,0,1,1,0.0,1.0,1609,1895
2010-01-05,Ghana,Malawi,0,0,0,0.5,0.5,1815,1624
2010-01-06,Bahrain,Hong Kong,4,0,4,1.0,0.0,1831,1571
2010-01-06,Benin,Libya,1,0,1,1.0,0.0,1612,1665
2010-01-06,China PR,Syria,0,0,0,0.5,0.5,1795,1766
2010-01-06,Gabon,Mozambique,2,0,2,1.0,0.0,1729,1642
2010-01-06,Indonesia,Oman,1,2,1,0.0,1.0,1628,1832
2010-01-06,Kuwait,Australia,2,2,0,0.5,0.5,1742,1937
2010-01-06,Lebanon,Vietnam,1,1,0,0.5,0.5,1581,1652
2010-01-06,Singapore,Iran,1,3,2,0.0,1.0,1681,1880
2010-01-06,Thailand,Jordan,0,0,0,0.5,0.5,1761,1696
2010-01-06,United Arab Emirates,Malaysia,1,0,1,1.0,0.0,1710,1575
2010-01-06,Yemen,Japan,2,3,1,0.0,1.0,1545,1954
2010-01-07,Rwanda,Ivory Coast,0,2,2,0.0,1.0,1605,1898
2010-01-09,Kenya,Cameroon,1,3,2,0.0,1.0,1620,1887
2010-01-09,Tunisia,Gambia,1,2,1,0.0,1.0,1830,1596
2010-01-09,Zambia,South Korea,4,2,2,1.0,0.0,1730,1905
2010-01-10,Angola,Mali,4,4,0,0.5,0.5,1700,1762
2010-01-11,Ivory Coast,Burkina Faso,0,0,0,0.5,0.5,1894,1665
2010-01-11,Malawi,Algeria,3,0,3,1.0,0.0,1636,1754
2010-01-12,Egypt,Nigeria,3,1,2,1.0,0.0,1907,1887
2010-01-12,Mozambique,Benin,2,2,0,0.5,0.5,1642,1613
2010-01-13,Cameroon,Gabon,0,1,1,0.0,1.0,1876,1741
2010-01-13,Zambia,Tunisia,1,1,0,0.5,0.5,1733,1828
2010-01-14,Angola,Malawi,2,0,2,1.0,0.0,1707,1630
2010-01-14,Mali,Algeria,0,1,1,0.0,1.0,1754,1763
2010-01-15,Ivory Coast,Ghana,3,1,2,1.0,0.0,1901,1809
2010-01-15,Yemen,Kenya,3,1,2,1.0,0.0,1555,1611
2010-01-16,Egypt,Mozambique,2,0,2,1.0,0.0,1910,1640
2010-01-16,Nigeria,Benin,1,0,1,1.0,0.0,1890,1611
2010-01-17,Cameroon,Zambia,3,2,1,1.0,0.0,1881,1729
2010-01-17,Gabon,Tunisia,0,0,0,0.5,0.5,1743,1827
2010-01-17,Thailand,Singapore,1,0,1,1.0,0.0,1768,1675
2010-01-17,Vietnam,China PR,1,2,1,0.0,1.0,1648,1800
2010-01-18,Angola,Algeria,0,0,0,0.5,0.5,1709,1762
2010-01-18,Finland,South Korea,0,2,2,0.0,1.0,1764,1910
2010-01-18,Mali,Malawi,3,1,2,1.0,0.0,1760,1625
2010-01-19,Burkina Faso,Ghana,0,1,1,0.0,1.0,1661,1814
2010-01-20,Chile,Panama,2,1,1,1.0,0.0,1918,1699
2010-01-20,Egypt,Benin,2,0,2,1.0,0.0,1913,1609
2010-01-20,Nigeria,Mozambique,3,0,3,1.0,0.0,1894,1637
2010-01-20,Oman,Sweden,0,1,1,0.0,1.0,1826,1887
2010-01-20,Thailand,Poland,1,3,2,0.0,1.0,1762,1845
2010-01-20,Yemen,Bahrain,3,0,3,1.0,0.0,1569,1818
2010-01-21,Cameroon,Tunisia,2,2,0,0.5,0.5,1880,1829
2010-01-21,Gabon,Zambia,1,2,1,0.0,1.0,1735,1738
2010-01-22,Latvia,South Korea,0,1,1,0.0,1.0,1650,1913
2010-01-23,Poland,Singapore,6,1,5,1.0,0.0,1850,1671
2010-01-23,Syria,Sweden,1,1,0,0.5,0.5,1769,1885
2010-01-23,United States,Honduras,1,3,2,0.0,1.0,1948,1871
2010-01-24,Angola,Ghana,0,1,1,0.0,1.0,1704,1820
2010-01-24,Ivory Coast,Algeria,2,3,1,0.0,1.0,1890,1774
2010-01-25,Egypt,Cameroon,3,1,2,1.0,0.0,1921,1873
2010-01-25,Zambia,Nigeria,0,0,0,0.5,0.5,1742,1891
2010-01-26,Argentina,Costa Rica,3,2,1,1.0,0.0,2009,1836
2010-01-27,South Africa,Zimbabwe,3,0,3,1.0,0.0,1786,1666
2010-01-28,Algeria,Egypt,0,4,4,0.0,1.0,1770,1926
2010-01-28,Ghana,Nigeria,1,0,1,1.0,0.0,1830,1882
2010-01-30,Nigeria,Algeria,1,0,1,1.0,0.0,1888,1765
2010-01-31,Ghana,Egypt,0,1,1,0.0,1.0,1825,1932
2010-01-31,Jamaica,Canada,1,0,1,1.0,0.0,1806,1734
2010-02-02,Japan,Venezuela,0,0,0,0.5,0.5,1951,1814
2010-02-06,Japan,China PR,0,0,0,0.5,0.5,1948,1804
2010-02-07,South Korea,Hong Kong,5,0,5,1.0,0.0,1915,1570
2010-02-10,Argentina,Jamaica,2,1,1,1.0,0.0,2013,1803
2010-02-10,China PR,South Korea,3,0,3,1.0,0.0,1815,1905
2010-02-11,Japan,Hong Kong,3,0,3,1.0,0.0,1950,1569
2010-02-14,Hong Kong,China PR,0,2,2,0.0,1.0,1566,1819
2010-02-14,Japan,South Korea,1,3,2,0.0,1.0,1941,1915
2010-02-16,Sri Lanka,Myanmar,0,4,4,0.0,1.0,1410,1595
2010-02-16,Tajikistan,Bangladesh,1,2,1,0.0,1.0,1552,1454
2010-02-17,North Korea,Turkmenistan,1,1,0,0.5,0.5,1744,1578
2010-02-18,Bangladesh,Myanmar,1,2,1,0.0,1.0,1450,1600
2010-02-18,Sri Lanka,Tajikistan,1,3,2,0.0,1.0,1406,1557
2010-02-19,Kuwait,Syria,1,1,0,0.5,0.5,1743,1769
2010-02-19,Kyrgyzstan,North Korea,0,4,4,0.0,1.0,1463,1747
2010-02-20,Sri Lanka,Bangladesh,3,0,3,1.0,0.0,1416,1441
2010-02-20,Tajikistan,Myanmar,3,0,3,1.0,0.0,1566,1592
2010-02-21,Turkmenistan,Kyrgyzstan,1,0,1,1.0,0.0,1584,1458
2010-02-24,North Korea,Myanmar,5,0,5,1.0,0.0,1752,1588
2010-02-24,Mexico,Bolivia,5,0,5,1.0,0.0,1946,1717
2010-02-24,Tajikistan,Turkmenistan,0,2,2,0.0,1.0,1559,1592
2010-02-24,United States,El Salvador,2,1,1,1.0,0.0,1951,1676
2010-02-25,Jordan,Azerbaijan,0,2,2,0.0,1.0,1686,1583
2010-02-25,Kuwait,Bahrain,4,1,3,1.0,0.0,1753,1809
2010-02-25,Turkmenistan,North Korea,1,1,0,0.5,0.5,1596,1749
2010-02-27,Malaysia,Yemen,1,0,1,1.0,0.0,1583,1562
2010-02-27,Tajikistan,Myanmar,1,0,1,1.0,0.0,1568,1580
2010-03-02,Guadeloupe,Saint Kitts and Nevis,2,1,1,1.0,0.0,1675,1546
2010-03-02,Republic of Ireland,Brazil,0,2,2,0.0,1.0,1901,2110
2010-03-03,Albania,Northern Ireland,1,0,1,1.0,0.0,1636,1712
2010-03-03,Algeria,Serbia,0,3,3,0.0,1.0,1760,1878
2010-03-03,Angola,Latvia,1,1,0,0.5,0.5,1703,1652
2010-03-03,Armenia,Belarus,1,3,2,0.0,1.0,1574,1689
2010-03-03,Australia,Indonesia,1,0,1,1.0,0.0,1940,1626
2010-03-03,Austria,Denmark,2,1,1,1.0,0.0,1770,1921
2010-03-03,Belgium,Croatia,0,1,1,0.0,1.0,1791,1974
2010-03-03,Bosnia and Herzegovina,Ghana,2,1,1,1.0,0.0,1738,1815
2010-03-03,Cyprus,Iceland,0,0,0,0.5,0.5,1670,1662
2010-03-03,El Salvador,Guatemala,1,2,1,0.0,1.0,1669,1689
2010-03-03,England,Egypt,3,1,2,1.0,0.0,2030,1927
2010-03-03,France,Spain,0,2,2,0.0,1.0,2025,2139
2010-03-03,Georgia,Estonia,2,1,1,1.0,0.0,1593,1617
2010-03-03,Germany,Argentina,0,1,1,0.0,1.0,2023,2022
2010-03-03,Greece,Senegal,0,2,2,0.0,1.0,1870,1811
2010-03-03,Hong Kong,Yemen,0,0,0,0.5,0.5,1566,1563
2010-03-03,Hungary,Russia,1,1,0,0.5,0.5,1750,1889
2010-03-03,Iran,Thailand,1,0,1,1.0,0.0,1886,1757
2010-03-03,Italy,Cameroon,0,0,0,0.5,0.5,2016,1877
2010-03-03,Ivory Coast,South Korea,0,2,2,0.0,1.0,1883,1923
2010-03-03,Japan,Bahrain,2,0,2,1.0,0.0,1947,1804
2010-03-03,Jordan,Singapore,2,1,1,1.0,0.0,1694,1664
2010-03-03,Kazakhstan,Moldova,0,1,1,0.0,1.0,1547,1591
2010-03-03,Libya,Mali,2,1,1,1.0,0.0,1676,1750
2010-03-03,Luxembourg,Azerbaijan,1,2,1,0.0,1.0,1379,1587
2010-03-03,North Macedonia,Montenegro,2,1,1,1.0,0.0,1704,1612
2010-03-03,Malta,Finland,1,2,1,0.0,1.0,1451,1767
2010-03-03,Mexico,New Zealand,2,0,2,1.0,0.0,1950,1707
2010-03-03,Mozambique,Botswana,0,1,1,0.0,1.0,1628,1600
2010-03-03,Netherlands,United States,2,1,1,1.0,0.0,2058,1946
2010-03-03,Nigeria,DR Congo,5,2,3,1.0,0.0,1892,1670
2010-03-03,Oman,Kuwait,0,0,0,0.5,0.5,1825,1755
2010-03-03,Poland,Bulgaria,2,0,2,1.0,0.0,1859,1850
2010-03-03,Portugal,China PR,2,0,2,1.0,0.0,1970,1815
2010-03-03,Romania,Israel,0,2,2,0.0,1.0,1893,1821
2010-03-03,Scotland,Czech Republic,1,0,1,1.0,0.0,1808,1914
2010-03-03,Slovakia,Norway,0,1,1,0.0,1.0,1781,1866
2010-03-03,Slovenia,Qatar,4,1,3,1.0,0.0,1749,1773
2010-03-03,South Africa,Namibia,1,1,0,0.5,0.5,1782,1557
2010-03-03,Switzerland,Uruguay,1,3,2,0.0,1.0,1868,1904
2010-03-03,Syria,Lebanon,4,0,4,1.0,0.0,1774,1577
2010-03-03,Tanzania,Uganda,2,3,1,0.0,1.0,1604,1715
2010-03-03,Turkey,Honduras,2,0,2,1.0,0.0,1888,1864
2010-03-03,Uzbekistan,United Arab Emirates,0,1,1,0.0,1.0,1736,1719
2010-03-03,Venezuela,Panama,1,2,1,0.0,1.0,1804,1710
2010-03-03,Wales,Sweden,0,1,1,0.0,1.0,1757,1891
2010-03-03,Zimbabwe,Malawi,2,1,1,1.0,0.0,1674,1618
2010-03-06,Venezuela,North Korea,2,1,1,1.0,0.0,1811,1743
2010-03-07,Niger,Benin,2,0,2,1.0,0.0,1529,1599
2010-03-17,Mexico,North Korea,2,1,1,1.0,0.0,1954,1740
2010-03-20,Alderney,Jersey,0,3,3,0.0,1.0,1279,1758
2010-03-21,Iceland,Faroe Islands,2,0,2,1.0,0.0,1666,1467
2010-03-21,Namibia,Botswana,0,0,0,0.5,0.5,1558,1600
2010-03-24,Martinique,Haiti,0,0,0,0.5,0.5,1669,1664
2010-03-24,Mexico,Iceland,0,0,0,0.5,0.5,1949,1672
2010-03-31,Chile,Venezuela,0,0,0,0.5,0.5,1916,1814
2010-03-31,Paraguay,South Africa,1,1,0,0.5,0.5,1868,1784
2010-04-03,Saint Kitts and Nevis,Guadeloupe,3,0,3,1.0,0.0,1557,1665
2010-04-03,Occitania,Monaco,5,1,4,1.0,0.0,1504,1488
2010-04-07,Japan,Serbia,0,3,3,0.0,1.0,1938,1888
2010-04-21,Honduras,Venezuela,0,1,1,0.0,1.0,1855,1824
2010-04-22,South Africa,North Korea,0,0,0,0.5,0.5,1783,1742
2010-04-28,South Africa,Jamaica,2,0,2,1.0,0.0,1792,1795
2010-05-05,Argentina,Haiti,4,0,4,1.0,0.0,2024,1663
2010-05-05,Chile,Trinidad and Tobago,2,0,2,1.0,0.0,1921,1755
2010-05-07,Mexico,Ecuador,0,0,0,0.5,0.5,1947,1821
2010-05-08,Jersey,Guernsey,0,1,1,0.0,1.0,1749,1689
2010-05-10,Mexico,Senegal,1,0,1,1.0,0.0,1953,1806
2010-05-12,Yemen,Malawi,1,0,1,1.0,0.0,1573,1609
2010-05-13,Germany,Malta,3,0,3,1.0,0.0,2024,1451
2010-05-13,Mexico,Angola,1,0,1,1.0,0.0,1957,1700
2010-05-15,Paraguay,North Korea,1,0,1,1.0,0.0,1874,1737
2010-05-16,South Korea,Ecuador,2,0,2,1.0,0.0,1929,1816
2010-05-16,Mexico,Chile,1,0,1,1.0,0.0,1965,1914
2010-05-16,South Africa,Thailand,4,0,4,1.0,0.0,1800,1750
2010-05-18,Yemen,Oman,0,1,1,0.0,1.0,1570,1829
2010-05-19,Austria,Croatia,0,1,1,0.0,1.0,1767,1978
2010-05-19,Belgium,Bulgaria,2,1,1,1.0,0.0,1801,1841
2010-05-19,Gabon,Togo,3,0,3,1.0,0.0,1742,1678
2010-05-19,Corsica,Brittany,2,0,2,1.0,0.0,1521,1523
2010-05-20,Aruba,Venezuela,0,3,3,0.0,1.0,1384,1826
2010-05-21,DR Congo,Saudi Arabia,0,2,2,0.0,1.0,1667,1895
2010-05-21,Estonia,Finland,2,0,2,1.0,0.0,1629,1756
2010-05-21,Brittany,Togo,2,1,1,1.0,0.0,1535,1667
2010-05-21,Corsica,Gabon,1,1,0,0.5,0.5,1526,1738
2010-05-22,Turkey,Czech Republic,2,1,1,1.0,0.0,1897,1906
2010-05-23,Croatia,Wales,2,0,2,1.0,0.0,1982,1754
2010-05-24,Argentina,Canada,5,0,5,1.0,0.0,2027,1732
2010-05-24,Australia,New Zealand,2,1,1,1.0,0.0,1944,1704
2010-05-24,England,Mexico,3,1,2,1.0,0.0,2037,1959
2010-05-24,Japan,South Korea,0,2,2,0.0,1.0,1930,1938
2010-05-24,Portugal,Cape Verde,0,0,0,0.5,0.5,1964,1598
2010-05-24,South Africa,Bulgaria,1,1,0,0.5,0.5,1801,1841
2010-05-25,Armenia,Uzbekistan,3,1,2,1.0,0.0,1586,1725
2010-05-25,Georgia,Cameroon,0,0,0,0.5,0.5,1599,1872
2010-05-25,Greece,North Korea,2,2,0,0.5,0.5,1868,1740
2010-05-25,Republic of Ireland,Paraguay,2,1,1,1.0,0.0,1909,1867
2010-05-25,Montenegro,Albania,0,1,1,0.0,1.0,1605,1644
2010-05-25,Nigeria,Saudi Arabia,0,0,0,0.5,0.5,1893,1895
2010-05-25,Ukraine,Lithuania,4,0,4,1.0,0.0,1864,1655
2010-05-25,United States,Czech Republic,2,4,2,0.0,1.0,1938,1915
2010-05-26,Azerbaijan,Moldova,1,1,0,0.5,0.5,1588,1591
2010-05-26,Chile,Zambia,3,0,3,1.0,0.0,1919,1738
2010-05-26,Estonia,Croatia,0,0,0,0.5,0.5,1636,1976
2010-05-26,France,Costa Rica,2,1,1,1.0,0.0,2030,1832
2010-05-26,Netherlands,Mexico,2,1,1,1.0,0.0,2064,1954
2010-05-26,Northern Ireland,Turkey,0,2,2,0.0,1.0,1708,1902
2010-05-26,Uruguay,Israel,4,1,3,1.0,0.0,1911,1815
2010-05-27,Belarus,Honduras,2,2,0,0.5,0.5,1693,1852
2010-05-27,Denmark,Senegal,2,0,2,1.0,0.0,1927,1801
2010-05-27,South Africa,Colombia,2,1,1,1.0,0.0,1811,1867
2010-05-28,Republic of Ireland,Algeria,3,0,3,1.0,0.0,1914,1756
2010-05-29,Azerbaijan,North Macedonia,1,3,2,0.0,1.0,1583,1710
2010-05-29,Hungary,Germany,0,3,3,0.0,1.0,1748,2027
2010-05-29,Iceland,Andorra,4,0,4,1.0,0.0,1675,1375
2010-05-29,Moldova,United Arab Emirates,2,3,1,0.0,1.0,1586,1725
2010-05-29,New Zealand,Serbia,1,0,1,1.0,0.0,1716,1877
2010-05-29,Norway,Montenegro,2,1,1,1.0,0.0,1869,1603
2010-05-29,Poland,Finland,0,0,0,0.5,0.5,1857,1759
2010-05-29,Slovakia,Cameroon,1,1,0,0.5,0.5,1784,1870
2010-05-29,Spain,Saudi Arabia,3,2,1,1.0,0.0,2143,1892
2010-05-29,Sweden,Bosnia and Herzegovina,4,2,2,1.0,0.0,1896,1734
2010-05-29,Ukraine,Romania,3,2,1,1.0,0.0,1873,1885
2010-05-29,United States,Turkey,2,1,1,1.0,0.0,1946,1895
2010-05-29,Venezuela,Canada,1,1,0,0.5,0.5,1824,1735
2010-05-30,Belarus,South Korea,1,0,1,1.0,0.0,1706,1926
2010-05-30,Chile,Northern Ireland,1,0,1,1.0,0.0,1923,1705
2010-05-30,Chile,Israel,3,0,3,1.0,0.0,1929,1810
2010-05-30,Grenada,Martinique,2,2,0,0.5,0.5,1572,1667
2010-05-30,Japan,England,1,2,1,0.0,1.0,1925,2043
2010-05-30,Mexico,Gambia,5,1,4,1.0,0.0,1956,1595
2010-05-30,Nigeria,Colombia,1,1,0,0.5,0.5,1893,1868
2010-05-30,Paraguay,Ivory Coast,2,2,0,0.5,0.5,1868,1883
2010-05-30,Tunisia,France,1,1,0,0.5,0.5,1834,2026
2010-05-31,South Africa,Guatemala,5,0,5,1.0,0.0,1817,1684
2010-05-31,Gozo,Padania,1,2,1,0.0,1.0,1473,1578
2010-05-31,Iraqi Kurdistan,Two Sicilies,4,1,3,1.0,0.0,1508,1492
2010-06-01,Australia,Denmark,1,0,1,1.0,0.0,1952,1920
2010-06-01,Netherlands,Ghana,4,1,3,1.0,0.0,2068,1812
2010-06-01,Portugal,Cameroon,3,1,2,1.0,0.0,1970,1865
2010-06-01,Switzerland,Costa Rica,0,1,1,0.0,1.0,1860,1841
2010-06-01,Occitania,Padania,0,1,1,0.0,1.0,1498,1585
2010-06-01,Provence,Two Sicilies,0,1,1,0.0,1.0,1474,1500
2010-06-02,Albania,Andorra,1,0,1,1.0,0.0,1647,1373
2010-06-02,Azerbaijan,Honduras,0,0,0,0.5,0.5,1589,1847
2010-06-02,Belarus,Sweden,0,1,1,0.0,1.0,1702,1901
2010-06-02,Greece,Paraguay,0,2,2,0.0,1.0,1860,1876
2010-06-02,Norway,Ukraine,0,1,1,0.0,1.0,1862,1881
2010-06-02,Romania,North Macedonia,0,1,1,0.0,1.0,1874,1722
2010-06-02,Serbia,Poland,0,0,0,0.5,0.5,1877,1858
2010-06-02,Zimbabwe,Brazil,0,3,3,0.0,1.0,1673,2112
2010-06-02,Gozo,Occitania,0,5,5,0.0,1.0,1466,1506
2010-06-02,Iraqi Kurdistan,Provence,3,2,1,1.0,0.0,1516,1467
2010-06-03,Germany,Bosnia and Herzegovina,3,1,2,1.0,0.0,2030,1732
2010-06-03,Italy,Mexico,1,2,1,0.0,1.0,2007,1966
2010-06-03,Spain,South Korea,1,0,1,1.0,0.0,2147,1923
2010-06-04,France,China PR,0,1,1,0.0,1.0,2014,1828
2010-06-04,Japan,Ivory Coast,0,2,2,0.0,1.0,1917,1892
2010-06-04,Luxembourg,Faroe Islands,0,0,0,0.5,0.5,1381,1466
2010-06-04,Slovenia,New Zealand,3,1,2,1.0,0.0,1757,1709
2010-06-04,Sudan,Palestine,1,1,0,0.5,0.5,1606,1507
2010-06-04,Iraqi Kurdistan,Occitania,2,1,1,1.0,0.0,1524,1499
2010-06-04,Padania,Two Sicilies,2,0,2,1.0,0.0,1592,1494
2010-06-04,Gozo,Provence,2,1,1,1.0,0.0,1475,1459
2010-06-05,Algeria,United Arab Emirates,1,0,1,1.0,0.0,1764,1718
2010-06-05,Australia,United States,1,3,2,0.0,1.0,1944,1955
2010-06-05,Ghana,Latvia,1,0,1,1.0,0.0,1817,1648
2010-06-05,Netherlands,Hungary,6,1,5,1.0,0.0,2071,1746
2010-06-05,Romania,Honduras,3,0,3,1.0,0.0,1882,1840
2010-06-05,Serbia,Cameroon,4,3,1,1.0,0.0,1885,1858
2010-06-05,Slovakia,Costa Rica,3,0,3,1.0,0.0,1794,1832
2010-06-05,South Africa,Denmark,1,0,1,1.0,0.0,1828,1910
2010-06-05,Switzerland,Italy,1,1,0,0.5,0.5,1864,2004
2010-06-05,Occitania,Two Sicilies,2,0,2,1.0,0.0,1507,1487
2010-06-05,Iraqi Kurdistan,Padania,0,1,1,0.0,1.0,1518,1599
2010-06-06,Nigeria,North Korea,3,1,2,1.0,0.0,1898,1736
2010-06-07,Tanzania,Brazil,1,5,4,0.0,1.0,1604,2113
2010-06-08,Mozambique,Portugal,0,3,3,0.0,1.0,1627,1972
2010-06-08,Spain,Poland,6,0,6,1.0,0.0,2150,1856
2010-06-11,South Africa,Mexico,1,1,0,0.5,0.5,1832,1963
2010-06-11,Uruguay,France,0,0,0,0.5,0.5,1914,2012
2010-06-12,Argentina,Nigeria,1,0,1,1.0,0.0,2033,1893
2010-06-12,England,United States,1,1,0,0.5,0.5,2042,1957
2010-06-12,South Korea,Greece,2,0,2,1.0,0.0,1930,1854
2010-06-13,Algeria,Slovenia,0,1,1,0.0,1.0,1756,1766
2010-06-13,Germany,Australia,4,0,4,1.0,0.0,2037,1938
2010-06-13,Serbia,Ghana,0,1,1,0.0,1.0,1876,1827
2010-06-14,Italy,Paraguay,1,1,0,0.5,0.5,2002,1879
2010-06-14,Japan,Cameroon,1,0,1,1.0,0.0,1924,1852
2010-06-14,Netherlands,Denmark,2,0,2,1.0,0.0,2076,1906
2010-06-15,Brazil,North Korea,2,1,1,1.0,0.0,2115,1735
2010-06-15,Ivory Coast,Portugal,0,0,0,0.5,0.5,1894,1971
2010-06-15,New Zealand,Slovakia,1,1,0,0.5,0.5,1711,1793
2010-06-16,Honduras,Chile,0,1,1,0.0,1.0,1835,1935
2010-06-16,South Africa,Uruguay,0,3,3,0.0,1.0,1826,1921
2010-06-16,Spain,Switzerland,0,1,1,0.0,1.0,2137,1878
2010-06-17,Argentina,South Korea,4,1,3,1.0,0.0,2039,1925
2010-06-17,France,Mexico,0,2,2,0.0,1.0,2003,1973
2010-06-17,Greece,Nigeria,2,1,1,1.0,0.0,1863,1885
2010-06-18,England,Algeria,0,0,0,0.5,0.5,2037,1762
2010-06-18,Germany,Serbia,0,1,1,0.0,1.0,2026,1888
2010-06-18,Lithuania,Latvia,0,0,0,0.5,0.5,1655,1649
2010-06-18,Slovenia,United States,2,2,0,0.5,0.5,1771,1953
2010-06-19,Cameroon,Denmark,1,2,1,0.0,1.0,1846,1913
2010-06-19,Estonia,Latvia,0,0,0,0.5,0.5,1637,1649
2010-06-19,Ghana,Australia,1,1,0,0.5,0.5,1830,1936
2010-06-19,Netherlands,Japan,1,0,1,1.0,0.0,2081,1920
2010-06-19,Niger,Chad,1,1,0,0.5,0.5,1529,1519
2010-06-19,Northern Mariana Islands,Guam,1,1,0,0.5,0.5,1431,1369
2010-06-20,Brazil,Ivory Coast,3,1,2,1.0,0.0,2119,1891
2010-06-20,Italy,New Zealand,1,1,0,0.5,0.5,1997,1717
2010-06-20,Lithuania,Estonia,2,0,2,1.0,0.0,1663,1630
2010-06-20,Slovakia,Paraguay,0,2,2,0.0,1.0,1787,1886
2010-06-20,Sudan,Tunisia,2,6,4,0.0,1.0,1603,1838
2010-06-21,Chile,Switzerland,1,0,1,1.0,0.0,1942,1872
2010-06-21,Portugal,North Korea,7,0,7,1.0,0.0,1975,1732
2010-06-21,Spain,Honduras,2,0,2,1.0,0.0,2140,1833
2010-06-22,Greece,Argentina,0,2,2,0.0,1.0,1859,2044
2010-06-22,Mexico,Uruguay,0,1,1,0.0,1.0,1964,1931
2010-06-22,Nigeria,South Korea,2,2,0,0.5,0.5,1886,1925
2010-06-22,South Africa,France,2,1,1,1.0,0.0,1838,1992
2010-06-23,Australia,Serbia,2,1,1,1.0,0.0,1943,1882
2010-06-23,Ghana,Germany,0,1,1,0.0,1.0,1827,2030
2010-06-23,Slovenia,England,0,1,1,0.0,1.0,1769,2040
2010-06-23,United States,Algeria,1,0,1,1.0,0.0,1957,1759
2010-06-24,Cameroon,Netherlands,1,2,1,0.0,1.0,1843,2085
2010-06-24,Denmark,Japan,1,3,2,0.0,1.0,1906,1928
2010-06-24,Paraguay,New Zealand,0,0,0,0.5,0.5,1883,1721
2010-06-24,Slovakia,Italy,3,2,1,1.0,0.0,1800,1985
2010-06-25,Chile,Spain,1,2,1,0.0,1.0,1939,2144
2010-06-25,North Korea,Ivory Coast,0,3,3,0.0,1.0,1728,1896
2010-06-25,Portugal,Brazil,0,0,0,0.5,0.5,1979,2116
2010-06-25,Switzerland,Honduras,0,0,0,0.5,0.5,1872,1834
2010-06-26,China PR,Tajikistan,4,0,4,1.0,0.0,1831,1566
2010-06-26,Uruguay,South Korea,2,1,1,1.0,0.0,1939,1918
2010-06-26,United States,Ghana,1,2,1,0.0,1.0,1947,1838
2010-06-27,Argentina,Mexico,3,1,2,1.0,0.0,2051,1958
2010-06-27,Germany,England,4,1,3,1.0,0.0,2039,2032
2010-06-28,Brazil,Chile,3,0,3,1.0,0.0,2121,1935
2010-06-28,Netherlands,Slovakia,2,1,1,1.0,0.0,2088,1798
2010-06-29,Paraguay,Japan,0,0,0,0.5,0.5,1885,1927
2010-06-29,Spain,Portugal,1,0,1,1.0,0.0,2149,1975
2010-07-01,Chad,Togo,2,2,0,0.5,0.5,1523,1664
2010-07-01,Tunisia,Botswana,0,1,1,0.0,1.0,1826,1613
2010-07-02,Netherlands,Brazil,2,1,1,1.0,0.0,2097,2113
2010-07-02,Uruguay,Ghana,1,1,0,0.5,0.5,1937,1841
2010-07-03,Argentina,Germany,0,4,4,0.0,1.0,2043,2048
2010-07-03,Paraguay,Spain,0,1,1,0.0,1.0,1883,2152
2010-07-03,Saint Martin,Saint Barthélemy,3,0,3,1.0,0.0,1462,1491
2010-07-06,Uruguay,Netherlands,2,3,1,0.0,1.0,1933,2102
2010-07-07,Germany,Spain,0,1,1,0.0,1.0,2043,2158
2010-07-09,Botswana,Chad,1,0,1,1.0,0.0,1619,1518
2010-07-09,Togo,Malawi,1,1,0,0.5,0.5,1663,1611
2010-07-10,Uruguay,Germany,2,3,1,0.0,1.0,1928,2049
2010-07-11,Netherlands,Spain,0,1,1,0.0,1.0,2096,2165
2010-08-04,Botswana,Zimbabwe,2,0,2,1.0,0.0,1629,1664
2010-08-08,Anguilla,Saint Martin,1,3,2,0.0,1.0,1345,1468
2010-08-10,Bosnia and Herzegovina,Qatar,1,1,0,0.5,0.5,1733,1773
2010-08-10,Italy,Ivory Coast,0,1,1,0.0,1.0,1975,1907
2010-08-10,United States,Brazil,0,2,2,0.0,1.0,1943,2118
2010-08-11,Albania,Uzbekistan,1,0,1,1.0,0.0,1657,1716
2010-08-11,Algeria,Gabon,1,2,1,0.0,1.0,1751,1747
2010-08-11,Angola,Uruguay,0,2,2,0.0,1.0,1697,1932
2010-08-11,Armenia,Iran,1,3,2,0.0,1.0,1584,1889
2010-08-11,Austria,Switzerland,0,1,1,0.0,1.0,1762,1878
2010-08-11,Azerbaijan,Kuwait,1,1,0,0.5,0.5,1593,1752
2010-08-11,Benin,Niger,0,0,0,0.5,0.5,1598,1531
2010-08-11,Bolivia,Colombia,1,1,0,0.5,0.5,1721,1865
2010-08-11,Burkina Faso,Congo,3,0,3,1.0,0.0,1669,1623
2010-08-11,Chad,Tunisia,1,3,2,0.0,1.0,1516,1829
2010-08-11,China PR,Bahrain,1,1,0,0.5,0.5,1831,1805
2010-08-11,Cyprus,Andorra,1,0,1,1.0,0.0,1673,1371
2010-08-11,Czech Republic,Latvia,4,1,3,1.0,0.0,1918,1647
2010-08-11,Denmark,Germany,2,2,0,0.5,0.5,1910,2046
2010-08-11,Egypt,DR Congo,6,3,3,1.0,0.0,1930,1665
2010-08-11,England,Hungary,2,1,1,1.0,0.0,2035,1744
2010-08-11,Estonia,Faroe Islands,2,1,1,1.0,0.0,1635,1462
2010-08-11,Finland,Belgium,1,0,1,1.0,0.0,1768,1793
2010-08-11,Iceland,Liechtenstein,1,1,0,0.5,0.5,1670,1416
2010-08-11,Republic of Ireland,Argentina,0,1,1,0.0,1.0,1909,2049
2010-08-11,Kazakhstan,Oman,3,1,2,1.0,0.0,1561,1816
2010-08-11,South Korea,Nigeria,2,1,1,1.0,0.0,1926,1879
2010-08-11,Lithuania,Belarus,0,2,2,0.0,1.0,1656,1710
2010-08-11,Malawi,Botswana,1,1,0,0.5,0.5,1612,1629
2010-08-11,Mali,Guinea,0,2,2,0.0,1.0,1742,1723
2010-08-11,Malta,North Macedonia,1,1,0,0.5,0.5,1457,1717
2010-08-11,Mauritania,Palestine,0,0,0,0.5,0.5,1436,1506
2010-08-11,Mexico,Spain,1,1,0,0.5,0.5,1963,2161
2010-08-11,Moldova,Georgia,0,0,0,0.5,0.5,1587,1599
2010-08-11,Montenegro,Northern Ireland,2,0,2,1.0,0.0,1614,1695
2010-08-11,Morocco,Equatorial Guinea,2,1,1,1.0,0.0,1837,1474
2010-08-11,Mozambique,Eswatini,2,1,1,1.0,0.0,1633,1494
2010-08-11,Norway,France,2,1,1,1.0,0.0,1873,1982
2010-08-11,Panama,Venezuela,3,1,2,1.0,0.0,1721,1814
2010-08-11,Paraguay,Costa Rica,2,0,2,1.0,0.0,1890,1826
2010-08-11,Poland,Cameroon,0,3,3,0.0,1.0,1848,1852
2010-08-11,Russia,Bulgaria,1,0,1,1.0,0.0,1896,1835
2010-08-11,Saudi Arabia,Togo,1,0,1,1.0,0.0,1896,1660
2010-08-11,Senegal,Cape Verde,1,0,1,1.0,0.0,1805,1595
2010-08-11,Serbia,Greece,0,1,1,0.0,1.0,1874,1868
2010-08-11,Slovakia,Croatia,1,1,0,0.5,0.5,1802,1973
2010-08-11,Slovenia,Australia,2,0,2,1.0,0.0,1781,1932
2010-08-11,South Africa,Ghana,1,0,1,1.0,0.0,1847,1833
2010-08-11,Sweden,Scotland,3,0,3,1.0,0.0,1907,1803
2010-08-11,Tanzania,Kenya,1,1,0,0.5,0.5,1605,1611
2010-08-11,Thailand,Singapore,1,0,1,1.0,0.0,1757,1658
2010-08-11,Trinidad and Tobago,Jamaica,1,3,2,0.0,1.0,1748,1803
2010-08-11,Turkey,Romania,2,0,2,1.0,0.0,1903,1875
2010-08-11,Uganda,Zambia,1,1,0,0.5,0.5,1716,1738
2010-08-11,Ukraine,Netherlands,1,1,0,0.5,0.5,1886,2092
2010-08-11,Wales,Luxembourg,5,1,4,1.0,0.0,1756,1380
2010-08-18,Ethiopia,Kenya,0,3,3,0.0,1.0,1606,1620
2010-08-20,Madagascar,Mayotte,0,0,0,0.5,0.5,1583,1472
2010-08-26,Saint Lucia,Martinique,1,3,2,0.0,1.0,1496,1672
2010-08-28,Saint Kitts and Nevis,Antigua and Barbuda,1,1,0,0.5,0.5,1557,1539
2010-08-28,Saint Lucia,Martinique,1,1,0,0.5,0.5,1500,1669
2010-08-29,Ethiopia,Chad,1,0,1,1.0,0.0,1612,1511
2010-08-29,Madagascar,Comoros,1,0,1,1.0,0.0,1588,1403
2010-09-02,Israel,Malta,3,1,2,1.0,0.0,1812,1456
2010-09-03,Algeria,Tanzania,1,1,0,0.5,0.5,1748,1609
2010-09-03,Andorra,Russia,0,2,2,0.0,1.0,1371,1897
2010-09-03,Armenia,Republic of Ireland,0,1,1,0.0,1.0,1582,1912
2010-09-03,Belgium,Germany,0,1,1,0.0,1.0,1790,2050
2010-09-03,China PR,Iran,0,2,2,0.0,1.0,1825,1896
2010-09-03,England,Bulgaria,4,0,4,1.0,0.0,2039,1832
2010-09-03,Estonia,Italy,1,2,1,0.0,1.0,1634,1977
2010-09-03,Faroe Islands,Serbia,0,3,3,0.0,1.0,1461,1876
2010-09-03,France,Belarus,0,1,1,0.0,1.0,1969,1724
2010-09-03,Greece,Georgia,1,1,0,0.5,0.5,1863,1605
2010-09-03,Iceland,Norway,1,2,1,0.0,1.0,1667,1877
2010-09-03,Kazakhstan,Turkey,0,3,3,0.0,1.0,1560,1905
2010-09-03,Kuwait,Syria,3,0,3,1.0,0.0,1761,1766
2010-09-03,Latvia,Croatia,0,3,3,0.0,1.0,1645,1976
2010-09-03,Liechtenstein,Spain,0,4,4,0.0,1.0,1416,2162
2010-09-03,Lithuania,Scotland,0,0,0,0.5,0.5,1660,1800
2010-09-03,Luxembourg,Bosnia and Herzegovina,0,3,3,0.0,1.0,1379,1735
2010-09-03,Moldova,Finland,2,0,2,1.0,0.0,1599,1757
2010-09-03,Montenegro,Wales,1,0,1,1.0,0.0,1626,1745
2010-09-03,Oman,Malaysia,3,0,3,1.0,0.0,1820,1580
2010-09-03,Panama,Costa Rica,2,2,0,0.5,0.5,1724,1824
2010-09-03,Portugal,Cyprus,4,4,0,0.5,0.5,1970,1679
2010-09-03,Qatar,Bahrain,1,1,0,0.5,0.5,1774,1805
2010-09-03,Romania,Albania,1,1,0,0.5,0.5,1871,1662
2010-09-03,San Marino,Netherlands,0,5,5,0.0,1.0,1359,2093
2010-09-03,Slovakia,North Macedonia,1,0,1,1.0,0.0,1809,1711
2010-09-03,Slovenia,Northern Ireland,0,1,1,0.0,1.0,1772,1705
2010-09-03,Sweden,Hungary,2,0,2,1.0,0.0,1912,1740
2010-09-03,Switzerland,Australia,0,0,0,0.5,0.5,1880,1931
2010-09-03,Venezuela,Colombia,0,2,2,0.0,1.0,1808,1872
2010-09-04,Botswana,Togo,2,1,1,1.0,0.0,1638,1652
2010-09-04,Canada,Peru,0,2,2,0.0,1.0,1728,1758
2010-09-04,Cape Verde,Mali,1,0,1,1.0,0.0,1607,1731
2010-09-04,El Salvador,Honduras,2,2,0,0.5,0.5,1673,1831
2010-09-04,Guatemala,Nicaragua,5,0,5,1.0,0.0,1687,1375
2010-09-04,Gambia,Namibia,3,1,2,1.0,0.0,1603,1551
2010-09-04,Guinea-Bissau,Kenya,1,0,1,1.0,0.0,1524,1610
2010-09-04,Ivory Coast,Rwanda,3,0,3,1.0,0.0,1910,1603
2010-09-04,Japan,Paraguay,1,0,1,1.0,0.0,1935,1883
2010-09-04,Mauritius,Cameroon,1,3,2,0.0,1.0,1462,1854
2010-09-04,Mexico,Ecuador,1,2,1,0.0,1.0,1952,1828
2010-09-04,Morocco,Central African Republic,0,0,0,0.5,0.5,1831,1445
2010-09-04,Poland,Ukraine,1,1,0,0.5,0.5,1849,1886
2010-09-04,South Africa,Niger,2,0,2,1.0,0.0,1850,1529
2010-09-04,Sudan,Congo,2,0,2,1.0,0.0,1612,1615
2010-09-04,Thailand,India,1,0,1,1.0,0.0,1762,1589
2010-09-04,Tunisia,Malawi,2,2,0,0.5,0.5,1825,1617
2010-09-04,Uganda,Angola,3,0,3,1.0,0.0,1724,1690
2010-09-05,Benin,Burundi,1,1,0,0.5,0.5,1597,1531
2010-09-05,DR Congo,Senegal,2,4,2,0.0,1.0,1661,1810
2010-09-05,Egypt,Sierra Leone,1,1,0,0.5,0.5,1924,1583
2010-09-05,Ethiopia,Guinea,1,4,3,0.0,1.0,1607,1729
2010-09-05,Jamaica,Costa Rica,1,0,1,1.0,0.0,1812,1816
2010-09-05,Liberia,Zimbabwe,1,1,0,0.5,0.5,1562,1662
2010-09-05,Mozambique,Libya,0,0,0,0.5,0.5,1634,1676
2010-09-05,Nigeria,Madagascar,2,0,2,1.0,0.0,1882,1586
2010-09-05,Eswatini,Ghana,0,3,3,0.0,1.0,1493,1835
2010-09-05,Zambia,Comoros,4,0,4,1.0,0.0,1741,1401
2010-09-06,Burkina Faso,Gabon,1,1,0,0.5,0.5,1671,1746
2010-09-07,Albania,Luxembourg,1,0,1,1.0,0.0,1665,1377
2010-09-07,Argentina,Spain,4,1,3,1.0,0.0,2060,2152
2010-09-07,Austria,Kazakhstan,2,0,2,1.0,0.0,1766,1557
2010-09-07,Bahrain,Togo,3,0,3,1.0,0.0,1810,1648
2010-09-07,Belarus,Romania,0,0,0,0.5,0.5,1728,1868
2010-09-07,Bosnia and Herzegovina,France,0,2,2,0.0,1.0,1732,1973
2010-09-07,Bulgaria,Montenegro,0,1,1,0.0,1.0,1820,1639
2010-09-07,Canada,Honduras,2,1,1,1.0,0.0,1739,1821
2010-09-07,China PR,Paraguay,1,1,0,0.5,0.5,1827,1882
2010-09-07,Croatia,Greece,0,0,0,0.5,0.5,1974,1866
2010-09-07,Czech Republic,Lithuania,0,1,1,0.0,1.0,1905,1674
2010-09-07,Denmark,Iceland,1,0,1,1.0,0.0,1914,1664
2010-09-07,El Salvador,Guatemala,0,2,2,0.0,1.0,1666,1695
2010-09-07,Estonia,Uzbekistan,3,3,0,0.5,0.5,1636,1715
2010-09-07,Georgia,Israel,0,0,0,0.5,0.5,1610,1808
2010-09-07,Germany,Azerbaijan,6,1,5,1.0,0.0,2052,1592
2010-09-07,Hungary,Moldova,2,1,1,1.0,0.0,1745,1595
2010-09-07,Republic of Ireland,Andorra,3,1,2,1.0,0.0,1913,1371
2010-09-07,Italy,Faroe Islands,5,0,5,1.0,0.0,1978,1461
2010-09-07,Jamaica,Peru,1,2,1,0.0,1.0,1803,1768
2010-09-07,Japan,Guatemala,2,1,1,1.0,0.0,1939,1692
2010-09-07,South Korea,Iran,0,1,1,0.0,1.0,1918,1905
2010-09-07,North Macedonia,Armenia,2,2,0,0.5,0.5,1709,1585
2010-09-07,Malta,Latvia,0,2,2,0.0,1.0,1452,1650
2010-09-07,Mexico,Colombia,1,0,1,1.0,0.0,1959,1866
2010-09-07,Netherlands,Finland,2,1,1,1.0,0.0,2096,1755
2010-09-07,Norway,Portugal,1,0,1,1.0,0.0,1888,1960
2010-09-07,Panama,Trinidad and Tobago,3,0,3,1.0,0.0,1733,1740
2010-09-07,Poland,Australia,1,2,1,0.0,1.0,1843,1938
2010-09-07,Qatar,Oman,1,1,0,0.5,0.5,1776,1819
2010-09-07,Russia,Slovakia,0,1,1,0.0,1.0,1888,1819
2010-09-07,Scotland,Liechtenstein,2,1,1,1.0,0.0,1802,1415
2010-09-07,Serbia,Slovenia,1,1,0,0.5,0.5,1874,1775
2010-09-07,Sweden,San Marino,6,0,6,1.0,0.0,1913,1359
2010-09-07,Switzerland,England,1,3,2,0.0,1.0,1876,2044
2010-09-07,Turkey,Belgium,3,2,1,1.0,0.0,1911,1785
2010-09-07,Ukraine,Chile,2,1,1,1.0,0.0,1896,1926
2010-09-07,United Arab Emirates,Kuwait,3,0,3,1.0,0.0,1727,1753
2010-09-07,Venezuela,Ecuador,1,0,1,1.0,0.0,1817,1820
2010-09-07,Yemen,Syria,2,1,1,1.0,0.0,1583,1754
2010-09-08,India,Thailand,1,2,1,0.0,1.0,1585,1767
2010-09-10,Belize,Trinidad and Tobago,0,0,0,0.5,0.5,1463,1735
2010-09-10,Saint Lucia,Saint Vincent and the Grenadines,1,5,4,0.0,1.0,1494,1569
2010-09-11,French Guiana,Suriname,1,2,1,0.0,1.0,1476,1581
2010-09-15,India,Namibia,2,0,2,1.0,0.0,1593,1544
2010-09-16,Jordan,Iraq,4,1,3,1.0,0.0,1704,1755
2010-09-18,Anguilla,British Virgin Islands,1,2,1,0.0,1.0,1339,1415
2010-09-18,Yemen,Zambia,0,1,1,0.0,1.0,1579,1746
2010-09-19,Antigua and Barbuda,Trinidad and Tobago,0,1,1,0.0,1.0,1536,1739
2010-09-19,Jordan,Bahrain,2,0,2,1.0,0.0,1715,1800
2010-09-19,Saint Martin,British Virgin Islands,3,1,2,1.0,0.0,1475,1409
2010-09-21,Iraq,Oman,3,2,1,1.0,0.0,1765,1810
2010-09-21,Saint Lucia,Trinidad and Tobago,0,3,3,0.0,1.0,1491,1743
2010-09-22,Réunion,Saint Pierre and Miquelon,11,0,11,1.0,0.0,1583,1494
2010-09-22,French Guiana,Mayotte,2,2,0,0.5,0.5,1476,1473
2010-09-23,Antigua and Barbuda,Saint Lucia,5,0,5,1.0,0.0,1543,1485
2010-09-23,Martinique,Tahiti,4,1,3,1.0,0.0,1677,1644
2010-09-23,Guadeloupe,New Caledonia,1,1,0,0.5,0.5,1665,1652
2010-09-24,Iran,Bahrain,3,0,3,1.0,0.0,1911,1795
2010-09-24,Jordan,Syria,1,1,0,0.5,0.5,1716,1754
2010-09-24,Vietnam,North Korea,0,0,0,0.5,0.5,1650,1727
2010-09-25,Iraq,Yemen,2,1,1,1.0,0.0,1770,1575
2010-09-25,Mayotte,Réunion,1,2,1,0.0,1.0,1468,1589
2010-09-25,French Guiana,Saint Pierre and Miquelon,7,0,7,1.0,0.0,1485,1486
2010-09-26,Bahrain,Oman,2,0,2,1.0,0.0,1804,1802
2010-09-26,Barbados,Dominica,1,3,2,0.0,1.0,1594,1427
2010-09-26,Guyana,Trinidad and Tobago,1,1,0,0.5,0.5,1547,1739
2010-09-26,Syria,Kuwait,1,2,1,0.0,1.0,1746,1762
2010-09-26,New Caledonia,Martinique,0,4,4,0.0,1.0,1645,1685
2010-09-26,Guadeloupe,Tahiti,1,1,0,0.5,0.5,1665,1645
2010-09-27,Yemen,Palestine,3,1,2,1.0,0.0,1582,1500
2010-09-28,Jordan,Kuwait,2,2,0,0.5,0.5,1718,1761
2010-09-28,Oman,Iran,2,2,0,0.5,0.5,1805,1909
2010-09-28,French Guiana,Réunion,0,1,1,0.0,1.0,1480,1595
2010-09-28,Mayotte,Saint Pierre and Miquelon,10,0,10,1.0,0.0,1477,1478
2010-09-29,Palestine,Iraq,0,3,3,0.0,1.0,1498,1773
2010-09-29,Guadeloupe,Martinique,2,0,2,1.0,0.0,1674,1677
2010-09-29,New Caledonia,Tahiti,1,1,0,0.5,0.5,1645,1645
2010-10-01,Iran,Iraq,2,1,1,1.0,0.0,1915,1768
2010-10-01,Kuwait,Yemen,1,1,0,0.5,0.5,1758,1586
2010-10-01,Saint Martin,Cayman Islands,1,1,0,0.5,0.5,1475,1438
2010-10-01,Mayotte,Guadeloupe,0,4,4,0.0,1.0,1474,1678
2010-10-02,Puerto Rico,Anguilla,3,1,2,1.0,0.0,1402,1333
2010-10-02,Réunion,Martinique,0,0,0,0.5,0.5,1597,1676
2010-10-03,Iran,Kuwait,1,2,1,0.0,1.0,1904,1770
2010-10-04,Cayman Islands,Anguilla,4,1,3,1.0,0.0,1444,1328
2010-10-04,India,Hong Kong,0,1,1,0.0,1.0,1585,1575
2010-10-04,Puerto Rico,Saint Martin,2,0,2,1.0,0.0,1412,1466
2010-10-06,Anguilla,Saint Martin,2,1,1,1.0,0.0,1340,1455
2010-10-06,Barbados,Saint Kitts and Nevis,1,1,0,0.5,0.5,1594,1558
2010-10-06,Puerto Rico,Cayman Islands,2,0,2,1.0,0.0,1421,1436
2010-10-07,Iran,Brazil,0,3,3,0.0,1.0,1901,2122
2010-10-08,Albania,Bosnia and Herzegovina,1,1,0,0.5,0.5,1667,1731
2010-10-08,Andorra,North Macedonia,0,2,2,0.0,1.0,1369,1712
2010-10-08,Armenia,Slovakia,3,1,2,1.0,0.0,1598,1807
2010-10-08,Austria,Azerbaijan,3,0,3,1.0,0.0,1771,1588
2010-10-08,China PR,Syria,2,1,1,1.0,0.0,1834,1740
2010-10-08,Colombia,Ecuador,1,0,1,1.0,0.0,1873,1814
2010-10-08,Cyprus,Norway,1,2,1,0.0,1.0,1676,1892
2010-10-08,Czech Republic,Scotland,1,0,1,1.0,0.0,1911,1797
2010-10-08,Georgia,Malta,1,0,1,1.0,0.0,1615,1448
2010-10-08,Germany,Turkey,3,0,3,1.0,0.0,2057,1907
2010-10-08,Greece,Latvia,1,0,1,1.0,0.0,1870,1647
2010-10-08,Hungary,San Marino,8,0,8,1.0,0.0,1747,1358
2010-10-08,India,Vietnam,3,1,2,1.0,0.0,1595,1641
2010-10-08,Indonesia,Uruguay,1,7,6,0.0,1.0,1624,1935
2010-10-08,Republic of Ireland,Russia,2,3,1,0.0,1.0,1905,1897
2010-10-08,Japan,Argentina,1,0,1,1.0,0.0,1950,2050
2010-10-08,Kazakhstan,Belgium,0,2,2,0.0,1.0,1554,1789
2010-10-08,Kuwait,Bahrain,1,3,2,0.0,1.0,1763,1812
2010-10-08,Luxembourg,Belarus,0,0,0,0.5,0.5,1384,1722
2010-10-08,Moldova,Netherlands,0,1,1,0.0,1.0,1595,2097
2010-10-08,Montenegro,Switzerland,1,0,1,1.0,0.0,1652,1864
2010-10-08,Montserrat,Barbados,0,5,5,0.0,1.0,1396,1598
2010-10-08,Northern Ireland,Italy,0,0,0,0.5,0.5,1711,1973
2010-10-08,Oman,Gabon,1,0,1,1.0,0.0,1812,1740
2010-10-08,Panama,El Salvador,1,0,1,1.0,0.0,1740,1660
2010-10-08,Peru,Costa Rica,2,0,2,1.0,0.0,1778,1807
2010-10-08,Portugal,Denmark,3,1,2,1.0,0.0,1967,1908
2010-10-08,Serbia,Estonia,1,3,2,0.0,1.0,1862,1649
2010-10-08,Slovenia,Faroe Islands,5,1,4,1.0,0.0,1778,1459
2010-10-08,Spain,Lithuania,3,1,2,1.0,0.0,2153,1674
2010-10-08,Saint Vincent and the Grenadines,Saint Kitts and Nevis,1,1,0,0.5,0.5,1569,1559
2010-10-08,Ukraine,Canada,2,2,0,0.5,0.5,1893,1743
2010-10-08,Wales,Bulgaria,0,1,1,0.0,1.0,1739,1827
2010-10-09,Angola,Guinea-Bissau,1,0,1,1.0,0.0,1695,1520
2010-10-09,Australia,Paraguay,1,0,1,1.0,0.0,1945,1876
2010-10-09,Burkina Faso,Gambia,3,1,2,1.0,0.0,1678,1597
2010-10-09,Burundi,Ivory Coast,0,1,1,0.0,1.0,1530,1912
2010-10-09,Cameroon,DR Congo,1,1,0,0.5,0.5,1850,1666
2010-10-09,Comoros,Mozambique,0,1,1,0.0,1.0,1398,1638
2010-10-09,France,Romania,2,0,2,1.0,0.0,1979,1863
2010-10-09,Guatemala,Belize,4,2,2,1.0,0.0,1696,1460
2010-10-09,Israel,Croatia,1,2,1,0.0,1.0,1804,1979
2010-10-09,Kenya,Uganda,0,0,0,0.5,0.5,1613,1722
2010-10-09,Malawi,Chad,6,2,4,1.0,0.0,1623,1506
2010-10-09,Mali,Liberia,2,1,1,1.0,0.0,1736,1558
2010-10-09,New Zealand,Honduras,1,1,0,0.5,0.5,1724,1819
2010-10-09,Rwanda,Benin,0,3,3,0.0,1.0,1595,1606
2010-10-09,Saudi Arabia,Uzbekistan,4,0,4,1.0,0.0,1901,1711
2010-10-09,Senegal,Mauritius,7,0,7,1.0,0.0,1812,1461
2010-10-09,Tanzania,Morocco,0,1,1,0.0,1.0,1606,1835
2010-10-09,United Arab Emirates,Chile,0,2,2,0.0,1.0,1724,1930
2010-10-09,United States,Poland,2,2,0,0.5,0.5,1941,1846
2010-10-10,Central African Republic,Algeria,2,0,2,1.0,0.0,1459,1735
2010-10-10,Congo,Eswatini,3,1,2,1.0,0.0,1621,1488
2010-10-10,Ghana,Sudan,0,0,0,0.5,0.5,1831,1617
2010-10-10,Guinea,Nigeria,1,0,1,1.0,0.0,1741,1871
2010-10-10,Jamaica,Trinidad and Tobago,1,0,1,1.0,0.0,1810,1733
2010-10-10,Libya,Zambia,1,0,1,1.0,0.0,1686,1737
2010-10-10,Madagascar,Ethiopia,0,1,1,0.0,1.0,1579,1615
2010-10-10,Niger,Egypt,1,0,1,1.0,0.0,1544,1910
2010-10-10,Sierra Leone,South Africa,0,0,0,0.5,0.5,1589,1845
2010-10-10,Saint Kitts and Nevis,Montserrat,4,0,4,1.0,0.0,1564,1392
2010-10-10,Togo,Tunisia,1,2,1,0.0,1.0,1644,1830
2010-10-10,Zimbabwe,Cape Verde,0,0,0,0.5,0.5,1661,1609
2010-10-11,Brazil,Ukraine,2,0,2,1.0,0.0,2126,1890
2010-10-12,Armenia,Andorra,4,0,4,1.0,0.0,1602,1366
2010-10-12,Azerbaijan,Turkey,1,0,1,1.0,0.0,1602,1894
2010-10-12,Bahrain,Uzbekistan,2,4,2,0.0,1.0,1802,1722
2010-10-12,Belarus,Albania,2,0,2,1.0,0.0,1729,1661
2010-10-12,Belgium,Austria,4,4,0,0.5,0.5,1789,1772
2010-10-12,Bulgaria,Saudi Arabia,2,0,2,1.0,0.0,1837,1892
2010-10-12,China PR,Uruguay,0,4,4,0.0,1.0,1829,1941
2010-10-12,Costa Rica,El Salvador,2,1,1,1.0,0.0,1812,1656
2010-10-12,Croatia,Norway,2,1,1,1.0,0.0,1986,1886
2010-10-12,Denmark,Cyprus,2,0,2,1.0,0.0,1912,1673
2010-10-12,Ecuador,Poland,2,2,0,0.5,0.5,1815,1846
2010-10-12,England,Montenegro,0,0,0,0.5,0.5,2038,1659
2010-10-12,Equatorial Guinea,Botswana,0,2,2,0.0,1.0,1470,1643
2010-10-12,Estonia,Slovenia,0,1,1,0.0,1.0,1644,1784
2010-10-12,Faroe Islands,Northern Ireland,1,1,0,0.5,0.5,1464,1707
2010-10-12,Finland,Hungary,1,2,1,0.0,1.0,1747,1756
2010-10-12,France,Luxembourg,2,0,2,1.0,0.0,1980,1384
2010-10-12,Greece,Israel,2,1,1,1.0,0.0,1877,1798
2010-10-12,Guatemala,Honduras,0,2,2,0.0,1.0,1691,1825
2010-10-12,Iceland,Portugal,1,3,2,0.0,1.0,1662,1970
2010-10-12,Indonesia,Maldives,3,0,3,1.0,0.0,1629,1465
2010-10-12,Italy,Serbia,3,0,3,1.0,0.0,1979,1857
2010-10-12,Kazakhstan,Germany,0,3,3,0.0,1.0,1554,2058
2010-10-12,South Korea,Japan,0,0,0,0.5,0.5,1919,1950
2010-10-12,Kuwait,Vietnam,3,1,2,1.0,0.0,1769,1636
2010-10-12,Latvia,Georgia,1,1,0,0.5,0.5,1647,1616
2010-10-12,Liechtenstein,Czech Republic,0,2,2,0.0,1.0,1415,1912
2010-10-12,North Macedonia,Russia,0,1,1,0.0,1.0,1708,1902
2010-10-12,Mexico,Venezuela,2,2,0,0.5,0.5,1956,1821
2010-10-12,Netherlands,Sweden,4,1,3,1.0,0.0,2102,1909
2010-10-12,New Zealand,Paraguay,0,2,2,0.0,1.0,1720,1881
2010-10-12,Oman,Chile,0,1,1,0.0,1.0,1807,1936
2010-10-12,Panama,Peru,1,0,1,1.0,0.0,1749,1770
2010-10-12,Philippines,Macau,5,0,5,1.0,0.0,1333,1317
2010-10-12,Qatar,Iraq,1,2,1,0.0,1.0,1768,1777
2010-10-12,San Marino,Moldova,0,2,2,0.0,1.0,1355,1599
2010-10-12,Saudi Arabia,Gabon,1,0,1,1.0,0.0,1897,1736
2010-10-12,Scotland,Spain,2,3,1,0.0,1.0,1796,2155
2010-10-12,Slovakia,Republic of Ireland,1,1,0,0.5,0.5,1810,1903
2010-10-12,Switzerland,Wales,4,1,3,1.0,0.0,1870,1734
2010-10-12,United Arab Emirates,Angola,0,2,2,0.0,1.0,1716,1704
2010-10-12,United States,Colombia,0,0,0,0.5,0.5,1940,1875
2010-10-13,Guyana,Saint Lucia,1,0,1,1.0,0.0,1554,1479
2010-10-13,India,Yemen,3,6,3,0.0,1.0,1587,1595
2010-10-13,Suriname,Curaçao,2,1,1,1.0,0.0,1588,1507
2010-10-14,Dominican Republic,British Virgin Islands,17,0,17,1.0,0.0,1464,1403
2010-10-15,British Virgin Islands,Dominica,0,10,10,0.0,1.0,1396,1435
2010-10-15,Curaçao,Guyana,2,3,1,0.0,1.0,1501,1561
2010-10-15,Suriname,Saint Lucia,2,1,1,1.0,0.0,1594,1474
2010-10-17,Dominican Republic,Dominica,0,1,1,0.0,1.0,1456,1444
2010-10-17,Saint Lucia,Curaçao,2,2,0,0.5,0.5,1475,1501
2010-10-17,Suriname,Guyana,0,2,2,0.0,1.0,1586,1570
2010-10-22,Timor-Leste,Philippines,0,5,5,0.0,1.0,1376,1343
2010-10-22,Grenada,Puerto Rico,3,1,2,1.0,0.0,1577,1417
2010-10-22,Laos,Cambodia,0,0,0,0.5,0.5,1388,1337
2010-10-22,Saint Kitts and Nevis,Guadeloupe,1,2,1,0.0,1.0,1559,1684
2010-10-24,Cambodia,Timor-Leste,4,2,2,1.0,0.0,1346,1368
2010-10-24,Grenada,Saint Kitts and Nevis,2,0,2,1.0,0.0,1585,1552
2010-10-24,Guadeloupe,Puerto Rico,3,2,1,1.0,0.0,1687,1415
2010-10-24,Laos,Philippines,2,2,0,0.5,0.5,1387,1345
2010-10-26,Grenada,Guadeloupe,0,3,3,0.0,1.0,1580,1693
2010-10-26,Laos,Timor-Leste,6,1,5,1.0,0.0,1395,1361
2010-10-26,Panama,Cuba,0,3,3,0.0,1.0,1740,1706
2010-10-26,Philippines,Cambodia,0,0,0,0.5,0.5,1346,1346
2010-10-26,Puerto Rico,Saint Kitts and Nevis,0,1,1,0.0,1.0,1411,1557
2010-10-27,Botswana,Eswatini,2,0,2,1.0,0.0,1648,1484
2010-10-29,Curaçao,Aruba,3,0,3,1.0,0.0,1507,1379
2010-10-29,Suriname,Bonaire,4,2,2,1.0,0.0,1593,1494
2010-10-31,Aruba,Bonaire,3,3,0,0.5,0.5,1382,1492
2010-10-31,Curaçao,Suriname,2,2,0,0.5,0.5,1509,1592
2010-11-02,Haiti,Guyana,0,0,0,0.5,0.5,1661,1573
2010-11-02,Singapore,North Korea,1,2,1,0.0,1.0,1652,1734
2010-11-04,Trinidad and Tobago,Guyana,2,1,1,1.0,0.0,1738,1569
2010-11-04,Vietnam,Singapore,1,1,0,0.5,0.5,1637,1652
2010-11-06,Trinidad and Tobago,Haiti,4,0,4,1.0,0.0,1745,1655
2010-11-06,Vietnam,North Korea,0,2,2,0.0,1.0,1632,1740
2010-11-07,Yemen,Uganda,2,2,0,0.5,0.5,1598,1720
2010-11-10,Antigua and Barbuda,Suriname,2,1,1,1.0,0.0,1553,1583
2010-11-10,Bahrain,Uganda,0,0,0,0.5,0.5,1801,1722
2010-11-10,Cuba,Dominica,4,2,2,1.0,0.0,1709,1442
2010-11-10,Yemen,North Korea,1,1,0,0.5,0.5,1602,1737
2010-11-11,Iraq,India,2,0,2,1.0,0.0,1782,1583
2010-11-12,Antigua and Barbuda,Dominica,0,0,0,0.5,0.5,1551,1445
2010-11-12,Suriname,Cuba,3,3,0,0.5,0.5,1586,1707
2010-11-14,Antigua and Barbuda,Cuba,0,0,0,0.5,0.5,1555,1704
2010-11-14,Bahrain,Syria,0,2,2,0.0,1.0,1792,1750
2010-11-14,Dominica,Suriname,0,5,5,0.0,1.0,1441,1591
2010-11-14,India,Kuwait,1,9,8,0.0,1.0,1579,1774
2010-11-16,Cape Verde,Guinea-Bissau,2,1,1,1.0,0.0,1615,1515
2010-11-16,Jordan,Cyprus,0,0,0,0.5,0.5,1717,1675
2010-11-16,Saudi Arabia,Uganda,0,0,0,0.5,0.5,1894,1726
2010-11-16,Scotland,Faroe Islands,3,0,3,1.0,0.0,1799,1462
2010-11-17,Albania,North Macedonia,0,0,0,0.5,0.5,1663,1707
2010-11-17,Argentina,Brazil,1,0,1,1.0,0.0,2060,2117
2010-11-17,Austria,Greece,1,2,1,0.0,1.0,1767,1883
2010-11-17,Botswana,Tunisia,1,0,1,1.0,0.0,1660,1819
2010-11-17,Bulgaria,Serbia,0,1,1,0.0,1.0,1830,1865
2010-11-17,Burkina Faso,Guinea,2,1,1,1.0,0.0,1688,1732
2010-11-17,Chile,Uruguay,2,0,2,1.0,0.0,1945,1933
2010-11-17,China PR,Latvia,1,0,1,1.0,0.0,1834,1643
2010-11-17,Colombia,Peru,1,1,0,0.5,0.5,1873,1773
2010-11-17,Croatia,Malta,3,0,3,1.0,0.0,1987,1448
2010-11-17,Denmark,Czech Republic,0,0,0,0.5,0.5,1912,1912
2010-11-17,Ecuador,Venezuela,4,1,3,1.0,0.0,1824,1813
2010-11-17,Egypt,Australia,3,0,3,1.0,0.0,1919,1937
2010-11-17,England,France,1,2,1,0.0,1.0,2029,1990
2010-11-17,Estonia,Liechtenstein,1,1,0,0.5,0.5,1640,1420
2010-11-17,Finland,San Marino,8,0,8,1.0,0.0,1749,1354
2010-11-17,Gabon,Senegal,1,2,1,0.0,1.0,1730,1819
2010-11-17,Guatemala,Guyana,3,0,3,1.0,0.0,1697,1564
2010-11-17,Hong Kong,Paraguay,0,7,7,0.0,1.0,1573,1884
2010-11-17,Hungary,Lithuania,2,0,2,1.0,0.0,1763,1668
2010-11-17,Iraq,Kuwait,1,1,0,0.5,0.5,1782,1775
2010-11-17,Republic of Ireland,Norway,1,2,1,0.0,1.0,1895,1895
2010-11-17,Israel,Iceland,3,2,1,1.0,0.0,1804,1657
2010-11-17,Italy,Romania,1,1,0,0.5,0.5,1977,1866
2010-11-17,Jamaica,Costa Rica,0,0,0,0.5,0.5,1811,1812
2010-11-17,Libya,Niger,1,1,0,0.5,0.5,1683,1548
2010-11-17,Luxembourg,Algeria,0,0,0,0.5,0.5,1391,1729
2010-11-17,Malawi,Rwanda,2,1,1,1.0,0.0,1631,1588
2010-11-17,Mali,DR Congo,3,1,2,1.0,0.0,1743,1660
2010-11-17,Montenegro,Azerbaijan,2,0,2,1.0,0.0,1666,1596
2010-11-17,Mozambique,Zimbabwe,1,3,2,0.0,1.0,1631,1669
2010-11-17,Netherlands,Turkey,1,0,1,1.0,0.0,2106,1891
2010-11-17,Northern Ireland,Morocco,1,1,0,0.5,0.5,1710,1833
2010-11-17,Oman,Belarus,0,4,4,0.0,1.0,1798,1739
2010-11-17,Panama,Honduras,2,0,2,1.0,0.0,1750,1816
2010-11-17,Poland,Ivory Coast,3,1,2,1.0,0.0,1856,1903
2010-11-17,Portugal,Spain,4,0,4,1.0,0.0,1982,2144
2010-11-17,Russia,Belgium,0,2,2,0.0,1.0,1892,1800
2010-11-17,Saudi Arabia,Ghana,0,0,0,0.5,0.5,1893,1833
2010-11-17,Slovakia,Bosnia and Herzegovina,2,3,1,0.0,1.0,1801,1741
2010-11-17,Slovenia,Georgia,1,2,1,0.0,1.0,1773,1628
2010-11-17,South Africa,United States,0,1,1,0.0,1.0,1840,1946
2010-11-17,Sweden,Germany,0,0,0,0.5,0.5,1913,2055
2010-11-17,Switzerland,Ukraine,2,2,0,0.5,0.5,1871,1890
2010-11-17,Tajikistan,Afghanistan,1,0,1,1.0,0.0,1570,1352
2010-11-17,Togo,Chad,0,0,0,0.5,0.5,1641,1510
2010-11-18,Qatar,Haiti,0,1,1,0.0,1.0,1758,1666
2010-11-18,United Arab Emirates,India,5,0,5,1.0,0.0,1721,1575
2010-11-21,Indonesia,Timor-Leste,6,0,6,1.0,0.0,1632,1359
2010-11-22,Kuwait,Qatar,1,0,1,1.0,0.0,1783,1751
2010-11-22,Yemen,Saudi Arabia,0,4,4,0.0,1.0,1600,1896
2010-11-23,Iraq,United Arab Emirates,0,0,0,0.5,0.5,1781,1723
2010-11-23,Oman,Bahrain,1,1,0,0.5,0.5,1798,1793
2010-11-23,Tanzania,Kenya,1,0,1,1.0,0.0,1615,1605
2010-11-24,Indonesia,Taiwan,2,0,2,1.0,0.0,1636,1416
2010-11-25,Saudi Arabia,Kuwait,0,0,0,0.5,0.5,1894,1786
2010-11-25,Yemen,Qatar,1,2,1,0.0,1.0,1596,1756
2010-11-26,Bahrain,Iraq,2,3,1,0.0,1.0,1785,1790
2010-11-26,Martinique,Grenada,1,1,0,0.5,0.5,1674,1583
2010-11-26,Singapore,Laos,4,0,4,1.0,0.0,1655,1393
2010-11-26,Trinidad and Tobago,Cuba,0,2,2,0.0,1.0,1737,1713
2010-11-26,United Arab Emirates,Oman,0,0,0,0.5,0.5,1725,1797
2010-11-27,Guyana,Guadeloupe,1,1,0,0.5,0.5,1567,1691
2010-11-27,Jamaica,Antigua and Barbuda,3,1,2,1.0,0.0,1814,1553
2010-11-27,Tanzania,Zambia,0,1,1,0.0,1.0,1610,1743
2010-11-28,Burundi,Somalia,2,0,2,1.0,0.0,1535,1352
2010-11-28,Grenada,Trinidad and Tobago,1,0,1,1.0,0.0,1595,1726
2010-11-28,Martinique,Cuba,0,1,1,0.0,1.0,1667,1721
2010-11-28,Qatar,Saudi Arabia,1,1,0,0.5,0.5,1760,1891
2010-11-28,Yemen,Kuwait,0,3,3,0.0,1.0,1592,1791
2010-11-28,Zanzibar,Sudan,2,0,2,1.0,0.0,1516,1607
2010-11-29,Antigua and Barbuda,Guyana,1,0,1,1.0,0.0,1562,1559
2010-11-29,Guadeloupe,Jamaica,0,2,2,0.0,1.0,1686,1820
2010-11-29,Malawi,Kenya,3,2,1,1.0,0.0,1639,1598
2010-11-29,Oman,Iraq,0,0,0,0.5,0.5,1797,1791
2010-11-29,Uganda,Ethiopia,2,1,1,1.0,0.0,1732,1610
2010-11-29,United Arab Emirates,Bahrain,3,1,2,1.0,0.0,1735,1776
2010-11-30,Cuba,Grenada,0,0,0,0.5,0.5,1719,1598
2010-11-30,Martinique,Trinidad and Tobago,0,1,1,0.0,1.0,1661,1733
2010-11-30,Tanzania,Somalia,3,0,3,1.0,0.0,1613,1350
2010-11-30,Zambia,Burundi,0,0,0,0.5,0.5,1739,1540
2010-12-01,Guadeloupe,Antigua and Barbuda,1,0,1,1.0,0.0,1692,1557
2010-12-01,Guyana,Jamaica,0,4,4,0.0,1.0,1557,1823
2010-12-01,Indonesia,Malaysia,5,1,4,1.0,0.0,1643,1574
2010-12-01,Sudan,Rwanda,0,0,0,0.5,0.5,1607,1589
2010-12-01,Thailand,Laos,2,2,0,0.5,0.5,1761,1400
2010-12-02,Ethiopia,Kenya,2,1,1,1.0,0.0,1618,1591
2010-12-02,Kuwait,Iraq,2,2,0,0.5,0.5,1791,1791
2010-12-02,Malawi,Uganda,1,1,0,0.5,0.5,1642,1730
2010-12-02,Singapore,Philippines,1,1,0,0.5,0.5,1650,1352
2010-12-02,United Arab Emirates,Saudi Arabia,0,1,1,0.0,1.0,1731,1896
2010-12-02,Vietnam,Myanmar,7,1,6,1.0,0.0,1639,1574
2010-12-03,Cuba,Guadeloupe,1,2,1,0.0,1.0,1711,1701
2010-12-03,Jamaica,Grenada,2,1,1,1.0,0.0,1827,1595
2010-12-03,Rwanda,Zanzibar,0,0,0,0.5,0.5,1588,1518
2010-12-03,Zambia,Somalia,6,0,6,1.0,0.0,1741,1349
2010-12-04,Indonesia,Laos,6,0,6,1.0,0.0,1647,1397
2010-12-04,Thailand,Malaysia,0,0,0,0.5,0.5,1758,1578
2010-12-05,Grenada,Cuba,0,1,1,0.0,1.0,1590,1717
2010-12-05,Guadeloupe,Jamaica,1,1,0,0.5,0.5,1704,1825
2010-12-05,Kuwait,Saudi Arabia,1,0,1,1.0,0.0,1802,1886
2010-12-05,Singapore,Myanmar,2,1,1,1.0,0.0,1657,1568
2010-12-05,Uganda,Kenya,2,0,2,1.0,0.0,1735,1587
2010-12-05,Vietnam,Philippines,0,2,2,0.0,1.0,1626,1366
2010-12-07,Indonesia,Thailand,2,1,1,1.0,0.0,1658,1748
2010-12-07,Malaysia,Laos,5,1,4,1.0,0.0,1583,1393
2010-12-07,Zambia,Ethiopia,1,2,1,0.0,1.0,1731,1629
2010-12-08,Myanmar,Philippines,0,0,0,0.5,0.5,1564,1371
2010-12-08,Tanzania,Rwanda,1,0,1,1.0,0.0,1621,1581
2010-12-08,Uganda,Zanzibar,2,2,0,0.5,0.5,1731,1523
2010-12-08,Vietnam,Singapore,1,0,1,1.0,0.0,1635,1649
2010-12-10,Bosnia and Herzegovina,Poland,2,2,0,0.5,0.5,1744,1854
2010-12-10,Tanzania,Uganda,0,0,0,0.5,0.5,1624,1729
2010-12-12,Ethiopia,Uganda,3,4,1,0.0,1.0,1624,1735
2010-12-15,Malaysia,Vietnam,2,0,2,1.0,0.0,1593,1626
2010-12-16,Indonesia,Philippines,1,0,1,1.0,0.0,1661,1369
2010-12-16,Qatar,Egypt,2,1,1,1.0,0.0,1772,1908
2010-12-18,China PR,Estonia,3,0,3,1.0,0.0,1838,1637
2010-12-18,Honduras,Panama,2,1,1,1.0,0.0,1823,1744
2010-12-18,Iraq,Syria,0,1,1,0.0,1.0,1783,1759
2010-12-18,Vietnam,Malaysia,0,0,0,0.5,0.5,1626,1594
2010-12-19,Indonesia,Philippines,1,0,1,1.0,0.0,1664,1367
2010-12-22,China PR,North Macedonia,1,0,1,1.0,0.0,1844,1702
2010-12-22,Qatar,Estonia,2,0,2,1.0,0.0,1778,1632
2010-12-22,Syria,Iraq,0,1,1,0.0,1.0,1752,1791
2010-12-24,Kuwait,North Korea,2,1,1,1.0,0.0,1809,1731
2010-12-25,Bahrain,Uzbekistan,1,1,0,0.5,0.5,1775,1724
2010-12-26,Malaysia,Indonesia,3,0,3,1.0,0.0,1604,1655
2010-12-27,Kuwait,North Korea,2,2,0,0.5,0.5,1808,1733
2010-12-28,Bahrain,Jordan,2,1,1,1.0,0.0,1782,1711
2010-12-28,Saudi Arabia,Iraq,0,1,1,0.0,1.0,1876,1802
2010-12-28,Catalonia,Honduras,4,0,4,1.0,0.0,1650,1812
2010-12-29,Indonesia,Malaysia,2,1,1,1.0,0.0,1662,1598
2010-12-29,Basque Country,Venezuela,3,1,2,1.0,0.0,1733,1803
2010-12-30,Syria,South Korea,0,1,1,0.0,1.0,1748,1924
2010-12-31,Kuwait,Zambia,4,0,4,1.0,0.0,1815,1725
2010-12-31,Qatar,North Korea,0,1,1,0.0,1.0,1769,1743
2011-01-02,Iran,Angola,1,0,1,1.0,0.0,1905,1701
2011-01-02,Iraq,China PR,2,3,1,0.0,1.0,1795,1852
2011-01-02,Jordan,Uzbekistan,2,2,0,0.5,0.5,1712,1724
2011-01-02,United Arab Emirates,Syria,2,0,2,1.0,0.0,1740,1740
2011-01-04,Bahrain,North Korea,0,1,1,0.0,1.0,1774,1752
2011-01-04,Saudi Arabia,Angola,0,0,0,0.5,0.5,1873,1705
2011-01-05,Egypt,Tanzania,5,1,4,1.0,0.0,1911,1622
2011-01-05,Kenya,Sudan,1,0,1,1.0,0.0,1596,1599
2011-01-05,Uganda,Burundi,3,1,2,1.0,0.0,1739,1537
2011-01-05,United Arab Emirates,Australia,0,0,0,0.5,0.5,1745,1933
2011-01-07,Qatar,Uzbekistan,0,2,2,0.0,1.0,1760,1734
2011-01-08,DR Congo,Kenya,1,0,1,1.0,0.0,1667,1590
2011-01-08,Egypt,Uganda,1,0,1,1.0,0.0,1916,1735
2011-01-08,Kuwait,China PR,0,2,2,0.0,1.0,1808,1860
2011-01-08,Tanzania,Burundi,1,1,0,0.5,0.5,1621,1539
2011-01-09,Japan,Jordan,1,1,0,0.5,0.5,1946,1717
2011-01-09,Saudi Arabia,Syria,1,2,1,0.0,1.0,1863,1751
2011-01-10,India,Australia,0,4,4,0.0,1.0,1574,1935
2011-01-10,South Korea,Bahrain,2,1,1,1.0,0.0,1929,1770
2011-01-11,DR Congo,Sudan,2,1,1,1.0,0.0,1674,1593
2011-01-11,Egypt,Burundi,3,0,3,1.0,0.0,1918,1538
2011-01-11,Iraq,Iran,1,2,1,0.0,1.0,1790,1911
2011-01-11,North Korea,United Arab Emirates,0,0,0,0.5,0.5,1752,1746
2011-01-11,Uganda,Tanzania,1,1,0,0.5,0.5,1733,1624
2011-01-12,Qatar,China PR,2,0,2,1.0,0.0,1771,1850
2011-01-12,Uzbekistan,Kuwait,2,1,1,1.0,0.0,1744,1799
2011-01-13,Jordan,Saudi Arabia,1,0,1,1.0,0.0,1729,1852
2011-01-13,Syria,Japan,1,2,1,0.0,1.0,1748,1950
2011-01-14,Australia,South Korea,1,1,0,0.5,0.5,1935,1930
2011-01-14,Bahrain,India,5,2,3,1.0,0.0,1774,1571
2011-01-14,DR Congo,Uganda,0,1,1,0.0,1.0,1668,1740
2011-01-14,Costa Rica,Honduras,1,1,0,0.5,0.5,1812,1812
2011-01-14,Egypt,Kenya,5,1,4,1.0,0.0,1921,1588
2011-01-14,El Salvador,Nicaragua,2,0,2,1.0,0.0,1659,1373
2011-01-14,Panama,Belize,2,0,2,1.0,0.0,1747,1458
2011-01-15,Iran,North Korea,1,0,1,1.0,0.0,1916,1748
2011-01-15,United Arab Emirates,Iraq,0,1,1,0.0,1.0,1740,1797
2011-01-16,Belize,El Salvador,2,5,3,0.0,1.0,1455,1663
2011-01-16,China PR,Uzbekistan,2,2,0,0.5,0.5,1848,1747
2011-01-16,Guatemala,Costa Rica,0,2,2,0.0,1.0,1692,1818
2011-01-16,Panama,Nicaragua,2,0,2,1.0,0.0,1749,1372
2011-01-16,Qatar,Kuwait,3,0,3,1.0,0.0,1780,1791
2011-01-16,Tanzania,Sudan,0,2,2,0.0,1.0,1616,1602
2011-01-17,DR Congo,Kenya,1,0,1,1.0,0.0,1675,1582
2011-01-17,Egypt,Uganda,3,1,2,1.0,0.0,1926,1736
2011-01-17,Jordan,Syria,2,1,1,1.0,0.0,1738,1740
2011-01-17,Saudi Arabia,Japan,0,5,5,0.0,1.0,1847,1956
2011-01-18,Australia,Bahrain,1,0,1,1.0,0.0,1940,1770
2011-01-18,Honduras,Guatemala,3,1,2,1.0,0.0,1818,1687
2011-01-18,South Korea,India,4,1,3,1.0,0.0,1932,1570
2011-01-18,Nicaragua,Belize,1,1,0,0.5,0.5,1374,1454
2011-01-18,Panama,El Salvador,2,0,2,1.0,0.0,1756,1657
2011-01-19,Botswana,Sweden,1,2,1,0.0,1.0,1657,1917
2011-01-19,Iraq,North Korea,1,0,1,1.0,0.0,1804,1742
2011-01-19,United Arab Emirates,Iran,0,3,3,0.0,1.0,1736,1921
2011-01-21,Honduras,El Salvador,2,0,2,1.0,0.0,1823,1653
2011-01-21,Nicaragua,Guatemala,1,2,1,0.0,1.0,1372,1690
2011-01-21,Panama,Costa Rica,1,1,0,0.5,0.5,1758,1817
2011-01-21,Qatar,Japan,2,3,1,0.0,1.0,1776,1961
2011-01-21,Uzbekistan,Jordan,2,1,1,1.0,0.0,1755,1731
2011-01-22,Australia,Iraq,1,0,1,1.0,0.0,1946,1799
2011-01-22,Iran,South Korea,0,1,1,0.0,1.0,1914,1940
2011-01-22,United States,Chile,1,1,0,0.5,0.5,1946,1946
2011-01-23,Honduras,Costa Rica,2,1,1,1.0,0.0,1831,1810
2011-01-23,Panama,El Salvador,0,0,0,0.5,0.5,1756,1656
2011-01-24,Vanuatu,New Caledonia,0,0,0,0.5,0.5,1569,1644
2011-01-25,Japan,South Korea,2,2,0,0.5,0.5,1961,1941
2011-01-25,Uzbekistan,Australia,0,6,6,0.0,1.0,1752,1950
2011-01-28,Uzbekistan,South Korea,2,3,1,0.0,1.0,1748,1946
2011-01-29,Australia,Japan,0,1,1,0.0,1.0,1943,1969
2011-02-06,Moldova,Poland,0,1,1,0.0,1.0,1597,1857
2011-02-08,Cyprus,Sweden,0,2,2,0.0,1.0,1672,1921
2011-02-08,Ghana,Togo,4,1,3,1.0,0.0,1837,1638
2011-02-08,Republic of Ireland,Wales,3,0,3,1.0,0.0,1900,1730
2011-02-08,Mali,Ivory Coast,0,1,1,0.0,1.0,1739,1908
2011-02-08,Peru,Panama,1,0,1,1.0,0.0,1781,1749
2011-02-08,Romania,Ukraine,2,2,0,0.5,0.5,1867,1890
2011-02-09,Albania,Slovenia,1,2,1,0.0,1.0,1658,1779
2011-02-09,Andorra,Moldova,1,2,1,0.0,1.0,1363,1601
2011-02-09,Argentina,Portugal,2,1,1,1.0,0.0,2067,1976
2011-02-09,Armenia,Georgia,1,2,1,0.0,1.0,1595,1636
2011-02-09,Azerbaijan,Hungary,0,2,2,0.0,1.0,1592,1768
2011-02-09,Belarus,Kazakhstan,1,1,0,0.5,0.5,1736,1558
2011-02-09,Belgium,Finland,1,1,0,0.5,0.5,1799,1751
2011-02-09,Cambodia,Macau,3,1,2,1.0,0.0,1354,1310
2011-02-09,Cape Verde,Burkina Faso,1,0,1,1.0,0.0,1625,1679
2011-02-09,DR Congo,Gabon,0,2,2,0.0,1.0,1669,1737
2011-02-09,Croatia,Czech Republic,4,2,2,1.0,0.0,1994,1906
2011-02-09,Cyprus,Romania,1,1,0,0.5,0.5,1677,1863
2011-02-09,Denmark,England,1,2,1,0.0,1.0,1907,2035
2011-02-09,El Salvador,Haiti,1,0,1,1.0,0.0,1665,1658
2011-02-09,France,Brazil,1,0,1,1.0,0.0,2001,2107
2011-02-09,Germany,Italy,1,1,0,0.5,0.5,2054,1979
2011-02-09,Greece,Canada,1,0,1,1.0,0.0,1888,1739
2011-02-09,Guinea-Bissau,Gambia,3,1,2,1.0,0.0,1525,1588
2011-02-09,Honduras,Ecuador,1,1,0,0.5,0.5,1831,1825
2011-02-09,Iran,Russia,1,0,1,1.0,0.0,1922,1885
2011-02-09,Israel,Serbia,0,2,2,0.0,1.0,1798,1872
2011-02-09,Latvia,Bolivia,2,1,1,1.0,0.0,1653,1712
2011-02-09,Libya,Benin,3,2,1,1.0,0.0,1690,1600
2011-02-09,Luxembourg,Slovakia,2,1,1,1.0,0.0,1406,1787
2011-02-09,North Macedonia,Cameroon,0,1,1,0.0,1.0,1698,1855
2011-02-09,Malaysia,Hong Kong,2,0,2,1.0,0.0,1606,1566
2011-02-09,Malta,Switzerland,0,0,0,0.5,0.5,1455,1865
2011-02-09,Mexico,Bosnia and Herzegovina,2,0,2,1.0,0.0,1960,1741
2011-02-09,Morocco,Niger,3,0,3,1.0,0.0,1836,1546
2011-02-09,Mozambique,Botswana,1,1,0,0.5,0.5,1632,1657
2011-02-09,Namibia,Malawi,1,2,1,0.0,1.0,1539,1648
2011-02-09,Netherlands,Austria,3,1,2,1.0,0.0,2108,1766
2011-02-09,Nigeria,Sierra Leone,2,1,1,1.0,0.0,1874,1587
2011-02-09,Norway,Poland,0,1,1,0.0,1.0,1887,1866
2011-02-09,Philippines,Mongolia,2,0,2,1.0,0.0,1377,1412
2011-02-09,San Marino,Liechtenstein,0,1,1,0.0,1.0,1348,1427
2011-02-09,Scotland,Northern Ireland,3,0,3,1.0,0.0,1805,1705
2011-02-09,Senegal,Guinea,3,0,3,1.0,0.0,1826,1726
2011-02-09,South Africa,Kenya,2,0,2,1.0,0.0,1843,1580
2011-02-09,Spain,Colombia,1,0,1,1.0,0.0,2147,1871
2011-02-09,Eswatini,Zambia,0,4,4,0.0,1.0,1481,1729
2011-02-09,Sweden,Ukraine,1,1,0,0.5,0.5,1921,1891
2011-02-09,Tanzania,Palestine,1,0,1,1.0,0.0,1622,1493
2011-02-09,Turkey,South Korea,0,0,0,0.5,0.5,1893,1945
2011-02-09,Venezuela,Costa Rica,2,2,0,0.5,0.5,1804,1810
2011-02-14,Bahrain,Kuwait,0,0,0,0.5,0.5,1771,1791
2011-02-16,Laos,Taiwan,1,1,0,0.5,0.5,1394,1416
2011-02-16,Macau,Cambodia,3,2,1,1.0,0.0,1320,1345
2011-03-11,Gibraltar,Faroe Islands,3,0,3,1.0,0.0,1585,1457
2011-03-15,Mongolia,Philippines,2,1,1,1.0,0.0,1420,1370
2011-03-16,Argentina,Venezuela,4,1,3,1.0,0.0,2070,1802
2011-03-16,Botswana,Namibia,1,1,0,0.5,0.5,1655,1542
2011-03-17,Nepal,Bhutan,1,0,1,1.0,0.0,1415,1303
2011-03-19,Nepal,Bhutan,2,1,1,1.0,0.0,1421,1298
2011-03-19,Alderney,Guernsey,0,5,5,0.0,1.0,1278,1691
2011-03-21,Myanmar,Philippines,1,1,0,0.5,0.5,1560,1375
2011-03-21,India,Taiwan,3,0,3,1.0,0.0,1575,1412
2011-03-21,Maldives,Cambodia,4,0,4,1.0,0.0,1471,1340
2011-03-21,Palestine,Bangladesh,2,0,2,1.0,0.0,1500,1435
2011-03-21,Tajikistan,Kyrgyzstan,1,0,1,1.0,0.0,1576,1453
2011-03-21,Turkmenistan,Pakistan,3,0,3,1.0,0.0,1600,1367
2011-03-23,Bhutan,Afghanistan,0,3,3,0.0,1.0,1292,1359
2011-03-23,Myanmar,Bangladesh,0,2,2,0.0,1.0,1550,1446
2011-03-23,Cambodia,Tajikistan,0,3,3,0.0,1.0,1337,1580
2011-03-23,Maldives,Kyrgyzstan,2,1,1,1.0,0.0,1479,1446
2011-03-23,Pakistan,India,1,3,2,0.0,1.0,1364,1579
2011-03-23,Philippines,Palestine,0,0,0,0.5,0.5,1378,1498
2011-03-24,Cuba,El Salvador,0,1,1,0.0,1.0,1708,1675
2011-03-25,Afghanistan,Bhutan,2,0,2,1.0,0.0,1366,1286
2011-03-25,Austria,Belgium,0,2,2,0.0,1.0,1759,1807
2011-03-25,Bangladesh,Philippines,0,3,3,0.0,1.0,1437,1388
2011-03-25,Myanmar,Palestine,1,3,2,0.0,1.0,1541,1508
2011-03-25,Cambodia,Kyrgyzstan,3,4,1,0.0,1.0,1332,1452
2011-03-25,China PR,New Zealand,1,1,0,0.5,0.5,1846,1723
2011-03-25,Estonia,Uruguay,2,0,2,1.0,0.0,1646,1920
2011-03-25,Hungary,Netherlands,0,4,4,0.0,1.0,1767,2110
2011-03-25,Jamaica,Venezuela,0,2,2,0.0,1.0,1817,1811
2011-03-25,South Korea,Honduras,4,0,4,1.0,0.0,1951,1826
2011-03-25,Lithuania,Poland,2,0,2,1.0,0.0,1681,1854
2011-03-25,Luxembourg,France,0,2,2,0.0,1.0,1406,2002
2011-03-25,Maldives,Tajikistan,0,0,0,0.5,0.5,1482,1578
2011-03-25,Montenegro,Uzbekistan,1,0,1,1.0,0.0,1676,1739
2011-03-25,Panama,Bolivia,2,0,2,1.0,0.0,1757,1705
2011-03-25,Serbia,Northern Ireland,2,1,1,1.0,0.0,1877,1701
2011-03-25,Slovenia,Italy,0,1,1,0.0,1.0,1776,1983
2011-03-25,Spain,Czech Republic,2,1,1,1.0,0.0,2151,1903
2011-03-25,Turkmenistan,India,1,1,0,0.5,0.5,1600,1580
2011-03-26,Albania,Belarus,1,0,1,1.0,0.0,1668,1727
2011-03-26,Andorra,Slovakia,0,1,1,0.0,1.0,1362,1789
2011-03-26,Armenia,Russia,0,0,0,0.5,0.5,1601,1880
2011-03-26,Bosnia and Herzegovina,Romania,2,1,1,1.0,0.0,1752,1853
2011-03-26,Bulgaria,Switzerland,0,0,0,0.5,0.5,1831,1865
2011-03-26,Burkina Faso,Namibia,4,0,4,1.0,0.0,1684,1538
2011-03-26,Cape Verde,Liberia,4,2,2,1.0,0.0,1632,1552
2011-03-26,Chad,Botswana,0,1,1,0.0,1.0,1506,1660
2011-03-26,Colombia,Ecuador,2,0,2,1.0,0.0,1878,1819
2011-03-26,Costa Rica,China PR,2,2,0,0.5,0.5,1811,1846
2011-03-26,Cyprus,Iceland,0,0,0,0.5,0.5,1677,1658
2011-03-26,Georgia,Croatia,1,0,1,1.0,0.0,1651,1980
2011-03-26,Germany,Kazakhstan,4,0,4,1.0,0.0,2055,1558
2011-03-26,Guinea-Bissau,Uganda,0,1,1,0.0,1.0,1522,1740
2011-03-26,Republic of Ireland,North Macedonia,2,1,1,1.0,0.0,1904,1695
2011-03-26,Israel,Latvia,2,1,1,1.0,0.0,1803,1649
2011-03-26,Jordan,Kuwait,1,1,0,0.5,0.5,1733,1790
2011-03-26,Kenya,Angola,2,1,1,1.0,0.0,1591,1695
2011-03-26,North Korea,Iraq,2,0,2,1.0,0.0,1752,1790
2011-03-26,Malawi,Togo,1,0,1,1.0,0.0,1656,1631
2011-03-26,Mali,Zimbabwe,1,0,1,1.0,0.0,1746,1663
2011-03-26,Malta,Greece,0,1,1,0.0,1.0,1454,1890
2011-03-26,Mexico,Paraguay,3,1,2,1.0,0.0,1967,1878
2011-03-26,Norway,Denmark,1,1,0,0.5,0.5,1888,1907
2011-03-26,Portugal,Chile,1,1,0,0.5,0.5,1976,1947
2011-03-26,Rwanda,Burundi,3,1,2,1.0,0.0,1589,1531
2011-03-26,Senegal,Cameroon,1,0,1,1.0,0.0,1835,1847
2011-03-26,South Africa,Egypt,1,0,1,1.0,0.0,1853,1917
2011-03-26,Tanzania,Central African Republic,2,1,1,1.0,0.0,1627,1455
2011-03-26,United States,Argentina,1,1,0,0.5,0.5,1949,2068
2011-03-26,Wales,England,0,2,2,0.0,1.0,1728,2038
2011-03-27,Algeria,Morocco,1,0,1,1.0,0.0,1740,1826
2011-03-27,Brazil,Scotland,2,0,2,1.0,0.0,2110,1803
2011-03-27,Congo,Ghana,0,3,3,0.0,1.0,1618,1841
2011-03-27,DR Congo,Mauritius,3,0,3,1.0,0.0,1673,1458
2011-03-27,Ivory Coast,Benin,2,1,1,1.0,0.0,1911,1598
2011-03-27,Madagascar,Guinea,1,1,0,0.5,0.5,1583,1723
2011-03-27,Mozambique,Zambia,0,2,2,0.0,1.0,1627,1735
2011-03-27,Niger,Sierra Leone,3,1,2,1.0,0.0,1555,1579
2011-03-27,Nigeria,Ethiopia,4,0,4,1.0,0.0,1878,1621
2011-03-27,Sri Lanka,Tajikistan,2,2,0,0.5,0.5,1420,1575
2011-03-27,Saint Kitts and Nevis,Grenada,0,0,0,0.5,0.5,1558,1590
2011-03-27,Sudan,Eswatini,3,0,3,1.0,0.0,1608,1476
2011-03-28,Libya,Comoros,3,0,3,1.0,0.0,1693,1396
2011-03-28,Guatemala,Bolivia,1,1,0,0.5,0.5,1691,1705
2011-03-29,Belarus,Canada,0,1,1,0.0,1.0,1720,1747
2011-03-29,Belgium,Azerbaijan,4,1,3,1.0,0.0,1811,1589
2011-03-29,China PR,Honduras,3,0,3,1.0,0.0,1854,1819
2011-03-29,Colombia,Chile,0,2,2,0.0,1.0,1872,1954
2011-03-29,Costa Rica,Argentina,0,0,0,0.5,0.5,1817,2063
2011-03-29,Cuba,Panama,0,2,2,0.0,1.0,1702,1764
2011-03-29,Cyprus,Bulgaria,0,1,1,0.0,1.0,1673,1836
2011-03-29,Czech Republic,Liechtenstein,2,0,2,1.0,0.0,1904,1427
2011-03-29,Ecuador,Peru,0,0,0,0.5,0.5,1819,1782
2011-03-29,El Salvador,Jamaica,2,3,1,0.0,1.0,1671,1822
2011-03-29,England,Ghana,1,1,0,0.5,0.5,2034,1846
2011-03-29,Equatorial Guinea,Gambia,1,0,1,1.0,0.0,1481,1578
2011-03-29,Estonia,Serbia,1,1,0,0.5,0.5,1651,1873
2011-03-29,France,Croatia,0,0,0,0.5,0.5,2002,1981
2011-03-29,Germany,Australia,1,2,1,0.0,1.0,2045,1954
2011-03-29,Greece,Poland,0,0,0,0.5,0.5,1890,1855
2011-03-29,Republic of Ireland,Uruguay,2,3,1,0.0,1.0,1897,1928
2011-03-29,Israel,Georgia,1,0,1,1.0,0.0,1808,1647
2011-03-29,Jordan,North Korea,1,1,0,0.5,0.5,1734,1752
2011-03-29,Kuwait,Iraq,1,0,1,1.0,0.0,1798,1782
2011-03-29,Lithuania,Spain,1,3,2,0.0,1.0,1680,2153
2011-03-29,Mexico,Venezuela,1,1,0,0.5,0.5,1964,1815
2011-03-29,Netherlands,Hungary,5,3,2,1.0,0.0,2112,1766
2011-03-29,Nigeria,Kenya,3,0,3,1.0,0.0,1881,1589
2011-03-29,Northern Ireland,Slovenia,0,0,0,0.5,0.5,1703,1775
2011-03-29,Oman,Tunisia,2,1,1,1.0,0.0,1806,1811
2011-03-29,Portugal,Finland,2,0,2,1.0,0.0,1980,1748
2011-03-29,Qatar,Russia,1,1,0,0.5,0.5,1779,1878
2011-03-29,Romania,Luxembourg,3,1,2,1.0,0.0,1855,1405
2011-03-29,Slovakia,Denmark,1,2,1,0.0,1.0,1784,1913
2011-03-29,Sri Lanka,Tajikistan,0,2,2,0.0,1.0,1416,1580
2011-03-29,Sweden,Moldova,2,1,1,1.0,0.0,1924,1599
2011-03-29,Turkey,Austria,2,0,2,1.0,0.0,1899,1754
2011-03-29,Ukraine,Italy,0,2,2,0.0,1.0,1886,1989
2011-03-29,United States,Paraguay,0,1,1,0.0,1.0,1940,1888
2011-04-02,Grenada,Saint Kitts and Nevis,0,1,1,0.0,1.0,1582,1567
2011-04-03,Tahiti,New Caledonia,1,3,2,0.0,1.0,1637,1653
2011-04-07,North Korea,Sri Lanka,4,0,4,1.0,0.0,1755,1414
2011-04-07,Nepal,Afghanistan,1,0,1,1.0,0.0,1428,1360
2011-04-07,Tahiti,New Caledonia,1,0,1,1.0,0.0,1646,1645
2011-04-09,Nepal,North Korea,0,1,1,0.0,1.0,1426,1758
2011-04-09,Sri Lanka,Afghanistan,0,1,1,0.0,1.0,1405,1370
2011-04-11,North Korea,Afghanistan,2,0,2,1.0,0.0,1760,1369
2011-04-11,Nepal,Sri Lanka,0,0,0,0.5,0.5,1426,1406
2011-04-20,Argentina,Ecuador,2,2,0,0.5,0.5,2059,1824
2011-04-23,Mozambique,Tanzania,2,0,2,1.0,0.0,1635,1619
2011-05-04,New Caledonia,Réunion,2,4,2,0.0,1.0,1636,1607
2011-05-07,Monaco,Vatican City,2,1,1,1.0,0.0,1497,1493
2011-05-07,New Caledonia,Réunion,1,3,2,0.0,1.0,1628,1616
2011-05-08,Guernsey,Jersey,1,1,0,0.5,0.5,1693,1748
2011-05-14,Tanzania,South Africa,0,1,1,0.0,1.0,1616,1857
2011-05-20,Guyana,Barbados,1,0,1,1.0,0.0,1566,1590
2011-05-22,Guyana,Barbados,3,2,1,1.0,0.0,1575,1582
2011-05-24,Republic of Ireland,Northern Ireland,5,0,5,1.0,0.0,1901,1700
2011-05-25,Argentina,Paraguay,4,2,2,1.0,0.0,2064,1884
2011-05-25,Eswatini,Botswana,0,0,0,0.5,0.5,1480,1657
2011-05-25,Wales,Scotland,1,3,2,0.0,1.0,1722,1810
2011-05-25,Estonia,Basque Country,1,2,1,0.0,1.0,1645,1740
2011-05-26,Cuba,Nicaragua,1,1,0,0.5,0.5,1697,1378
2011-05-27,Grenada,Antigua and Barbuda,2,2,0,0.5,0.5,1582,1558
2011-05-27,Wales,Northern Ireland,2,0,2,1.0,0.0,1730,1693
2011-05-28,Cuba,Nicaragua,2,1,1,1.0,0.0,1700,1376
2011-05-28,Mexico,Ecuador,1,1,0,0.5,0.5,1961,1828
2011-05-28,Occitania,Romani people,11,2,9,1.0,0.0,1516,1500
2011-05-29,Barbados,Guyana,1,1,0,0.5,0.5,1582,1576
2011-05-29,El Salvador,Honduras,2,2,0,0.5,0.5,1675,1816
2011-05-29,Ethiopia,Sudan,1,2,1,0.0,1.0,1613,1617
2011-05-29,Germany,Uruguay,2,1,1,1.0,0.0,2051,1923
2011-05-29,Republic of Ireland,Scotland,1,0,1,1.0,0.0,1907,1805
2011-05-29,Panama,Grenada,2,0,2,1.0,0.0,1769,1578
2011-05-29,Eswatini,Malawi,1,1,0,0.5,0.5,1484,1653
2011-05-29,Tunisia,Central African Republic,3,0,3,1.0,0.0,1813,1454
2011-05-31,Corsica,Bulgaria,1,0,1,1.0,0.0,1540,1823
2011-06-01,Canada,Ecuador,2,2,0,0.5,0.5,1749,1827
2011-06-01,Guatemala,Venezuela,0,2,2,0.0,1.0,1686,1821
2011-06-01,Japan,Peru,0,0,0,0.5,0.5,1966,1786
2011-06-01,Mexico,New Zealand,3,0,3,1.0,0.0,1965,1720
2011-06-01,Nigeria,Argentina,4,1,3,1.0,0.0,1893,2053
2011-06-01,Ukraine,Uzbekistan,2,0,2,1.0,0.0,1891,1735
2011-06-02,Brittany,Equatorial Guinea,0,1,1,0.0,1.0,1526,1491
2011-06-03,Austria,Germany,1,2,1,0.0,1.0,1752,2054
2011-06-03,Belarus,France,1,1,0,0.5,0.5,1726,1997
2011-06-03,Belgium,Turkey,1,1,0,0.5,0.5,1813,1898
2011-06-03,Croatia,Georgia,2,1,1,1.0,0.0,1984,1645
2011-06-03,Faroe Islands,Slovenia,0,2,2,0.0,1.0,1455,1778
2011-06-03,Hong Kong,Malaysia,1,1,0,0.5,0.5,1567,1606
2011-06-03,Italy,Estonia,3,0,3,1.0,0.0,1991,1644
2011-06-03,Kazakhstan,Azerbaijan,2,1,1,1.0,0.0,1567,1581
2011-06-03,South Korea,Serbia,2,1,1,1.0,0.0,1958,1867
2011-06-03,Liechtenstein,Lithuania,2,0,2,1.0,0.0,1440,1668
2011-06-03,Luxembourg,Hungary,0,1,1,0.0,1.0,1404,1768
2011-06-03,Moldova,Sweden,1,4,3,0.0,1.0,1597,1927
2011-06-03,Romania,Bosnia and Herzegovina,3,0,3,1.0,0.0,1861,1747
2011-06-03,San Marino,Finland,0,1,1,0.0,1.0,1347,1750
2011-06-03,Ghana,Congo,3,1,2,1.0,0.0,1850,1615
2011-06-04,Bolivia,Paraguay,0,2,2,0.0,1.0,1701,1889
2011-06-04,Brazil,Netherlands,0,0,0,0.5,0.5,2111,2112
2011-06-04,Cameroon,Senegal,0,0,0,0.5,0.5,1847,1836
2011-06-04,Central African Republic,Tanzania,2,1,1,1.0,0.0,1466,1605
2011-06-04,England,Switzerland,2,2,0,0.5,0.5,2031,1869
2011-06-04,Greece,Malta,3,1,2,1.0,0.0,1892,1453
2011-06-04,Iceland,Denmark,0,2,2,0.0,1.0,1656,1916
2011-06-04,Latvia,Israel,1,2,1,0.0,1.0,1645,1813
2011-06-04,North Macedonia,Republic of Ireland,0,2,2,0.0,1.0,1692,1911
2011-06-04,Montenegro,Bulgaria,1,1,0,0.5,0.5,1680,1820
2011-06-04,Morocco,Algeria,4,0,4,1.0,0.0,1833,1734
2011-06-04,Namibia,Burkina Faso,1,4,3,0.0,1.0,1534,1689
2011-06-04,Peru,Czech Republic,0,0,0,0.5,0.5,1789,1902
2011-06-04,Portugal,Norway,1,0,1,1.0,0.0,1986,1883
2011-06-04,Russia,Armenia,3,1,2,1.0,0.0,1881,1599
2011-06-04,Sierra Leone,Niger,1,0,1,1.0,0.0,1587,1548
2011-06-04,Slovakia,Andorra,1,0,1,1.0,0.0,1786,1361
2011-06-04,Uganda,Guinea-Bissau,2,0,2,1.0,0.0,1744,1519
2011-06-04,United States,Spain,0,4,4,0.0,1.0,1937,2157
2011-06-04,Zambia,Mozambique,3,0,3,1.0,0.0,1741,1630
2011-06-05,Angola,Kenya,1,0,1,1.0,0.0,1701,1584
2011-06-05,Australia,New Zealand,3,0,3,1.0,0.0,1958,1717
2011-06-05,Benin,Ivory Coast,2,6,4,0.0,1.0,1596,1914
2011-06-05,Botswana,Malawi,0,0,0,0.5,0.5,1657,1654
2011-06-05,Burundi,Rwanda,3,1,2,1.0,0.0,1541,1580
2011-06-05,China PR,Uzbekistan,1,0,1,1.0,0.0,1860,1730
2011-06-05,Comoros,Libya,1,1,0,0.5,0.5,1402,1688
2011-06-05,Costa Rica,Cuba,5,0,5,1.0,0.0,1823,1695
2011-06-05,Egypt,South Africa,0,0,0,0.5,0.5,1916,1859
2011-06-05,Ethiopia,Nigeria,2,2,0,0.5,0.5,1619,1888
2011-06-05,Guinea,Madagascar,4,1,3,1.0,0.0,1728,1579
2011-06-05,Liberia,Cape Verde,1,0,1,1.0,0.0,1562,1623
2011-06-05,Mauritius,DR Congo,1,2,1,0.0,1.0,1455,1677
2011-06-05,Mexico,El Salvador,5,0,5,1.0,0.0,1968,1673
2011-06-05,Poland,Argentina,2,1,1,1.0,0.0,1868,2041
2011-06-05,Eswatini,Sudan,1,2,1,0.0,1.0,1479,1623
2011-06-05,Tunisia,Chad,5,0,5,1.0,0.0,1816,1504
2011-06-05,Zimbabwe,Mali,2,1,1,1.0,0.0,1673,1737
2011-06-06,Honduras,Guatemala,0,0,0,0.5,0.5,1814,1689
2011-06-06,Jamaica,Grenada,4,0,4,1.0,0.0,1826,1575
2011-06-06,Ukraine,France,1,4,3,0.0,1.0,1886,2003
2011-06-07,Australia,Serbia,0,0,0,0.5,0.5,1956,1870
2011-06-07,Austria,Latvia,3,1,2,1.0,0.0,1758,1640
2011-06-07,Azerbaijan,Germany,1,3,2,0.0,1.0,1581,2055
2011-06-07,Belarus,Luxembourg,2,0,2,1.0,0.0,1729,1402
2011-06-07,Bosnia and Herzegovina,Albania,2,0,2,1.0,0.0,1754,1662
2011-06-07,Brazil,Romania,1,0,1,1.0,0.0,2115,1858
2011-06-07,Ecuador,Greece,1,1,0,0.5,0.5,1829,1891
2011-06-07,Faroe Islands,Estonia,2,0,2,1.0,0.0,1467,1633
2011-06-07,Gabon,Gambia,0,1,1,0.0,1.0,1726,1590
2011-06-07,Italy,Republic of Ireland,0,2,2,0.0,1.0,1982,1921
2011-06-07,Japan,Czech Republic,0,0,0,0.5,0.5,1965,1904
2011-06-07,South Korea,Ghana,2,1,1,1.0,0.0,1964,1845
2011-06-07,Norway,Lithuania,1,0,1,1.0,0.0,1887,1665
2011-06-07,Panama,Guadeloupe,3,2,1,1.0,0.0,1776,1698
2011-06-07,Paraguay,Bolivia,0,0,0,0.5,0.5,1886,1705
2011-06-07,Russia,Cameroon,0,0,0,0.5,0.5,1881,1848
2011-06-07,San Marino,Hungary,0,3,3,0.0,1.0,1346,1770
2011-06-07,Sweden,Finland,5,0,5,1.0,0.0,1932,1746
2011-06-07,United States,Canada,2,0,2,1.0,0.0,1942,1745
2011-06-07,Venezuela,Spain,0,3,3,0.0,1.0,1819,2160
2011-06-08,China PR,North Korea,2,0,2,1.0,0.0,1866,1755
2011-06-08,Uruguay,Netherlands,1,1,0,0.5,0.5,1927,2109
2011-06-09,Costa Rica,El Salvador,1,1,0,0.5,0.5,1820,1677
2011-06-09,Cuba,Mexico,0,5,5,0.0,1.0,1693,1971
2011-06-09,Poland,France,0,1,1,0.0,1.0,1863,2009
2011-06-10,Grenada,Honduras,1,7,6,0.0,1.0,1572,1818
2011-06-10,Jamaica,Guatemala,2,0,2,1.0,0.0,1831,1685
2011-06-11,Canada,Guadeloupe,1,0,1,1.0,0.0,1752,1692
2011-06-11,Mexico,Venezuela,0,3,3,0.0,1.0,1960,1831
2011-06-11,Paraguay,Romania,2,0,2,1.0,0.0,1894,1851
2011-06-11,United States,Panama,1,2,1,0.0,1.0,1931,1788
2011-06-12,El Salvador,Cuba,6,1,5,1.0,0.0,1686,1685
2011-06-12,Mexico,Costa Rica,4,1,3,1.0,0.0,1965,1816
2011-06-12,Palestine,Vatican City,9,1,8,1.0,0.0,1516,1486
2011-06-13,Guatemala,Grenada,4,0,4,1.0,0.0,1691,1567
2011-06-13,Honduras,Jamaica,0,1,1,0.0,1.0,1811,1839
2011-06-14,Canada,Panama,1,1,0,0.5,0.5,1753,1788
2011-06-14,United States,Guadeloupe,1,0,1,1.0,0.0,1935,1689
2011-06-15,Montserrat,Belize,2,5,3,0.0,1.0,1386,1461
2011-06-18,Costa Rica,Honduras,1,1,0,0.5,0.5,1816,1812
2011-06-18,Malaysia,Myanmar,2,0,2,1.0,0.0,1613,1535
2011-06-18,Mexico,Guatemala,2,1,1,1.0,0.0,1968,1689
2011-06-19,Chile,Estonia,4,0,4,1.0,0.0,1957,1631
2011-06-19,Anguilla,United States Virgin Islands,0,0,0,0.5,0.5,1342,1395
2011-06-19,Panama,El Salvador,1,1,0,0.5,0.5,1786,1689
2011-06-19,United States,Jamaica,2,0,2,1.0,0.0,1941,1834
2011-06-20,Argentina,Albania,4,0,4,1.0,0.0,2043,1661
2011-06-22,Honduras,Mexico,0,2,2,0.0,1.0,1808,1973
2011-06-22,United States,Panama,1,0,1,1.0,0.0,1946,1782
2011-06-23,Uruguay,Estonia,3,0,3,1.0,0.0,1930,1629
2011-06-23,Paraguay,Chile,0,0,0,0.5,0.5,1896,1956
2011-06-25,Colombia,Senegal,2,0,2,1.0,0.0,1880,1829
2011-06-25,Kenya,Sudan,1,2,1,0.0,1.0,1577,1631
2011-06-25,United States,Mexico,2,4,2,0.0,1.0,1939,1981
2011-06-26,Rhodes,Greenland,2,1,1,1.0,0.0,1563,1450
2011-06-26,Jersey,Menorca,2,0,2,1.0,0.0,1752,1524
2011-06-26,Alderney,Gibraltar,1,6,5,0.0,1.0,1276,1588
2011-06-26,Isle of Wight,Ynys Môn,4,0,4,1.0,0.0,1559,1566
2011-06-26,Gotland,Isle of Man,2,4,2,0.0,1.0,1516,1557
2011-06-26,Guernsey,Falkland Islands,5,0,5,1.0,0.0,1697,1440
2011-06-26,Åland Islands,Saare County,3,3,0,0.5,0.5,1544,1404
2011-06-27,Bolivia,Mexico,0,1,1,0.0,1.0,1703,1984
2011-06-27,Greenland,Menorca,2,3,1,0.0,1.0,1444,1531
2011-06-27,Jersey,Rhodes,2,0,2,1.0,0.0,1757,1559
2011-06-27,Isle of Wight,Alderney,4,0,4,1.0,0.0,1562,1274
2011-06-27,Gibraltar,Ynys Môn,6,3,3,1.0,0.0,1596,1559
2011-06-27,Isle of Man,Falkland Islands,6,0,6,1.0,0.0,1563,1435
2011-06-27,Gotland,Guernsey,2,5,3,0.0,1.0,1512,1702
2011-06-27,Western Isles,Åland Islands,0,2,2,0.0,1.0,1527,1552
2011-06-28,Peru,Senegal,1,0,1,1.0,0.0,1798,1821
2011-06-28,Greenland,Jersey,1,2,1,0.0,1.0,1442,1760
2011-06-28,Alderney,Ynys Môn,0,5,5,0.0,1.0,1272,1562
2011-06-28,Isle of Wight,Gibraltar,3,2,1,1.0,0.0,1571,1588
2011-06-28,Guernsey,Isle of Man,2,1,1,1.0,0.0,1707,1559
2011-06-28,Falkland Islands,Gotland,1,6,5,0.0,1.0,1429,1519
2011-06-28,Saare County,Western Isles,2,0,2,1.0,0.0,1415,1517
2011-06-29,Afghanistan,Palestine,0,2,2,0.0,1.0,1365,1521
2011-06-29,Bangladesh,Pakistan,3,0,3,1.0,0.0,1444,1358
2011-06-29,Cambodia,Laos,4,2,2,1.0,0.0,1342,1385
2011-06-29,Iraq,Syria,1,2,1,0.0,1.0,1774,1749
2011-06-29,Malaysia,Taiwan,2,1,1,1.0,0.0,1617,1409
2011-06-29,Mongolia,Myanmar,1,0,1,1.0,0.0,1431,1525
2011-06-29,Nepal,Timor-Leste,2,1,1,1.0,0.0,1433,1353
2011-06-29,Sri Lanka,Philippines,1,1,0,0.5,0.5,1406,1389
2011-06-29,Vietnam,Macau,6,0,6,1.0,0.0,1629,1318
2011-06-30,Alderney,Falkland Islands,0,3,3,0.0,1.0,1268,1434
2011-06-30,Greenland,Western Isles,1,0,1,1.0,0.0,1452,1508
2011-06-30,Gotland,Ynys Môn,1,2,1,0.0,1.0,1512,1570
2011-06-30,Isle of Man,Menorca,2,2,0,0.5,0.5,1559,1532
2011-06-30,Saare County,Gibraltar,0,4,4,0.0,1.0,1411,1593
2011-06-30,Isle of Wight,Jersey,1,0,1,1.0,0.0,1583,1749
2011-06-30,Guernsey,Åland Islands,3,2,1,1.0,0.0,1712,1548
2011-07-01,Argentina,Bolivia,1,1,0,0.5,0.5,2037,1710
2011-07-01,Jersey,Åland Islands,5,1,4,1.0,0.0,1753,1545
2011-07-01,Isle of Wight,Guernsey,4,2,2,1.0,0.0,1594,1702
2011-07-02,Colombia,Costa Rica,1,0,1,1.0,0.0,1887,1810
2011-07-02,Lebanon,Kuwait,0,6,6,0.0,1.0,1574,1802
2011-07-02,Nepal,Timor-Leste,5,0,5,1.0,0.0,1440,1347
2011-07-02,Turks and Caicos Islands,Bahamas,0,4,4,0.0,1.0,1456,1469
2011-07-03,Brazil,Venezuela,0,0,0,0.5,0.5,2110,1837
2011-07-03,Myanmar,Mongolia,2,0,2,1.0,0.0,1531,1426
2011-07-03,Laos,Cambodia,6,2,4,1.0,0.0,1393,1335
2011-07-03,Macau,Vietnam,1,7,6,0.0,1.0,1316,1632
2011-07-03,Pakistan,Bangladesh,0,0,0,0.5,0.5,1360,1443
2011-07-03,Palestine,Afghanistan,1,1,0,0.5,0.5,1518,1369
2011-07-03,Paraguay,Ecuador,0,0,0,0.5,0.5,1895,1831
2011-07-03,Philippines,Sri Lanka,4,0,4,1.0,0.0,1398,1398
2011-07-03,United States Virgin Islands,British Virgin Islands,2,0,2,1.0,0.0,1404,1388
2011-07-03,Taiwan,Malaysia,3,2,1,1.0,0.0,1422,1605
2011-07-04,Chile,Mexico,2,1,1,1.0,0.0,1965,1976
2011-07-04,Uruguay,Peru,1,1,0,0.5,0.5,1928,1801
2011-07-05,Jordan,Syria,1,3,2,0.0,1.0,1727,1757
2011-07-06,Argentina,Colombia,0,0,0,0.5,0.5,2034,1891
2011-07-06,Kuwait,Oman,1,1,0,0.5,0.5,1803,1806
2011-07-06,Malawi,Namibia,0,1,1,0.0,1.0,1644,1545
2011-07-07,Bolivia,Costa Rica,0,2,2,0.0,1.0,1705,1816
2011-07-07,Solomon Islands,Vanuatu,2,1,1,1.0,0.0,1654,1563
2011-07-08,Aruba,Saint Lucia,4,2,2,1.0,0.0,1393,1465
2011-07-08,Dominican Republic,Anguilla,2,0,2,1.0,0.0,1462,1337
2011-07-08,Jordan,Yemen,4,0,4,1.0,0.0,1733,1587
2011-07-08,Peru,Mexico,1,0,1,1.0,0.0,1813,1965
2011-07-08,Uruguay,Chile,1,1,0,0.5,0.5,1929,1965
2011-07-09,Bahamas,Turks and Caicos Islands,6,0,6,1.0,0.0,1477,1449
2011-07-09,Brazil,Paraguay,2,2,0,0.5,0.5,2106,1900
2011-07-09,Lebanon,Oman,0,1,1,0.0,1.0,1571,1810
2011-07-09,Solomon Islands,Vanuatu,0,0,0,0.5,0.5,1652,1566
2011-07-09,Venezuela,Ecuador,1,0,1,1.0,0.0,1845,1824
2011-07-10,British Virgin Islands,United States Virgin Islands,1,2,1,0.0,1.0,1381,1412
2011-07-10,Colombia,Bolivia,2,0,2,1.0,0.0,1896,1701
2011-07-10,Dominican Republic,Anguilla,4,0,4,1.0,0.0,1468,1332
2011-07-10,Maldives,India,1,1,0,0.5,0.5,1485,1578
2011-07-11,Argentina,Costa Rica,3,0,3,1.0,0.0,2038,1813
2011-07-12,Chile,Peru,1,0,1,1.0,0.0,1970,1809
2011-07-12,Saint Lucia,Aruba,4,2,2,1.0,0.0,1472,1387
2011-07-12,Uruguay,Mexico,1,0,1,1.0,0.0,1938,1957
2011-07-13,Brazil,Ecuador,4,2,2,1.0,0.0,2109,1822
2011-07-13,Iraq,Kuwait,0,2,2,0.0,1.0,1767,1811
2011-07-13,Jordan,Saudi Arabia,1,1,0,0.5,0.5,1736,1845
2011-07-13,Paraguay,Venezuela,3,3,0,0.5,0.5,1899,1847
2011-07-14,Thailand,Myanmar,1,0,1,1.0,0.0,1752,1528
2011-07-15,Fiji,Vanuatu,1,2,1,0.0,1.0,1687,1577
2011-07-15,Oman,Syria,1,1,0,0.5,0.5,1809,1759
2011-07-15,Thailand,Myanmar,1,1,0,0.5,0.5,1748,1533
2011-07-16,Argentina,Uruguay,1,1,0,0.5,0.5,2036,1941
2011-07-16,Colombia,Peru,0,2,2,0.0,1.0,1887,1819
2011-07-16,Jordan,Iraq,1,1,0,0.5,0.5,1737,1767
2011-07-16,Kuwait,Saudi Arabia,1,0,1,1.0,0.0,1820,1837
2011-07-17,Belize,Montserrat,3,1,2,1.0,0.0,1468,1380
2011-07-17,Brazil,Paraguay,0,0,0,0.5,0.5,2105,1904
2011-07-17,Chile,Venezuela,1,2,1,0.0,1.0,1960,1858
2011-07-17,Iran,Madagascar,1,0,1,1.0,0.0,1924,1578
2011-07-17,Qatar,India,1,2,1,0.0,1.0,1767,1591
2011-07-17,United Arab Emirates,Lebanon,6,2,4,1.0,0.0,1741,1567
2011-07-18,Singapore,Taiwan,3,2,1,1.0,0.0,1653,1419
2011-07-19,Peru,Uruguay,0,2,2,0.0,1.0,1814,1947
2011-07-20,Paraguay,Venezuela,0,0,0,0.5,0.5,1903,1860
2011-07-23,China PR,Laos,7,2,5,1.0,0.0,1867,1393
2011-07-23,Iran,Maldives,4,0,4,1.0,0.0,1926,1484
2011-07-23,Iraq,Yemen,2,0,2,1.0,0.0,1772,1583
2011-07-23,Jordan,Nepal,9,0,9,1.0,0.0,1740,1438
2011-07-23,Kuwait,Philippines,3,0,3,1.0,0.0,1822,1397
2011-07-23,Lebanon,Bangladesh,4,0,4,1.0,0.0,1573,1438
2011-07-23,Oman,Myanmar,2,0,2,1.0,0.0,1812,1531
2011-07-23,Peru,Venezuela,4,1,3,1.0,0.0,1824,1851
2011-07-23,Qatar,Vietnam,3,0,3,1.0,0.0,1773,1627
2011-07-23,Saudi Arabia,Hong Kong,3,0,3,1.0,0.0,1840,1565
2011-07-23,Singapore,Malaysia,5,3,2,1.0,0.0,1660,1599
2011-07-23,Syria,Tajikistan,0,3,3,0.0,1.0,1748,1592
2011-07-23,Thailand,Palestine,1,0,1,1.0,0.0,1752,1515
2011-07-23,Turkmenistan,Indonesia,1,1,0,0.5,0.5,1602,1661
2011-07-23,United Arab Emirates,India,3,0,3,1.0,0.0,1746,1587
2011-07-23,Uzbekistan,Kyrgyzstan,4,0,4,1.0,0.0,1733,1450
2011-07-24,Liberia,Gambia,3,2,1,1.0,0.0,1571,1582
2011-07-24,Uruguay,Paraguay,3,0,3,1.0,0.0,1954,1897
2011-07-27,Vanuatu,Solomon Islands,0,0,0,0.5,0.5,1579,1651
2011-07-28,Bangladesh,Lebanon,2,0,2,1.0,0.0,1449,1563
2011-07-28,Myanmar,Oman,0,2,2,0.0,1.0,1529,1815
2011-07-28,Hong Kong,Saudi Arabia,0,5,5,0.0,1.0,1563,1843
2011-07-28,India,United Arab Emirates,2,2,0,0.5,0.5,1591,1743
2011-07-28,Indonesia,Turkmenistan,4,3,1,1.0,0.0,1668,1596
2011-07-28,Kyrgyzstan,Uzbekistan,0,3,3,0.0,1.0,1448,1736
2011-07-28,Laos,China PR,1,6,5,0.0,1.0,1393,1868
2011-07-28,Malaysia,Singapore,1,1,0,0.5,0.5,1601,1659
2011-07-28,Maldives,Iran,0,1,1,0.0,1.0,1483,1928
2011-07-28,Nepal,Jordan,1,1,0,0.5,0.5,1444,1735
2011-07-28,Palestine,Thailand,2,2,0,0.5,0.5,1520,1748
2011-07-28,Philippines,Kuwait,1,2,1,0.0,1.0,1396,1824
2011-07-28,Tajikistan,Syria,3,0,3,1.0,0.0,1604,1737
2011-07-28,Vietnam,Qatar,2,1,1,1.0,0.0,1639,1762
2011-07-28,Yemen,Iraq,0,0,0,0.5,0.5,1587,1769
2011-07-30,Vanuatu,Solomon Islands,2,0,2,1.0,0.0,1589,1642
2011-07-31,Eswatini,Botswana,0,2,2,0.0,1.0,1475,1662
2011-08-04,Seychelles,Comoros,0,0,0,0.5,0.5,1430,1403
2011-08-04,Maldives,Mauritius,1,1,0,0.5,0.5,1483,1456
2011-08-04,Madagascar,Mayotte,1,1,0,0.5,0.5,1576,1477
2011-08-06,Seychelles,Mauritius,2,1,1,1.0,0.0,1439,1448
2011-08-06,Comoros,Maldives,2,2,0,0.5,0.5,1405,1482
2011-08-06,Réunion,Madagascar,2,1,1,1.0,0.0,1624,1569
2011-08-07,El Salvador,Venezuela,2,1,1,1.0,0.0,1701,1840
2011-08-08,Mayotte,Réunion,2,0,2,1.0,0.0,1489,1613
2011-08-09,Mauritius,Comoros,2,0,2,1.0,0.0,1456,1398
2011-08-09,Seychelles,Maldives,5,1,4,1.0,0.0,1448,1474
2011-08-10,Albania,Montenegro,3,2,1,1.0,0.0,1670,1672
2011-08-10,Austria,Slovakia,1,2,1,0.0,1.0,1751,1794
2011-08-10,Azerbaijan,North Macedonia,0,1,1,0.0,1.0,1576,1698
2011-08-10,Belarus,Bulgaria,1,0,1,1.0,0.0,1740,1810
2011-08-10,Bolivia,Panama,1,3,2,0.0,1.0,1695,1789
2011-08-10,Bosnia and Herzegovina,Greece,0,0,0,0.5,0.5,1758,1888
2011-08-10,Botswana,Kenya,1,0,1,1.0,0.0,1669,1571
2011-08-10,China PR,Jamaica,1,0,1,1.0,0.0,1876,1827
2011-08-10,Costa Rica,Ecuador,0,2,2,0.0,1.0,1806,1830
2011-08-10,Cyprus,Moldova,3,2,1,1.0,0.0,1680,1591
2011-08-10,Equatorial Guinea,Guinea-Bissau,1,4,3,0.0,1.0,1484,1527
2011-08-10,France,Chile,1,1,0,0.5,0.5,2008,1962
2011-08-10,Gabon,Guinea,1,1,0,0.5,0.5,1727,1728
2011-08-10,Gambia,DR Congo,3,0,3,1.0,0.0,1593,1667
2011-08-10,Germany,Brazil,3,2,1,1.0,0.0,2065,2096
2011-08-10,Honduras,Venezuela,2,0,2,1.0,0.0,1817,1832
2011-08-10,Hungary,Iceland,4,0,4,1.0,0.0,1776,1651
2011-08-10,Republic of Ireland,Croatia,0,0,0,0.5,0.5,1923,1983
2011-08-10,Israel,Ivory Coast,3,4,1,0.0,1.0,1808,1920
2011-08-10,Italy,Spain,2,1,1,1.0,0.0,1994,2149
2011-08-10,Japan,South Korea,3,0,3,1.0,0.0,1973,1957
2011-08-10,Kazakhstan,Syria,1,1,0,0.5,0.5,1571,1734
2011-08-10,Kuwait,North Korea,0,0,0,0.5,0.5,1823,1757
2011-08-10,Latvia,Finland,0,2,2,0.0,1.0,1635,1752
2011-08-10,Liberia,Angola,0,0,0,0.5,0.5,1574,1699
2011-08-10,Liechtenstein,Switzerland,1,2,1,0.0,1.0,1439,1871
2011-08-10,Lithuania,Armenia,3,0,3,1.0,0.0,1672,1593
2011-08-10,Malta,Central African Republic,2,1,1,1.0,0.0,1462,1458
2011-08-10,Niger,Togo,3,3,0,0.5,0.5,1550,1630
2011-08-10,Northern Ireland,Faroe Islands,4,0,4,1.0,0.0,1697,1464
2011-08-10,Norway,Czech Republic,3,0,3,1.0,0.0,1896,1896
2011-08-10,Oman,Bahrain,1,1,0,0.5,0.5,1814,1773
2011-08-10,Poland,Georgia,1,0,1,1.0,0.0,1867,1642
2011-08-10,Portugal,Luxembourg,5,0,5,1.0,0.0,1987,1402
2011-08-10,Russia,Serbia,1,0,1,1.0,0.0,1889,1863
2011-08-10,San Marino,Romania,0,1,1,0.0,1.0,1346,1852
2011-08-10,Scotland,Denmark,2,1,1,1.0,0.0,1816,1906
2011-08-10,Senegal,Morocco,0,2,2,0.0,1.0,1814,1841
2011-08-10,Slovenia,Belgium,0,0,0,0.5,0.5,1779,1813
2011-08-10,South Africa,Burkina Faso,3,0,3,1.0,0.0,1864,1685
2011-08-10,Tunisia,Mali,4,2,2,1.0,0.0,1823,1731
2011-08-10,Turkey,Estonia,3,0,3,1.0,0.0,1901,1627
2011-08-10,Ukraine,Sweden,0,1,1,0.0,1.0,1880,1939
2011-08-10,United States,Mexico,1,1,0,0.5,0.5,1940,1957
2011-08-10,Wales,Australia,1,2,1,0.0,1.0,1727,1960
2011-08-10,Zimbabwe,Zambia,2,0,2,1.0,0.0,1683,1732
2011-08-11,Seychelles,Réunion,2,1,1,1.0,0.0,1460,1602
2011-08-11,Mayotte,Mauritius,0,0,0,0.5,0.5,1489,1457
2011-08-13,Réunion,Mayotte,1,0,1,1.0,0.0,1608,1484
2011-08-13,Seychelles,Mauritius,1,1,0,0.5,0.5,1460,1458
2011-08-14,Liberia,Niger,0,0,0,0.5,0.5,1574,1551
2011-08-17,Fiji,Samoa,3,0,3,1.0,0.0,1691,1472
2011-08-17,Lebanon,Syria,2,3,1,0.0,1.0,1559,1739
2011-08-18,Fiji,Samoa,5,1,4,1.0,0.0,1695,1469
2011-08-19,Eritrea,Sudan,0,3,3,0.0,1.0,1484,1636
2011-08-19,Qatar,Iraq,0,1,1,0.0,1.0,1755,1777
2011-08-20,Dominican Republic,Curaçao,1,0,1,1.0,0.0,1477,1501
2011-08-20,Lesotho,Eswatini,0,0,0,0.5,0.5,1481,1476
2011-08-21,Barbados,Saint Lucia,4,0,4,1.0,0.0,1588,1467
2011-08-21,Dominican Republic,Curaçao,1,0,1,1.0,0.0,1486,1493
2011-08-21,Trinidad and Tobago,India,3,0,3,1.0,0.0,1738,1587
2011-08-22,Indonesia,Palestine,4,1,3,1.0,0.0,1673,1516
2011-08-22,Jordan,Tunisia,3,3,0,0.5,0.5,1737,1822
2011-08-22,Lesotho,Eswatini,0,1,1,0.0,1.0,1473,1485
2011-08-22,Tuvalu,Samoa,3,0,3,1.0,0.0,1475,1461
2011-08-24,Guyana,India,2,1,1,1.0,0.0,1585,1579
2011-08-24,Thailand,Singapore,0,0,0,0.5,0.5,1746,1662
2011-08-25,United Arab Emirates,Qatar,3,1,2,1.0,0.0,1752,1747
2011-08-26,Bahrain,Sudan,1,0,1,1.0,0.0,1778,1632
2011-08-27,Angola,DR Congo,1,2,1,0.0,1.0,1691,1676
2011-08-27,Fiji,Tahiti,3,0,3,1.0,0.0,1702,1640
2011-08-27,Jordan,Indonesia,1,0,1,1.0,0.0,1744,1667
2011-08-27,New Caledonia,Vanuatu,5,0,5,1.0,0.0,1636,1582
2011-08-27,Oman,Kuwait,1,0,1,1.0,0.0,1823,1815
2011-08-27,Papua New Guinea,Cook Islands,4,0,4,1.0,0.0,1513,1442
2011-08-27,Solomon Islands,Guam,7,0,7,1.0,0.0,1645,1367
2011-08-27,Tuvalu,American Samoa,4,0,4,1.0,0.0,1481,1348
2011-08-28,Antigua and Barbuda,Saint Vincent and the Grenadines,2,2,0,0.5,0.5,1559,1569
2011-08-30,American Samoa,Solomon Islands,0,4,4,0.0,1.0,1346,1648
2011-08-30,Fiji,Kiribati,9,0,9,1.0,0.0,1706,1459
2011-08-30,New Caledonia,Guam,9,0,9,1.0,0.0,1639,1365
2011-08-30,Tahiti,Cook Islands,7,0,7,1.0,0.0,1644,1439
2011-08-30,Vanuatu,Tuvalu,5,1,4,1.0,0.0,1588,1476
2011-09-01,American Samoa,Guam,0,2,2,0.0,1.0,1339,1373
2011-09-01,Cook Islands,Kiribati,3,0,3,1.0,0.0,1448,1451
2011-09-01,New Caledonia,Tuvalu,8,0,8,1.0,0.0,1644,1472
2011-09-01,Tahiti,Papua New Guinea,1,1,0,0.5,0.5,1642,1516
2011-09-01,Vanuatu,Solomon Islands,1,0,1,1.0,0.0,1598,1639
2011-09-02,Albania,France,1,2,1,0.0,1.0,1668,2011
2011-09-02,Andorra,Armenia,0,3,3,0.0,1.0,1358,1597
2011-09-02,Antigua and Barbuda,Curaçao,5,2,3,1.0,0.0,1566,1487
2011-09-02,Argentina,Venezuela,1,0,1,1.0,0.0,2040,1829
2011-09-02,Australia,Thailand,2,1,1,1.0,0.0,1964,1743
2011-09-02,Azerbaijan,Belgium,1,1,0,0.5,0.5,1581,1809
2011-09-02,Bahrain,Qatar,0,0,0,0.5,0.5,1778,1748
2011-09-02,Belarus,Bosnia and Herzegovina,0,2,2,0.0,1.0,1733,1766
2011-09-02,Bulgaria,England,0,3,3,0.0,1.0,1807,2035
2011-09-02,Canada,Saint Lucia,4,1,3,1.0,0.0,1756,1465
2011-09-02,China PR,Singapore,2,1,1,1.0,0.0,1880,1659
2011-09-02,Cyprus,Portugal,0,4,4,0.0,1.0,1678,1990
2011-09-02,Dominica,Nicaragua,0,2,2,0.0,1.0,1432,1386
2011-09-02,Ecuador,Jamaica,5,2,3,1.0,0.0,1838,1820
2011-09-02,El Salvador,Dominican Republic,3,2,1,1.0,0.0,1705,1483
2011-09-02,Faroe Islands,Italy,0,1,1,0.0,1.0,1464,1995
2011-09-02,Finland,Moldova,4,1,3,1.0,0.0,1757,1587
2011-09-02,Georgia,Latvia,0,1,1,0.0,1.0,1634,1644
2011-09-02,Germany,Austria,6,2,4,1.0,0.0,2068,1749
2011-09-02,Ghana,Eswatini,2,0,2,1.0,0.0,1847,1484
2011-09-02,Grenada,Belize,0,3,3,0.0,1.0,1557,1479
2011-09-02,Guyana,Barbados,2,0,2,1.0,0.0,1594,1580
2011-09-02,Haiti,United States Virgin Islands,6,0,6,1.0,0.0,1662,1409
2011-09-02,Hungary,Sweden,2,1,1,1.0,0.0,1788,1928
2011-09-02,Iran,Indonesia,3,0,3,1.0,0.0,1931,1665
2011-09-02,Iraq,Jordan,0,2,2,0.0,1.0,1769,1753
2011-09-02,Republic of Ireland,Slovakia,0,0,0,0.5,0.5,1921,1797
2011-09-02,Israel,Greece,0,1,1,0.0,1.0,1802,1895
2011-09-02,Japan,North Korea,1,0,1,1.0,0.0,1977,1754
2011-09-02,South Korea,Lebanon,6,0,6,1.0,0.0,1959,1558
2011-09-02,Lithuania,Liechtenstein,0,0,0,0.5,0.5,1668,1444
2011-09-02,Luxembourg,Romania,0,2,2,0.0,1.0,1401,1854
2011-09-02,Malta,Croatia,1,3,2,0.0,1.0,1462,1984
2011-09-02,Netherlands,San Marino,11,0,11,1.0,0.0,2110,1346
2011-09-02,Northern Ireland,Serbia,0,1,1,0.0,1.0,1693,1868
2011-09-02,Norway,Iceland,1,0,1,1.0,0.0,1900,1648
2011-09-02,Oman,Saudi Arabia,0,0,0,0.5,0.5,1824,1843
2011-09-02,Panama,Paraguay,0,2,2,0.0,1.0,1784,1903
2011-09-02,Peru,Bolivia,2,2,0,0.5,0.5,1822,1698
2011-09-02,Poland,Mexico,1,1,0,0.5,0.5,1870,1955
2011-09-02,Russia,North Macedonia,1,0,1,1.0,0.0,1893,1695
2011-09-02,Slovenia,Estonia,1,2,1,0.0,1.0,1768,1639
2011-09-02,Spain,Chile,3,2,1,1.0,0.0,2154,1958
2011-09-02,Saint Kitts and Nevis,Puerto Rico,0,0,0,0.5,0.5,1564,1415
2011-09-02,Suriname,Cayman Islands,1,0,1,1.0,0.0,1596,1432
2011-09-02,Tajikistan,Uzbekistan,0,1,1,0.0,1.0,1599,1742
2011-09-02,Trinidad and Tobago,Bermuda,1,0,1,1.0,0.0,1742,1519
2011-09-02,Turkey,Kazakhstan,2,1,1,1.0,0.0,1904,1569
2011-09-02,Ukraine,Uruguay,2,3,1,0.0,1.0,1874,1961
2011-09-02,United Arab Emirates,Kuwait,2,3,1,0.0,1.0,1746,1822
2011-09-02,United States,Costa Rica,0,1,1,0.0,1.0,1930,1817
2011-09-02,Wales,Montenegro,2,1,1,1.0,0.0,1734,1666
2011-09-02,Guatemala,Saint Vincent and the Grenadines,4,0,4,1.0,0.0,1695,1564
2011-09-03,Burkina Faso,Equatorial Guinea,1,0,1,1.0,0.0,1689,1481
2011-09-03,Cameroon,Mauritius,5,0,5,1.0,0.0,1850,1457
2011-09-03,Cook Islands,Fiji,1,4,3,0.0,1.0,1446,1709
2011-09-03,Guam,Vanuatu,1,4,3,0.0,1.0,1370,1602
2011-09-03,Honduras,Colombia,0,2,2,0.0,1.0,1811,1894
2011-09-03,Kenya,Guinea-Bissau,2,1,1,1.0,0.0,1578,1521
2011-09-03,Kiribati,Papua New Guinea,1,17,16,0.0,1.0,1445,1523
2011-09-03,Libya,Mozambique,1,0,1,1.0,0.0,1695,1624
2011-09-03,Malawi,Tunisia,0,0,0,0.5,0.5,1648,1819
2011-09-03,Mali,Cape Verde,3,0,3,1.0,0.0,1737,1618
2011-09-03,Namibia,Gambia,1,0,1,1.0,0.0,1555,1584
2011-09-03,New Caledonia,American Samoa,8,0,8,1.0,0.0,1647,1337
2011-09-03,Rwanda,Ivory Coast,0,5,5,0.0,1.0,1579,1922
2011-09-03,Scotland,Czech Republic,2,2,0,0.5,0.5,1818,1895
2011-09-03,Senegal,DR Congo,2,0,2,1.0,0.0,1819,1672
2011-09-03,Sierra Leone,Egypt,2,1,1,1.0,0.0,1601,1903
2011-09-03,Solomon Islands,Tuvalu,6,1,5,1.0,0.0,1644,1468
2011-09-03,Tanzania,Algeria,1,1,0,0.5,0.5,1608,1732
2011-09-04,Angola,Uganda,2,0,2,1.0,0.0,1701,1735
2011-09-04,Burundi,Benin,1,1,0,0.5,0.5,1543,1595
2011-09-04,Central African Republic,Morocco,0,0,0,0.5,0.5,1465,1835
2011-09-04,Comoros,Zambia,1,2,1,0.0,1.0,1396,1735
2011-09-04,Congo,Sudan,0,1,1,0.0,1.0,1608,1640
2011-09-04,Guinea,Ethiopia,1,0,1,1.0,0.0,1734,1614
2011-09-04,Madagascar,Nigeria,0,2,2,0.0,1.0,1567,1891
2011-09-04,Mexico,Chile,1,0,1,1.0,0.0,1964,1950
2011-09-04,Niger,South Africa,2,1,1,1.0,0.0,1565,1851
2011-09-04,Togo,Botswana,1,0,1,1.0,0.0,1639,1661
2011-09-04,Zimbabwe,Liberia,3,0,3,1.0,0.0,1689,1569
2011-09-05,American Samoa,Vanuatu,0,8,8,0.0,1.0,1335,1605
2011-09-05,Bolivia,Peru,0,0,0,0.5,0.5,1701,1820
2011-09-05,Brazil,Ghana,1,0,1,1.0,0.0,2100,1844
2011-09-05,Guam,Tuvalu,1,1,0,0.5,0.5,1373,1466
2011-09-05,Kiribati,Tahiti,1,17,16,0.0,1.0,1442,1646
2011-09-05,New Caledonia,Solomon Islands,1,2,1,0.0,1.0,1639,1653
2011-09-05,Papua New Guinea,Fiji,0,2,2,0.0,1.0,1519,1714
2011-09-06,Argentina,Nigeria,3,1,2,1.0,0.0,2045,1887
2011-09-06,Austria,Turkey,0,0,0,0.5,0.5,1753,1901
2011-09-06,Azerbaijan,Kazakhstan,3,2,1,1.0,0.0,1589,1562
2011-09-06,Barbados,Trinidad and Tobago,0,2,2,0.0,1.0,1576,1747
2011-09-06,Belgium,United States,1,0,1,1.0,0.0,1820,1920
2011-09-06,Belize,Guatemala,1,2,1,0.0,1.0,1476,1699
2011-09-06,Bosnia and Herzegovina,Belarus,1,0,1,1.0,0.0,1774,1726
2011-09-06,Cayman Islands,El Salvador,1,4,3,0.0,1.0,1430,1708
2011-09-06,Croatia,Israel,3,1,2,1.0,0.0,1989,1798
2011-09-06,Curaçao,Haiti,2,4,2,0.0,1.0,1483,1667
2011-09-06,Czech Republic,Ukraine,4,0,4,1.0,0.0,1903,1867
2011-09-06,Denmark,Norway,2,0,2,1.0,0.0,1914,1893
2011-09-06,Dominican Republic,Suriname,1,1,0,0.5,0.5,1486,1594
2011-09-06,Ecuador,Costa Rica,4,0,4,1.0,0.0,1846,1810
2011-09-06,England,Wales,1,0,1,1.0,0.0,2038,1732
2011-09-06,Estonia,Northern Ireland,4,1,3,1.0,0.0,1649,1684
2011-09-06,Finland,Netherlands,0,2,2,0.0,1.0,1756,2112
2011-09-06,Gabon,Niger,1,0,1,1.0,0.0,1732,1561
2011-09-06,Guyana,Bermuda,2,1,1,1.0,0.0,1601,1513
2011-09-06,Honduras,Paraguay,0,3,3,0.0,1.0,1806,1909
2011-09-06,Iceland,Cyprus,1,0,1,1.0,0.0,1657,1670
2011-09-06,Indonesia,Bahrain,0,2,2,0.0,1.0,1660,1784
2011-09-06,Italy,Slovenia,1,0,1,1.0,0.0,1999,1765
2011-09-06,Jamaica,Colombia,0,2,2,0.0,1.0,1814,1901
2011-09-06,Jordan,China PR,2,1,1,1.0,0.0,1764,1870
2011-09-06,North Korea,Tajikistan,1,0,1,1.0,0.0,1759,1595
2011-09-06,Kuwait,South Korea,1,1,0,0.5,0.5,1826,1956
2011-09-06,Latvia,Greece,1,1,0,0.5,0.5,1649,1891
2011-09-06,Lebanon,United Arab Emirates,3,1,2,1.0,0.0,1570,1735
2011-09-06,Luxembourg,Albania,2,1,1,1.0,0.0,1415,1655
2011-09-06,North Macedonia,Andorra,1,0,1,1.0,0.0,1698,1356
2011-09-06,Malta,Georgia,1,1,0,0.5,0.5,1466,1631
2011-09-06,Moldova,Hungary,0,2,2,0.0,1.0,1584,1792
2011-09-06,Nicaragua,Panama,1,2,1,0.0,1.0,1385,1786
2011-09-06,Poland,Germany,2,2,0,0.5,0.5,1875,2064
2011-09-06,Puerto Rico,Canada,0,3,3,0.0,1.0,1414,1758
2011-09-06,Qatar,Iran,1,1,0,0.5,0.5,1752,1928
2011-09-06,Romania,France,0,0,0,0.5,0.5,1858,2008
2011-09-06,Russia,Republic of Ireland,0,0,0,0.5,0.5,1894,1921
2011-09-06,San Marino,Sweden,0,5,5,0.0,1.0,1346,1929
2011-09-06,Saudi Arabia,Australia,1,3,2,0.0,1.0,1838,1970
2011-09-06,Scotland,Lithuania,1,0,1,1.0,0.0,1823,1664
2011-09-06,Serbia,Faroe Islands,3,1,2,1.0,0.0,1870,1463
2011-09-06,Singapore,Iraq,0,2,2,0.0,1.0,1654,1775
2011-09-06,Slovakia,Armenia,0,4,4,0.0,1.0,1785,1610
2011-09-06,Spain,Liechtenstein,6,0,6,1.0,0.0,2155,1444
2011-09-06,Saint Lucia,Saint Kitts and Nevis,2,4,2,0.0,1.0,1460,1570
2011-09-06,Switzerland,Bulgaria,3,1,2,1.0,0.0,1878,1801
2011-09-06,Thailand,Oman,3,0,3,1.0,0.0,1753,1815
2011-09-06,Uzbekistan,Japan,1,1,0,0.5,0.5,1747,1973
2011-09-06,Venezuela,Guinea,2,1,1,1.0,0.0,1835,1729
2011-09-06,United States Virgin Islands,Antigua and Barbuda,1,8,7,0.0,1.0,1405,1571
2011-09-07,Equatorial Guinea,Central African Republic,3,0,3,1.0,0.0,1489,1458
2011-09-07,New Caledonia,Tahiti,3,1,2,1.0,0.0,1648,1638
2011-09-07,Solomon Islands,Fiji,2,1,1,1.0,0.0,1663,1705
2011-09-09,New Caledonia,Solomon Islands,2,0,2,1.0,0.0,1657,1655
2011-09-09,Tahiti,Fiji,2,1,1,1.0,0.0,1648,1696
2011-09-11,Saint Vincent and the Grenadines,Dominica,1,0,1,1.0,0.0,1570,1427
2011-09-14,Argentina,Brazil,0,0,0,0.5,0.5,2047,2099
2011-09-18,Saint Vincent and the Grenadines,Grenada,2,1,1,1.0,0.0,1578,1550
2011-09-23,Suriname,Curaçao,2,0,2,1.0,0.0,1600,1478
2011-09-25,Suriname,Curaçao,2,2,0,0.5,0.5,1598,1481
2011-09-28,Brazil,Argentina,2,0,2,1.0,0.0,2106,2041
2011-09-30,Antigua and Barbuda,Martinique,1,0,1,1.0,0.0,1582,1651
2011-09-30,Hong Kong,Philippines,3,3,0,0.5,0.5,1560,1400
2011-10-01,Ethiopia,Sudan,1,2,1,0.0,1.0,1607,1648
2011-10-02,Antigua and Barbuda,Martinique,1,2,1,0.0,1.0,1576,1658
2011-10-02,Hong Kong,Macau,5,1,4,1.0,0.0,1564,1313
2011-10-04,Ethiopia,Malawi,0,0,0,0.5,0.5,1608,1648
2011-10-04,Philippines,Macau,2,0,2,1.0,0.0,1407,1307
2011-10-05,Iran,Palestine,7,0,7,1.0,0.0,1930,1515
2011-10-06,China PR,United Arab Emirates,2,1,1,1.0,0.0,1876,1730
2011-10-06,Thailand,Jordan,0,0,0,0.5,0.5,1754,1764
2011-10-07,Andorra,Republic of Ireland,0,2,2,0.0,1.0,1356,1922
2011-10-07,Argentina,Chile,4,1,3,1.0,0.0,2047,1945
2011-10-07,Armenia,North Macedonia,4,1,3,1.0,0.0,1620,1689
2011-10-07,Australia,Malaysia,5,0,5,1.0,0.0,1972,1600
2011-10-07,Azerbaijan,Austria,1,4,3,0.0,1.0,1585,1758
2011-10-07,Barbados,Guyana,0,2,2,0.0,1.0,1569,1609
2011-10-07,Belgium,Kazakhstan,4,1,3,1.0,0.0,1823,1560
2011-10-07,Belize,Grenada,1,4,3,0.0,1.0,1470,1557
2011-10-07,Bermuda,Trinidad and Tobago,2,1,1,1.0,0.0,1526,1735
2011-10-07,Bosnia and Herzegovina,Luxembourg,5,0,5,1.0,0.0,1776,1414
2011-10-07,Cayman Islands,Suriname,0,1,1,0.0,1.0,1426,1603
2011-10-07,DR Congo,Cameroon,2,3,1,0.0,1.0,1668,1855
2011-10-07,Costa Rica,Brazil,0,1,1,0.0,1.0,1808,2109
2011-10-07,Curaçao,Antigua and Barbuda,0,1,1,0.0,1.0,1476,1582
2011-10-07,Cyprus,Denmark,1,4,3,0.0,1.0,1667,1918
2011-10-07,Czech Republic,Spain,0,2,2,0.0,1.0,1900,2159
2011-10-07,Dominica,Panama,0,5,5,0.0,1.0,1426,1788
2011-10-07,Dominican Republic,El Salvador,1,2,1,0.0,1.0,1483,1712
2011-10-07,Ecuador,Venezuela,2,0,2,1.0,0.0,1854,1828
2011-10-07,Finland,Sweden,1,2,1,0.0,1.0,1752,1934
2011-10-07,France,Albania,3,0,3,1.0,0.0,2010,1654
2011-10-07,Gabon,Equatorial Guinea,2,0,2,1.0,0.0,1736,1486
2011-10-07,Greece,Croatia,2,0,2,1.0,0.0,1902,1979
2011-10-07,Indonesia,Saudi Arabia,0,0,0,0.5,0.5,1664,1835
2011-10-07,Japan,Vietnam,1,0,1,1.0,0.0,1976,1637
2011-10-07,South Korea,Poland,2,2,0,0.5,0.5,1955,1877
2011-10-07,Latvia,Malta,2,0,2,1.0,0.0,1654,1462
2011-10-07,Montenegro,England,2,2,0,0.5,0.5,1673,2032
2011-10-07,Netherlands,Moldova,1,0,1,1.0,0.0,2113,1584
2011-10-07,Northern Ireland,Estonia,1,2,1,0.0,1.0,1676,1658
2011-10-07,Peru,Paraguay,2,0,2,1.0,0.0,1831,1899
2011-10-07,Portugal,Iceland,5,3,2,1.0,0.0,1993,1655
2011-10-07,Puerto Rico,Saint Kitts and Nevis,1,1,0,0.5,0.5,1418,1567
2011-10-07,Romania,Belarus,2,2,0,0.5,0.5,1856,1729
2011-10-07,Serbia,Italy,1,1,0,0.5,0.5,1873,1997
2011-10-07,Singapore,Philippines,2,0,2,1.0,0.0,1658,1404
2011-10-07,Slovakia,Russia,0,1,1,0.0,1.0,1780,1900
2011-10-07,Saint Lucia,Canada,0,7,7,0.0,1.0,1458,1761
2011-10-07,Turkey,Germany,1,3,2,0.0,1.0,1897,2069
2011-10-07,Ukraine,Bulgaria,3,0,3,1.0,0.0,1874,1795
2011-10-07,Uruguay,Bolivia,4,2,2,1.0,0.0,1964,1699
2011-10-07,United States Virgin Islands,Haiti,0,7,7,0.0,1.0,1403,1670
2011-10-07,Wales,Switzerland,2,0,2,1.0,0.0,1744,1867
2011-10-07,Saint Vincent and the Grenadines,Guatemala,0,3,3,0.0,1.0,1573,1705
2011-10-08,Cape Verde,Zimbabwe,2,1,1,1.0,0.0,1628,1680
2011-10-08,Chad,Malawi,2,2,0,0.5,0.5,1508,1645
2011-10-08,Egypt,Niger,3,0,3,1.0,0.0,1905,1560
2011-10-08,Ethiopia,Madagascar,4,2,2,1.0,0.0,1616,1560
2011-10-08,Gambia,Burkina Faso,1,1,0,0.5,0.5,1587,1687
2011-10-08,Guinea-Bissau,Angola,0,2,2,0.0,1.0,1517,1706
2011-10-08,Liberia,Mali,2,2,0,0.5,0.5,1573,1734
2011-10-08,Liechtenstein,Scotland,0,1,1,0.0,1.0,1443,1825
2011-10-08,Mozambique,Comoros,3,0,3,1.0,0.0,1628,1393
2011-10-08,Nigeria,Guinea,2,2,0,0.5,0.5,1884,1733
2011-10-08,South Africa,Sierra Leone,0,0,0,0.5,0.5,1847,1606
2011-10-08,Sudan,Ghana,0,2,2,0.0,1.0,1645,1848
2011-10-08,Eswatini,Congo,0,1,1,0.0,1.0,1479,1614
2011-10-08,Tunisia,Togo,2,0,2,1.0,0.0,1824,1635
2011-10-08,Uganda,Kenya,0,0,0,0.5,0.5,1732,1582
2011-10-08,United States,Honduras,1,0,1,1.0,0.0,1926,1801
2011-10-08,Zambia,Libya,0,0,0,0.5,0.5,1735,1696
2011-10-09,Algeria,Central African Republic,2,0,2,1.0,0.0,1735,1456
2011-10-09,Benin,Rwanda,0,1,1,0.0,1.0,1587,1588
2011-10-09,Ivory Coast,Burundi,2,1,1,1.0,0.0,1924,1542
2011-10-09,Mauritius,Senegal,0,2,2,0.0,1.0,1456,1821
2011-10-09,Morocco,Tanzania,3,1,2,1.0,0.0,1839,1605
2011-10-11,Albania,Romania,1,1,0,0.5,0.5,1659,1852
2011-10-11,Antigua and Barbuda,United States Virgin Islands,10,0,10,1.0,0.0,1587,1399
2011-10-11,Australia,Oman,3,0,3,1.0,0.0,1977,1811
2011-10-11,Belarus,Poland,0,2,2,0.0,1.0,1725,1882
2011-10-11,Bermuda,Guyana,1,1,0,0.5,0.5,1528,1608
2011-10-11,Bolivia,Colombia,1,2,1,0.0,1.0,1696,1905
2011-10-11,Bulgaria,Wales,0,1,1,0.0,1.0,1786,1754
2011-10-11,Canada,Puerto Rico,0,0,0,0.5,0.5,1755,1425
2011-10-11,Chile,Peru,4,2,2,1.0,0.0,1951,1826
2011-10-11,China PR,Iraq,0,1,1,0.0,1.0,1866,1786
2011-10-11,Croatia,Latvia,2,0,2,1.0,0.0,1982,1652
2011-10-11,Denmark,Portugal,2,1,1,1.0,0.0,1928,1984
2011-10-11,El Salvador,Cayman Islands,4,0,4,1.0,0.0,1715,1424
2011-10-11,Equatorial Guinea,Cameroon,1,1,0,0.5,0.5,1493,1849
2011-10-11,Estonia,Ukraine,0,2,2,0.0,1.0,1655,1878
2011-10-11,France,Bosnia and Herzegovina,1,1,0,0.5,0.5,2006,1781
2011-10-11,Georgia,Greece,1,2,1,0.0,1.0,1629,1905
2011-10-11,Germany,Belgium,3,1,2,1.0,0.0,2073,1820
2011-10-11,Ghana,Nigeria,0,0,0,0.5,0.5,1849,1884
2011-10-11,Guatemala,Belize,3,1,2,1.0,0.0,1709,1467
2011-10-11,Haiti,Curaçao,2,2,0,0.5,0.5,1666,1481
2011-10-11,Honduras,Jamaica,2,1,1,1.0,0.0,1810,1806
2011-10-11,Hungary,Finland,0,0,0,0.5,0.5,1792,1753
2011-10-11,Indonesia,Qatar,2,3,1,0.0,1.0,1658,1759
2011-10-11,Iran,Bahrain,6,0,6,1.0,0.0,1935,1780
2011-10-11,Republic of Ireland,Armenia,2,1,1,1.0,0.0,1925,1618
2011-10-11,Italy,Northern Ireland,3,0,3,1.0,0.0,2000,1674
2011-10-11,Japan,Tajikistan,8,0,8,1.0,0.0,1978,1594
2011-10-11,Kazakhstan,Austria,0,0,0,0.5,0.5,1565,1754
2011-10-11,North Korea,Uzbekistan,0,1,1,0.0,1.0,1751,1756
2011-10-11,South Korea,United Arab Emirates,2,1,1,1.0,0.0,1959,1727
2011-10-11,Lebanon,Kuwait,2,2,0,0.5,0.5,1576,1821
2011-10-11,Lithuania,Czech Republic,1,4,3,0.0,1.0,1661,1904
2011-10-11,North Macedonia,Slovakia,1,1,0,0.5,0.5,1692,1778
2011-10-11,Malta,Israel,0,2,2,0.0,1.0,1460,1801
2011-10-11,Mexico,Brazil,1,2,1,0.0,1.0,1960,2114
2011-10-11,Moldova,San Marino,4,0,4,1.0,0.0,1588,1343
2011-10-11,Norway,Cyprus,3,1,2,1.0,0.0,1897,1664
2011-10-11,Panama,Nicaragua,5,1,4,1.0,0.0,1790,1384
2011-10-11,Paraguay,Uruguay,1,1,0,0.5,0.5,1901,1963
2011-10-11,Philippines,Nepal,4,0,4,1.0,0.0,1413,1436
2011-10-11,Russia,Andorra,6,0,6,1.0,0.0,1901,1356
2011-10-11,Singapore,Jordan,0,3,3,0.0,1.0,1653,1770
2011-10-11,Slovenia,Serbia,1,0,1,1.0,0.0,1776,1863
2011-10-11,Spain,Scotland,3,1,2,1.0,0.0,2162,1823
2011-10-11,Saint Kitts and Nevis,Saint Lucia,1,1,0,0.5,0.5,1565,1461
2011-10-11,Suriname,Dominican Republic,1,3,2,0.0,1.0,1593,1494
2011-10-11,Sweden,Netherlands,3,2,1,1.0,0.0,1946,2102
2011-10-11,Switzerland,Montenegro,2,0,2,1.0,0.0,1871,1670
2011-10-11,Thailand,Saudi Arabia,0,0,0,0.5,0.5,1756,1834
2011-10-11,Trinidad and Tobago,Barbados,4,0,4,1.0,0.0,1740,1565
2011-10-11,Turkey,Azerbaijan,1,0,1,1.0,0.0,1900,1583
2011-10-11,United States,Ecuador,0,1,1,0.0,1.0,1917,1864
2011-10-11,Venezuela,Argentina,1,0,1,1.0,0.0,1841,2035
2011-10-15,Grenada,Saint Vincent and the Grenadines,1,1,0,0.5,0.5,1558,1573
2011-10-31,Namibia,Lesotho,0,0,0,0.5,0.5,1554,1475
2011-11-04,Kuwait,Bahrain,0,1,1,0.0,1.0,1813,1789
2011-11-04,Qatar,Oman,0,0,0,0.5,0.5,1761,1810
2011-11-05,Antigua and Barbuda,Guadeloupe,0,0,0,0.5,0.5,1590,1687
2011-11-06,Iraq,Lebanon,1,0,1,1.0,0.0,1790,1573
2011-11-06,Lesotho,DR Congo,0,3,3,0.0,1.0,1472,1672
2011-11-10,Gabon,Brazil,0,2,2,0.0,1.0,1735,2116
2011-11-11,Albania,Azerbaijan,0,1,1,0.0,1.0,1650,1593
2011-11-11,Antigua and Barbuda,Haiti,1,0,1,1.0,0.0,1600,1657
2011-11-11,Argentina,Bolivia,1,1,0,0.5,0.5,2029,1703
2011-11-11,Bahrain,Iran,1,1,0,0.5,0.5,1793,1932
2011-11-11,Belgium,Romania,2,1,1,1.0,0.0,1829,1844
2011-11-11,Bermuda,Barbados,2,1,1,1.0,0.0,1537,1557
2011-11-11,Bosnia and Herzegovina,Portugal,0,0,0,0.5,0.5,1786,1980
2011-11-11,Burkina Faso,Mali,1,1,0,0.5,0.5,1689,1733
2011-11-11,Cameroon,Sudan,3,1,2,1.0,0.0,1853,1642
2011-11-11,Chad,Tanzania,1,2,1,0.0,1.0,1503,1611
2011-11-11,Colombia,Venezuela,1,1,0,0.5,0.5,1904,1843
2011-11-11,Comoros,Mozambique,0,1,1,0.0,1.0,1390,1632
2011-11-11,Cyprus,Scotland,1,2,1,0.0,1.0,1660,1828
2011-11-11,Czech Republic,Montenegro,2,0,2,1.0,0.0,1908,1667
2011-11-11,Denmark,Sweden,2,0,2,1.0,0.0,1937,1938
2011-11-11,Djibouti,Namibia,0,4,4,0.0,1.0,1319,1558
2011-11-11,Dominican Republic,Cayman Islands,4,0,4,1.0,0.0,1501,1418
2011-11-11,Equatorial Guinea,Madagascar,2,0,2,1.0,0.0,1503,1551
2011-11-11,Eritrea,Rwanda,1,1,0,0.5,0.5,1487,1586
2011-11-11,Estonia,Republic of Ireland,0,4,4,0.0,1.0,1653,1928
2011-11-11,France,United States,1,0,1,1.0,0.0,2012,1912
2011-11-11,Georgia,Moldova,2,0,2,1.0,0.0,1637,1581
2011-11-11,Greece,Russia,1,1,0,0.5,0.5,1905,1902
2011-11-11,Guatemala,Grenada,3,0,3,1.0,0.0,1714,1554
2011-11-11,Guinea-Bissau,Togo,1,1,0,0.5,0.5,1520,1633
2011-11-11,Guyana,Trinidad and Tobago,2,1,1,1.0,0.0,1619,1730
2011-11-11,Hungary,Liechtenstein,5,0,5,1.0,0.0,1794,1442
2011-11-11,Iraq,China PR,1,0,1,1.0,0.0,1800,1857
2011-11-11,Jordan,Singapore,2,0,2,1.0,0.0,1776,1648
2011-11-11,Kuwait,Lebanon,0,1,1,0.0,1.0,1801,1586
2011-11-11,Lesotho,Burundi,1,0,1,1.0,0.0,1482,1533
2011-11-11,Mexico,Serbia,2,0,2,1.0,0.0,1966,1858
2011-11-11,Morocco,Uganda,0,1,1,0.0,1.0,1829,1743
2011-11-11,Netherlands,Switzerland,0,0,0,0.5,0.5,2098,1876
2011-11-11,Nicaragua,Dominica,1,0,1,1.0,0.0,1393,1418
2011-11-11,Oman,Australia,1,0,1,1.0,0.0,1822,1966
2011-11-11,Panama,Costa Rica,2,0,2,1.0,0.0,1799,1800
2011-11-11,Paraguay,Ecuador,2,1,1,1.0,0.0,1909,1857
2011-11-11,Poland,Italy,0,2,2,0.0,1.0,1877,2006
2011-11-11,Puerto Rico,Saint Lucia,4,0,4,1.0,0.0,1434,1453
2011-11-11,Qatar,Indonesia,4,0,4,1.0,0.0,1767,1653
2011-11-11,São Tomé and Príncipe,Congo,0,5,5,0.0,1.0,1438,1619
2011-11-11,Saudi Arabia,Thailand,3,0,3,1.0,0.0,1841,1750
2011-11-11,Seychelles,Kenya,0,3,3,0.0,1.0,1455,1588
2011-11-11,Saint Kitts and Nevis,Canada,0,0,0,0.5,0.5,1569,1752
2011-11-11,Suriname,El Salvador,1,3,2,0.0,1.0,1588,1721
2011-11-11,Eswatini,DR Congo,1,3,2,0.0,1.0,1476,1676
2011-11-11,Tajikistan,Japan,0,4,4,0.0,1.0,1593,1980
2011-11-11,Turkey,Croatia,0,3,3,0.0,1.0,1894,1989
2011-11-11,Ukraine,Germany,3,3,0,0.5,0.5,1883,2069
2011-11-11,United Arab Emirates,South Korea,0,2,2,0.0,1.0,1724,1963
2011-11-11,Uruguay,Chile,4,0,4,1.0,0.0,1971,1944
2011-11-11,Uzbekistan,North Korea,1,0,1,1.0,0.0,1764,1744
2011-11-11,United States Virgin Islands,Curaçao,0,3,3,0.0,1.0,1393,1488
2011-11-11,Belize,Saint Vincent and the Grenadines,1,1,0,0.5,0.5,1470,1571
2011-11-12,Algeria,Tunisia,1,0,1,1.0,0.0,1746,1814
2011-11-12,England,Spain,1,0,1,1.0,0.0,2043,2152
2011-11-12,Nigeria,Botswana,0,0,0,0.5,0.5,1880,1666
2011-11-12,Somalia,Ethiopia,0,0,0,0.5,0.5,1355,1611
2011-11-12,South Africa,Ivory Coast,1,1,0,0.5,0.5,1849,1923
2011-11-12,Wales,Norway,4,1,3,1.0,0.0,1766,1886
2011-11-13,India,Malaysia,1,1,0,0.5,0.5,1580,1600
2011-11-13,Morocco,Cameroon,1,1,0,0.5,0.5,1830,1853
2011-11-13,Sudan,Uganda,0,0,0,0.5,0.5,1645,1741
2011-11-14,Bermuda,Barbados,2,1,1,1.0,0.0,1546,1549
2011-11-14,Brazil,Egypt,2,0,2,1.0,0.0,2120,1902
2011-11-14,Cayman Islands,Dominican Republic,1,1,0,0.5,0.5,1420,1500
2011-11-14,Honduras,Serbia,2,0,2,1.0,0.0,1820,1849
2011-11-14,Puerto Rico,Saint Lucia,3,0,3,1.0,0.0,1443,1445
2011-11-15,Belarus,Libya,1,1,0,0.5,0.5,1725,1697
2011-11-15,Burundi,Lesotho,2,2,0,0.5,0.5,1532,1484
2011-11-15,Canada,Saint Kitts and Nevis,4,0,4,1.0,0.0,1757,1565
2011-11-15,Chile,Paraguay,2,0,2,1.0,0.0,1952,1902
2011-11-15,Colombia,Argentina,1,2,1,0.0,1.0,1899,2035
2011-11-15,Congo,São Tomé and Príncipe,1,1,0,0.5,0.5,1616,1442
2011-11-15,DR Congo,Eswatini,5,1,4,1.0,0.0,1680,1473
2011-11-15,Costa Rica,Spain,2,2,0,0.5,0.5,1807,2146
2011-11-15,Croatia,Turkey,0,0,0,0.5,0.5,1987,1897
2011-11-15,Curaçao,United States Virgin Islands,6,1,5,1.0,0.0,1494,1388
2011-11-15,Denmark,Finland,2,1,1,1.0,0.0,1942,1749
2011-11-15,Ecuador,Peru,2,0,2,1.0,0.0,1865,1819
2011-11-15,El Salvador,Suriname,4,0,4,1.0,0.0,1727,1583
2011-11-15,England,Sweden,1,0,1,1.0,0.0,2049,1933
2011-11-15,France,Belgium,0,0,0,0.5,0.5,2009,1833
2011-11-15,Germany,Netherlands,3,0,3,1.0,0.0,2078,2090
2011-11-15,Ghana,Gabon,2,1,1,1.0,0.0,1855,1730
2011-11-15,Greece,Romania,1,3,2,0.0,1.0,1896,1854
2011-11-15,Grenada,Guatemala,1,4,3,0.0,1.0,1550,1719
2011-11-15,Guinea,Burkina Faso,1,1,0,0.5,0.5,1732,1691
2011-11-15,Haiti,Antigua and Barbuda,2,1,1,1.0,0.0,1664,1594
2011-11-15,Indonesia,Iran,1,4,3,0.0,1.0,1651,1935
2011-11-15,Republic of Ireland,Estonia,1,1,0,0.5,0.5,1923,1659
2011-11-15,Italy,Uruguay,0,1,1,0.0,1.0,1998,1980
2011-11-15,Jordan,Iraq,1,3,2,0.0,1.0,1769,1808
2011-11-15,Kenya,Seychelles,4,0,4,1.0,0.0,1594,1450
2011-11-15,North Korea,Japan,1,0,1,1.0,0.0,1757,1968
2011-11-15,Kuwait,United Arab Emirates,2,1,1,1.0,0.0,1808,1718
2011-11-15,Lebanon,South Korea,2,1,1,1.0,0.0,1601,1949
2011-11-15,Luxembourg,Switzerland,0,1,1,0.0,1.0,1413,1878
2011-11-15,North Macedonia,Albania,0,0,0,0.5,0.5,1692,1651
2011-11-15,Madagascar,Equatorial Guinea,2,1,1,1.0,0.0,1558,1497
2011-11-15,Montenegro,Czech Republic,0,1,1,0.0,1.0,1664,1912
2011-11-15,Mozambique,Comoros,4,1,3,1.0,0.0,1636,1387
2011-11-15,Namibia,Djibouti,4,0,4,1.0,0.0,1562,1316
2011-11-15,Niger,Botswana,1,1,0,0.5,0.5,1563,1664
2011-11-15,Nigeria,Zambia,2,0,2,1.0,0.0,1885,1731
2011-11-15,Panama,Dominica,3,0,3,1.0,0.0,1801,1417
2011-11-15,Poland,Hungary,2,1,1,1.0,0.0,1884,1788
2011-11-15,Portugal,Bosnia and Herzegovina,6,2,4,1.0,0.0,1984,1783
2011-11-15,Qatar,Bahrain,0,0,0,0.5,0.5,1768,1793
2011-11-15,Rwanda,Eritrea,3,1,2,1.0,0.0,1592,1482
2011-11-15,Saudi Arabia,Oman,0,0,0,0.5,0.5,1841,1823
2011-11-15,Singapore,China PR,0,4,4,0.0,1.0,1645,1861
2011-11-15,Slovenia,United States,2,3,1,0.0,1.0,1771,1918
2011-11-15,Tanzania,Chad,0,1,1,0.0,1.0,1601,1514
2011-11-15,Thailand,Australia,0,1,1,0.0,1.0,1747,1970
2011-11-15,Togo,Guinea-Bissau,1,0,1,1.0,0.0,1639,1515
2011-11-15,Trinidad and Tobago,Guyana,2,0,2,1.0,0.0,1736,1614
2011-11-15,Ukraine,Austria,2,1,1,1.0,0.0,1889,1749
2011-11-15,Uzbekistan,Tajikistan,3,0,3,1.0,0.0,1769,1589
2011-11-15,Venezuela,Bolivia,1,0,1,1.0,0.0,1848,1699
2011-11-15,Zimbabwe,South Africa,2,1,1,1.0,0.0,1692,1838
2011-11-15,Saint Vincent and the Grenadines,Belize,0,2,2,0.0,1.0,1561,1481
2011-11-16,Ethiopia,Somalia,5,0,5,1.0,0.0,1614,1353
2011-11-16,India,Malaysia,3,2,1,1.0,0.0,1589,1592
2011-11-22,American Samoa,Tonga,2,1,1,1.0,0.0,1346,1443
2011-11-22,Maldives,Seychelles,3,0,3,1.0,0.0,1482,1443
2011-11-22,Samoa,Cook Islands,3,2,1,1.0,0.0,1469,1439
2011-11-24,American Samoa,Cook Islands,1,1,0,0.5,0.5,1349,1437
2011-11-24,Maldives,Seychelles,2,1,1,1.0,0.0,1490,1436
2011-11-24,Samoa,Tonga,1,1,0,0.5,0.5,1469,1444
2011-11-25,Burundi,Somalia,4,1,3,1.0,0.0,1537,1349
2011-11-25,Uganda,Zanzibar,2,1,1,1.0,0.0,1745,1520
2011-11-26,Samoa,American Samoa,1,0,1,1.0,0.0,1475,1344
2011-11-26,Tanzania,Rwanda,0,1,1,0.0,1.0,1593,1601
2011-11-26,Tonga,Cook Islands,2,1,1,1.0,0.0,1452,1430
2011-11-27,Zanzibar,Burundi,0,0,0,0.5,0.5,1521,1537
2011-11-27,Zimbabwe,Djibouti,2,0,2,1.0,0.0,1694,1315
2011-11-28,Kenya,Malawi,0,2,2,0.0,1.0,1588,1652
2011-11-28,Somalia,Uganda,0,4,4,0.0,1.0,1348,1747
2011-11-28,Sudan,Ethiopia,1,1,0,0.5,0.5,1645,1615
2011-11-29,India,Zambia,0,5,5,0.0,1.0,1585,1736
2011-11-29,Rwanda,Zimbabwe,2,0,2,1.0,0.0,1612,1684
2011-11-29,Tanzania,Djibouti,3,0,3,1.0,0.0,1596,1313
2011-11-30,Ethiopia,Kenya,0,2,2,0.0,1.0,1607,1597
2011-11-30,Malawi,Sudan,0,0,0,0.5,0.5,1652,1646
2011-12-01,Burundi,Uganda,1,0,1,1.0,0.0,1550,1735
2011-12-01,Somalia,Zanzibar,0,3,3,0.0,1.0,1344,1526
2011-12-02,Bangladesh,Pakistan,0,0,0,0.5,0.5,1447,1363
2011-12-02,Curaçao,Bonaire,1,3,2,0.0,1.0,1486,1501
2011-12-02,Ethiopia,Malawi,1,1,0,0.5,0.5,1609,1651
2011-12-02,Maldives,Nepal,1,1,0,0.5,0.5,1489,1438
2011-12-02,Rwanda,Djibouti,5,2,3,1.0,0.0,1615,1311
2011-12-02,Suriname,Aruba,0,0,0,0.5,0.5,1579,1392
2011-12-03,India,Afghanistan,1,1,0,0.5,0.5,1581,1374
2011-12-03,Kenya,Sudan,0,1,1,0.0,1.0,1591,1653
2011-12-03,Sri Lanka,Bhutan,3,0,3,1.0,0.0,1404,1281
2011-12-03,Tanzania,Zimbabwe,1,2,1,0.0,1.0,1590,1691
2011-12-04,Bangladesh,Nepal,0,1,1,0.0,1.0,1439,1447
2011-12-04,Bonaire,Aruba,2,2,0,0.5,0.5,1499,1395
2011-12-04,Maldives,Pakistan,0,0,0,0.5,0.5,1487,1366
2011-12-04,Suriname,Curaçao,2,0,2,1.0,0.0,1585,1481
2011-12-04,Chagos Islands,Raetia,6,1,5,1.0,0.0,1508,1492
2011-12-05,Burundi,Sudan,0,2,2,0.0,1.0,1545,1659
2011-12-05,India,Bhutan,5,0,5,1.0,0.0,1584,1279
2011-12-05,Rwanda,Zanzibar,2,1,1,1.0,0.0,1621,1521
2011-12-05,Sri Lanka,Afghanistan,1,3,2,0.0,1.0,1396,1383
2011-12-06,Bahrain,Palestine,0,1,1,0.0,1.0,1780,1529
2011-12-06,Maldives,Bangladesh,3,1,2,1.0,0.0,1494,1433
2011-12-06,Pakistan,Nepal,1,1,0,0.5,0.5,1368,1446
2011-12-06,Tanzania,Malawi,1,0,1,1.0,0.0,1600,1642
2011-12-06,Uganda,Zimbabwe,1,0,1,1.0,0.0,1742,1685
2011-12-07,Bhutan,Afghanistan,1,8,7,0.0,1.0,1274,1389
2011-12-07,India,Sri Lanka,3,0,3,1.0,0.0,1589,1392
2011-12-08,Sudan,Rwanda,1,2,1,0.0,1.0,1651,1630
2011-12-08,Tanzania,Uganda,1,3,2,0.0,1.0,1596,1747
2011-12-09,Afghanistan,Nepal,1,0,1,1.0,0.0,1399,1437
2011-12-09,India,Maldives,3,1,2,1.0,0.0,1595,1489
2011-12-10,Rwanda,Uganda,2,2,0,0.5,0.5,1633,1745
2011-12-10,Tanzania,Sudan,0,1,1,0.0,1.0,1590,1658
2011-12-11,Cuba,Costa Rica,1,1,0,0.5,0.5,1688,1805
2011-12-11,India,Afghanistan,4,0,4,1.0,0.0,1599,1396
2011-12-14,Angola,Cameroon,1,1,0,0.5,0.5,1710,1850
2011-12-18,Angola,Zambia,1,0,1,1.0,0.0,1719,1728
2011-12-21,Chile,Paraguay,3,2,1,1.0,0.0,1959,1896
2011-12-22,Angola,Namibia,0,0,0,0.5,0.5,1716,1566
2011-12-22,Venezuela,Costa Rica,0,2,2,0.0,1.0,1840,1814
2011-12-28,Basque Country,Tunisia,0,2,2,0.0,1.0,1734,1821
2011-12-29,Occitania,Cilento,2,0,2,1.0,0.0,1524,1493
2011-12-30,Catalonia,Tunisia,0,0,0,0.5,0.5,1654,1818
2012-01-06,Equatorial Guinea,South Africa,0,0,0,0.5,0.5,1504,1832
2012-01-07,Botswana,Zimbabwe,0,0,0,0.5,0.5,1665,1685
2012-01-09,Gabon,Burkina Faso,0,0,0,0.5,0.5,1730,1692
2012-01-09,Tunisia,Sudan,3,0,3,1.0,0.0,1823,1654
2012-01-11,Nigeria,Angola,0,0,0,0.5,0.5,1882,1720
2012-01-12,Senegal,Sudan,1,0,1,1.0,0.0,1826,1650
2012-01-13,Tunisia,Ivory Coast,0,2,2,0.0,1.0,1818,1929
2012-01-14,Angola,Sierra Leone,3,1,2,1.0,0.0,1726,1601
2012-01-14,Zambia,Namibia,0,0,0,0.5,0.5,1725,1570
2012-01-14,Gozo,Raetia,17,1,16,1.0,0.0,1484,1484
2012-01-15,Oman,DR Congo,2,2,0,0.5,0.5,1820,1684
2012-01-15,São Tomé and Príncipe,Lesotho,1,0,1,1.0,0.0,1451,1476
2012-01-16,Gabon,Sudan,0,0,0,0.5,0.5,1729,1652
2012-01-16,Ivory Coast,Libya,1,0,1,1.0,0.0,1933,1694
2012-01-17,Kuwait,Uzbekistan,1,0,1,1.0,0.0,1816,1762
2012-01-18,Bahrain,Sweden,0,2,2,0.0,1.0,1776,1938
2012-01-18,Thailand,Norway,0,1,1,0.0,1.0,1743,1891
2012-01-21,Equatorial Guinea,Libya,1,0,1,1.0,0.0,1516,1683
2012-01-21,Senegal,Zambia,1,2,1,0.0,1.0,1816,1736
2012-01-21,United States,Venezuela,1,0,1,1.0,0.0,1925,1834
2012-01-22,Burkina Faso,Angola,1,2,1,0.0,1.0,1685,1734
2012-01-22,Ivory Coast,Sudan,1,0,1,1.0,0.0,1936,1650
2012-01-22,Lebanon,Iraq,1,0,1,1.0,0.0,1614,1796
2012-01-22,Trinidad and Tobago,Finland,2,3,1,0.0,1.0,1729,1757
2012-01-22,Lesotho,São Tomé and Príncipe,0,0,0,0.5,0.5,1476,1452
2012-01-23,Gabon,Niger,2,0,2,1.0,0.0,1734,1559
2012-01-23,Morocco,Tunisia,1,2,1,0.0,1.0,1822,1827
2012-01-24,Ghana,Botswana,1,0,1,1.0,0.0,1860,1661
2012-01-24,Mali,Guinea,1,0,1,1.0,0.0,1741,1725
2012-01-25,Equatorial Guinea,Senegal,2,1,1,1.0,0.0,1530,1803
2012-01-25,Libya,Zambia,2,2,0,0.5,0.5,1685,1735
2012-01-25,Mexico,Venezuela,3,1,2,1.0,0.0,1972,1829
2012-01-25,Panama,United States,0,1,1,0.0,1.0,1796,1931
2012-01-26,Ivory Coast,Burkina Faso,2,0,2,1.0,0.0,1940,1682
2012-01-26,Sudan,Angola,2,2,0,0.5,0.5,1652,1733
2012-01-27,Gabon,Morocco,3,2,1,1.0,0.0,1744,1813
2012-01-27,Niger,Tunisia,1,2,1,0.0,1.0,1557,1830
2012-01-27,Romania,Turkmenistan,4,0,4,1.0,0.0,1857,1594
2012-01-28,Botswana,Guinea,1,6,5,0.0,1.0,1655,1732
2012-01-28,Ghana,Mali,2,0,2,1.0,0.0,1866,1736
2012-01-29,Equatorial Guinea,Zambia,0,1,1,0.0,1.0,1527,1739
2012-01-29,Libya,Senegal,2,1,1,1.0,0.0,1696,1793
2012-01-29,United Arab Emirates,Uzbekistan,1,0,1,1.0,0.0,1728,1753
2012-01-30,Ivory Coast,Angola,2,0,2,1.0,0.0,1944,1730
2012-01-30,Sudan,Burkina Faso,2,1,1,1.0,0.0,1661,1674
2012-01-31,Gabon,Tunisia,1,0,1,1.0,0.0,1754,1821
2012-01-31,Niger,Morocco,0,1,1,0.0,1.0,1555,1816
2012-02-01,Botswana,Mali,1,2,1,0.0,1.0,1649,1743
2012-02-01,Ghana,Guinea,1,1,0,0.5,0.5,1864,1735
2012-02-04,Equatorial Guinea,Ivory Coast,0,3,3,0.0,1.0,1526,1946
2012-02-04,Zambia,Sudan,3,0,3,1.0,0.0,1746,1655
2012-02-05,Gabon,Mali,1,1,0,0.5,0.5,1754,1744
2012-02-05,Ghana,Tunisia,2,1,1,1.0,0.0,1872,1814
2012-02-08,Mali,Ivory Coast,0,1,1,0.0,1.0,1741,1950
2012-02-08,Zambia,Ghana,1,0,1,1.0,0.0,1757,1862
2012-02-11,Ghana,Mali,0,2,2,0.0,1.0,1852,1752
2012-02-12,Zambia,Ivory Coast,0,0,0,0.5,0.5,1762,1946
2012-02-15,Liberia,Nigeria,0,2,2,0.0,1.0,1571,1885
2012-02-15,Paraguay,Chile,2,0,2,1.0,0.0,1906,1950
2012-02-17,North Korea,Kuwait,1,1,0,0.5,0.5,1759,1815
2012-02-22,China PR,Kuwait,2,0,2,1.0,0.0,1868,1809
2012-02-22,Grenada,Guyana,1,2,1,0.0,1.0,1544,1621
2012-02-22,Jamaica,Cuba,1,0,1,1.0,0.0,1812,1683
2012-02-22,Paraguay,Guatemala,2,1,1,1.0,0.0,1911,1715
2012-02-23,Iran,Jordan,2,2,0,0.5,0.5,1932,1773
2012-02-23,Oman,India,5,1,4,1.0,0.0,1824,1596
2012-02-23,Tanzania,DR Congo,0,0,0,0.5,0.5,1593,1682
2012-02-24,Jamaica,Cuba,3,0,3,1.0,0.0,1818,1678
2012-02-24,Japan,Iceland,3,1,2,1.0,0.0,1971,1653
2012-02-24,Nicaragua,Puerto Rico,1,0,1,1.0,0.0,1403,1434
2012-02-24,Singapore,Azerbaijan,2,2,0,0.5,0.5,1644,1595
2012-02-24,Thailand,Maldives,3,0,3,1.0,0.0,1747,1486
2012-02-24,United Arab Emirates,Palestine,3,0,3,1.0,0.0,1732,1526
2012-02-25,South Korea,Uzbekistan,4,2,2,1.0,0.0,1953,1750
2012-02-26,Nicaragua,Puerto Rico,4,1,3,1.0,0.0,1412,1426
2012-02-27,Egypt,Kenya,5,0,5,1.0,0.0,1905,1589
2012-02-27,India,Azerbaijan,0,3,3,0.0,1.0,1588,1604
2012-02-28,Armenia,Serbia,0,2,2,0.0,1.0,1615,1853
2012-02-28,Bosnia and Herzegovina,Brazil,1,2,1,0.0,1.0,1781,2123
2012-02-29,Antigua and Barbuda,Trinidad and Tobago,0,4,4,0.0,1.0,1589,1735
2012-02-29,Armenia,Canada,3,1,2,1.0,0.0,1627,1746
2012-02-29,Australia,Saudi Arabia,4,2,2,1.0,0.0,1976,1836
2012-02-29,Austria,Finland,3,1,2,1.0,0.0,1758,1749
2012-02-29,Bahrain,Indonesia,10,0,10,1.0,0.0,1782,1646
2012-02-29,Bolivia,Cuba,1,0,1,1.0,0.0,1707,1671
2012-02-29,Chile,Ghana,1,1,0,0.5,0.5,1948,1855
2012-02-29,China PR,Jordan,3,1,2,1.0,0.0,1874,1768
2012-02-29,Croatia,Sweden,1,3,2,0.0,1.0,1978,1948
2012-02-29,Cyprus,Serbia,0,0,0,0.5,0.5,1665,1849
2012-02-29,Denmark,Russia,0,2,2,0.0,1.0,1934,1911
2012-02-29,Ecuador,Honduras,2,0,2,1.0,0.0,1872,1814
2012-02-29,Egypt,Niger,1,0,1,1.0,0.0,1907,1554
2012-02-29,El Salvador,Estonia,0,2,2,0.0,1.0,1718,1669
2012-02-29,England,Netherlands,2,3,1,0.0,1.0,2042,2098
2012-02-29,Georgia,Albania,2,1,1,1.0,0.0,1646,1643
2012-02-29,Germany,France,1,2,1,0.0,1.0,2069,2019
2012-02-29,Greece,Belgium,1,1,0,0.5,0.5,1895,1835
2012-02-29,Guyana,Guatemala,0,2,2,0.0,1.0,1616,1721
2012-02-29,Hong Kong,Taiwan,5,1,4,1.0,0.0,1569,1415
2012-02-29,Hungary,Bulgaria,1,1,0,0.5,0.5,1788,1787
2012-02-29,Iran,Qatar,2,2,0,0.5,0.5,1929,1772
2012-02-29,Iraq,Singapore,7,1,6,1.0,0.0,1801,1640
2012-02-29,Republic of Ireland,Czech Republic,1,1,0,0.5,0.5,1923,1913
2012-02-29,Israel,Ukraine,2,3,1,0.0,1.0,1795,1896
2012-02-29,Italy,United States,0,1,1,0.0,1.0,1989,1941
2012-02-29,Ivory Coast,Guinea,0,0,0,0.5,0.5,1942,1740
2012-02-29,Japan,Uzbekistan,0,1,1,0.0,1.0,1959,1763
2012-02-29,South Korea,Kuwait,2,0,2,1.0,0.0,1958,1805
2012-02-29,Latvia,Kazakhstan,0,0,0,0.5,0.5,1651,1567
2012-02-29,Luxembourg,North Macedonia,2,1,1,1.0,0.0,1427,1679
2012-02-29,Malta,Liechtenstein,2,1,1,1.0,0.0,1468,1435
2012-02-29,Mexico,Colombia,0,2,2,0.0,1.0,1963,1909
2012-02-29,Moldova,Belarus,0,0,0,0.5,0.5,1585,1722
2012-02-29,Montenegro,Iceland,2,1,1,1.0,0.0,1672,1646
2012-02-29,Morocco,Burkina Faso,2,0,2,1.0,0.0,1821,1670
2012-02-29,New Zealand,Jamaica,2,3,1,0.0,1.0,1712,1824
2012-02-29,Northern Ireland,Norway,0,3,3,0.0,1.0,1671,1895
2012-02-29,Oman,Thailand,2,0,2,1.0,0.0,1831,1741
2012-02-29,Palestine,Azerbaijan,2,0,2,1.0,0.0,1536,1595
2012-02-29,Paraguay,Panama,1,0,1,1.0,0.0,1917,1791
2012-02-29,Philippines,Malaysia,1,1,0,0.5,0.5,1417,1589
2012-02-29,Poland,Portugal,0,0,0,0.5,0.5,1887,1982
2012-02-29,Romania,Uruguay,1,1,0,0.5,0.5,1860,1978
2012-02-29,Slovenia,Scotland,1,1,0,0.5,0.5,1773,1827
2012-02-29,South Africa,Senegal,0,0,0,0.5,0.5,1832,1794
2012-02-29,Spain,Venezuela,5,0,5,1.0,0.0,2149,1827
2012-02-29,Switzerland,Argentina,1,3,2,0.0,1.0,1874,2040
2012-02-29,Tajikistan,North Korea,1,1,0,0.5,0.5,1593,1756
2012-02-29,Tunisia,Peru,1,1,0,0.5,0.5,1815,1819
2012-02-29,Turkey,Slovakia,1,2,1,0.0,1.0,1887,1789
2012-02-29,United Arab Emirates,Lebanon,4,2,2,1.0,0.0,1738,1609
2012-02-29,Wales,Costa Rica,0,1,1,0.0,1.0,1760,1821
2012-02-29,Ethiopia,Benin,0,0,0,0.5,0.5,1609,1588
2012-02-29,Rwanda,Nigeria,0,0,0,0.5,0.5,1638,1881
2012-02-29,Congo,Uganda,3,1,2,1.0,0.0,1627,1735
2012-02-29,Burundi,Zimbabwe,2,1,1,1.0,0.0,1557,1674
2012-02-29,Gambia,Algeria,1,2,1,0.0,1.0,1583,1751
2012-02-29,Kenya,Togo,2,1,1,1.0,0.0,1599,1630
2012-02-29,São Tomé and Príncipe,Sierra Leone,2,1,1,1.0,0.0,1464,1590
2012-02-29,Guinea-Bissau,Cameroon,0,1,1,0.0,1.0,1513,1853
2012-02-29,Chad,Malawi,3,2,1,1.0,0.0,1525,1632
2012-02-29,Seychelles,DR Congo,0,4,4,0.0,1.0,1433,1686
2012-02-29,Tanzania,Mozambique,1,1,0,0.5,0.5,1594,1636
2012-02-29,Madagascar,Cape Verde,0,4,4,0.0,1.0,1552,1635
2012-02-29,Liberia,Namibia,1,0,1,1.0,0.0,1579,1563
2012-03-02,Egypt,DR Congo,0,0,0,0.5,0.5,1903,1691
2012-03-03,Martinique,Guadeloupe,1,2,1,0.0,1.0,1651,1695
2012-03-03,Saint Kitts and Nevis,Antigua and Barbuda,1,0,1,1.0,0.0,1574,1581
2012-03-08,Nepal,Palestine,0,2,2,0.0,1.0,1432,1542
2012-03-08,Turkmenistan,Maldives,3,1,2,1.0,0.0,1600,1481
2012-03-09,India,Tajikistan,0,2,2,0.0,1.0,1581,1601
2012-03-09,North Korea,Philippines,2,0,2,1.0,0.0,1758,1416
2012-03-10,Nepal,Maldives,0,1,1,0.0,1.0,1426,1488
2012-03-10,Palestine,Turkmenistan,0,0,0,0.5,0.5,1544,1599
2012-03-11,Philippines,India,2,0,2,1.0,0.0,1428,1570
2012-03-11,Tajikistan,North Korea,0,2,2,0.0,1.0,1597,1763
2012-03-12,Maldives,Palestine,0,2,2,0.0,1.0,1482,1551
2012-03-12,Nepal,Turkmenistan,0,3,3,0.0,1.0,1422,1604
2012-03-13,North Korea,India,4,0,4,1.0,0.0,1767,1567
2012-03-13,Tajikistan,Philippines,1,2,1,0.0,1.0,1586,1440
2012-03-16,North Korea,Palestine,2,0,2,1.0,0.0,1771,1548
2012-03-16,Turkmenistan,Philippines,2,1,1,1.0,0.0,1609,1436
2012-03-19,Philippines,Palestine,4,3,1,1.0,0.0,1447,1538
2012-03-19,Turkmenistan,North Korea,1,2,1,0.0,1.0,1605,1776
2012-03-21,Chile,Peru,3,1,2,1.0,0.0,1954,1814
2012-03-21,French Guiana,Guyana,1,0,1,1.0,0.0,1491,1606
2012-03-21,Jamaica,Costa Rica,0,0,0,0.5,0.5,1824,1822
2012-03-22,French Guiana,Guyana,0,2,2,0.0,1.0,1486,1612
2012-03-24,Alderney,Guernsey,0,7,7,0.0,1.0,1267,1704
2012-03-29,Egypt,Uganda,2,1,1,1.0,0.0,1908,1731
2012-03-30,Occitania,Sápmi,3,2,1,1.0,0.0,1532,1516
2012-03-31,Egypt,Chad,4,0,4,1.0,0.0,1910,1524
2012-04-07,Guadeloupe,Martinique,0,1,1,0.0,1.0,1686,1661
2012-04-11,Costa Rica,Honduras,1,1,0,0.5,0.5,1822,1815
2012-04-11,Peru,Chile,0,3,3,0.0,1.0,1810,1959
2012-04-12,Egypt,Nigeria,3,2,1,1.0,0.0,1918,1874
2012-04-15,Egypt,Mauritania,3,0,3,1.0,0.0,1919,1436
2012-04-17,Egypt,Iraq,0,0,0,0.5,0.5,1917,1804
2012-04-18,Iran,Mauritania,2,0,2,1.0,0.0,1930,1436
2012-04-25,Guatemala,Paraguay,0,1,1,0.0,1.0,1718,1921
2012-04-28,Malaysia,Sri Lanka,6,0,6,1.0,0.0,1593,1389
2012-05-02,Iran,Mozambique,3,0,3,1.0,0.0,1933,1634
2012-05-02,Martinique,Guyana,2,2,0,0.5,0.5,1660,1614
2012-05-04,Guadeloupe,Guyana,1,2,1,0.0,1.0,1677,1624
2012-05-05,Sealand,Chagos Islands,1,3,2,0.0,1.0,1494,1516
2012-05-06,Jersey,Guernsey,0,2,2,0.0,1.0,1744,1714
2012-05-11,Lebanon,Egypt,1,4,3,0.0,1.0,1607,1920
2012-05-16,Angola,Zambia,0,0,0,0.5,0.5,1731,1762
2012-05-18,Jamaica,Guyana,1,0,1,1.0,0.0,1828,1621
2012-05-18,Lebanon,Jordan,1,2,1,0.0,1.0,1603,1773
2012-05-20,Egypt,Cameroon,2,1,1,1.0,0.0,1927,1847
2012-05-20,Panama,Guyana,2,0,2,1.0,0.0,1796,1617
2012-05-22,Albania,Qatar,2,1,1,1.0,0.0,1654,1762
2012-05-22,Egypt,Togo,3,0,3,1.0,0.0,1930,1628
2012-05-22,Latvia,Poland,0,1,1,0.0,1.0,1648,1891
2012-05-23,Botswana,Lesotho,3,0,3,1.0,0.0,1654,1472
2012-05-23,El Salvador,New Zealand,2,2,0,0.5,0.5,1718,1713
2012-05-23,Iraq,Sierra Leone,1,0,1,1.0,0.0,1808,1587
2012-05-23,Japan,Azerbaijan,2,0,2,1.0,0.0,1961,1594
2012-05-23,Libya,Rwanda,2,0,2,1.0,0.0,1703,1632
2012-05-23,Peru,Nigeria,1,0,1,1.0,0.0,1820,1865
2012-05-23,Venezuela,Moldova,4,0,4,1.0,0.0,1831,1582
2012-05-24,Georgia,Turkey,1,3,2,0.0,1.0,1643,1891
2012-05-25,Belgium,Montenegro,2,2,0,0.5,0.5,1832,1676
2012-05-25,Costa Rica,Guatemala,3,2,1,1.0,0.0,1828,1713
2012-05-25,Croatia,Estonia,3,1,2,1.0,0.0,1981,1667
2012-05-25,Morocco,Senegal,0,1,1,0.0,1.0,1813,1803
2012-05-25,Russia,Uruguay,1,1,0,0.5,0.5,1913,1977
2012-05-26,Algeria,Niger,3,0,3,1.0,0.0,1755,1551
2012-05-26,Burkina Faso,Benin,2,2,0,0.5,0.5,1669,1590
2012-05-26,Czech Republic,Israel,2,1,1,1.0,0.0,1919,1790
2012-05-26,Denmark,Brazil,1,3,2,0.0,1.0,1930,2128
2012-05-26,El Salvador,Moldova,2,0,2,1.0,0.0,1724,1577
2012-05-26,Finland,Turkey,3,2,1,1.0,0.0,1761,1880
2012-05-26,Greece,Slovenia,1,1,0,0.5,0.5,1893,1776
2012-05-26,Guinea,Cameroon,1,2,1,0.0,1.0,1735,1853
2012-05-26,Honduras,New Zealand,0,1,1,0.0,1.0,1805,1724
2012-05-26,Republic of Ireland,Bosnia and Herzegovina,1,0,1,1.0,0.0,1928,1777
2012-05-26,Jordan,Sierra Leone,4,0,4,1.0,0.0,1778,1583
2012-05-26,Mozambique,Namibia,0,0,0,0.5,0.5,1633,1565
2012-05-26,Netherlands,Bulgaria,1,2,1,0.0,1.0,2085,1801
2012-05-26,Norway,England,0,1,1,0.0,1.0,1891,2047
2012-05-26,Poland,Slovakia,1,0,1,1.0,0.0,1897,1784
2012-05-26,Portugal,North Macedonia,0,0,0,0.5,0.5,1977,1685
2012-05-26,Spain,Serbia,2,0,2,1.0,0.0,2152,1847
2012-05-26,Switzerland,Germany,5,3,2,1.0,0.0,1887,2057
2012-05-26,Tanzania,Malawi,0,0,0,0.5,0.5,1595,1632
2012-05-26,United States,Scotland,5,1,4,1.0,0.0,1947,1822
2012-05-27,Albania,Iran,1,0,1,1.0,0.0,1668,1920
2012-05-27,Chad,Libya,0,1,1,0.0,1.0,1520,1708
2012-05-27,France,Iceland,3,2,1,1.0,0.0,2021,1645
2012-05-27,Jamaica,Panama,0,1,1,0.0,1.0,1820,1805
2012-05-27,Mexico,Wales,2,0,2,1.0,0.0,1967,1757
2012-05-27,Oman,Lebanon,1,1,0,0.5,0.5,1827,1608
2012-05-27,Tunisia,Rwanda,5,1,4,1.0,0.0,1820,1628
2012-05-28,Iraq,Botswana,1,1,0,0.5,0.5,1805,1658
2012-05-28,Qatar,Palestine,0,0,0,0.5,0.5,1758,1543
2012-05-28,Ukraine,Estonia,4,0,4,1.0,0.0,1900,1664
2012-05-29,Angola,North Macedonia,0,0,0,0.5,0.5,1730,1687
2012-05-29,Bulgaria,Turkey,0,2,2,0.0,1.0,1795,1887
2012-05-29,Lithuania,Russia,0,0,0,0.5,0.5,1666,1909
2012-05-30,Azerbaijan,Andorra,0,0,0,0.5,0.5,1590,1361
2012-05-30,Chad,Rwanda,1,1,0,0.5,0.5,1523,1626
2012-05-30,Netherlands,Slovakia,2,0,2,1.0,0.0,2088,1782
2012-05-30,Spain,South Korea,4,1,3,1.0,0.0,2156,1955
2012-05-30,Sweden,Iceland,3,2,1,1.0,0.0,1951,1643
2012-05-30,Switzerland,Romania,0,1,1,0.0,1.0,1879,1869
2012-05-30,United States,Brazil,1,4,3,0.0,1.0,1943,2133
2012-05-31,Armenia,Greece,0,1,1,0.0,1.0,1625,1896
2012-05-31,France,Serbia,2,0,2,1.0,0.0,2026,1843
2012-05-31,Germany,Israel,2,0,2,1.0,0.0,2060,1788
2012-05-31,Mexico,Bosnia and Herzegovina,2,1,1,1.0,0.0,1972,1773
2012-06-01,Austria,Ukraine,3,2,1,1.0,0.0,1770,1889
2012-06-01,Czech Republic,Hungary,1,2,1,0.0,1.0,1909,1799
2012-06-01,Egypt,Mozambique,2,0,2,1.0,0.0,1933,1631
2012-06-01,Estonia,Finland,1,2,1,0.0,1.0,1659,1767
2012-06-01,Ghana,Lesotho,7,0,7,1.0,0.0,1857,1471
2012-06-01,Guatemala,Costa Rica,1,0,1,1.0,0.0,1724,1818
2012-06-01,Hong Kong,Singapore,1,0,1,1.0,0.0,1579,1631
2012-06-01,Italy,Russia,0,3,3,0.0,1.0,1980,1919
2012-06-01,Kazakhstan,Kyrgyzstan,5,2,3,1.0,0.0,1573,1443
2012-06-01,Latvia,Lithuania,5,0,5,1.0,0.0,1657,1658
2012-06-01,Malaysia,Philippines,0,0,0,0.5,0.5,1590,1451
2012-06-01,Panama,Jamaica,2,1,1,1.0,0.0,1814,1812
2012-06-01,Puerto Rico,Nicaragua,3,1,2,1.0,0.0,1434,1405
2012-06-01,Samoa,Tahiti,1,10,9,0.0,1.0,1471,1653
2012-06-01,Vanuatu,New Caledonia,2,5,3,0.0,1.0,1599,1664
2012-06-02,Algeria,Rwanda,4,0,4,1.0,0.0,1761,1621
2012-06-02,Argentina,Ecuador,4,0,4,1.0,0.0,2045,1868
2012-06-02,Bolivia,Chile,0,2,2,0.0,1.0,1704,1963
2012-06-02,Burkina Faso,Congo,0,3,3,0.0,1.0,1661,1636
2012-06-02,Cameroon,DR Congo,1,0,1,1.0,0.0,1858,1687
2012-06-02,Central African Republic,Botswana,2,0,2,1.0,0.0,1469,1646
2012-06-02,Denmark,Australia,2,0,2,1.0,0.0,1940,1967
2012-06-02,El Salvador,Honduras,0,3,3,0.0,1.0,1718,1812
2012-06-02,England,Belgium,1,0,1,1.0,0.0,2051,1829
2012-06-02,Fiji,New Zealand,0,1,1,0.0,1.0,1689,1732
2012-06-02,Gambia,Morocco,1,1,0,0.5,0.5,1588,1809
2012-06-02,Ivory Coast,Tanzania,2,0,2,1.0,0.0,1944,1594
2012-06-02,Kenya,Malawi,0,0,0,0.5,0.5,1600,1632
2012-06-02,Luxembourg,Malta,0,2,2,0.0,1.0,1420,1476
2012-06-02,Netherlands,Northern Ireland,6,0,6,1.0,0.0,2090,1670
2012-06-02,Norway,Croatia,1,1,0,0.5,0.5,1894,1979
2012-06-02,Poland,Andorra,4,0,4,1.0,0.0,1898,1361
2012-06-02,Portugal,Turkey,1,3,2,0.0,1.0,1967,1898
2012-06-02,Senegal,Liberia,3,1,2,1.0,0.0,1807,1576
2012-06-02,Sierra Leone,Cape Verde,2,1,1,1.0,0.0,1593,1626
2012-06-02,Solomon Islands,Papua New Guinea,1,0,1,1.0,0.0,1661,1514
2012-06-02,Sudan,Zambia,0,3,3,0.0,1.0,1650,1768
2012-06-02,Tunisia,Equatorial Guinea,3,1,2,1.0,0.0,1823,1524
2012-06-02,Uruguay,Venezuela,1,1,0,0.5,0.5,1974,1835
2012-06-03,Angola,Uganda,1,1,0,0.5,0.5,1731,1731
2012-06-03,Benin,Mali,1,0,1,1.0,0.0,1602,1741
2012-06-03,Canada,United States,0,0,0,0.5,0.5,1751,1939
2012-06-03,Estonia,Lithuania,1,0,1,1.0,0.0,1667,1651
2012-06-03,Finland,Latvia,1,1,0,0.5,0.5,1765,1660
2012-06-03,Japan,Oman,3,0,3,1.0,0.0,1967,1822
2012-06-03,Jordan,Iraq,1,1,0,0.5,0.5,1779,1805
2012-06-03,Lebanon,Qatar,0,1,1,0.0,1.0,1604,1763
2012-06-03,Mexico,Brazil,2,0,2,1.0,0.0,1984,2122
2012-06-03,Niger,Gabon,3,0,3,1.0,0.0,1564,1742
2012-06-03,Nigeria,Namibia,1,0,1,1.0,0.0,1868,1563
2012-06-03,Peru,Colombia,0,1,1,0.0,1.0,1815,1915
2012-06-03,Puerto Rico,Nicaragua,1,1,0,0.5,0.5,1434,1406
2012-06-03,South Africa,Ethiopia,1,1,0,0.5,0.5,1828,1614
2012-06-03,Spain,China PR,1,0,1,1.0,0.0,2159,1872
2012-06-03,Tahiti,New Caledonia,4,3,1,1.0,0.0,1662,1656
2012-06-03,Togo,Libya,1,1,0,0.5,0.5,1630,1707
2012-06-03,Uzbekistan,Iran,0,1,1,0.0,1.0,1759,1925
2012-06-03,Vanuatu,Samoa,5,0,5,1.0,0.0,1605,1466
2012-06-03,Zimbabwe,Guinea,0,1,1,0.0,1.0,1668,1742
2012-06-04,Hungary,Republic of Ireland,0,0,0,0.5,0.5,1802,1926
2012-06-04,Papua New Guinea,New Zealand,1,2,1,0.0,1.0,1511,1736
2012-06-04,Solomon Islands,Fiji,0,0,0,0.5,0.5,1662,1689
2012-06-04,Iraqi Kurdistan,Western Sahara,6,0,6,1.0,0.0,1526,1493
2012-06-04,Zanzibar,Raetia,6,0,6,1.0,0.0,1529,1477
2012-06-04,Northern Cyprus,Darfur,15,0,15,1.0,0.0,1551,1494
2012-06-05,Armenia,Kazakhstan,3,0,3,1.0,0.0,1632,1567
2012-06-05,Austria,Romania,0,0,0,0.5,0.5,1773,1867
2012-06-05,France,Estonia,4,0,4,1.0,0.0,2028,1666
2012-06-05,New Caledonia,Samoa,9,0,9,1.0,0.0,1661,1462
2012-06-05,Philippines,Indonesia,2,2,0,0.5,0.5,1456,1642
2012-06-05,Sweden,Serbia,2,1,1,1.0,0.0,1957,1838
2012-06-05,Tahiti,Vanuatu,4,1,3,1.0,0.0,1669,1599
2012-06-05,Turkey,Ukraine,2,0,2,1.0,0.0,1906,1882
2012-06-05,Western Sahara,Occitania,2,6,4,0.0,1.0,1486,1540
2012-06-05,Raetia,Tamil Eelam,1,0,1,1.0,0.0,1486,1492
2012-06-05,Darfur,Provence,0,18,18,0.0,1.0,1486,1468
2012-06-06,Papua New Guinea,Fiji,1,1,0,0.5,0.5,1515,1686
2012-06-06,Solomon Islands,New Zealand,1,1,0,0.5,0.5,1664,1735
2012-06-06,Iraqi Kurdistan,Occitania,1,0,1,1.0,0.0,1535,1532
2012-06-06,Tamil Eelam,Zanzibar,0,3,3,0.0,1.0,1485,1537
2012-06-06,Provence,Northern Cyprus,2,1,1,1.0,0.0,1478,1542
2012-06-07,Belarus,Lithuania,1,1,0,0.5,0.5,1721,1653
2012-06-07,Western Sahara,Darfur,5,1,4,1.0,0.0,1494,1478
2012-06-07,Occitania,Tamil Eelam,7,0,7,1.0,0.0,1539,1479
2012-06-08,Bahrain,Kuwait,1,1,0,0.5,0.5,1783,1805
2012-06-08,China PR,Vietnam,3,0,3,1.0,0.0,1876,1634
2012-06-08,Costa Rica,El Salvador,2,2,0,0.5,0.5,1816,1721
2012-06-08,Cuba,Canada,0,1,1,0.0,1.0,1665,1758
2012-06-08,Honduras,Panama,0,2,2,0.0,1.0,1805,1822
2012-06-08,Jamaica,Guatemala,2,1,1,1.0,0.0,1819,1718
2012-06-08,Japan,Jordan,6,0,6,1.0,0.0,1972,1775
2012-06-08,Lebanon,Uzbekistan,1,1,0,0.5,0.5,1608,1756
2012-06-08,Mexico,Guyana,3,1,2,1.0,0.0,1986,1616
2012-06-08,New Zealand,New Caledonia,0,2,2,0.0,1.0,1726,1671
2012-06-08,Oman,Australia,0,0,0,0.5,0.5,1826,1964
2012-06-08,Poland,Greece,1,1,0,0.5,0.5,1898,1897
2012-06-08,Qatar,South Korea,1,4,3,0.0,1.0,1760,1959
2012-06-08,Russia,Czech Republic,4,1,3,1.0,0.0,1927,1902
2012-06-08,Singapore,Malaysia,2,2,0,0.5,0.5,1631,1591
2012-06-08,Solomon Islands,Tahiti,0,1,1,0.0,1.0,1657,1677
2012-06-08,United States,Antigua and Barbuda,3,1,2,1.0,0.0,1941,1580
2012-06-08,Western Sahara,Raetia,3,0,3,1.0,0.0,1502,1479
2012-06-08,Iraqi Kurdistan,Provence,2,1,1,1.0,0.0,1542,1472
2012-06-08,Zanzibar,Northern Cyprus,0,2,2,0.0,1.0,1530,1550
2012-06-09,Bolivia,Paraguay,3,1,2,1.0,0.0,1717,1909
2012-06-09,Botswana,South Africa,1,1,0,0.5,0.5,1650,1825
2012-06-09,Brazil,Argentina,3,4,1,0.0,1.0,2113,2055
2012-06-09,Cape Verde,Tunisia,1,2,1,0.0,1.0,1623,1827
2012-06-09,Congo,Niger,1,0,1,1.0,0.0,1643,1558
2012-06-09,Equatorial Guinea,Sierra Leone,2,2,0,0.5,0.5,1526,1592
2012-06-09,French Guiana,Suriname,2,1,1,1.0,0.0,1497,1575
2012-06-09,Gabon,Burkina Faso,1,0,1,1.0,0.0,1749,1655
2012-06-09,Germany,Portugal,1,0,1,1.0,0.0,2066,1962
2012-06-09,Malawi,Nigeria,1,1,0,0.5,0.5,1637,1864
2012-06-09,Morocco,Ivory Coast,2,2,0,0.5,0.5,1812,1942
2012-06-09,Namibia,Kenya,1,0,1,1.0,0.0,1572,1592
2012-06-09,Netherlands,Denmark,0,1,1,0.0,1.0,2079,1952
2012-06-09,Uganda,Senegal,1,1,0,0.5,0.5,1733,1806
2012-06-09,Venezuela,Chile,0,2,2,0.0,1.0,1830,1969
2012-06-09,Zambia,Ghana,1,0,1,1.0,0.0,1779,1847
2012-06-09,Tamil Eelam,Raetia,4,0,4,1.0,0.0,1487,1471
2012-06-09,Occitania,Western Sahara,3,1,2,1.0,0.0,1547,1495
2012-06-09,Provence,Zanzibar,2,7,5,0.0,1.0,1466,1537
2012-06-09,Iraqi Kurdistan,Northern Cyprus,2,1,1,1.0,0.0,1551,1542
2012-06-10,DR Congo,Togo,2,0,2,1.0,0.0,1694,1624
2012-06-10,Ecuador,Colombia,1,0,1,1.0,0.0,1878,1906
2012-06-10,Ethiopia,Central African Republic,2,0,2,1.0,0.0,1619,1465
2012-06-10,Guinea,Egypt,2,3,1,0.0,1.0,1739,1937
2012-06-10,Hong Kong,Vietnam,1,2,1,0.0,1.0,1573,1641
2012-06-10,Republic of Ireland,Croatia,1,3,2,0.0,1.0,1920,1986
2012-06-10,Lesotho,Sudan,0,0,0,0.5,0.5,1475,1647
2012-06-10,Liberia,Angola,0,0,0,0.5,0.5,1580,1728
2012-06-10,Libya,Cameroon,2,1,1,1.0,0.0,1719,1847
2012-06-10,Mali,Algeria,2,1,1,1.0,0.0,1750,1753
2012-06-10,Mozambique,Zimbabwe,0,0,0,0.5,0.5,1632,1668
2012-06-10,Rwanda,Benin,1,1,0,0.5,0.5,1621,1603
2012-06-10,Solomon Islands,New Zealand,3,4,1,0.0,1.0,1651,1733
2012-06-10,Spain,Italy,1,1,0,0.5,0.5,2156,1984
2012-06-10,Tahiti,New Caledonia,1,0,1,1.0,0.0,1685,1664
2012-06-10,Tanzania,Gambia,2,1,1,1.0,0.0,1602,1581
2012-06-10,Uruguay,Peru,4,2,2,1.0,0.0,1979,1811
2012-06-10,Monaco,Raetia,1,2,1,0.0,1.0,1489,1480
2012-06-11,France,England,1,1,0,0.5,0.5,2029,2051
2012-06-11,Ukraine,Sweden,2,1,1,1.0,0.0,1892,1948
2012-06-12,Antigua and Barbuda,Jamaica,0,0,0,0.5,0.5,1585,1815
2012-06-12,Australia,Japan,1,1,0,0.5,0.5,1965,1972
2012-06-12,Bahrain,Kuwait,0,1,1,0.0,1.0,1776,1813
2012-06-12,Canada,Honduras,0,0,0,0.5,0.5,1760,1804
2012-06-12,El Salvador,Mexico,1,2,1,0.0,1.0,1719,1989
2012-06-12,Greece,Czech Republic,1,2,1,0.0,1.0,1890,1910
2012-06-12,Guatemala,United States,1,1,0,0.5,0.5,1723,1937
2012-06-12,Guyana,Costa Rica,0,4,4,0.0,1.0,1613,1820
2012-06-12,Iran,Qatar,0,0,0,0.5,0.5,1922,1764
2012-06-12,Iraq,Oman,1,1,0,0.5,0.5,1806,1826
2012-06-12,South Korea,Lebanon,3,0,3,1.0,0.0,1961,1607
2012-06-12,Malaysia,Singapore,2,0,2,1.0,0.0,1600,1623
2012-06-12,Panama,Cuba,1,0,1,1.0,0.0,1827,1661
2012-06-12,Philippines,Guam,3,0,3,1.0,0.0,1463,1367
2012-06-12,Poland,Russia,1,1,0,0.5,0.5,1899,1927
2012-06-13,Denmark,Portugal,2,3,1,0.0,1.0,1945,1970
2012-06-13,Netherlands,Germany,1,2,1,0.0,1.0,2071,2075
2012-06-14,Italy,Croatia,1,1,0,0.5,0.5,1985,1986
2012-06-14,Spain,Republic of Ireland,4,0,4,1.0,0.0,2160,1917
2012-06-15,South Africa,Gabon,3,0,3,1.0,0.0,1832,1743
2012-06-15,Sweden,England,2,3,1,0.0,1.0,1943,2057
2012-06-15,Ukraine,France,0,2,2,0.0,1.0,1888,2034
2012-06-15,Algeria,Gambia,4,1,3,1.0,0.0,1758,1577
2012-06-15,Egypt,Central African Republic,2,3,1,0.0,1.0,1922,1481
2012-06-16,Greece,Russia,1,0,1,1.0,0.0,1899,1919
2012-06-16,Poland,Czech Republic,0,1,1,0.0,1.0,1892,1918
2012-06-16,Nigeria,Rwanda,2,0,2,1.0,0.0,1868,1618
2012-06-16,Uganda,Congo,4,0,4,1.0,0.0,1739,1638
2012-06-16,Sierra Leone,São Tomé and Príncipe,4,2,2,1.0,0.0,1598,1459
2012-06-16,Cameroon,Guinea-Bissau,1,0,1,1.0,0.0,1850,1511
2012-06-16,Malawi,Chad,2,0,2,1.0,0.0,1643,1518
2012-06-16,Cape Verde,Madagascar,3,1,2,1.0,0.0,1630,1546
2012-06-16,Namibia,Liberia,0,0,0,0.5,0.5,1573,1580
2012-06-17,Denmark,Germany,1,2,1,0.0,1.0,1940,2081
2012-06-17,Portugal,Netherlands,2,1,1,1.0,0.0,1981,2061
2012-06-17,Benin,Ethiopia,1,1,0,0.5,0.5,1604,1619
2012-06-17,Zimbabwe,Burundi,1,0,1,1.0,0.0,1674,1552
2012-06-17,Togo,Kenya,1,0,1,1.0,0.0,1632,1585
2012-06-17,DR Congo,Seychelles,3,0,3,1.0,0.0,1697,1431
2012-06-17,Mozambique,Tanzania,1,1,0,0.5,0.5,1632,1603
2012-06-18,Croatia,Spain,0,1,1,0.0,1.0,1982,2165
2012-06-18,Italy,Republic of Ireland,2,0,2,1.0,0.0,1992,1911
2012-06-18,Saudi Arabia,Morocco,4,0,4,1.0,0.0,1844,1805
2012-06-18,Yemen,Palestine,1,2,1,0.0,1.0,1578,1553
2012-06-19,Sweden,France,2,0,2,1.0,0.0,1954,2024
2012-06-19,Ukraine,England,0,1,1,0.0,1.0,1884,2062
2012-06-21,Czech Republic,Portugal,0,1,1,0.0,1.0,1912,1988
2012-06-22,Germany,Greece,4,2,2,1.0,0.0,2086,1895
2012-06-22,Saudi Arabia,Kuwait,4,0,4,1.0,0.0,1852,1806
2012-06-23,Libya,Yemen,3,1,2,1.0,0.0,1724,1574
2012-06-23,Spain,France,2,0,2,1.0,0.0,2170,2020
2012-06-24,England,Italy,0,0,0,0.5,0.5,2061,1994
2012-06-24,Iraq,Lebanon,1,0,1,1.0,0.0,1810,1604
2012-06-25,Kuwait,Palestine,2,0,2,1.0,0.0,1810,1550
2012-06-26,Bahrain,Yemen,0,2,2,0.0,1.0,1764,1587
2012-06-27,Lebanon,Sudan,0,2,2,0.0,1.0,1597,1655
2012-06-27,Portugal,Spain,0,0,0,0.5,0.5,1992,2167
2012-06-28,Germany,Italy,1,2,1,0.0,1.0,2076,2005
2012-06-28,Saudi Arabia,Palestine,2,2,0,0.5,0.5,1847,1556
2012-06-29,Libya,Bahrain,2,1,1,1.0,0.0,1733,1756
2012-06-30,Sudan,Iraq,1,1,0,0.5,0.5,1659,1807
2012-06-30,Central African Republic,Egypt,1,1,0,0.5,0.5,1488,1916
2012-07-01,Spain,Italy,4,0,4,1.0,0.0,2172,2001
2012-07-03,Saudi Arabia,Libya,0,2,2,0.0,1.0,1837,1744
2012-07-05,Saudi Arabia,Iraq,0,1,1,0.0,1.0,1829,1816
2012-07-06,Malawi,Zambia,1,0,1,1.0,0.0,1654,1769
2012-07-07,British Virgin Islands,Anguilla,1,0,1,1.0,0.0,1388,1326
2012-07-10,South Sudan,Uganda,2,2,0,0.5,0.5,1505,1735
2012-07-12,Kenya,Botswana,3,1,2,1.0,0.0,1595,1641
2012-07-13,Aruba,Curaçao,3,2,1,1.0,0.0,1405,1472
2012-07-13,Suriname,Bonaire,8,0,8,1.0,0.0,1582,1493
2012-07-15,Aruba,Suriname,1,0,1,1.0,0.0,1417,1571
2012-07-15,Bonaire,Curaçao,2,9,7,0.0,1.0,1485,1481
2012-07-16,Botswana,Zimbabwe,1,0,1,1.0,0.0,1650,1666
2012-07-17,Zimbabwe,Lesotho,5,3,2,1.0,0.0,1670,1472
2012-07-18,Botswana,Lesotho,0,0,0,0.5,0.5,1647,1476
2012-07-18,Guam,Northern Mariana Islands,3,1,2,1.0,0.0,1377,1422
2012-07-20,Northern Mariana Islands,Macau,1,5,4,0.0,1.0,1412,1318
2012-07-22,Guam,Macau,3,0,3,1.0,0.0,1384,1312
2012-08-08,Zambia,Zimbabwe,2,1,1,1.0,0.0,1775,1665
2012-08-11,El Salvador,Guatemala,1,0,1,1.0,0.0,1728,1715
2012-08-13,Jordan,Uzbekistan,0,1,1,0.0,1.0,1767,1765
2012-08-14,Burkina Faso,Togo,3,0,3,1.0,0.0,1663,1625
2012-08-14,Liechtenstein,Andorra,1,0,1,1.0,0.0,1442,1355
2012-08-14,San Marino,Malta,2,3,1,0.0,1.0,1338,1482
2012-08-15,Albania,Moldova,0,0,0,0.5,0.5,1666,1580
2012-08-15,Angola,Mozambique,2,0,2,1.0,0.0,1734,1627
2012-08-15,Armenia,Belarus,1,2,1,0.0,1.0,1627,1727
2012-08-15,Austria,Turkey,2,0,2,1.0,0.0,1784,1896
2012-08-15,Azerbaijan,Bahrain,3,0,3,1.0,0.0,1602,1745
2012-08-15,Belgium,Netherlands,4,2,2,1.0,0.0,1842,2049
2012-08-15,Bolivia,Guyana,2,0,2,1.0,0.0,1723,1608
2012-08-15,Botswana,Tanzania,3,3,0,0.5,0.5,1646,1605
2012-08-15,Bulgaria,Cyprus,1,0,1,1.0,0.0,1801,1660
2012-08-15,Canada,Trinidad and Tobago,2,0,2,1.0,0.0,1768,1728
2012-08-15,China PR,Ghana,1,1,0,0.5,0.5,1876,1848
2012-08-15,Costa Rica,Peru,0,1,1,0.0,1.0,1812,1820
2012-08-15,Croatia,Switzerland,2,4,2,0.0,1.0,1972,1890
2012-08-15,Denmark,Slovakia,1,3,2,0.0,1.0,1929,1794
2012-08-15,Ecuador,Chile,3,0,3,1.0,0.0,1889,1959
2012-08-15,El Salvador,Jamaica,0,2,2,0.0,1.0,1722,1822
2012-08-15,England,Italy,2,1,1,1.0,0.0,2068,1995
2012-08-15,Equatorial Guinea,Liberia,1,0,1,1.0,0.0,1536,1571
2012-08-15,Estonia,Poland,1,0,1,1.0,0.0,1679,1880
2012-08-15,France,Uruguay,0,0,0,0.5,0.5,2020,1980
2012-08-15,Germany,Argentina,1,3,2,0.0,1.0,2068,2064
2012-08-15,Guatemala,Paraguay,3,3,0,0.5,0.5,1720,1905
2012-08-15,Hungary,Israel,1,1,0,0.5,0.5,1802,1789
2012-08-15,Iceland,Faroe Islands,2,0,2,1.0,0.0,1648,1459
2012-08-15,Iran,Tunisia,2,2,0,0.5,0.5,1920,1830
2012-08-15,Japan,Venezuela,1,1,0,0.5,0.5,1969,1834
2012-08-15,Jordan,Uzbekistan,2,0,2,1.0,0.0,1775,1758
2012-08-15,South Korea,Zambia,2,1,1,1.0,0.0,1966,1771
2012-08-15,Luxembourg,Georgia,1,2,1,0.0,1.0,1417,1647
2012-08-15,North Macedonia,Lithuania,1,0,1,1.0,0.0,1695,1646
2012-08-15,Mexico,United States,0,1,1,0.0,1.0,1980,1947
2012-08-15,Montenegro,Latvia,2,0,2,1.0,0.0,1684,1653
2012-08-15,Morocco,Guinea,1,2,1,0.0,1.0,1796,1749
2012-08-15,Niger,Nigeria,0,0,0,0.5,0.5,1564,1863
2012-08-15,Northern Ireland,Finland,3,3,0,0.5,0.5,1673,1763
2012-08-15,Norway,Greece,2,3,1,0.0,1.0,1887,1903
2012-08-15,Oman,Egypt,1,1,0,0.5,0.5,1829,1914
2012-08-15,Portugal,Panama,2,0,2,1.0,0.0,1997,1823
2012-08-15,Puerto Rico,Spain,1,2,1,0.0,1.0,1434,2173
2012-08-15,Russia,Ivory Coast,1,1,0,0.5,0.5,1920,1942
2012-08-15,Scotland,Australia,3,1,2,1.0,0.0,1834,1954
2012-08-15,Serbia,Republic of Ireland,0,0,0,0.5,0.5,1840,1910
2012-08-15,Singapore,Hong Kong,2,0,2,1.0,0.0,1630,1567
2012-08-15,Slovenia,Romania,4,3,1,1.0,0.0,1787,1857
2012-08-15,Sweden,Brazil,0,3,3,0.0,1.0,1950,2118
2012-08-15,Ukraine,Czech Republic,0,0,0,0.5,0.5,1885,1912
2012-08-15,Wales,Bosnia and Herzegovina,0,2,2,0.0,1.0,1750,1781
2012-08-22,India,Syria,2,1,1,1.0,0.0,1579,1728
2012-08-23,Maldives,Nepal,2,1,1,1.0,0.0,1489,1416
2012-08-24,Syria,Cameroon,2,2,0,0.5,0.5,1731,1848
2012-08-25,India,Maldives,3,0,3,1.0,0.0,1585,1484
2012-08-25,Alderney,Sealand,1,1,0,0.5,0.5,1272,1490
2012-08-26,Botswana,Uganda,0,0,0,0.5,0.5,1649,1733
2012-08-26,Libya,Sudan,3,0,3,1.0,0.0,1751,1653
2012-08-26,Nepal,Cameroon,0,5,5,0.0,1.0,1415,1850
2012-08-27,Maldives,Syria,2,1,1,1.0,0.0,1497,1719
2012-08-28,India,Nepal,0,0,0,0.5,0.5,1582,1419
2012-08-29,Cameroon,Maldives,3,1,2,1.0,0.0,1852,1496
2012-08-30,Syria,Nepal,2,0,2,1.0,0.0,1722,1417
2012-08-31,India,Cameroon,0,1,1,0.0,1.0,1580,1855
2012-09-02,India,Cameroon,2,2,0,0.5,0.5,1586,1850
2012-09-04,Liberia,Malawi,1,0,1,1.0,0.0,1581,1645
2012-09-05,Cambodia,Philippines,0,0,0,0.5,0.5,1338,1461
2012-09-05,Jordan,Iran,0,0,0,0.5,0.5,1779,1917
2012-09-05,Martinique,British Virgin Islands,16,0,16,1.0,0.0,1663,1386
2012-09-05,Montserrat,Suriname,1,7,6,0.0,1.0,1377,1575
2012-09-06,Japan,United Arab Emirates,1,0,1,1.0,0.0,1973,1735
2012-09-06,Lebanon,Australia,0,3,3,0.0,1.0,1596,1956
2012-09-06,Qatar,Tajikistan,1,2,1,0.0,1.0,1753,1598
2012-09-06,Sweden,China PR,1,0,1,1.0,0.0,1957,1870
2012-09-07,Albania,Cyprus,3,1,2,1.0,0.0,1674,1653
2012-09-07,Andorra,Hungary,0,5,5,0.0,1.0,1354,1804
2012-09-07,Argentina,Paraguay,3,1,2,1.0,0.0,2069,1901
2012-09-07,Azerbaijan,Israel,1,1,0,0.5,0.5,1606,1786
2012-09-07,Bermuda,Puerto Rico,1,2,1,0.0,1.0,1536,1445
2012-09-07,Brazil,South Africa,1,0,1,1.0,0.0,2121,1830
2012-09-07,British Virgin Islands,Suriname,0,4,4,0.0,1.0,1382,1580
2012-09-07,Bulgaria,Italy,2,2,0,0.5,0.5,1806,1991
2012-09-07,Canada,Panama,1,0,1,1.0,0.0,1778,1814
2012-09-07,Colombia,Uruguay,4,0,4,1.0,0.0,1916,1971
2012-09-07,Costa Rica,Mexico,0,2,2,0.0,1.0,1808,1985
2012-09-07,Croatia,North Macedonia,1,0,1,1.0,0.0,1975,1693
2012-09-07,Cuba,Honduras,0,3,3,0.0,1.0,1657,1809
2012-09-07,Ecuador,Bolivia,1,0,1,1.0,0.0,1894,1719
2012-09-07,El Salvador,Guyana,2,2,0,0.5,0.5,1720,1611
2012-09-07,Estonia,Romania,0,2,2,0.0,1.0,1675,1862
2012-09-07,Finland,France,0,1,1,0.0,1.0,1761,2023
2012-09-07,Georgia,Belarus,1,0,1,1.0,0.0,1657,1718
2012-09-07,Germany,Faroe Islands,3,0,3,1.0,0.0,2069,1459
2012-09-07,Guatemala,Antigua and Barbuda,3,1,2,1.0,0.0,1726,1580
2012-09-07,Haiti,Saint Martin,7,0,7,1.0,0.0,1668,1452
2012-09-07,Iceland,Norway,2,0,2,1.0,0.0,1661,1875
2012-09-07,Jamaica,United States,2,1,1,1.0,0.0,1833,1937
2012-09-07,Kazakhstan,Republic of Ireland,1,2,1,0.0,1.0,1566,1912
2012-09-07,Latvia,Greece,1,2,1,0.0,1.0,1650,1907
2012-09-07,Liechtenstein,Bosnia and Herzegovina,1,8,7,0.0,1.0,1441,1783
2012-09-07,Lithuania,Slovakia,1,1,0,0.5,0.5,1650,1791
2012-09-07,Luxembourg,Portugal,1,2,1,0.0,1.0,1417,1998
2012-09-07,Malta,Armenia,0,1,1,0.0,1.0,1478,1632
2012-09-07,Martinique,Montserrat,5,0,5,1.0,0.0,1666,1375
2012-09-07,Moldova,England,0,5,5,0.0,1.0,1580,2069
2012-09-07,Montenegro,Poland,2,2,0,0.5,0.5,1689,1876
2012-09-07,Netherlands,Turkey,2,0,2,1.0,0.0,2054,1892
2012-09-07,New Caledonia,New Zealand,0,2,2,0.0,1.0,1658,1740
2012-09-07,Peru,Venezuela,2,1,1,1.0,0.0,1829,1826
2012-09-07,Russia,Northern Ireland,2,0,2,1.0,0.0,1924,1670
2012-09-07,Singapore,Philippines,0,2,2,0.0,1.0,1619,1473
2012-09-07,Slovenia,Switzerland,0,2,2,0.0,1.0,1782,1896
2012-09-07,Solomon Islands,Tahiti,2,0,2,1.0,0.0,1660,1677
2012-09-07,Spain,Saudi Arabia,5,0,5,1.0,0.0,2175,1828
2012-09-07,Uzbekistan,Kuwait,3,0,3,1.0,0.0,1768,1801
2012-09-07,Wales,Belgium,0,2,2,0.0,1.0,1745,1848
2012-09-08,Denmark,Czech Republic,0,0,0,0.5,0.5,1929,1913
2012-09-08,Scotland,Serbia,0,0,0,0.5,0.5,1835,1840
2012-09-08,Mali,Botswana,3,0,3,1.0,0.0,1756,1644
2012-09-08,Ghana,Malawi,2,0,2,1.0,0.0,1852,1642
2012-09-08,Liberia,Nigeria,2,2,0,0.5,0.5,1587,1858
2012-09-08,Zambia,Uganda,1,0,1,1.0,0.0,1779,1726
2012-09-08,Cape Verde,Cameroon,2,0,2,1.0,0.0,1643,1838
2012-09-08,Sierra Leone,Tunisia,2,2,0,0.5,0.5,1603,1826
2012-09-08,Sudan,Ethiopia,5,3,2,1.0,0.0,1661,1612
2012-09-08,Ivory Coast,Senegal,4,2,2,1.0,0.0,1948,1801
2012-09-08,Gabon,Togo,1,1,0,0.5,0.5,1741,1628
2012-09-08,Central African Republic,Burkina Faso,1,0,1,1.0,0.0,1500,1652
2012-09-08,Saint Barthélemy,Guadeloupe,1,8,7,0.0,1.0,1487,1682
2012-09-09,British Virgin Islands,Montserrat,0,7,7,0.0,1.0,1374,1384
2012-09-09,Haiti,Bermuda,3,1,2,1.0,0.0,1674,1531
2012-09-09,Martinique,Suriname,2,2,0,0.5,0.5,1665,1582
2012-09-09,Puerto Rico,Saint Martin,9,0,9,1.0,0.0,1454,1444
2012-09-09,Zimbabwe,Angola,3,1,2,1.0,0.0,1675,1725
2012-09-09,Mozambique,Morocco,2,0,2,1.0,0.0,1639,1785
2012-09-09,Guinea,Niger,1,0,1,1.0,0.0,1754,1560
2012-09-09,Libya,Algeria,0,1,1,0.0,1.0,1744,1766
2012-09-09,DR Congo,Equatorial Guinea,4,0,4,1.0,0.0,1702,1532
2012-09-10,Brazil,China PR,8,0,8,1.0,0.0,2125,1867
2012-09-10,Indonesia,North Korea,0,2,2,0.0,1.0,1637,1782
2012-09-10,Laos,Philippines,2,1,1,1.0,0.0,1403,1464
2012-09-11,Antigua and Barbuda,Guatemala,0,1,1,0.0,1.0,1576,1731
2012-09-11,Austria,Germany,1,2,1,0.0,1.0,1782,2072
2012-09-11,Belgium,Croatia,1,1,0,0.5,0.5,1851,1973
2012-09-11,Bosnia and Herzegovina,Latvia,4,1,3,1.0,0.0,1789,1645
2012-09-11,Bulgaria,Armenia,1,0,1,1.0,0.0,1811,1628
2012-09-11,Myanmar,Singapore,1,1,0,0.5,0.5,1532,1617
2012-09-11,Chile,Colombia,1,3,2,0.0,1.0,1951,1925
2012-09-11,Cyprus,Iceland,1,0,1,1.0,0.0,1662,1653
2012-09-11,Czech Republic,Finland,0,1,1,0.0,1.0,1902,1773
2012-09-11,England,Ukraine,1,1,0,0.5,0.5,2066,1889
2012-09-11,France,Belarus,3,1,2,1.0,0.0,2026,1716
2012-09-11,Gabon,Saudi Arabia,1,0,1,1.0,0.0,1751,1819
2012-09-11,Georgia,Spain,0,1,1,0.0,1.0,1657,2176
2012-09-11,Greece,Lithuania,2,0,2,1.0,0.0,1910,1648
2012-09-11,Guyana,El Salvador,2,3,1,0.0,1.0,1606,1726
2012-09-11,Haiti,Puerto Rico,2,1,1,1.0,0.0,1678,1451
2012-09-11,Honduras,Cuba,1,0,1,1.0,0.0,1814,1653
2012-09-11,Hungary,Netherlands,1,4,3,0.0,1.0,1801,2058
2012-09-11,Republic of Ireland,Oman,4,1,3,1.0,0.0,1919,1823
2012-09-11,Israel,Russia,0,4,4,0.0,1.0,1782,1929
2012-09-11,Italy,Malta,2,0,2,1.0,0.0,1992,1478
2012-09-11,Japan,Iraq,1,0,1,1.0,0.0,1978,1812
2012-09-11,Jordan,Australia,2,1,1,1.0,0.0,1791,1945
2012-09-11,Lebanon,Iran,1,0,1,1.0,0.0,1610,1904
2012-09-11,Liberia,Ghana,2,0,2,1.0,0.0,1601,1839
2012-09-11,Malaysia,Vietnam,0,2,2,0.0,1.0,1593,1649
2012-09-11,Mexico,Costa Rica,1,0,1,1.0,0.0,1990,1804
2012-09-11,New Zealand,Solomon Islands,6,1,5,1.0,0.0,1747,1654
2012-09-11,Northern Ireland,Luxembourg,1,1,0,0.5,0.5,1666,1422
2012-09-11,Norway,Slovenia,2,1,1,1.0,0.0,1881,1777
2012-09-11,Panama,Canada,2,0,2,1.0,0.0,1822,1771
2012-09-11,Paraguay,Venezuela,0,2,2,0.0,1.0,1892,1836
2012-09-11,Peru,Argentina,1,1,0,0.5,0.5,1834,2065
2012-09-11,Poland,Moldova,2,0,2,1.0,0.0,1879,1578
2012-09-11,Portugal,Azerbaijan,3,0,3,1.0,0.0,2000,1605
2012-09-11,Romania,Andorra,4,0,4,1.0,0.0,1863,1354
2012-09-11,San Marino,Montenegro,0,6,6,0.0,1.0,1337,1691
2012-09-11,Scotland,North Macedonia,1,1,0,0.5,0.5,1832,1697
2012-09-11,Serbia,Wales,6,1,5,1.0,0.0,1846,1740
2012-09-11,Slovakia,Liechtenstein,2,0,2,1.0,0.0,1793,1440
2012-09-11,South Africa,Mozambique,2,0,2,1.0,0.0,1834,1636
2012-09-11,Saint Martin,Bermuda,0,8,8,0.0,1.0,1438,1538
2012-09-11,Sweden,Kazakhstan,2,0,2,1.0,0.0,1959,1565
2012-09-11,Switzerland,Albania,2,0,2,1.0,0.0,1900,1671
2012-09-11,Tahiti,New Caledonia,0,4,4,0.0,1.0,1669,1667
2012-09-11,Turkey,Estonia,3,0,3,1.0,0.0,1896,1672
2012-09-11,United Arab Emirates,Kuwait,3,0,3,1.0,0.0,1745,1792
2012-09-11,Uruguay,Ecuador,1,1,0,0.5,0.5,1970,1896
2012-09-11,United States,Jamaica,1,0,1,1.0,0.0,1943,1828
2012-09-11,Uzbekistan,South Korea,2,2,0,0.5,0.5,1773,1962
2012-09-12,Thailand,Laos,2,1,1,1.0,0.0,1744,1401
2012-09-16,French Guiana,Haiti,1,2,1,0.0,1.0,1493,1683
2012-09-19,Brazil,Argentina,2,1,1,1.0,0.0,2132,2059
2012-09-20,Nepal,Bangladesh,1,1,0,0.5,0.5,1418,1433
2012-09-22,Guadeloupe,Saint Pierre and Miquelon,13,0,13,1.0,0.0,1686,1475
2012-09-22,Réunion,French Guiana,2,0,2,1.0,0.0,1614,1488
2012-09-22,Tahiti,Mayotte,1,3,2,0.0,1.0,1658,1496
2012-09-22,Martinique,New Caledonia,2,0,2,1.0,0.0,1674,1659
2012-09-23,Aruba,Dominican Republic,2,2,0,0.5,0.5,1419,1499
2012-09-23,Barbados,Dominica,1,0,1,1.0,0.0,1555,1412
2012-09-24,Réunion,Saint Pierre and Miquelon,10,0,10,1.0,0.0,1619,1471
2012-09-24,Guadeloupe,French Guiana,4,2,2,1.0,0.0,1690,1485
2012-09-24,New Caledonia,Mayotte,0,2,2,0.0,1.0,1648,1508
2012-09-24,Martinique,Tahiti,2,3,1,0.0,1.0,1666,1667
2012-09-25,Barbados,Dominican Republic,0,1,1,0.0,1.0,1546,1509
2012-09-25,Dominica,Aruba,3,2,1,1.0,0.0,1421,1411
2012-09-25,Philippines,Guam,1,0,1,1.0,0.0,1471,1378
2012-09-25,Abkhazia,Artsakh,1,1,0,0.5,0.5,1500,1500
2012-09-26,Réunion,Guadeloupe,2,1,1,1.0,0.0,1629,1681
2012-09-26,French Guiana,Saint Pierre and Miquelon,11,1,10,1.0,0.0,1493,1464
2012-09-26,New Caledonia,Tahiti,0,1,1,0.0,1.0,1641,1675
2012-09-26,Martinique,Mayotte,3,0,3,1.0,0.0,1671,1504
2012-09-27,Barbados,Aruba,2,1,1,1.0,0.0,1552,1406
2012-09-27,Dominican Republic,Dominica,2,1,1,1.0,0.0,1516,1415
2012-09-27,Philippines,Macau,5,0,5,1.0,0.0,1476,1308
2012-09-28,Oman,Yemen,2,1,1,1.0,0.0,1827,1584
2012-09-28,Saint Pierre and Miquelon,New Caledonia,1,16,15,0.0,1.0,1460,1646
2012-09-28,French Guiana,Tahiti,2,1,1,1.0,0.0,1505,1664
2012-09-29,Macau,Guam,0,3,3,0.0,1.0,1302,1385
2012-09-29,Philippines,Taiwan,3,1,2,1.0,0.0,1483,1409
2012-09-29,Guadeloupe,Mayotte,1,0,1,1.0,0.0,1686,1500
2012-09-29,Réunion,Martinique,2,2,0,0.5,0.5,1630,1671
2012-10-05,Myanmar,Brunei,1,0,1,1.0,0.0,1536,1282
2012-10-05,Cambodia,Timor-Leste,1,5,4,0.0,1.0,1331,1355
2012-10-07,Myanmar,Timor-Leste,2,1,1,1.0,0.0,1541,1351
2012-10-07,Laos,Cambodia,1,0,1,1.0,0.0,1408,1325
2012-10-09,Cambodia,Brunei,2,3,1,0.0,1.0,1317,1291
2012-10-09,Timor-Leste,Laos,3,1,2,1.0,0.0,1361,1399
2012-10-10,French Guiana,Trinidad and Tobago,1,4,3,0.0,1.0,1502,1732
2012-10-11,Brazil,Iraq,6,0,6,1.0,0.0,2135,1810
2012-10-11,Brunei,Laos,1,3,2,0.0,1.0,1286,1405
2012-10-11,Myanmar,Cambodia,3,0,3,1.0,0.0,1545,1314
2012-10-11,Kuwait,Syria,1,1,0,0.5,0.5,1791,1724
2012-10-12,Albania,Iceland,1,2,1,0.0,1.0,1663,1662
2012-10-12,Antigua and Barbuda,United States,1,2,1,0.0,1.0,1575,1945
2012-10-12,Argentina,Uruguay,3,0,3,1.0,0.0,2065,1965
2012-10-12,Armenia,Italy,1,3,2,0.0,1.0,1627,1994
2012-10-12,Bahrain,Philippines,0,0,0,0.5,0.5,1740,1489
2012-10-12,Belarus,Spain,0,4,4,0.0,1.0,1715,2178
2012-10-12,Bolivia,Peru,1,1,0,0.5,0.5,1722,1832
2012-10-12,Bulgaria,Denmark,1,1,0,0.5,0.5,1814,1927
2012-10-12,Canada,Cuba,3,0,3,1.0,0.0,1777,1648
2012-10-12,Colombia,Paraguay,2,0,2,1.0,0.0,1933,1885
2012-10-12,Czech Republic,Malta,3,1,2,1.0,0.0,1904,1477
2012-10-12,Ecuador,Chile,3,1,2,1.0,0.0,1906,1942
2012-10-12,Egypt,Congo,3,0,3,1.0,0.0,1917,1636
2012-10-12,El Salvador,Costa Rica,0,1,1,0.0,1.0,1720,1811
2012-10-12,England,San Marino,5,0,5,1.0,0.0,2067,1337
2012-10-12,Estonia,Hungary,0,1,1,0.0,1.0,1667,1807
2012-10-12,Faroe Islands,Sweden,1,2,1,0.0,1.0,1459,1960
2012-10-12,Finland,Georgia,1,1,0,0.5,0.5,1771,1660
2012-10-12,France,Japan,0,1,1,0.0,1.0,2017,1988
2012-10-12,French Guiana,Anguilla,4,1,3,1.0,0.0,1507,1322
2012-10-12,Greece,Bosnia and Herzegovina,0,0,0,0.5,0.5,1908,1792
2012-10-12,Guatemala,Jamaica,2,1,1,1.0,0.0,1742,1818
2012-10-12,Guyana,Mexico,0,5,5,0.0,1.0,1605,1992
2012-10-12,Republic of Ireland,Germany,1,6,5,0.0,1.0,1915,2077
2012-10-12,Kazakhstan,Austria,0,0,0,0.5,0.5,1570,1778
2012-10-12,Lesotho,Eswatini,2,1,1,1.0,0.0,1484,1466
2012-10-12,Liechtenstein,Lithuania,0,2,2,0.0,1.0,1437,1652
2012-10-12,Luxembourg,Israel,0,6,6,0.0,1.0,1421,1784
2012-10-12,North Macedonia,Croatia,1,2,1,0.0,1.0,1695,1976
2012-10-12,Moldova,Ukraine,0,0,0,0.5,0.5,1584,1884
2012-10-12,Netherlands,Andorra,3,0,3,1.0,0.0,2059,1354
2012-10-12,Panama,Honduras,0,0,0,0.5,0.5,1822,1815
2012-10-12,Poland,South Africa,1,0,1,1.0,0.0,1886,1828
2012-10-12,Russia,Portugal,1,0,1,1.0,0.0,1939,1991
2012-10-12,Serbia,Belgium,0,3,3,0.0,1.0,1839,1859
2012-10-12,Slovakia,Latvia,2,1,1,1.0,0.0,1798,1641
2012-10-12,Slovenia,Cyprus,2,1,1,1.0,0.0,1783,1657
2012-10-12,Solomon Islands,New Caledonia,2,6,4,0.0,1.0,1646,1655
2012-10-12,Switzerland,Norway,1,1,0,0.5,0.5,1900,1882
2012-10-12,Tahiti,New Zealand,0,2,2,0.0,1.0,1658,1754
2012-10-12,Turkey,Romania,0,1,1,0.0,1.0,1888,1872
2012-10-12,United Arab Emirates,Uzbekistan,2,2,0,0.5,0.5,1746,1773
2012-10-12,Wales,Scotland,2,1,1,1.0,0.0,1751,1822
2012-10-13,Brunei,Timor-Leste,2,1,1,1.0,0.0,1296,1352
2012-10-13,Myanmar,Laos,0,0,0,0.5,0.5,1542,1409
2012-10-13,Namibia,Rwanda,0,0,0,0.5,0.5,1575,1617
2012-10-13,Botswana,Mali,1,4,3,0.0,1.0,1639,1762
2012-10-13,Malawi,Ghana,0,1,1,0.0,1.0,1639,1843
2012-10-13,Nigeria,Liberia,6,1,5,1.0,0.0,1861,1599
2012-10-13,Uganda,Zambia,1,0,1,1.0,0.0,1736,1770
2012-10-13,Morocco,Mozambique,4,0,4,1.0,0.0,1790,1632
2012-10-13,Tunisia,Sierra Leone,0,0,0,0.5,0.5,1822,1608
2012-10-13,Senegal,Ivory Coast,0,2,2,0.0,1.0,1797,1953
2012-10-14,Lesotho,Eswatini,0,1,1,0.0,1.0,1476,1475
2012-10-14,Saudi Arabia,Congo,3,2,1,1.0,0.0,1824,1632
2012-10-14,Saint Kitts and Nevis,French Guiana,0,3,3,0.0,1.0,1565,1517
2012-10-14,Trinidad and Tobago,Anguilla,10,0,10,1.0,0.0,1734,1321
2012-10-14,Angola,Zimbabwe,2,0,2,1.0,0.0,1732,1669
2012-10-14,Cameroon,Cape Verde,2,1,1,1.0,0.0,1842,1640
2012-10-14,Niger,Guinea,2,0,2,1.0,0.0,1573,1742
2012-10-14,Ethiopia,Sudan,2,0,2,1.0,0.0,1622,1652
2012-10-14,Algeria,Libya,2,0,2,1.0,0.0,1774,1737
2012-10-14,Equatorial Guinea,DR Congo,2,1,1,1.0,0.0,1544,1691
2012-10-14,Togo,Gabon,2,1,1,1.0,0.0,1639,1741
2012-10-14,Burkina Faso,Central African Republic,3,1,2,1.0,0.0,1657,1496
2012-10-16,Albania,Slovenia,1,0,1,1.0,0.0,1674,1773
2012-10-16,Andorra,Estonia,0,1,1,0.0,1.0,1352,1670
2012-10-16,Austria,Kazakhstan,4,0,4,1.0,0.0,1782,1567
2012-10-16,Belarus,Georgia,2,0,2,1.0,0.0,1722,1654
2012-10-16,Belgium,Scotland,2,0,2,1.0,0.0,1867,1815
2012-10-16,Bolivia,Uruguay,4,1,3,1.0,0.0,1735,1953
2012-10-16,Bosnia and Herzegovina,Lithuania,3,0,3,1.0,0.0,1797,1648
2012-10-16,Chile,Argentina,1,2,1,0.0,1.0,1937,2071
2012-10-16,Colombia,Cameroon,3,0,3,1.0,0.0,1939,1837
2012-10-16,Costa Rica,Guyana,7,0,7,1.0,0.0,1815,1602
2012-10-16,Croatia,Wales,2,0,2,1.0,0.0,1980,1748
2012-10-16,Cuba,Panama,1,1,0,0.5,0.5,1652,1819
2012-10-16,Cyprus,Norway,1,3,2,0.0,1.0,1654,1886
2012-10-16,Czech Republic,Bulgaria,0,0,0,0.5,0.5,1902,1817
2012-10-16,Egypt,Tunisia,0,1,1,0.0,1.0,1907,1833
2012-10-16,Faroe Islands,Republic of Ireland,1,4,3,0.0,1.0,1458,1917
2012-10-16,Germany,Sweden,4,4,0,0.5,0.5,2075,1963
2012-10-16,Honduras,Canada,8,1,7,1.0,0.0,1823,1770
2012-10-16,Hong Kong,Malaysia,0,3,3,0.0,1.0,1560,1601
2012-10-16,Hungary,Turkey,3,1,2,1.0,0.0,1817,1879
2012-10-16,Iceland,Switzerland,0,2,2,0.0,1.0,1659,1904
2012-10-16,Iran,South Korea,1,0,1,1.0,0.0,1914,1953
2012-10-16,Iraq,Australia,1,2,1,0.0,1.0,1805,1951
2012-10-16,Israel,Luxembourg,3,0,3,1.0,0.0,1786,1420
2012-10-16,Italy,Denmark,3,1,2,1.0,0.0,2001,1921
2012-10-16,Jamaica,Antigua and Barbuda,4,1,3,1.0,0.0,1822,1572
2012-10-16,Japan,Brazil,0,4,4,0.0,1.0,1984,2140
2012-10-16,Kenya,South Africa,1,2,1,0.0,1.0,1592,1832
2012-10-16,Kuwait,Philippines,2,1,1,1.0,0.0,1794,1487
2012-10-16,Latvia,Liechtenstein,2,0,2,1.0,0.0,1645,1434
2012-10-16,Lebanon,Yemen,2,1,1,1.0,0.0,1618,1577
2012-10-16,North Macedonia,Serbia,1,0,1,1.0,0.0,1707,1828
2012-10-16,Mexico,El Salvador,2,0,2,1.0,0.0,1995,1718
2012-10-16,New Caledonia,Solomon Islands,5,0,5,1.0,0.0,1663,1639
2012-10-16,New Zealand,Tahiti,3,0,3,1.0,0.0,1760,1653
2012-10-16,Oman,Jordan,2,1,1,1.0,0.0,1835,1784
2012-10-16,Paraguay,Peru,1,0,1,1.0,0.0,1892,1826
2012-10-16,Portugal,Northern Ireland,1,1,0,0.5,0.5,1986,1672
2012-10-16,Qatar,Uzbekistan,0,1,1,0.0,1.0,1746,1781
2012-10-16,Romania,Netherlands,1,4,3,0.0,1.0,1868,2064
2012-10-16,Russia,Azerbaijan,1,0,1,1.0,0.0,1942,1603
2012-10-16,San Marino,Moldova,0,2,2,0.0,1.0,1334,1588
2012-10-16,Singapore,India,2,0,2,1.0,0.0,1625,1579
2012-10-16,Slovakia,Greece,0,1,1,0.0,1.0,1793,1914
2012-10-16,Spain,France,1,1,0,0.5,0.5,2175,2021
2012-10-16,Ukraine,Montenegro,0,1,1,0.0,1.0,1872,1704
2012-10-16,United Arab Emirates,Bahrain,6,2,4,1.0,0.0,1754,1733
2012-10-16,United States,Guatemala,3,1,2,1.0,0.0,1949,1739
2012-10-16,Venezuela,Ecuador,1,1,0,0.5,0.5,1838,1905
2012-10-16,Vietnam,Indonesia,0,0,0,0.5,0.5,1649,1638
2012-10-17,Poland,England,1,1,0,0.5,0.5,1890,2064
2012-10-21,Saint Lucia,Curaçao,5,1,4,1.0,0.0,1454,1473
2012-10-21,Artsakh,Abkhazia,3,0,3,1.0,0.0,1508,1492
2012-10-23,Curaçao,Guyana,1,2,1,0.0,1.0,1468,1608
2012-10-23,Guadeloupe,Dominican Republic,0,2,2,0.0,1.0,1675,1528
2012-10-23,Martinique,Puerto Rico,2,1,1,1.0,0.0,1675,1448
2012-10-24,Vietnam,Turkmenistan,0,1,1,0.0,1.0,1640,1615
2012-10-25,Dominican Republic,Martinique,1,1,0,0.5,0.5,1532,1672
2012-10-25,Guadeloupe,Puerto Rico,4,1,3,1.0,0.0,1679,1445
2012-10-25,Saint Vincent and the Grenadines,Curaçao,4,0,4,1.0,0.0,1567,1463
2012-10-26,Vietnam,Laos,4,0,4,1.0,0.0,1644,1406
2012-10-27,Guadeloupe,Martinique,3,3,0,0.5,0.5,1679,1673
2012-10-27,Puerto Rico,Dominican Republic,1,3,2,0.0,1.0,1439,1539
2012-10-28,Laos,Turkmenistan,2,4,2,0.0,1.0,1403,1619
2012-11-03,Vietnam,Malaysia,1,0,1,1.0,0.0,1652,1594
2012-11-06,Iran,Tajikistan,6,1,5,1.0,0.0,1917,1596
2012-11-07,Thailand,Malaysia,2,0,2,1.0,0.0,1749,1590
2012-11-08,Bahrain,Jordan,3,0,3,1.0,0.0,1743,1775
2012-11-08,Oman,Estonia,1,2,1,0.0,1.0,1824,1682
2012-11-11,Eswatini,Lesotho,0,0,0,0.5,0.5,1476,1476
2012-11-14,Albania,Cameroon,0,0,0,0.5,0.5,1678,1834
2012-11-14,Algeria,Bosnia and Herzegovina,0,1,1,0.0,1.0,1767,1805
2012-11-14,Andorra,Iceland,0,2,2,0.0,1.0,1350,1662
2012-11-14,Angola,Congo,1,1,0,0.5,0.5,1730,1635
2012-11-14,Armenia,Lithuania,4,2,2,1.0,0.0,1636,1640
2012-11-14,Austria,Ivory Coast,0,3,3,0.0,1.0,1778,1958
2012-11-14,Bolivia,Costa Rica,1,1,0,0.5,0.5,1737,1814
2012-11-14,Brazil,Colombia,1,1,0,0.5,0.5,2136,1944
2012-11-14,Bulgaria,Ukraine,0,1,1,0.0,1.0,1811,1879
2012-11-14,Cape Verde,Ghana,0,1,1,0.0,1.0,1637,1847
2012-11-14,China PR,New Zealand,1,1,0,0.5,0.5,1865,1763
2012-11-14,DR Congo,Burkina Faso,0,1,1,0.0,1.0,1683,1666
2012-11-14,Cuba,Suriname,5,0,5,1.0,0.0,1659,1576
2012-11-14,Cyprus,Finland,0,3,3,0.0,1.0,1649,1777
2012-11-14,Czech Republic,Slovakia,3,0,3,1.0,0.0,1908,1788
2012-11-14,Gabon,Portugal,2,2,0,0.5,0.5,1746,1982
2012-11-14,Georgia,Egypt,0,0,0,0.5,0.5,1659,1903
2012-11-14,Grenada,French Guiana,1,1,0,0.5,0.5,1544,1518
2012-11-14,Haiti,Guyana,1,0,1,1.0,0.0,1690,1602
2012-11-14,Honduras,Peru,0,0,0,0.5,0.5,1824,1826
2012-11-14,Hungary,Norway,0,2,2,0.0,1.0,1811,1893
2012-11-14,Indonesia,Timor-Leste,1,0,1,1.0,0.0,1641,1350
2012-11-14,Iran,Uzbekistan,0,1,1,0.0,1.0,1907,1792
2012-11-14,Iraq,Jordan,1,0,1,1.0,0.0,1813,1768
2012-11-14,Republic of Ireland,Greece,0,1,1,0.0,1.0,1909,1923
2012-11-14,Israel,Belarus,1,2,1,0.0,1.0,1777,1732
2012-11-14,Italy,France,1,2,1,0.0,1.0,1994,2029
2012-11-14,South Korea,Australia,1,2,1,0.0,1.0,1945,1960
2012-11-14,Kuwait,Bahrain,1,1,0,0.5,0.5,1793,1745
2012-11-14,Liechtenstein,Malta,0,1,1,0.0,1.0,1427,1485
2012-11-14,Luxembourg,Scotland,1,2,1,0.0,1.0,1419,1817
2012-11-14,North Macedonia,Slovenia,3,2,1,1.0,0.0,1717,1764
2012-11-14,Malaysia,Hong Kong,1,1,0,0.5,0.5,1590,1561
2012-11-14,Montenegro,San Marino,3,0,3,1.0,0.0,1706,1333
2012-11-14,Morocco,Togo,0,1,1,0.0,1.0,1779,1651
2012-11-14,Netherlands,Germany,0,0,0,0.5,0.5,2065,2075
2012-11-14,Niger,Senegal,1,1,0,0.5,0.5,1578,1793
2012-11-14,Northern Ireland,Azerbaijan,1,1,0,0.5,0.5,1671,1605
2012-11-14,Oman,Japan,1,2,1,0.0,1.0,1820,1989
2012-11-14,Panama,Spain,1,5,4,0.0,1.0,1818,2177
2012-11-14,Paraguay,Guatemala,3,1,2,1.0,0.0,1897,1735
2012-11-14,Poland,Uruguay,1,3,2,0.0,1.0,1884,1960
2012-11-14,Qatar,Lebanon,1,0,1,1.0,0.0,1752,1613
2012-11-14,Romania,Belgium,2,1,1,1.0,0.0,1876,1860
2012-11-14,Russia,United States,2,2,0,0.5,0.5,1943,1949
2012-11-14,Rwanda,Namibia,2,2,0,0.5,0.5,1617,1576
2012-11-14,Saudi Arabia,Argentina,0,0,0,0.5,0.5,1829,2067
2012-11-14,Serbia,Chile,3,1,2,1.0,0.0,1839,1927
2012-11-14,South Africa,Zambia,0,1,1,0.0,1.0,1823,1780
2012-11-14,Sweden,England,4,2,2,1.0,0.0,1974,2054
2012-11-14,Tanzania,Kenya,1,0,1,1.0,0.0,1613,1585
2012-11-14,Thailand,Bhutan,5,0,5,1.0,0.0,1750,1274
2012-11-14,Tunisia,Switzerland,1,2,1,0.0,1.0,1827,1911
2012-11-14,Turkey,Denmark,1,1,0,0.5,0.5,1880,1921
2012-11-14,United Arab Emirates,Estonia,2,1,1,1.0,0.0,1761,1676
2012-11-14,Venezuela,Nigeria,1,3,2,0.0,1.0,1831,1869
2012-11-15,Philippines,Singapore,1,0,1,1.0,0.0,1499,1614
2012-11-16,French Guiana,Haiti,1,0,1,1.0,0.0,1530,1679
2012-11-16,Trinidad and Tobago,Suriname,3,0,3,1.0,0.0,1739,1572
2012-11-17,Indonesia,Cameroon,0,0,0,0.5,0.5,1646,1830
2012-11-17,Palestine,Syria,1,1,0,0.5,0.5,1560,1721
2012-11-17,Thailand,Bangladesh,5,0,5,1.0,0.0,1753,1431
2012-11-18,Guyana,French Guiana,4,3,1,1.0,0.0,1609,1524
2012-11-19,Singapore,Pakistan,4,0,4,1.0,0.0,1618,1365
2012-11-20,Malaysia,Bangladesh,1,1,0,0.5,0.5,1587,1435
2012-11-20,Palestine,Syria,2,1,1,1.0,0.0,1572,1710
2012-11-21,Argentina,Brazil,2,1,1,1.0,0.0,2077,2127
2012-11-24,Ethiopia,South Sudan,1,0,1,1.0,0.0,1628,1500
2012-11-24,Guam,Northern Mariana Islands,8,0,8,1.0,0.0,1394,1404
2012-11-24,Thailand,Philippines,2,1,1,1.0,0.0,1757,1496
2012-11-24,Uganda,Kenya,1,0,1,1.0,0.0,1741,1581
2012-11-24,Vietnam,Myanmar,1,1,0,0.5,0.5,1650,1545
2012-11-25,Burundi,Somalia,5,1,4,1.0,0.0,1556,1341
2012-11-25,Indonesia,Laos,2,2,0,0.5,0.5,1642,1408
2012-11-25,Malaysia,Singapore,0,3,3,0.0,1.0,1580,1626
2012-11-25,Tanzania,Sudan,2,0,2,1.0,0.0,1622,1644
2012-11-26,Rwanda,Malawi,2,0,2,1.0,0.0,1626,1631
2012-11-26,Zanzibar,Eritrea,0,0,0,0.5,0.5,1536,1484
2012-11-27,South Sudan,Kenya,0,2,2,0.0,1.0,1494,1588
2012-11-27,Thailand,Myanmar,4,0,4,1.0,0.0,1761,1542
2012-11-27,Uganda,Ethiopia,1,0,1,1.0,0.0,1747,1623
2012-11-27,Vietnam,Philippines,0,1,1,0.0,1.0,1639,1508
2012-11-28,Indonesia,Singapore,1,0,1,1.0,0.0,1650,1619
2012-11-28,Malaysia,Laos,4,1,3,1.0,0.0,1585,1404
2012-11-28,Somalia,Sudan,0,1,1,0.0,1.0,1339,1647
2012-11-28,Tanzania,Burundi,0,1,1,0.0,1.0,1613,1566
2012-11-29,Malawi,Eritrea,3,2,1,1.0,0.0,1636,1480
2012-11-29,Palestine,Bahrain,0,2,2,0.0,1.0,1568,1750
2012-11-29,Rwanda,Zanzibar,1,2,1,0.0,1.0,1616,1547
2012-11-30,Kenya,Ethiopia,3,1,2,1.0,0.0,1597,1615
2012-11-30,Philippines,Myanmar,2,0,2,1.0,0.0,1517,1534
2012-11-30,Thailand,Vietnam,3,1,2,1.0,0.0,1767,1634
2012-11-30,Uganda,South Sudan,4,0,4,1.0,0.0,1751,1491
2012-12-01,Eritrea,Rwanda,0,2,2,0.0,1.0,1475,1622
2012-12-01,Hong Kong,Guam,2,1,1,1.0,0.0,1566,1390
2012-12-01,Malawi,Zanzibar,2,0,2,1.0,0.0,1642,1542
2012-12-01,Malaysia,Indonesia,2,0,2,1.0,0.0,1595,1641
2012-12-01,Singapore,Laos,4,3,1,1.0,0.0,1623,1401
2012-12-01,Somalia,Tanzania,0,7,7,0.0,1.0,1337,1616
2012-12-01,Sudan,Burundi,0,1,1,0.0,1.0,1638,1576
2012-12-03,Burundi,Zanzibar,0,0,0,0.5,0.5,1576,1543
2012-12-03,Hong Kong,Australia,0,1,1,0.0,1.0,1565,1962
2012-12-03,North Korea,Guam,5,0,5,1.0,0.0,1784,1389
2012-12-03,Rwanda,Tanzania,0,2,2,0.0,1.0,1614,1625
2012-12-04,Kenya,Malawi,1,0,1,1.0,0.0,1607,1633
2012-12-04,Uganda,Ethiopia,2,0,2,1.0,0.0,1757,1610
2012-12-05,North Korea,Australia,1,1,0,0.5,0.5,1788,1959
2012-12-06,Uganda,Tanzania,3,0,3,1.0,0.0,1763,1620
2012-12-06,Zanzibar,Kenya,2,2,0,0.5,0.5,1545,1606
2012-12-07,Antigua and Barbuda,Dominican Republic,1,2,1,0.0,1.0,1564,1548
2012-12-07,Guam,Australia,0,9,9,0.0,1.0,1389,1960
2012-12-07,Haiti,Trinidad and Tobago,0,0,0,0.5,0.5,1681,1738
2012-12-07,Hong Kong,Taiwan,2,0,2,1.0,0.0,1570,1405
2012-12-08,Jamaica,French Guiana,1,2,1,0.0,1.0,1809,1538
2012-12-08,Kuwait,Palestine,2,1,1,1.0,0.0,1797,1565
2012-12-08,Martinique,Cuba,1,0,1,1.0,0.0,1681,1652
2012-12-08,Oman,Lebanon,0,1,1,0.0,1.0,1808,1626
2012-12-08,Philippines,Singapore,0,0,0,0.5,0.5,1520,1621
2012-12-08,Tanzania,Zanzibar,1,1,0,0.5,0.5,1619,1547
2012-12-08,Uganda,Kenya,2,1,1,1.0,0.0,1768,1602
2012-12-09,Antigua and Barbuda,Trinidad and Tobago,2,0,2,1.0,0.0,1576,1727
2012-12-09,Australia,Taiwan,8,0,8,1.0,0.0,1961,1405
2012-12-09,Bahrain,Yemen,1,0,1,1.0,0.0,1755,1573
2012-12-09,Dominican Republic,Haiti,1,2,1,0.0,1.0,1543,1687
2012-12-09,Hong Kong,North Korea,0,4,4,0.0,1.0,1567,1792
2012-12-09,Iran,Saudi Arabia,0,0,0,0.5,0.5,1906,1831
2012-12-09,Malaysia,Thailand,1,1,0,0.5,0.5,1599,1764
2012-12-10,Cuba,French Guiana,2,1,1,1.0,0.0,1658,1533
2012-12-10,Iraq,Jordan,1,0,1,1.0,0.0,1820,1762
2012-12-10,Jamaica,Martinique,0,0,0,0.5,0.5,1807,1684
2012-12-11,Antigua and Barbuda,Haiti,0,1,1,0.0,1.0,1571,1693
2012-12-11,Kuwait,Oman,0,2,2,0.0,1.0,1790,1816
2012-12-11,Lebanon,Palestine,0,1,1,0.0,1.0,1617,1575
2012-12-11,Trinidad and Tobago,Dominican Republic,2,1,1,1.0,0.0,1732,1539
2012-12-12,French Guiana,Martinique,1,3,2,0.0,1.0,1529,1689
2012-12-12,Iran,Bahrain,0,0,0,0.5,0.5,1903,1759
2012-12-12,Jamaica,Cuba,0,1,1,0.0,1.0,1796,1670
2012-12-12,Singapore,Philippines,1,0,1,1.0,0.0,1627,1515
2012-12-12,Yemen,Saudi Arabia,0,1,1,0.0,1.0,1571,1834
2012-12-13,Iraq,Syria,1,1,0,0.5,0.5,1818,1713
2012-12-13,Thailand,Malaysia,2,0,2,1.0,0.0,1769,1595
2012-12-14,Haiti,Cuba,0,1,1,0.0,1.0,1685,1679
2012-12-14,Kuwait,Lebanon,2,1,1,1.0,0.0,1795,1613
2012-12-14,North Macedonia,Poland,1,4,3,0.0,1.0,1713,1889
2012-12-14,Martinique,Trinidad and Tobago,1,1,0,0.5,0.5,1690,1732
2012-12-14,Oman,Palestine,2,1,1,1.0,0.0,1820,1572
2012-12-15,Angola,Gambia,1,1,0,0.5,0.5,1727,1581
2012-12-15,Bahrain,Saudi Arabia,1,0,1,1.0,0.0,1769,1825
2012-12-15,Iran,Yemen,2,1,1,1.0,0.0,1906,1569
2012-12-16,Cuba,Trinidad and Tobago,1,0,1,1.0,0.0,1689,1723
2012-12-16,Haiti,Martinique,1,0,1,1.0,0.0,1694,1682
2012-12-16,Syria,Jordan,2,1,1,1.0,0.0,1723,1753
2012-12-18,Bahrain,Syria,1,1,0,0.5,0.5,1768,1725
2012-12-18,Oman,Iraq,0,2,2,0.0,1.0,1812,1827
2012-12-19,Oman,Benin,2,0,2,1.0,0.0,1816,1601
2012-12-19,Singapore,Thailand,3,1,2,1.0,0.0,1639,1758
2012-12-20,Iraq,Syria,0,1,1,0.0,1.0,1817,1736
2012-12-20,Oman,Bahrain,1,0,1,1.0,0.0,1823,1762
2012-12-22,Angola,Rwanda,1,0,1,1.0,0.0,1733,1609
2012-12-22,South Africa,Malawi,3,1,2,1.0,0.0,1828,1629
2012-12-22,Tanzania,Zambia,1,0,1,1.0,0.0,1631,1769
2012-12-22,Thailand,Singapore,1,0,1,1.0,0.0,1764,1634
2012-12-25,United Arab Emirates,Yemen,2,0,2,1.0,0.0,1765,1566
2012-12-26,Bahrain,Burkina Faso,0,0,0,0.5,0.5,1760,1669
2012-12-28,Qatar,Egypt,0,2,2,0.0,1.0,1748,1908
2012-12-29,Bahrain,Guinea,3,0,3,1.0,0.0,1768,1735
2012-12-29,Oman,Togo,0,1,1,0.0,1.0,1812,1663
2012-12-29,United Arab Emirates,Yemen,3,1,2,1.0,0.0,1769,1563
2012-12-29,Basque Country,Bolivia,6,1,5,1.0,0.0,1743,1729
2012-12-30,Ethiopia,Niger,1,0,1,1.0,0.0,1618,1571
2012-12-30,Iraq,Tunisia,1,2,1,0.0,1.0,1810,1835
2013-01-02,Catalonia,Nigeria,1,1,0,0.5,0.5,1659,1865
2013-01-05,Bahrain,Oman,0,0,0,0.5,0.5,1770,1811
2013-01-05,Niger,Togo,3,1,2,1.0,0.0,1582,1653
2013-01-05,Qatar,United Arab Emirates,1,3,2,0.0,1.0,1741,1777
2013-01-05,Zambia,Angola,0,2,2,0.0,1.0,1761,1742
2013-01-06,Kuwait,Yemen,2,0,2,1.0,0.0,1799,1560
2013-01-06,Saudi Arabia,Iraq,0,2,2,0.0,1.0,1817,1819
2013-01-07,Tunisia,Ethiopia,1,1,0,0.5,0.5,1831,1623
2013-01-08,Bahrain,United Arab Emirates,1,2,1,0.0,1.0,1763,1785
2013-01-08,Qatar,Oman,2,1,1,1.0,0.0,1751,1802
2013-01-08,South Africa,Norway,0,1,1,0.0,1.0,1822,1900
2013-01-08,Zambia,Morocco,0,0,0,0.5,0.5,1762,1779
2013-01-09,Cape Verde,Nigeria,0,0,0,0.5,0.5,1642,1861
2013-01-09,Iraq,Kuwait,1,0,1,1.0,0.0,1827,1792
2013-01-09,Yemen,Saudi Arabia,0,2,2,0.0,1.0,1558,1820
2013-01-10,Gabon,Tunisia,1,1,0,0.5,0.5,1748,1830
2013-01-10,Ghana,Egypt,3,0,3,1.0,0.0,1857,1899
2013-01-10,Panama,Guatemala,3,0,3,1.0,0.0,1825,1729
2013-01-11,Bahrain,Qatar,1,0,1,1.0,0.0,1771,1744
2013-01-11,Ethiopia,Tanzania,2,1,1,1.0,0.0,1632,1623
2013-01-11,United Arab Emirates,Oman,2,0,2,1.0,0.0,1794,1794
2013-01-12,Iraq,Yemen,2,0,2,1.0,0.0,1830,1556
2013-01-12,Kuwait,Saudi Arabia,1,0,1,1.0,0.0,1801,1812
2013-01-12,Namibia,Morocco,1,2,1,0.0,1.0,1573,1783
2013-01-12,South Africa,Algeria,0,0,0,0.5,0.5,1821,1769
2013-01-12,Zambia,Norway,0,0,0,0.5,0.5,1766,1897
2013-01-13,Angola,Botswana,2,0,2,1.0,0.0,1748,1634
2013-01-13,Ghana,Tunisia,4,2,2,1.0,0.0,1865,1823
2013-01-13,Panama,Guatemala,2,0,2,1.0,0.0,1831,1724
2013-01-13,Togo,Niger,2,1,1,1.0,0.0,1660,1576
2013-01-14,Ivory Coast,Egypt,4,2,2,1.0,0.0,1965,1893
2013-01-15,Bahrain,Iraq,1,1,0,0.5,0.5,1773,1829
2013-01-15,Lebanon,Gabon,0,0,0,0.5,0.5,1616,1746
2013-01-15,United Arab Emirates,Kuwait,1,0,1,1.0,0.0,1803,1793
2013-01-17,Eswatini,Burkina Faso,0,3,3,0.0,1.0,1473,1673
2013-01-18,Bahrain,Kuwait,1,6,5,0.0,1.0,1766,1801
2013-01-18,Costa Rica,Belize,1,0,1,1.0,0.0,1817,1479
2013-01-18,Guatemala,Nicaragua,1,1,0,0.5,0.5,1719,1412
2013-01-18,Honduras,El Salvador,1,1,0,0.5,0.5,1822,1721
2013-01-18,United Arab Emirates,Iraq,2,1,1,1.0,0.0,1812,1821
2013-01-19,Angola,Morocco,0,0,0,0.5,0.5,1749,1783
2013-01-19,Chile,Haiti,3,0,3,1.0,0.0,1931,1691
2013-01-19,South Africa,Cape Verde,0,0,0,0.5,0.5,1818,1646
2013-01-20,Belize,Guatemala,0,0,0,0.5,0.5,1484,1715
2013-01-20,Costa Rica,Nicaragua,2,0,2,1.0,0.0,1819,1411
2013-01-20,El Salvador,Panama,0,0,0,0.5,0.5,1724,1829
2013-01-20,Ghana,DR Congo,2,2,0,0.5,0.5,1862,1687
2013-01-20,Mali,Niger,1,0,1,1.0,0.0,1767,1572
2013-01-21,Nigeria,Burkina Faso,1,1,0,0.5,0.5,1858,1677
2013-01-21,Zambia,Ethiopia,1,1,0,0.5,0.5,1764,1635
2013-01-22,Costa Rica,Guatemala,1,1,0,0.5,0.5,1817,1718
2013-01-22,Ivory Coast,Togo,2,1,1,1.0,0.0,1968,1658
2013-01-22,Nicaragua,Belize,1,2,1,0.0,1.0,1405,1491
2013-01-22,Panama,Honduras,1,1,0,0.5,0.5,1829,1823
2013-01-22,Tunisia,Algeria,1,0,1,1.0,0.0,1830,1763
2013-01-23,Morocco,Cape Verde,1,1,0,0.5,0.5,1780,1650
2013-01-23,South Africa,Angola,2,0,2,1.0,0.0,1825,1743
2013-01-23,Sweden,North Korea,1,1,0,0.5,0.5,1971,1796
2013-01-23,Thailand,Finland,1,3,2,0.0,1.0,1757,1785
2013-01-24,Ghana,Mali,1,0,1,1.0,0.0,1868,1762
2013-01-24,Niger,DR Congo,0,0,0,0.5,0.5,1575,1685
2013-01-25,Burkina Faso,Ethiopia,4,0,4,1.0,0.0,1685,1628
2013-01-25,Costa Rica,El Salvador,1,0,1,1.0,0.0,1823,1719
2013-01-25,Guatemala,Panama,1,3,2,0.0,1.0,1713,1835
2013-01-25,Honduras,Belize,1,0,1,1.0,0.0,1826,1489
2013-01-25,Zambia,Nigeria,1,1,0,0.5,0.5,1767,1856
2013-01-26,Algeria,Togo,0,2,2,0.0,1.0,1753,1669
2013-01-26,Ivory Coast,Tunisia,3,0,3,1.0,0.0,1973,1826
2013-01-26,Sweden,Finland,3,0,3,1.0,0.0,1976,1781
2013-01-26,Thailand,North Korea,2,2,0,0.5,0.5,1758,1796
2013-01-27,Cape Verde,Angola,2,1,1,1.0,0.0,1661,1733
2013-01-27,Costa Rica,Honduras,1,0,1,1.0,0.0,1832,1818
2013-01-27,El Salvador,Belize,1,0,1,1.0,0.0,1723,1486
2013-01-27,South Africa,Morocco,2,2,0,0.5,0.5,1824,1782
2013-01-28,DR Congo,Mali,1,1,0,0.5,0.5,1687,1761
2013-01-28,Niger,Ghana,0,3,3,0.0,1.0,1573,1871
2013-01-29,Burkina Faso,Zambia,0,0,0,0.5,0.5,1687,1766
2013-01-29,Ethiopia,Nigeria,0,2,2,0.0,1.0,1625,1860
2013-01-29,United States,Canada,0,0,0,0.5,0.5,1946,1774
2013-01-30,Algeria,Ivory Coast,2,2,0,0.5,0.5,1758,1969
2013-01-30,Oman,China PR,1,0,1,1.0,0.0,1804,1856
2013-01-30,Togo,Tunisia,1,1,0,0.5,0.5,1673,1823
2013-01-31,Jordan,Indonesia,5,0,5,1.0,0.0,1759,1636
2013-01-31,Qatar,Lebanon,1,0,1,1.0,0.0,1750,1611
2013-02-01,Uzbekistan,Azerbaijan,0,0,0,0.5,0.5,1789,1609
2013-02-02,Ghana,Cape Verde,2,0,2,1.0,0.0,1875,1658
2013-02-02,Romania,Poland,1,4,3,0.0,1.0,1869,1897
2013-02-02,South Africa,Mali,1,1,0,0.5,0.5,1823,1763
2013-02-03,Burkina Faso,Togo,1,0,1,1.0,0.0,1695,1666
2013-02-03,Ivory Coast,Nigeria,1,2,1,0.0,1.0,1959,1871
2013-02-05,Armenia,Luxembourg,1,1,0,0.5,0.5,1632,1424
2013-02-06,Albania,Georgia,1,2,1,0.0,1.0,1670,1668
2013-02-06,Azerbaijan,Liechtenstein,1,0,1,1.0,0.0,1614,1423
2013-02-06,Belgium,Slovakia,2,1,1,1.0,0.0,1867,1782
2013-02-06,Burkina Faso,Ghana,1,1,0,0.5,0.5,1699,1872
2013-02-06,Myanmar,Philippines,0,1,1,0.0,1.0,1526,1524
2013-02-06,Chile,Egypt,2,1,1,1.0,0.0,1939,1886
2013-02-06,Croatia,South Korea,4,0,4,1.0,0.0,1988,1938
2013-02-06,Cyprus,Serbia,1,3,2,0.0,1.0,1645,1844
2013-02-06,England,Brazil,2,1,1,1.0,0.0,2064,2118
2013-02-06,France,Germany,1,2,1,0.0,1.0,2023,2082
2013-02-06,Greece,Switzerland,0,0,0,0.5,0.5,1923,1912
2013-02-06,Honduras,United States,2,1,1,1.0,0.0,1829,1936
2013-02-06,Hungary,Belarus,1,1,0,0.5,0.5,1810,1734
2013-02-06,Iceland,Russia,0,2,2,0.0,1.0,1660,1946
2013-02-06,India,Palestine,2,4,2,0.0,1.0,1571,1581
2013-02-06,Iran,Lebanon,5,0,5,1.0,0.0,1909,1609
2013-02-06,Iraq,Indonesia,1,0,1,1.0,0.0,1826,1632
2013-02-06,Republic of Ireland,Poland,2,0,2,1.0,0.0,1917,1890
2013-02-06,Israel,Finland,2,1,1,1.0,0.0,1786,1773
2013-02-06,Japan,Latvia,3,0,3,1.0,0.0,1991,1644
2013-02-06,Jordan,Singapore,4,0,4,1.0,0.0,1765,1629
2013-02-06,Kenya,Libya,3,0,3,1.0,0.0,1613,1727
2013-02-06,North Korea,Laos,1,0,1,1.0,0.0,1798,1400
2013-02-06,North Macedonia,Denmark,3,0,3,1.0,0.0,1726,1909
2013-02-06,Mali,Nigeria,1,4,3,0.0,1.0,1758,1877
2013-02-06,Malta,Northern Ireland,0,0,0,0.5,0.5,1489,1668
2013-02-06,Mexico,Jamaica,0,0,0,0.5,0.5,1991,1801
2013-02-06,Moldova,Kazakhstan,1,3,2,0.0,1.0,1580,1576
2013-02-06,Nepal,Pakistan,0,1,1,0.0,1.0,1409,1375
2013-02-06,Netherlands,Italy,1,1,0,0.5,0.5,2064,1996
2013-02-06,Norway,Ukraine,0,2,2,0.0,1.0,1889,1888
2013-02-06,Oman,Syria,1,0,1,1.0,0.0,1811,1730
2013-02-06,Panama,Costa Rica,2,2,0,0.5,0.5,1835,1833
2013-02-06,Portugal,Ecuador,2,3,1,0.0,1.0,1973,1915
2013-02-06,Qatar,Malaysia,2,0,2,1.0,0.0,1755,1591
2013-02-06,Romania,Australia,3,2,1,1.0,0.0,1880,1951
2013-02-06,Rwanda,Uganda,2,2,0,0.5,0.5,1613,1765
2013-02-06,Saudi Arabia,China PR,2,1,1,1.0,0.0,1822,1847
2013-02-06,Scotland,Estonia,1,0,1,1.0,0.0,1822,1672
2013-02-06,Slovenia,Bosnia and Herzegovina,0,3,3,0.0,1.0,1757,1813
2013-02-06,Spain,Uruguay,3,1,2,1.0,0.0,2181,1957
2013-02-06,Sweden,Argentina,2,3,1,0.0,1.0,1971,2083
2013-02-06,Tanzania,Cameroon,1,0,1,1.0,0.0,1636,1818
2013-02-06,Thailand,Kuwait,1,3,2,0.0,1.0,1751,1809
2013-02-06,Turkey,Czech Republic,0,2,2,0.0,1.0,1873,1916
2013-02-06,Uzbekistan,Hong Kong,0,0,0,0.5,0.5,1785,1572
2013-02-06,Vietnam,United Arab Emirates,1,2,1,0.0,1.0,1630,1817
2013-02-06,Wales,Austria,2,1,1,1.0,0.0,1757,1770
2013-02-06,Yemen,Bahrain,0,2,2,0.0,1.0,1553,1770
2013-02-06,Zimbabwe,Botswana,2,1,1,1.0,0.0,1677,1627
2013-02-06,Trinidad and Tobago,Peru,0,2,2,0.0,1.0,1718,1832
2013-02-09,Mali,Ghana,3,1,2,1.0,0.0,1769,1862
2013-02-09,Nepal,Pakistan,0,1,1,0.0,1.0,1401,1384
2013-02-10,Nigeria,Burkina Faso,1,0,1,1.0,0.0,1882,1695
2013-02-12,Maldives,Pakistan,1,1,0,0.5,0.5,1494,1387
2013-02-13,Provence,Monaco,6,1,5,1.0,0.0,1475,1481
2013-02-14,Maldives,Pakistan,3,0,3,1.0,0.0,1500,1382
2013-02-27,Gambia,Mauritania,0,2,2,0.0,1.0,1570,1448
2013-03-02,Afghanistan,Sri Lanka,1,0,1,1.0,0.0,1404,1382
2013-03-02,Myanmar,Guam,5,0,5,1.0,0.0,1531,1385
2013-03-02,Gambia,Mauritania,0,0,0,0.5,0.5,1568,1451
2013-03-02,India,Taiwan,2,1,1,1.0,0.0,1576,1401
2013-03-02,Laos,Mongolia,1,1,0,0.5,0.5,1401,1426
2013-03-02,Nepal,Northern Mariana Islands,6,0,6,1.0,0.0,1410,1396
2013-03-02,Palestine,Bangladesh,1,0,1,1.0,0.0,1586,1431
2013-03-04,Guam,India,0,4,4,0.0,1.0,1382,1580
2013-03-04,Laos,Sri Lanka,4,2,2,1.0,0.0,1409,1375
2013-03-04,Mongolia,Afghanistan,0,1,1,0.0,1.0,1418,1413
2013-03-04,Nepal,Bangladesh,0,2,2,0.0,1.0,1403,1439
2013-03-04,Northern Mariana Islands,Palestine,0,9,9,0.0,1.0,1392,1591
2013-03-06,Bangladesh,Northern Mariana Islands,4,0,4,1.0,0.0,1446,1386
2013-03-06,Myanmar,India,1,0,1,1.0,0.0,1541,1571
2013-03-06,Laos,Afghanistan,1,1,0,0.5,0.5,1410,1413
2013-03-06,Nepal,Palestine,0,0,0,0.5,0.5,1407,1588
2013-03-06,Sri Lanka,Mongolia,3,0,3,1.0,0.0,1384,1410
2013-03-07,Qatar,Egypt,3,1,2,1.0,0.0,1766,1876
2013-03-08,Sealand,Alderney,2,1,1,1.0,0.0,1494,1269
2013-03-16,Senegal,Libya,0,4,4,0.0,1.0,1784,1737
2013-03-16,Alderney,Jersey,2,9,7,0.0,1.0,1269,1745
2013-03-17,Bahrain,Lebanon,0,0,0,0.5,0.5,1767,1613
2013-03-17,Kyrgyzstan,Macau,1,0,1,1.0,0.0,1448,1298
2013-03-17,Malaysia,Saudi Arabia,1,4,3,0.0,1.0,1588,1826
2013-03-17,Qatar,Thailand,1,0,1,1.0,0.0,1774,1744
2013-03-17,Tajikistan,Pakistan,1,0,1,1.0,0.0,1600,1379
2013-03-19,Botswana,Malawi,1,0,1,1.0,0.0,1636,1621
2013-03-19,Kyrgyzstan,Pakistan,1,0,1,1.0,0.0,1455,1373
2013-03-19,Macau,Tajikistan,0,3,3,0.0,1.0,1296,1603
2013-03-20,Oman,Haiti,3,0,3,1.0,0.0,1817,1686
2013-03-20,Rwanda,Libya,0,1,1,0.0,1.0,1608,1743
2013-03-21,Ecuador,El Salvador,5,0,5,1.0,0.0,1919,1720
2013-03-21,Italy,Brazil,2,2,0,0.5,0.5,1999,2116
2013-03-21,Jordan,Belarus,1,0,1,1.0,0.0,1773,1727
2013-03-21,Kuwait,Palestine,2,1,1,1.0,0.0,1813,1585
2013-03-21,Kyrgyzstan,Tajikistan,1,0,1,1.0,0.0,1467,1592
2013-03-21,Pakistan,Macau,2,0,2,1.0,0.0,1380,1290
2013-03-22,Andorra,Turkey,0,2,2,0.0,1.0,1350,1874
2013-03-22,Argentina,Venezuela,3,0,3,1.0,0.0,2087,1828
2013-03-22,Austria,Faroe Islands,6,0,6,1.0,0.0,1773,1456
2013-03-22,Bahrain,Qatar,1,0,1,1.0,0.0,1776,1766
2013-03-22,Bosnia and Herzegovina,Greece,3,1,2,1.0,0.0,1824,1913
2013-03-22,Bulgaria,Malta,6,0,6,1.0,0.0,1814,1487
2013-03-22,China PR,Iraq,1,0,1,1.0,0.0,1855,1819
2013-03-22,Colombia,Bolivia,5,0,5,1.0,0.0,1948,1726
2013-03-22,Croatia,Serbia,2,0,2,1.0,0.0,1993,1840
2013-03-22,Czech Republic,Denmark,0,3,3,0.0,1.0,1908,1918
2013-03-22,Egypt,Eswatini,10,0,10,1.0,0.0,1878,1472
2013-03-22,France,Georgia,3,1,2,1.0,0.0,2025,1667
2013-03-22,Honduras,Mexico,2,2,0,0.5,0.5,1833,1988
2013-03-22,Hong Kong,Vietnam,1,0,1,1.0,0.0,1582,1621
2013-03-22,Hungary,Romania,2,2,0,0.5,0.5,1812,1879
2013-03-22,Israel,Portugal,3,3,0,0.5,0.5,1790,1970
2013-03-22,Jamaica,Panama,1,1,0,0.5,0.5,1802,1835
2013-03-22,Japan,Canada,2,1,1,1.0,0.0,1995,1771
2013-03-22,Kazakhstan,Germany,0,3,3,0.0,1.0,1576,2083
2013-03-22,Lebanon,Thailand,5,2,3,1.0,0.0,1624,1734
2013-03-22,Liechtenstein,Latvia,1,1,0,0.5,0.5,1428,1640
2013-03-22,Luxembourg,Azerbaijan,0,0,0,0.5,0.5,1428,1611
2013-03-22,North Macedonia,Belgium,0,2,2,0.0,1.0,1722,1872
2013-03-22,Malaysia,Yemen,2,1,1,1.0,0.0,1596,1546
2013-03-22,Moldova,Montenegro,0,1,1,0.0,1.0,1575,1712
2013-03-22,Netherlands,Estonia,3,0,3,1.0,0.0,2066,1671
2013-03-22,New Zealand,New Caledonia,2,1,1,1.0,0.0,1769,1658
2013-03-22,Norway,Albania,0,1,1,0.0,1.0,1877,1683
2013-03-22,Peru,Chile,1,0,1,1.0,0.0,1843,1929
2013-03-22,Poland,Ukraine,1,3,2,0.0,1.0,1882,1897
2013-03-22,San Marino,England,0,8,8,0.0,1.0,1333,2065
2013-03-22,Scotland,Wales,1,2,1,0.0,1.0,1813,1767
2013-03-22,Slovakia,Lithuania,1,1,0,0.5,0.5,1779,1644
2013-03-22,Slovenia,Iceland,1,2,1,0.0,1.0,1747,1671
2013-03-22,Spain,Finland,1,1,0,0.5,0.5,2175,1780
2013-03-22,Sweden,Republic of Ireland,0,0,0,0.5,0.5,1970,1919
2013-03-22,Tahiti,Solomon Islands,2,0,2,1.0,0.0,1661,1632
2013-03-22,Turkmenistan,Cambodia,7,0,7,1.0,0.0,1622,1312
2013-03-22,United Arab Emirates,Uzbekistan,2,1,1,1.0,0.0,1825,1778
2013-03-22,Uruguay,Paraguay,1,1,0,0.5,0.5,1956,1899
2013-03-22,United States,Costa Rica,1,0,1,1.0,0.0,1942,1828
2013-03-23,Belize,Trinidad and Tobago,0,0,0,0.5,0.5,1491,1714
2013-03-23,Burkina Faso,Niger,4,0,4,1.0,0.0,1701,1568
2013-03-23,Cameroon,Togo,2,1,1,1.0,0.0,1823,1662
2013-03-23,Congo,Gabon,1,0,1,1.0,0.0,1646,1736
2013-03-23,Cyprus,Switzerland,0,0,0,0.5,0.5,1651,1907
2013-03-23,Indonesia,Saudi Arabia,1,2,1,0.0,1.0,1629,1830
2013-03-23,Ivory Coast,Gambia,3,0,3,1.0,0.0,1961,1567
2013-03-23,Namibia,Malawi,0,1,1,0.0,1.0,1567,1628
2013-03-23,Nigeria,Kenya,1,1,0,0.5,0.5,1877,1619
2013-03-23,Senegal,Angola,1,1,0,0.5,0.5,1783,1735
2013-03-23,South Africa,Central African Republic,2,0,2,1.0,0.0,1826,1494
2013-03-23,Tunisia,Sierra Leone,2,1,1,1.0,0.0,1827,1605
2013-03-24,DR Congo,Libya,0,0,0,0.5,0.5,1689,1742
2013-03-24,Dominican Republic,Haiti,3,1,2,1.0,0.0,1551,1675
2013-03-24,Equatorial Guinea,Cape Verde,0,3,3,0.0,1.0,1539,1664
2013-03-24,Ethiopia,Botswana,1,0,1,1.0,0.0,1634,1628
2013-03-24,Ghana,Sudan,4,0,4,1.0,0.0,1866,1635
2013-03-24,Lesotho,Zambia,1,1,0,0.5,0.5,1482,1761
2013-03-24,Liberia,Uganda,2,0,2,1.0,0.0,1611,1754
2013-03-24,Mozambique,Guinea,0,0,0,0.5,0.5,1635,1733
2013-03-24,Philippines,Cambodia,8,0,8,1.0,0.0,1528,1309
2013-03-24,Rwanda,Mali,1,2,1,0.0,1.0,1604,1774
2013-03-24,Tanzania,Morocco,3,1,2,1.0,0.0,1648,1771
2013-03-25,Canada,Belarus,0,2,2,0.0,1.0,1762,1737
2013-03-25,Russia,Brazil,1,1,0,0.5,0.5,1950,2113
2013-03-26,Albania,Lithuania,4,1,3,1.0,0.0,1691,1637
2013-03-26,Algeria,Benin,3,1,2,1.0,0.0,1763,1597
2013-03-26,Armenia,Czech Republic,0,3,3,0.0,1.0,1630,1911
2013-03-26,Australia,Oman,2,2,0,0.5,0.5,1949,1820
2013-03-26,Azerbaijan,Portugal,0,2,2,0.0,1.0,1610,1972
2013-03-26,Belgium,North Macedonia,1,0,1,1.0,0.0,1877,1718
2013-03-26,Bolivia,Argentina,1,1,0,0.5,0.5,1733,2081
2013-03-26,Chile,Uruguay,2,0,2,1.0,0.0,1938,1948
2013-03-26,Costa Rica,Jamaica,2,0,2,1.0,0.0,1836,1795
2013-03-26,Denmark,Bulgaria,1,1,0,0.5,0.5,1916,1817
2013-03-26,Ecuador,Paraguay,4,1,3,1.0,0.0,1927,1892
2013-03-26,Egypt,Zimbabwe,2,1,1,1.0,0.0,1882,1674
2013-03-26,Estonia,Andorra,2,0,2,1.0,0.0,1674,1348
2013-03-26,France,Spain,0,1,1,0.0,1.0,2021,2180
2013-03-26,Germany,Kazakhstan,4,1,3,1.0,0.0,2084,1576
2013-03-26,Iraq,Syria,2,1,1,1.0,0.0,1825,1725
2013-03-26,Republic of Ireland,Austria,2,2,0,0.5,0.5,1916,1777
2013-03-26,Jordan,Japan,2,1,1,1.0,0.0,1786,1983
2013-03-26,South Korea,Qatar,2,1,1,1.0,0.0,1943,1762
2013-03-26,Kuwait,Iran,1,1,0,0.5,0.5,1816,1907
2013-03-26,Luxembourg,Finland,0,3,3,0.0,1.0,1427,1782
2013-03-26,Malaysia,Palestine,0,2,2,0.0,1.0,1588,1594
2013-03-26,Malta,Italy,0,2,2,0.0,1.0,1487,2000
2013-03-26,Mexico,United States,0,0,0,0.5,0.5,1987,1944
2013-03-26,Montenegro,England,1,1,0,0.5,0.5,1719,2059
2013-03-26,Netherlands,Romania,4,0,4,1.0,0.0,2071,1875
2013-03-26,New Caledonia,Tahiti,1,0,1,1.0,0.0,1667,1653
2013-03-26,Northern Ireland,Israel,0,2,2,0.0,1.0,1663,1796
2013-03-26,Panama,Honduras,2,0,2,1.0,0.0,1843,1826
2013-03-26,Peru,Trinidad and Tobago,3,0,3,1.0,0.0,1849,1709
2013-03-26,Philippines,Turkmenistan,1,0,1,1.0,0.0,1539,1612
2013-03-26,Poland,San Marino,5,0,5,1.0,0.0,1883,1333
2013-03-26,Serbia,Scotland,2,0,2,1.0,0.0,1848,1806
2013-03-26,Slovakia,Sweden,0,0,0,0.5,0.5,1784,1966
2013-03-26,Solomon Islands,New Zealand,0,2,2,0.0,1.0,1628,1774
2013-03-26,Turkey,Hungary,1,1,0,0.5,0.5,1873,1814
2013-03-26,Ukraine,Moldova,2,1,1,1.0,0.0,1900,1573
2013-03-26,Uzbekistan,Lebanon,1,0,1,1.0,0.0,1783,1620
2013-03-26,Venezuela,Colombia,1,0,1,1.0,0.0,1839,1938
2013-03-26,Wales,Croatia,1,2,1,0.0,1.0,1764,1997
2013-04-06,Bolivia,Brazil,0,4,4,0.0,1.0,1732,2115
2013-04-17,Mexico,Peru,0,0,0,0.5,0.5,1984,1853
2013-04-17,Qatar,Palestine,2,0,2,1.0,0.0,1767,1590
2013-04-21,Saint Vincent and the Grenadines,Saint Lucia,0,2,2,0.0,1.0,1557,1465
2013-04-24,Brazil,Chile,2,2,0,0.5,0.5,2112,1942
2013-04-28,Zambia,Zimbabwe,2,0,2,1.0,0.0,1768,1668
2013-05-13,Libya,Mauritania,2,0,2,1.0,0.0,1745,1449
2013-05-18,Guernsey,Jersey,2,1,1,1.0,0.0,1723,1737
2013-05-22,Oman,Iran,3,1,2,1.0,0.0,1830,1898
2013-05-22,Venezuela,El Salvador,2,1,1,1.0,0.0,1845,1715
2013-05-24,Qatar,Latvia,3,1,2,1.0,0.0,1773,1635
2013-05-25,Algeria,Mauritania,1,0,1,1.0,0.0,1766,1447
2013-05-25,Ethiopia,Sudan,2,0,2,1.0,0.0,1643,1627
2013-05-25,Malawi,Zimbabwe,1,1,0,0.5,0.5,1629,1668
2013-05-25,Namibia,Zambia,0,0,0,0.5,0.5,1572,1764
2013-05-27,Iraq,Liberia,0,1,1,0.0,1.0,1813,1624
2013-05-27,Jordan,Libya,1,0,1,1.0,0.0,1794,1738
2013-05-28,Canada,Costa Rica,0,1,1,0.0,1.0,1756,1843
2013-05-28,Turkey,Latvia,3,3,0,0.5,0.5,1869,1640
2013-05-28,Brittany,Mali,1,0,1,1.0,0.0,1539,1762
2013-05-29,Ecuador,Germany,2,4,2,0.0,1.0,1923,2089
2013-05-29,England,Republic of Ireland,1,1,0,0.5,0.5,2056,1920
2013-05-29,Oman,Lebanon,1,1,0,0.5,0.5,1826,1625
2013-05-29,Qatar,Azerbaijan,1,1,0,0.5,0.5,1770,1614
2013-05-29,United States,Belgium,2,4,2,0.0,1.0,1935,1887
2013-05-30,Japan,Bulgaria,0,2,2,0.0,1.0,1972,1829
2013-05-31,Italy,San Marino,4,0,4,1.0,0.0,2001,1333
2013-05-31,Mexico,Nigeria,2,2,0,0.5,0.5,1982,1880
2013-05-31,Turkey,Slovenia,0,2,2,0.0,1.0,1859,1758
2013-06-01,Libya,Uganda,3,0,3,1.0,0.0,1747,1746
2013-06-01,Panama,Peru,1,2,1,0.0,1.0,1836,1861
2013-06-02,Algeria,Burkina Faso,2,0,2,1.0,0.0,1773,1695
2013-06-02,Brazil,England,2,2,0,0.5,0.5,2111,2058
2013-06-02,Honduras,Israel,0,2,2,0.0,1.0,1818,1805
2013-06-02,Republic of Ireland,Georgia,4,0,4,1.0,0.0,1924,1664
2013-06-02,Lesotho,South Africa,0,2,2,0.0,1.0,1481,1828
2013-06-02,Sudan,Tanzania,0,0,0,0.5,0.5,1628,1648
2013-06-02,Ukraine,Cameroon,0,0,0,0.5,0.5,1899,1825
2013-06-02,United States,Germany,4,3,1,1.0,0.0,1947,2078
2013-06-03,Estonia,Belarus,0,2,2,0.0,1.0,1668,1744
2013-06-03,Sweden,North Macedonia,1,0,1,1.0,0.0,1970,1715
2013-06-04,Myanmar,Singapore,0,2,2,0.0,1.0,1535,1636
2013-06-04,Egypt,Botswana,1,1,0,0.5,0.5,1878,1633
2013-06-04,Hong Kong,Philippines,0,1,1,0.0,1.0,1574,1548
2013-06-04,Jamaica,Mexico,0,1,1,0.0,1.0,1791,1987
2013-06-04,Japan,Australia,1,1,0,0.5,0.5,1972,1950
2013-06-04,Kazakhstan,Bulgaria,1,2,1,0.0,1.0,1573,1833
2013-06-04,Lebanon,South Korea,1,1,0,0.5,0.5,1631,1938
2013-06-04,Oman,Iraq,1,0,1,1.0,0.0,1834,1806
2013-06-04,Poland,Liechtenstein,2,0,2,1.0,0.0,1885,1427
2013-06-04,Qatar,Iran,0,1,1,0.0,1.0,1765,1904
2013-06-04,Romania,Trinidad and Tobago,4,0,4,1.0,0.0,1880,1705
2013-06-04,Tajikistan,Afghanistan,3,2,1,1.0,0.0,1597,1409
2013-06-05,Denmark,Georgia,2,1,1,1.0,0.0,1920,1661
2013-06-05,Kenya,Nigeria,0,1,1,0.0,1.0,1617,1883
2013-06-05,Malawi,Namibia,0,0,0,0.5,0.5,1628,1574
2013-06-05,Uruguay,France,1,0,1,1.0,0.0,1958,2012
2013-06-06,China PR,Uzbekistan,1,2,1,0.0,1.0,1846,1793
2013-06-06,Hungary,Kuwait,1,0,1,1.0,0.0,1823,1808
2013-06-07,Albania,Norway,1,1,0,0.5,0.5,1695,1874
2013-06-07,Argentina,Colombia,0,0,0,0.5,0.5,2078,1942
2013-06-07,Armenia,Malta,0,1,1,0.0,1.0,1619,1499
2013-06-07,Austria,Sweden,2,1,1,1.0,0.0,1790,1958
2013-06-07,Azerbaijan,Luxembourg,1,1,0,0.5,0.5,1611,1431
2013-06-07,Belgium,Serbia,2,1,1,1.0,0.0,1895,1841
2013-06-07,Bolivia,Venezuela,1,1,0,0.5,0.5,1735,1843
2013-06-07,Costa Rica,Honduras,1,0,1,1.0,0.0,1851,1811
2013-06-07,Croatia,Scotland,0,1,1,0.0,1.0,1985,1819
2013-06-07,Czech Republic,Italy,0,0,0,0.5,0.5,1914,1999
2013-06-07,Estonia,Trinidad and Tobago,1,0,1,1.0,0.0,1677,1697
2013-06-07,Finland,Belarus,1,0,1,1.0,0.0,1790,1737
2013-06-07,Iceland,Slovenia,2,4,2,0.0,1.0,1665,1765
2013-06-07,Indonesia,Netherlands,0,3,3,0.0,1.0,1628,2073
2013-06-07,Republic of Ireland,Faroe Islands,3,0,3,1.0,0.0,1926,1455
2013-06-07,Jamaica,United States,1,2,1,0.0,1.0,1787,1952
2013-06-07,Laos,Singapore,2,5,3,0.0,1.0,1407,1640
2013-06-07,Latvia,Bosnia and Herzegovina,0,5,5,0.0,1.0,1636,1829
2013-06-07,Libya,DR Congo,0,0,0,0.5,0.5,1746,1691
2013-06-07,Liechtenstein,Slovakia,1,1,0,0.5,0.5,1434,1778
2013-06-07,Lithuania,Greece,0,1,1,0.0,1.0,1635,1916
2013-06-07,Moldova,Poland,1,1,0,0.5,0.5,1579,1880
2013-06-07,Montenegro,Ukraine,0,4,4,0.0,1.0,1715,1904
2013-06-07,Panama,Mexico,0,0,0,0.5,0.5,1840,1984
2013-06-07,Paraguay,Chile,1,2,1,0.0,1.0,1886,1949
2013-06-07,Peru,Ecuador,1,0,1,1.0,0.0,1871,1914
2013-06-07,Portugal,Russia,1,0,1,1.0,0.0,1980,1943
2013-06-07,Sudan,Ghana,1,3,2,0.0,1.0,1625,1870
2013-06-07,Madrid,Andalusia,1,2,1,0.0,1.0,1495,1597
2013-06-08,Angola,Senegal,1,1,0,0.5,0.5,1737,1782
2013-06-08,Botswana,Ethiopia,3,0,3,1.0,0.0,1642,1635
2013-06-08,Cape Verde,Equatorial Guinea,3,0,3,1.0,0.0,1670,1534
2013-06-08,Central African Republic,South Africa,0,3,3,0.0,1.0,1492,1831
2013-06-08,Gabon,Congo,0,0,0,0.5,0.5,1734,1649
2013-06-08,Gambia,Ivory Coast,0,3,3,0.0,1.0,1566,1963
2013-06-08,Haiti,Spain,1,2,1,0.0,1.0,1675,2181
2013-06-08,Morocco,Tanzania,2,1,1,1.0,0.0,1777,1643
2013-06-08,Sierra Leone,Tunisia,2,2,0,0.5,0.5,1610,1823
2013-06-08,Switzerland,Cyprus,1,0,1,1.0,0.0,1910,1649
2013-06-08,Uganda,Liberia,1,0,1,1.0,0.0,1752,1619
2013-06-08,Zambia,Lesotho,4,0,4,1.0,0.0,1767,1479
2013-06-09,Benin,Algeria,1,3,2,0.0,1.0,1593,1778
2013-06-09,Brazil,France,3,0,3,1.0,0.0,2117,2007
2013-06-09,Guinea,Mozambique,6,1,5,1.0,0.0,1739,1630
2013-06-09,Mali,Rwanda,1,1,0,0.5,0.5,1759,1608
2013-06-09,Niger,Burkina Faso,0,1,1,0.0,1.0,1563,1701
2013-06-09,Togo,Cameroon,0,3,3,0.0,1.0,1658,1830
2013-06-09,Zimbabwe,Egypt,2,4,2,0.0,1.0,1665,1882
2013-06-10,Croatia,Portugal,0,1,1,0.0,1.0,1977,1989
2013-06-11,Australia,Jordan,4,0,4,1.0,0.0,1955,1790
2013-06-11,Belarus,Finland,1,1,0,0.5,0.5,1739,1789
2013-06-11,Chile,Bolivia,3,1,2,1.0,0.0,1953,1732
2013-06-11,China PR,Netherlands,0,2,2,0.0,1.0,1843,2077
2013-06-11,Colombia,Peru,2,0,2,1.0,0.0,1949,1865
2013-06-11,Denmark,Armenia,0,4,4,0.0,1.0,1907,1633
2013-06-11,Ecuador,Argentina,1,1,0,0.5,0.5,1918,2075
2013-06-11,Estonia,Kyrgyzstan,1,1,0,0.5,0.5,1673,1472
2013-06-11,Guatemala,Belize,0,0,0,0.5,0.5,1709,1496
2013-06-11,Honduras,Jamaica,2,0,2,1.0,0.0,1819,1780
2013-06-11,Iran,Lebanon,4,0,4,1.0,0.0,1907,1629
2013-06-11,Iraq,Japan,0,1,1,0.0,1.0,1802,1977
2013-06-11,Italy,Haiti,2,2,0,0.5,0.5,1994,1681
2013-06-11,South Korea,Uzbekistan,1,0,1,1.0,0.0,1943,1789
2013-06-11,Mexico,Costa Rica,0,0,0,0.5,0.5,1982,1854
2013-06-11,Norway,North Macedonia,2,0,2,1.0,0.0,1879,1711
2013-06-11,Qatar,North Korea,0,0,0,0.5,0.5,1766,1798
2013-06-11,Spain,Republic of Ireland,2,0,2,1.0,0.0,2184,1924
2013-06-11,Sweden,Faroe Islands,2,0,2,1.0,0.0,1959,1455
2013-06-11,United States,Panama,2,0,2,1.0,0.0,1958,1835
2013-06-11,Venezuela,Uruguay,0,1,1,0.0,1.0,1838,1964
2013-06-12,Ghana,Ivory Coast,2,1,1,1.0,0.0,1881,1953
2013-06-12,Malawi,Kenya,2,2,0,0.5,0.5,1628,1618
2013-06-12,Namibia,Nigeria,1,1,0,0.5,0.5,1580,1878
2013-06-14,Ghana,Ivory Coast,1,1,0,0.5,0.5,1883,1952
2013-06-14,Guatemala,Argentina,0,4,4,0.0,1.0,1708,2077
2013-06-14,Libya,Togo,2,0,2,1.0,0.0,1753,1652
2013-06-14,Moldova,Kyrgyzstan,2,1,1,1.0,0.0,1585,1467
2013-06-15,Botswana,Central African Republic,3,2,1,1.0,0.0,1647,1488
2013-06-15,Brazil,Japan,3,0,3,1.0,0.0,2122,1973
2013-06-15,Cape Verde,Sierra Leone,1,0,1,1.0,0.0,1677,1604
2013-06-15,China PR,Thailand,1,5,4,0.0,1.0,1833,1745
2013-06-15,Congo,Burkina Faso,0,1,1,0.0,1.0,1643,1708
2013-06-15,Gabon,Niger,4,1,3,1.0,0.0,1739,1559
2013-06-15,Morocco,Gambia,2,0,2,1.0,0.0,1781,1563
2013-06-15,Uganda,Angola,2,1,1,1.0,0.0,1760,1730
2013-06-15,Zambia,Sudan,1,1,0,0.5,0.5,1764,1629
2013-06-16,DR Congo,Cameroon,0,0,0,0.5,0.5,1695,1827
2013-06-16,Equatorial Guinea,Tunisia,1,1,0,0.5,0.5,1540,1818
2013-06-16,Ethiopia,South Africa,2,1,1,1.0,0.0,1648,1819
2013-06-16,Guinea,Zimbabwe,1,0,1,1.0,0.0,1746,1659
2013-06-16,Lesotho,Ghana,0,2,2,0.0,1.0,1478,1885
2013-06-16,Liberia,Senegal,0,2,2,0.0,1.0,1615,1787
2013-06-16,Mali,Benin,2,2,0,0.5,0.5,1756,1597
2013-06-16,Mexico,Italy,1,2,1,0.0,1.0,1975,2002
2013-06-16,Mozambique,Egypt,0,1,1,0.0,1.0,1627,1886
2013-06-16,Rwanda,Algeria,0,1,1,0.0,1.0,1604,1783
2013-06-16,Spain,Uruguay,2,1,1,1.0,0.0,2188,1961
2013-06-16,Tanzania,Ivory Coast,2,4,2,0.0,1.0,1641,1955
2013-06-17,Tahiti,Nigeria,1,6,5,0.0,1.0,1650,1882
2013-06-18,Australia,Iraq,1,0,1,1.0,0.0,1960,1798
2013-06-18,Costa Rica,Panama,2,0,2,1.0,0.0,1862,1828
2013-06-18,Jordan,Oman,1,0,1,1.0,0.0,1800,1825
2013-06-18,South Korea,Iran,0,1,1,0.0,1.0,1935,1916
2013-06-18,United States,Honduras,1,0,1,1.0,0.0,1963,1815
2013-06-18,Uzbekistan,Qatar,5,1,4,1.0,0.0,1797,1759
2013-06-19,Brazil,Mexico,2,0,2,1.0,0.0,2127,1971
2013-06-19,Italy,Japan,4,3,1,1.0,0.0,2010,1966
2013-06-20,Nigeria,Uruguay,1,2,1,0.0,1.0,1876,1968
2013-06-20,Spain,Tahiti,10,0,10,1.0,0.0,2189,1650
2013-06-22,Brazil,Italy,4,2,2,1.0,0.0,2133,2005
2013-06-22,Japan,Mexico,1,2,1,0.0,1.0,1959,1979
2013-06-22,Monaco,Vatican City,2,0,2,1.0,0.0,1490,1478
2013-06-23,Nigeria,Spain,0,3,3,0.0,1.0,1874,2192
2013-06-23,Uruguay,Tahiti,8,0,8,1.0,0.0,1971,1648
2013-06-26,Brazil,Uruguay,2,1,1,1.0,0.0,2138,1967
2013-06-27,Spain,Italy,0,0,0,0.5,0.5,2189,2009
2013-06-29,Libya,Burkina Faso,2,1,1,1.0,0.0,1760,1702
2013-06-29,Saugeais,Raetia,1,1,0,0.5,0.5,1500,1481
2013-06-30,Brazil,Spain,3,0,3,1.0,0.0,2148,2180
2013-06-30,Uruguay,Italy,2,2,0,0.5,0.5,1968,2009
2013-07-04,Sealand,Tamil Eelam,3,5,2,0.0,1.0,1486,1496
2013-07-05,Sealand,Occitania,0,8,8,0.0,1.0,1480,1554
2013-07-06,Namibia,Mauritius,2,1,1,1.0,0.0,1586,1451
2013-07-06,Raetia,Alderney,3,2,1,1.0,0.0,1485,1266
2013-07-06,Tamil Eelam,Occitania,0,5,5,0.0,1.0,1490,1561
2013-07-07,Botswana,Eswatini,0,0,0,0.5,0.5,1644,1476
2013-07-07,Canada,Martinique,0,1,1,0.0,1.0,1747,1692
2013-07-07,Mexico,Panama,1,2,1,0.0,1.0,1968,1840
2013-07-07,Raetia,Tamil Eelam,0,5,5,0.0,1.0,1478,1498
2013-07-07,Sealand,Alderney,2,2,0,0.5,0.5,1476,1271
2013-07-08,El Salvador,Trinidad and Tobago,2,2,0,0.5,0.5,1715,1698
2013-07-08,Haiti,Honduras,0,2,2,0.0,1.0,1676,1821
2013-07-08,Kenya,Lesotho,2,2,0,0.5,0.5,1615,1482
2013-07-08,Namibia,Seychelles,4,2,2,1.0,0.0,1591,1427
2013-07-09,Costa Rica,Cuba,3,0,3,1.0,0.0,1867,1685
2013-07-09,Kenya,Eswatini,2,0,2,1.0,0.0,1620,1472
2013-07-09,Lesotho,Botswana,3,3,0,0.5,0.5,1486,1641
2013-07-09,United States,Belize,6,1,5,1.0,0.0,1965,1495
2013-07-10,Mauritius,Seychelles,4,0,4,1.0,0.0,1459,1420
2013-07-11,Kenya,Botswana,1,2,1,0.0,1.0,1613,1649
2013-07-11,Lesotho,Eswatini,2,0,2,1.0,0.0,1494,1465
2013-07-11,Mexico,Canada,2,0,2,1.0,0.0,1972,1744
2013-07-11,Panama,Martinique,1,0,1,1.0,0.0,1845,1688
2013-07-12,Honduras,El Salvador,1,0,1,1.0,0.0,1827,1710
2013-07-12,Trinidad and Tobago,Haiti,0,2,2,0.0,1.0,1690,1685
2013-07-13,Costa Rica,Belize,1,0,1,1.0,0.0,1869,1494
2013-07-13,South Africa,Namibia,2,1,1,1.0,0.0,1823,1588
2013-07-13,United States,Cuba,4,1,3,1.0,0.0,1968,1683
2013-07-13,Zimbabwe,Malawi,1,1,0,0.5,0.5,1659,1629
2013-07-14,Martinique,Mexico,1,3,2,0.0,1.0,1686,1975
2013-07-14,Panama,Canada,0,0,0,0.5,0.5,1843,1747
2013-07-14,Zambia,Mozambique,3,1,2,1.0,0.0,1769,1623
2013-07-14,Angola,Lesotho,1,1,0,0.5,0.5,1726,1499
2013-07-14,Bermuda,Greenland,3,0,3,1.0,0.0,1545,1446
2013-07-14,Frøya,Falkland Islands,1,2,1,0.0,1.0,1456,1443
2013-07-15,El Salvador,Haiti,1,0,1,1.0,0.0,1718,1678
2013-07-15,Honduras,Trinidad and Tobago,0,2,2,0.0,1.0,1816,1702
2013-07-15,Bermuda,Falkland Islands,8,0,8,1.0,0.0,1551,1438
2013-07-15,Greenland,Frøya,12,0,12,1.0,0.0,1455,1448
2013-07-16,Cuba,Belize,4,0,4,1.0,0.0,1688,1490
2013-07-16,Namibia,Mozambique,0,1,1,0.0,1.0,1581,1631
2013-07-16,Malawi,Angola,2,3,1,0.0,1.0,1624,1732
2013-07-16,United States,Costa Rica,1,0,1,1.0,0.0,1974,1864
2013-07-17,Zambia,South Africa,0,0,0,0.5,0.5,1771,1822
2013-07-17,Zimbabwe,Lesotho,2,1,1,1.0,0.0,1664,1495
2013-07-17,Falkland Islands,Greenland,0,9,9,0.0,1.0,1431,1463
2013-07-17,Bermuda,Frøya,8,0,8,1.0,0.0,1557,1443
2013-07-18,Falkland Islands,Frøya,6,0,6,1.0,0.0,1440,1435
2013-07-18,Bermuda,Greenland,1,0,1,1.0,0.0,1563,1458
2013-07-18,Angola,Mozambique,0,1,1,0.0,1.0,1722,1642
2013-07-20,South Korea,Australia,0,0,0,0.5,0.5,1936,1960
2013-07-20,Lesotho,South Africa,1,2,1,0.0,1.0,1493,1825
2013-07-20,Mexico,Trinidad and Tobago,1,0,1,1.0,0.0,1978,1700
2013-07-20,Panama,Cuba,6,1,5,1.0,0.0,1848,1684
2013-07-20,Zambia,Zimbabwe,2,0,2,1.0,0.0,1777,1659
2013-07-21,Honduras,Costa Rica,1,0,1,1.0,0.0,1826,1855
2013-07-21,Japan,China PR,3,3,0,0.5,0.5,1957,1836
2013-07-21,United States,El Salvador,5,1,4,1.0,0.0,1977,1716
2013-07-24,South Korea,China PR,0,0,0,0.5,0.5,1934,1839
2013-07-24,Panama,Mexico,2,1,1,1.0,0.0,1859,1968
2013-07-24,United States,Honduras,3,1,2,1.0,0.0,1982,1822
2013-07-25,Japan,Australia,3,2,1,1.0,0.0,1966,1952
2013-07-28,Australia,China PR,3,4,1,0.0,1.0,1942,1850
2013-07-28,South Korea,Japan,1,2,1,0.0,1.0,1927,1974
2013-07-28,United States,Panama,1,0,1,1.0,0.0,1988,1854
2013-08-09,Jordan,Libya,2,1,1,1.0,0.0,1808,1753
2013-08-14,Albania,Armenia,2,0,2,1.0,0.0,1702,1627
2013-08-14,Algeria,Guinea,2,2,0,0.5,0.5,1783,1747
2013-08-14,Austria,Greece,0,2,2,0.0,1.0,1785,1922
2013-08-14,Azerbaijan,Malta,3,0,3,1.0,0.0,1617,1494
2013-08-14,Belarus,Montenegro,1,1,0,0.5,0.5,1739,1716
2013-08-14,Belgium,France,0,0,0,0.5,0.5,1898,2005
2013-08-14,Bosnia and Herzegovina,United States,3,4,1,0.0,1.0,1825,1993
2013-08-14,Chile,Iraq,6,0,6,1.0,0.0,1958,1794
2013-08-14,Colombia,Serbia,1,0,1,1.0,0.0,1955,1836
2013-08-14,Dominican Republic,Costa Rica,0,4,4,0.0,1.0,1549,1858
2013-08-14,Ecuador,Spain,0,2,2,0.0,1.0,1916,2183
2013-08-14,Egypt,Uganda,3,0,3,1.0,0.0,1892,1755
2013-08-14,England,Scotland,3,2,1,1.0,0.0,2062,1816
2013-08-14,Estonia,Latvia,1,1,0,0.5,0.5,1673,1637
2013-08-14,Finland,Slovenia,2,0,2,1.0,0.0,1797,1758
2013-08-14,Gabon,Cape Verde,1,1,0,0.5,0.5,1738,1679
2013-08-14,Germany,Paraguay,3,3,0,0.5,0.5,2074,1891
2013-08-14,Hungary,Czech Republic,1,1,0,0.5,0.5,1826,1912
2013-08-14,Iceland,Faroe Islands,1,0,1,1.0,0.0,1669,1452
2013-08-14,Indonesia,Philippines,2,0,2,1.0,0.0,1635,1542
2013-08-14,Italy,Argentina,1,2,1,0.0,1.0,2003,2084
2013-08-14,Japan,Uruguay,2,4,2,0.0,1.0,1966,1977
2013-08-14,Kazakhstan,Georgia,1,0,1,1.0,0.0,1583,1652
2013-08-14,South Korea,Peru,0,0,0,0.5,0.5,1926,1867
2013-08-14,Libya,Central African Republic,0,0,0,0.5,0.5,1748,1494
2013-08-14,Liechtenstein,Croatia,2,3,1,0.0,1.0,1434,1978
2013-08-14,Luxembourg,Lithuania,2,1,1,1.0,0.0,1444,1623
2013-08-14,North Macedonia,Bulgaria,2,0,2,1.0,0.0,1722,1823
2013-08-14,Mexico,Ivory Coast,4,1,3,1.0,0.0,1976,1948
2013-08-14,Moldova,Andorra,1,1,0,0.5,0.5,1581,1353
2013-08-14,Morocco,Burkina Faso,1,2,1,0.0,1.0,1772,1712
2013-08-14,Northern Ireland,Russia,1,0,1,1.0,0.0,1677,1930
2013-08-14,Poland,Denmark,3,2,1,1.0,0.0,1889,1899
2013-08-14,Portugal,Netherlands,1,1,0,0.5,0.5,1991,2076
2013-08-14,Romania,Slovakia,1,1,0,0.5,0.5,1878,1781
2013-08-14,Rwanda,Malawi,0,1,1,0.0,1.0,1597,1632
2013-08-14,Singapore,Oman,0,2,2,0.0,1.0,1636,1830
2013-08-14,South Africa,Nigeria,0,2,2,0.0,1.0,1819,1881
2013-08-14,Sweden,Norway,4,2,2,1.0,0.0,1966,1873
2013-08-14,Switzerland,Brazil,1,0,1,1.0,0.0,1923,2136
2013-08-14,Tajikistan,India,3,0,3,1.0,0.0,1605,1564
2013-08-14,Tunisia,Congo,3,0,3,1.0,0.0,1823,1639
2013-08-14,Turkey,Ghana,2,2,0,0.5,0.5,1860,1885
2013-08-14,Ukraine,Israel,2,0,2,1.0,0.0,1910,1800
2013-08-14,Venezuela,Bolivia,2,2,0,0.5,0.5,1836,1735
2013-08-14,Wales,Republic of Ireland,0,0,0,0.5,0.5,1768,1921
2013-08-14,Zambia,Senegal,1,1,0,0.5,0.5,1778,1787
2013-08-15,Syria,Jordan,1,1,0,0.5,0.5,1727,1807
2013-08-17,South Africa,Burkina Faso,2,0,2,1.0,0.0,1825,1707
2013-08-20,Afghanistan,Pakistan,3,0,3,1.0,0.0,1417,1373
2013-08-27,Libya,Mali,1,0,1,1.0,0.0,1757,1748
2013-08-30,Botswana,Uganda,1,3,2,0.0,1.0,1644,1761
2013-08-30,Libya,Ghana,1,0,1,1.0,0.0,1768,1875
2013-08-31,Nepal,Bangladesh,2,0,2,1.0,0.0,1416,1438
2013-09-01,India,Pakistan,1,0,1,1.0,0.0,1568,1370
2013-09-02,Afghanistan,Bhutan,3,0,3,1.0,0.0,1422,1270
2013-09-02,Maldives,Sri Lanka,10,0,10,1.0,0.0,1506,1379
2013-09-03,Bangladesh,India,1,1,0,0.5,0.5,1441,1566
2013-09-03,Botswana,Malawi,1,0,1,1.0,0.0,1652,1625
2013-09-03,Nepal,Pakistan,1,1,0,0.5,0.5,1415,1372
2013-09-04,Bhutan,Maldives,2,8,6,0.0,1.0,1267,1510
2013-09-04,Equatorial Guinea,Libya,1,1,0,0.5,0.5,1545,1764
2013-09-04,Sri Lanka,Afghanistan,1,3,2,0.0,1.0,1372,1430
2013-09-05,Bangladesh,Pakistan,1,2,1,0.0,1.0,1432,1382
2013-09-05,Nepal,India,2,1,1,1.0,0.0,1427,1555
2013-09-05,Qatar,Mauritius,3,0,3,1.0,0.0,1762,1457
2013-09-05,Saudi Arabia,New Zealand,0,1,1,0.0,1.0,1821,1784
2013-09-05,United Arab Emirates,Trinidad and Tobago,3,3,0,0.5,0.5,1823,1703
2013-09-06,Afghanistan,Maldives,0,0,0,0.5,0.5,1432,1509
2013-09-06,Belarus,Kyrgyzstan,3,1,2,1.0,0.0,1742,1465
2013-09-06,Bosnia and Herzegovina,Slovakia,0,1,1,0.0,1.0,1816,1791
2013-09-06,Myanmar,Hong Kong,0,0,0,0.5,0.5,1536,1574
2013-09-06,Chile,Venezuela,3,0,3,1.0,0.0,1964,1831
2013-09-06,China PR,Singapore,6,1,5,1.0,0.0,1854,1633
2013-09-06,Colombia,Ecuador,1,0,1,1.0,0.0,1963,1909
2013-09-06,Costa Rica,United States,3,1,2,1.0,0.0,1869,1983
2013-09-06,Czech Republic,Armenia,1,2,1,0.0,1.0,1899,1641
2013-09-06,England,Moldova,4,0,4,1.0,0.0,2063,1581
2013-09-06,Estonia,Netherlands,2,2,0,0.5,0.5,1680,2070
2013-09-06,Finland,Spain,0,2,2,0.0,1.0,1796,2185
2013-09-06,Georgia,France,0,0,0,0.5,0.5,1659,1999
2013-09-06,Germany,Austria,3,0,3,1.0,0.0,2077,1783
2013-09-06,Ghana,Zambia,2,1,1,1.0,0.0,1881,1773
2013-09-06,Republic of Ireland,Sweden,1,2,1,0.0,1.0,1915,1973
2013-09-06,Italy,Bulgaria,1,0,1,1.0,0.0,2008,1819
2013-09-06,Japan,Guatemala,3,0,3,1.0,0.0,1969,1706
2013-09-06,Jordan,Uzbekistan,1,1,0,0.5,0.5,1807,1798
2013-09-06,Kazakhstan,Faroe Islands,2,1,1,1.0,0.0,1589,1447
2013-09-06,South Korea,Haiti,4,1,3,1.0,0.0,1930,1675
2013-09-06,Kuwait,North Korea,2,1,1,1.0,0.0,1816,1791
2013-09-06,Latvia,Lithuania,2,1,1,1.0,0.0,1645,1616
2013-09-06,Lebanon,Syria,2,0,2,1.0,0.0,1640,1717
2013-09-06,Liechtenstein,Greece,0,1,1,0.0,1.0,1434,1923
2013-09-06,North Macedonia,Wales,2,1,1,1.0,0.0,1732,1759
2013-09-06,Malta,Denmark,1,2,1,0.0,1.0,1493,1901
2013-09-06,Mexico,Honduras,1,2,1,0.0,1.0,1965,1834
2013-09-06,Northern Ireland,Portugal,2,4,2,0.0,1.0,1675,1994
2013-09-06,Norway,Cyprus,2,0,2,1.0,0.0,1877,1646
2013-09-06,Panama,Jamaica,0,0,0,0.5,0.5,1853,1782
2013-09-06,Paraguay,Bolivia,4,0,4,1.0,0.0,1896,1731
2013-09-06,Peru,Uruguay,1,2,1,0.0,1.0,1862,1983
2013-09-06,Poland,Montenegro,1,1,0,0.5,0.5,1886,1720
2013-09-06,Romania,Hungary,3,0,3,1.0,0.0,1885,1820
2013-09-06,Russia,Luxembourg,4,1,3,1.0,0.0,1931,1444
2013-09-06,Scotland,Belgium,0,2,2,0.0,1.0,1810,1905
2013-09-06,Serbia,Croatia,1,1,0,0.5,0.5,1840,1975
2013-09-06,Slovenia,Albania,1,0,1,1.0,0.0,1765,1696
2013-09-06,Sri Lanka,Bhutan,5,2,3,1.0,0.0,1378,1262
2013-09-06,Switzerland,Iceland,4,4,0,0.5,0.5,1919,1674
2013-09-06,Turkey,Andorra,5,0,5,1.0,0.0,1861,1353
2013-09-06,Ukraine,San Marino,9,0,9,1.0,0.0,1911,1333
2013-09-07,Angola,Liberia,4,1,3,1.0,0.0,1728,1610
2013-09-07,Brazil,Australia,6,0,6,1.0,0.0,2140,1939
2013-09-07,Burkina Faso,Gabon,1,0,1,1.0,0.0,1716,1730
2013-09-07,Central African Republic,Ethiopia,1,2,1,0.0,1.0,1490,1653
2013-09-07,Gambia,Tanzania,2,0,2,1.0,0.0,1573,1632
2013-09-07,Israel,Azerbaijan,1,1,0,0.5,0.5,1797,1621
2013-09-07,Ivory Coast,Morocco,1,1,0,0.5,0.5,1945,1776
2013-09-07,Niger,Congo,2,2,0,0.5,0.5,1561,1638
2013-09-07,Nigeria,Malawi,2,0,2,1.0,0.0,1884,1623
2013-09-07,Senegal,Uganda,1,0,1,1.0,0.0,1795,1754
2013-09-07,Sierra Leone,Equatorial Guinea,3,2,1,1.0,0.0,1611,1539
2013-09-07,South Africa,Botswana,4,1,3,1.0,0.0,1830,1648
2013-09-07,Tunisia,Cape Verde,3,0,3,1.0,0.0,1828,1675
2013-09-08,Benin,Rwanda,2,0,2,1.0,0.0,1605,1589
2013-09-08,Cameroon,Libya,1,0,1,1.0,0.0,1834,1758
2013-09-08,Canada,Mauritania,0,0,0,0.5,0.5,1742,1453
2013-09-08,Kenya,Namibia,1,0,1,1.0,0.0,1621,1574
2013-09-08,Nepal,Afghanistan,0,1,1,0.0,1.0,1420,1440
2013-09-08,Sudan,Lesotho,1,3,2,0.0,1.0,1619,1504
2013-09-08,Togo,DR Congo,2,1,1,1.0,0.0,1661,1687
2013-09-08,Zimbabwe,Mozambique,1,1,0,0.5,0.5,1659,1643
2013-09-09,Kuwait,Bahrain,2,1,1,1.0,0.0,1824,1769
2013-09-09,Maldives,India,0,1,1,0.0,1.0,1503,1562
2013-09-09,Qatar,Lebanon,1,1,0,0.5,0.5,1760,1643
2013-09-09,Saudi Arabia,Trinidad and Tobago,1,3,2,0.0,1.0,1811,1714
2013-09-09,United Arab Emirates,New Zealand,2,0,2,1.0,0.0,1831,1777
2013-09-10,Algeria,Mali,1,0,1,1.0,0.0,1791,1741
2013-09-10,Andorra,Netherlands,0,2,2,0.0,1.0,1353,2071
2013-09-10,Armenia,Denmark,0,1,1,0.0,1.0,1639,1904
2013-09-10,Austria,Republic of Ireland,1,0,1,1.0,0.0,1794,1905
2013-09-10,Belarus,France,2,4,2,0.0,1.0,1740,2002
2013-09-10,Bolivia,Ecuador,1,1,0,0.5,0.5,1735,1906
2013-09-10,Brazil,Portugal,3,1,2,1.0,0.0,2145,1990
2013-09-10,Canada,Mauritania,0,1,1,0.0,1.0,1729,1467
2013-09-10,China PR,Malaysia,2,0,2,1.0,0.0,1857,1586
2013-09-10,Cyprus,Slovenia,0,2,2,0.0,1.0,1641,1771
2013-09-10,Egypt,Guinea,4,2,2,1.0,0.0,1897,1743
2013-09-10,Faroe Islands,Germany,0,3,3,0.0,1.0,1447,2078
2013-09-10,Georgia,Finland,0,1,1,0.0,1.0,1655,1801
2013-09-10,Greece,Latvia,1,0,1,1.0,0.0,1926,1643
2013-09-10,Honduras,Panama,2,2,0,0.5,0.5,1835,1853
2013-09-10,Hong Kong,Singapore,1,0,1,1.0,0.0,1584,1624
2013-09-10,Hungary,Estonia,5,1,4,1.0,0.0,1825,1676
2013-09-10,Iceland,Albania,2,1,1,1.0,0.0,1683,1688
2013-09-10,Italy,Czech Republic,2,1,1,1.0,0.0,2014,1894
2013-09-10,Jamaica,Costa Rica,1,1,0,0.5,0.5,1784,1868
2013-09-10,Japan,Ghana,3,1,2,1.0,0.0,1976,1875
2013-09-10,Kazakhstan,Sweden,0,1,1,0.0,1.0,1588,1975
2013-09-10,South Korea,Croatia,1,2,1,0.0,1.0,1924,1982
2013-09-10,Lithuania,Liechtenstein,2,0,2,1.0,0.0,1621,1430
2013-09-10,Luxembourg,Northern Ireland,3,2,1,1.0,0.0,1457,1663
2013-09-10,North Macedonia,Scotland,1,2,1,0.0,1.0,1726,1817
2013-09-10,Malta,Bulgaria,1,2,1,0.0,1.0,1491,1822
2013-09-10,Nigeria,Burkina Faso,4,1,3,1.0,0.0,1889,1712
2013-09-10,Norway,Switzerland,0,2,2,0.0,1.0,1870,1927
2013-09-10,Paraguay,Argentina,2,5,3,0.0,1.0,1892,2089
2013-09-10,Romania,Turkey,0,2,2,0.0,1.0,1877,1870
2013-09-10,Russia,Israel,3,1,2,1.0,0.0,1937,1792
2013-09-10,San Marino,Poland,1,5,4,0.0,1.0,1333,1887
2013-09-10,Slovakia,Bosnia and Herzegovina,1,2,1,0.0,1.0,1784,1824
2013-09-10,South Africa,Zimbabwe,1,2,1,0.0,1.0,1819,1671
2013-09-10,Spain,Chile,2,2,0,0.5,0.5,2181,1969
2013-09-10,Ukraine,England,0,0,0,0.5,0.5,1915,2060
2013-09-10,Uruguay,Colombia,2,0,2,1.0,0.0,1991,1956
2013-09-10,United States,Mexico,2,0,2,1.0,0.0,1991,1958
2013-09-10,Uzbekistan,Jordan,1,1,0,0.5,0.5,1799,1807
2013-09-10,Venezuela,Peru,3,2,1,1.0,0.0,1840,1854
2013-09-10,Wales,Serbia,0,3,3,0.0,1.0,1753,1847
2013-09-30,Botswana,Burkina Faso,1,0,1,1.0,0.0,1658,1703
2013-09-30,Egypt,Uganda,2,0,2,1.0,0.0,1902,1750
2013-10-06,Iraq,Yemen,3,2,1,1.0,0.0,1798,1543
2013-10-08,Lebanon,Iraq,1,1,0,0.5,0.5,1647,1795
2013-10-09,Jordan,Kuwait,1,1,0,0.5,0.5,1808,1824
2013-10-09,Oman,Mauritania,0,0,0,0.5,0.5,1824,1474
2013-10-09,Qatar,Vietnam,1,2,1,0.0,1.0,1749,1633
2013-10-10,Singapore,Laos,1,0,1,1.0,0.0,1628,1404
2013-10-10,Thailand,Bahrain,1,0,1,1.0,0.0,1754,1761
2013-10-11,Albania,Switzerland,1,2,1,0.0,1.0,1685,1931
2013-10-11,Andorra,Romania,0,4,4,0.0,1.0,1353,1878
2013-10-11,Argentina,Peru,3,1,2,1.0,0.0,2093,1851
2013-10-11,Armenia,Bulgaria,2,1,1,1.0,0.0,1651,1811
2013-10-11,Azerbaijan,Northern Ireland,2,0,2,1.0,0.0,1630,1655
2013-10-11,Bosnia and Herzegovina,Liechtenstein,4,1,3,1.0,0.0,1826,1429
2013-10-11,Colombia,Chile,3,3,0,0.5,0.5,1957,1969
2013-10-11,Croatia,Belgium,1,2,1,0.0,1.0,1973,1915
2013-10-11,Denmark,Italy,2,2,0,0.5,0.5,1907,2012
2013-10-11,Ecuador,Uruguay,1,0,1,1.0,0.0,1916,1982
2013-10-11,England,Montenegro,4,1,3,1.0,0.0,2062,1719
2013-10-11,Estonia,Turkey,0,2,2,0.0,1.0,1673,1874
2013-10-11,Faroe Islands,Kazakhstan,1,1,0,0.5,0.5,1451,1585
2013-10-11,France,Australia,6,0,6,1.0,0.0,2009,1933
2013-10-11,Germany,Republic of Ireland,3,0,3,1.0,0.0,2083,1901
2013-10-11,Greece,Slovakia,1,0,1,1.0,0.0,1931,1780
2013-10-11,Honduras,Costa Rica,1,0,1,1.0,0.0,1844,1860
2013-10-11,Iceland,Cyprus,2,0,2,1.0,0.0,1691,1634
2013-10-11,Lithuania,Latvia,2,0,2,1.0,0.0,1630,1635
2013-10-11,Luxembourg,Russia,0,4,4,0.0,1.0,1457,1938
2013-10-11,Malta,Czech Republic,1,4,3,0.0,1.0,1490,1896
2013-10-11,Mexico,Panama,2,1,1,1.0,0.0,1964,1848
2013-10-11,Moldova,San Marino,3,0,3,1.0,0.0,1585,1330
2013-10-11,Morocco,South Africa,1,1,0,0.5,0.5,1777,1819
2013-10-11,Netherlands,Hungary,8,1,7,1.0,0.0,2075,1822
2013-10-11,Philippines,Taiwan,1,2,1,0.0,1.0,1531,1413
2013-10-11,Portugal,Israel,1,1,0,0.5,0.5,1986,1797
2013-10-11,Serbia,Japan,2,0,2,1.0,0.0,1858,1966
2013-10-11,Slovenia,Norway,3,0,3,1.0,0.0,1782,1860
2013-10-11,Spain,Belarus,2,1,1,1.0,0.0,2183,1739
2013-10-11,Sweden,Austria,2,1,1,1.0,0.0,1980,1790
2013-10-11,Ukraine,Poland,1,0,1,1.0,0.0,1923,1880
2013-10-11,United States,Jamaica,2,0,2,1.0,0.0,1995,1781
2013-10-11,Venezuela,Paraguay,1,1,0,0.5,0.5,1842,1891
2013-10-11,Wales,North Macedonia,1,0,1,1.0,0.0,1761,1719
2013-10-12,Burkina Faso,Algeria,3,2,1,1.0,0.0,1713,1782
2013-10-12,Ivory Coast,Senegal,3,1,2,1.0,0.0,1950,1791
2013-10-12,South Korea,Brazil,0,2,2,0.0,1.0,1921,2149
2013-10-13,Ethiopia,Nigeria,1,2,1,0.0,1.0,1650,1893
2013-10-13,Qatar,Yemen,6,0,6,1.0,0.0,1753,1540
2013-10-13,Tunisia,Cameroon,0,0,0,0.5,0.5,1829,1834
2013-10-15,Australia,Canada,3,0,3,1.0,0.0,1937,1726
2013-10-15,Azerbaijan,Russia,1,1,0,0.5,0.5,1636,1933
2013-10-15,Belarus,Japan,1,0,1,1.0,0.0,1752,1954
2013-10-15,Belgium,Wales,1,1,0,0.5,0.5,1912,1765
2013-10-15,Brazil,Zambia,2,0,2,1.0,0.0,2151,1772
2013-10-15,Bulgaria,Czech Republic,0,1,1,0.0,1.0,1805,1903
2013-10-15,Chile,Ecuador,2,1,1,1.0,0.0,1976,1910
2013-10-15,Costa Rica,Mexico,2,1,1,1.0,0.0,1871,1954
2013-10-15,Cyprus,Albania,0,0,0,0.5,0.5,1636,1684
2013-10-15,Denmark,Malta,6,0,6,1.0,0.0,1909,1489
2013-10-15,England,Poland,2,0,2,1.0,0.0,2067,1876
2013-10-15,Faroe Islands,Austria,0,3,3,0.0,1.0,1450,1792
2013-10-15,France,Finland,3,0,3,1.0,0.0,2013,1798
2013-10-15,Ghana,Egypt,6,1,5,1.0,0.0,1884,1894
2013-10-15,Greece,Liechtenstein,2,0,2,1.0,0.0,1932,1429
2013-10-15,Hong Kong,United Arab Emirates,0,4,4,0.0,1.0,1581,1835
2013-10-15,Hungary,Andorra,2,0,2,1.0,0.0,1824,1352
2013-10-15,Indonesia,China PR,1,1,0,0.5,0.5,1640,1853
2013-10-15,Iran,Thailand,2,1,1,1.0,0.0,1921,1750
2013-10-15,Iraq,Saudi Arabia,0,2,2,0.0,1.0,1788,1819
2013-10-15,Republic of Ireland,Kazakhstan,3,1,2,1.0,0.0,1904,1583
2013-10-15,Israel,Northern Ireland,1,1,0,0.5,0.5,1794,1659
2013-10-15,Italy,Armenia,2,2,0,0.5,0.5,2006,1658
2013-10-15,Jamaica,Honduras,2,2,0,0.5,0.5,1783,1843
2013-10-15,Jordan,Oman,0,0,0,0.5,0.5,1809,1824
2013-10-15,South Korea,Mali,3,1,2,1.0,0.0,1926,1737
2013-10-15,Kyrgyzstan,Tajikistan,1,4,3,0.0,1.0,1461,1610
2013-10-15,Latvia,Slovakia,2,2,0,0.5,0.5,1639,1777
2013-10-15,Lebanon,Kuwait,1,1,0,0.5,0.5,1651,1821
2013-10-15,Lithuania,Bosnia and Herzegovina,0,1,1,0.0,1.0,1627,1830
2013-10-15,Malaysia,Bahrain,1,1,0,0.5,0.5,1590,1758
2013-10-15,Montenegro,Moldova,2,5,3,0.0,1.0,1709,1596
2013-10-15,Norway,Iceland,1,1,0,0.5,0.5,1857,1695
2013-10-15,Panama,United States,2,3,1,0.0,1.0,1844,2000
2013-10-15,Paraguay,Colombia,1,2,1,0.0,1.0,1885,1964
2013-10-15,Peru,Bolivia,1,1,0,0.5,0.5,1849,1738
2013-10-15,Philippines,Pakistan,3,1,2,1.0,0.0,1536,1378
2013-10-15,Portugal,Luxembourg,3,0,3,1.0,0.0,1987,1457
2013-10-15,Romania,Estonia,2,0,2,1.0,0.0,1882,1670
2013-10-15,San Marino,Ukraine,0,8,8,0.0,1.0,1330,1924
2013-10-15,Scotland,Croatia,2,0,2,1.0,0.0,1829,1962
2013-10-15,Serbia,North Macedonia,5,1,4,1.0,0.0,1863,1715
2013-10-15,Singapore,Syria,2,1,1,1.0,0.0,1639,1707
2013-10-15,Spain,Georgia,2,0,2,1.0,0.0,2184,1655
2013-10-15,Sweden,Germany,3,5,2,0.0,1.0,1975,2089
2013-10-15,Switzerland,Slovenia,1,0,1,1.0,0.0,1936,1778
2013-10-15,Trinidad and Tobago,New Zealand,0,0,0,0.5,0.5,1716,1776
2013-10-15,Turkey,Netherlands,0,2,2,0.0,1.0,1871,2079
2013-10-15,Uruguay,Argentina,3,2,1,1.0,0.0,1993,2083
2013-10-15,Uzbekistan,Vietnam,3,1,2,1.0,0.0,1804,1629
2013-10-28,Jordan,Nigeria,1,0,1,1.0,0.0,1819,1884
2013-11-01,Indonesia,Kyrgyzstan,4,0,4,1.0,0.0,1645,1457
2013-11-06,Jordan,Zambia,1,0,1,1.0,0.0,1826,1766
2013-11-08,Kuwait,Malaysia,3,0,3,1.0,0.0,1825,1587
2013-11-09,Bahrain,Lebanon,1,0,1,1.0,0.0,1764,1646
2013-11-09,United Arab Emirates,Philippines,4,0,4,1.0,0.0,1838,1534
2013-11-13,Jordan,Uruguay,0,5,5,0.0,1.0,1822,1998
2013-11-13,Mexico,New Zealand,5,1,4,1.0,0.0,1959,1772
2013-11-14,Belgium,Colombia,0,2,2,0.0,1.0,1906,1971
2013-11-14,Bonaire,Suriname,0,2,2,0.0,1.0,1479,1579
2013-11-14,Curaçao,Aruba,2,0,2,1.0,0.0,1470,1400
2013-11-14,Egypt,Zambia,2,0,2,1.0,0.0,1900,1761
2013-11-15,Argentina,Ecuador,0,0,0,0.5,0.5,2080,1914
2013-11-15,Bahrain,Malaysia,1,0,1,1.0,0.0,1769,1583
2013-11-15,Belarus,Albania,0,0,0,0.5,0.5,1751,1686
2013-11-15,China PR,Indonesia,1,0,1,1.0,0.0,1857,1642
2013-11-15,Czech Republic,Canada,2,0,2,1.0,0.0,1908,1722
2013-11-15,Denmark,Norway,2,1,1,1.0,0.0,1916,1851
2013-11-15,England,Chile,0,2,2,0.0,1.0,2057,1987
2013-11-15,Estonia,Azerbaijan,2,1,1,1.0,0.0,1678,1629
2013-11-15,Greece,Romania,3,1,2,1.0,0.0,1939,1876
2013-11-15,Iceland,Croatia,0,0,0,0.5,0.5,1701,1957
2013-11-15,India,Philippines,1,1,0,0.5,0.5,1562,1535
2013-11-15,Republic of Ireland,Latvia,3,0,3,1.0,0.0,1907,1637
2013-11-15,Italy,Germany,1,1,0,0.5,0.5,2008,2088
2013-11-15,Jamaica,Trinidad and Tobago,0,1,1,0.0,1.0,1774,1726
2013-11-15,South Korea,Switzerland,2,1,1,1.0,0.0,1935,1928
2013-11-15,Kuwait,Lebanon,0,0,0,0.5,0.5,1822,1650
2013-11-15,Libya,Niger,1,1,0,0.5,0.5,1754,1566
2013-11-15,Poland,Slovakia,0,2,2,0.0,1.0,1866,1788
2013-11-15,Portugal,Sweden,1,0,1,1.0,0.0,1995,1968
2013-11-15,Russia,Serbia,1,1,0,0.5,0.5,1932,1865
2013-11-15,Saudi Arabia,Iraq,2,1,1,1.0,0.0,1827,1781
2013-11-15,Scotland,United States,0,0,0,0.5,0.5,1833,1997
2013-11-15,Eswatini,South Africa,0,3,3,0.0,1.0,1464,1821
2013-11-15,Syria,Singapore,4,0,4,1.0,0.0,1714,1633
2013-11-15,Thailand,Iran,0,3,3,0.0,1.0,1746,1926
2013-11-15,Turkey,Northern Ireland,1,0,1,1.0,0.0,1875,1656
2013-11-15,Ukraine,France,2,0,2,1.0,0.0,1935,2003
2013-11-15,United Arab Emirates,Hong Kong,4,0,4,1.0,0.0,1841,1579
2013-11-15,Vietnam,Uzbekistan,0,3,3,0.0,1.0,1625,1809
2013-11-15,Yemen,Qatar,1,4,3,0.0,1.0,1537,1757
2013-11-16,Aruba,Bonaire,1,2,1,0.0,1.0,1394,1486
2013-11-16,Curaçao,Suriname,1,3,2,0.0,1.0,1465,1585
2013-11-16,Equatorial Guinea,Spain,1,2,1,0.0,1.0,1539,2185
2013-11-16,Honduras,Brazil,0,5,5,0.0,1.0,1841,2154
2013-11-16,Netherlands,Japan,2,2,0,0.5,0.5,2077,1957
2013-11-16,Nigeria,Ethiopia,2,0,2,1.0,0.0,1888,1647
2013-11-16,Senegal,Ivory Coast,1,1,0,0.5,0.5,1795,1947
2013-11-16,Uganda,Rwanda,0,0,0,0.5,0.5,1747,1593
2013-11-16,Wales,Finland,1,1,0,0.5,0.5,1766,1798
2013-11-17,Cameroon,Tunisia,4,1,3,1.0,0.0,1842,1822
2013-11-17,Luxembourg,Montenegro,1,4,3,0.0,1.0,1454,1713
2013-11-18,Argentina,Bosnia and Herzegovina,2,0,2,1.0,0.0,2084,1827
2013-11-18,Italy,Nigeria,2,2,0,0.5,0.5,2006,1891
2013-11-18,Moldova,Lithuania,1,1,0,0.5,0.5,1597,1627
2013-11-19,Algeria,Burkina Faso,1,0,1,1.0,0.0,1789,1707
2013-11-19,Australia,Costa Rica,1,0,1,1.0,0.0,1944,1865
2013-11-19,Austria,United States,1,0,1,1.0,0.0,1805,1985
2013-11-19,Bahrain,Yemen,2,0,2,1.0,0.0,1773,1534
2013-11-19,Belgium,Japan,2,3,1,0.0,1.0,1900,1964
2013-11-19,Brazil,Chile,2,1,1,1.0,0.0,2159,1983
2013-11-19,Cambodia,Guam,0,2,2,0.0,1.0,1303,1389
2013-11-19,China PR,Saudi Arabia,0,0,0,0.5,0.5,1857,1828
2013-11-19,Croatia,Iceland,2,0,2,1.0,0.0,1960,1699
2013-11-19,Egypt,Ghana,2,1,1,1.0,0.0,1908,1877
2013-11-19,England,Germany,0,1,1,0.0,1.0,2050,2096
2013-11-19,France,Ukraine,3,0,3,1.0,0.0,2010,1929
2013-11-19,Gibraltar,Slovakia,0,0,0,0.5,0.5,1598,1784
2013-11-19,Honduras,Ecuador,2,2,0,0.5,0.5,1843,1913
2013-11-19,Hong Kong,Uzbekistan,0,2,2,0.0,1.0,1576,1813
2013-11-19,India,Nepal,2,0,2,1.0,0.0,1567,1416
2013-11-19,Indonesia,Iraq,0,2,2,0.0,1.0,1638,1786
2013-11-19,Kuwait,Thailand,3,1,2,1.0,0.0,1829,1740
2013-11-19,Kyrgyzstan,Azerbaijan,0,0,0,0.5,0.5,1461,1626
2013-11-19,Lebanon,Iran,1,4,3,0.0,1.0,1648,1929
2013-11-19,Liechtenstein,Estonia,0,3,3,0.0,1.0,1426,1682
2013-11-19,Malaysia,Qatar,0,1,1,0.0,1.0,1579,1762
2013-11-19,Malta,Faroe Islands,3,2,1,1.0,0.0,1497,1443
2013-11-19,Namibia,Mozambique,0,0,0,0.5,0.5,1576,1642
2013-11-19,Netherlands,Colombia,0,0,0,0.5,0.5,2075,1974
2013-11-19,Norway,Scotland,0,1,1,0.0,1.0,1843,1842
2013-11-19,Poland,Republic of Ireland,0,0,0,0.5,0.5,1867,1907
2013-11-19,Romania,Greece,1,1,0,0.5,0.5,1878,1938
2013-11-19,Russia,South Korea,2,1,1,1.0,0.0,1941,1927
2013-11-19,Slovenia,Canada,1,0,1,1.0,0.0,1785,1716
2013-11-19,South Africa,Spain,1,0,1,1.0,0.0,1836,2171
2013-11-19,Sweden,Portugal,2,3,1,0.0,1.0,1961,2003
2013-11-19,Syria,Oman,0,1,1,0.0,1.0,1709,1830
2013-11-19,Tanzania,Zimbabwe,0,0,0,0.5,0.5,1633,1671
2013-11-19,Trinidad and Tobago,Jamaica,2,0,2,1.0,0.0,1736,1765
2013-11-19,Turkey,Belarus,2,1,1,1.0,0.0,1881,1746
2013-11-19,United Arab Emirates,Vietnam,5,0,5,1.0,0.0,1845,1622
2013-11-20,New Zealand,Mexico,2,4,2,0.0,1.0,1768,1964
2013-11-20,Uruguay,Jordan,0,0,0,0.5,0.5,1995,1826
2013-11-24,Singapore,Cambodia,1,0,1,1.0,0.0,1636,1301
2013-11-27,Kenya,Ethiopia,0,0,0,0.5,0.5,1622,1647
2013-11-27,Seychelles,Maldives,3,1,2,1.0,0.0,1430,1494
2013-11-27,Zanzibar,South Sudan,2,1,1,1.0,0.0,1554,1485
2013-11-28,Burundi,Somalia,2,0,2,1.0,0.0,1580,1334
2013-11-28,Tanzania,Zambia,1,1,0,0.5,0.5,1636,1759
2013-11-29,Seychelles,Maldives,2,1,1,1.0,0.0,1440,1485
2013-11-29,Sudan,Eritrea,3,0,3,1.0,0.0,1624,1471
2013-11-29,Uganda,Rwanda,1,0,1,1.0,0.0,1752,1589
2013-11-30,Dominica,Saint Lucia,0,1,1,0.0,1.0,1409,1472
2013-11-30,Ethiopia,Zanzibar,3,1,2,1.0,0.0,1653,1549
2013-11-30,Kenya,South Sudan,3,1,2,1.0,0.0,1627,1481
2013-12-01,Dominica,Saint Lucia,1,0,1,1.0,0.0,1419,1463
2013-12-01,Somalia,Tanzania,0,1,1,0.0,1.0,1332,1639
2013-12-01,Zambia,Burundi,1,0,1,1.0,0.0,1764,1576
2013-12-02,Eritrea,Uganda,0,3,3,0.0,1.0,1469,1755
2013-12-02,Sudan,Rwanda,1,0,1,1.0,0.0,1632,1582
2013-12-03,Kenya,Zanzibar,2,0,2,1.0,0.0,1634,1543
2013-12-03,South Sudan,Ethiopia,0,2,2,0.0,1.0,1477,1658
2013-12-04,Somalia,Zambia,0,4,4,0.0,1.0,1331,1766
2013-12-04,Tanzania,Burundi,1,0,1,1.0,0.0,1646,1570
2013-12-05,Rwanda,Eritrea,1,0,1,1.0,0.0,1588,1464
2013-12-05,Uganda,Sudan,1,0,1,1.0,0.0,1761,1627
2013-12-07,Kenya,Rwanda,1,0,1,1.0,0.0,1641,1582
2013-12-07,Uganda,Tanzania,2,2,0,0.5,0.5,1759,1649
2013-12-08,Ethiopia,Sudan,0,2,2,0.0,1.0,1650,1636
2013-12-08,Zambia,Burundi,4,3,1,1.0,0.0,1770,1567
2013-12-10,Kenya,Tanzania,1,0,1,1.0,0.0,1650,1641
2013-12-10,Zambia,Sudan,1,2,1,0.0,1.0,1760,1647
2013-12-12,Kenya,Sudan,2,0,2,1.0,0.0,1658,1640
2013-12-12,Tanzania,Zambia,1,1,0,0.5,0.5,1644,1758
2013-12-14,Libya,Mali,1,0,1,1.0,0.0,1762,1730
2013-12-21,Qatar,Bahrain,1,1,0,0.5,0.5,1763,1773
2013-12-25,Oman,Bahrain,0,0,0,0.5,0.5,1829,1775
2013-12-25,Qatar,Palestine,1,0,1,1.0,0.0,1768,1586
2013-12-26,Jordan,Lebanon,0,0,0,0.5,0.5,1823,1652
2013-12-28,Bahrain,Iraq,0,0,0,0.5,0.5,1776,1786
2013-12-28,Palestine,Saudi Arabia,0,0,0,0.5,0.5,1591,1824
2013-12-28,Basque Country,Peru,6,0,6,1.0,0.0,1754,1839
2013-12-28,Galicia,Occitania,1,7,6,0.0,1.0,1536,1569
2013-12-29,Lebanon,Kuwait,0,2,2,0.0,1.0,1648,1834
2013-12-30,Catalonia,Cape Verde,4,1,3,1.0,0.0,1668,1667
2013-12-31,Iraq,Oman,0,0,0,0.5,0.5,1787,1829
2013-12-31,Qatar,Saudi Arabia,4,1,3,1.0,0.0,1778,1815
2014-01-01,Kuwait,Jordan,1,2,1,0.0,1.0,1826,1832
2014-01-04,Bahrain,Jordan,0,1,1,0.0,1.0,1770,1839
2014-01-04,Namibia,Ghana,0,1,1,0.0,1.0,1574,1880
2014-01-04,Nigeria,Ethiopia,2,1,1,1.0,0.0,1895,1647
2014-01-04,Qatar,Kuwait,3,0,3,1.0,0.0,1788,1817
2014-01-07,Bahrain,Kuwait,0,0,0,0.5,0.5,1772,1816
2014-01-07,Qatar,Jordan,2,0,2,1.0,0.0,1798,1830
2014-01-07,Zimbabwe,Gabon,2,0,2,1.0,0.0,1681,1721
2014-01-15,Moldova,Norway,1,2,1,0.0,1.0,1594,1847
2014-01-17,Moldova,Sweden,1,2,1,0.0,1.0,1593,1963
2014-01-18,Norway,Poland,0,3,3,0.0,1.0,1840,1875
2014-01-20,Moldova,Poland,0,1,1,0.0,1.0,1591,1878
2014-01-21,Iceland,Sweden,0,2,2,0.0,1.0,1697,1966
2014-01-22,Chile,Costa Rica,4,0,4,1.0,0.0,1989,1860
2014-01-24,Oman,Finland,0,0,0,0.5,0.5,1829,1799
2014-01-25,Costa Rica,South Korea,0,1,1,0.0,1.0,1854,1934
2014-01-29,Mexico,South Korea,4,0,4,1.0,0.0,1972,1927
2014-01-31,Oman,Jordan,0,0,0,0.5,0.5,1830,1830
2014-02-01,United States,South Korea,2,0,2,1.0,0.0,1992,1921
2014-02-04,Singapore,Jordan,1,3,2,0.0,1.0,1633,1834
2014-02-19,Lebanon,Pakistan,3,1,2,1.0,0.0,1651,1376
2014-02-21,Iraq,North Korea,2,0,2,1.0,0.0,1796,1783
2014-02-23,Sealand,Chagos Islands,4,2,2,1.0,0.0,1485,1508
2014-03-01,Gibraltar,Faroe Islands,1,4,3,0.0,1.0,1587,1455
2014-03-01,Malaysia,Philippines,0,0,0,0.5,0.5,1578,1537
2014-03-03,Iran,Kuwait,3,2,1,1.0,0.0,1935,1811
2014-03-05,Albania,Malta,2,0,2,1.0,0.0,1691,1493
2014-03-05,Algeria,Slovenia,2,0,2,1.0,0.0,1797,1778
2014-03-05,Andorra,Moldova,0,3,3,0.0,1.0,1349,1595
2014-03-05,Australia,Ecuador,3,4,1,0.0,1.0,1936,1922
2014-03-05,Austria,Uruguay,1,1,0,0.5,0.5,1809,1992
2014-03-05,Belgium,Ivory Coast,2,2,0,0.5,0.5,1902,1946
2014-03-05,Bosnia and Herzegovina,Egypt,0,2,2,0.0,1.0,1821,1915
2014-03-05,Botswana,South Sudan,3,0,3,1.0,0.0,1663,1473
2014-03-05,Bulgaria,Belarus,2,1,1,1.0,0.0,1812,1740
2014-03-05,Burkina Faso,Comoros,1,1,0,0.5,0.5,1702,1393
2014-03-05,Burundi,Rwanda,1,1,0,0.5,0.5,1568,1582
2014-03-05,Colombia,Tunisia,1,1,0,0.5,0.5,1971,1826
2014-03-05,Cyprus,Northern Ireland,0,0,0,0.5,0.5,1637,1656
2014-03-05,Czech Republic,Norway,2,2,0,0.5,0.5,1907,1842
2014-03-05,England,Denmark,1,0,1,1.0,0.0,2056,1911
2014-03-05,France,Netherlands,2,0,2,1.0,0.0,2020,2066
2014-03-05,Georgia,Liechtenstein,2,0,2,1.0,0.0,1659,1423
2014-03-05,Germany,Chile,1,0,1,1.0,0.0,2102,1984
2014-03-05,Gibraltar,Estonia,0,2,2,0.0,1.0,1582,1688
2014-03-05,Greece,South Korea,0,2,2,0.0,1.0,1930,1930
2014-03-05,Hungary,Finland,1,2,1,0.0,1.0,1816,1808
2014-03-05,India,Bangladesh,2,2,0,0.5,0.5,1565,1435
2014-03-05,Iran,Guinea,1,2,1,0.0,1.0,1923,1756
2014-03-05,Iraq,China PR,3,1,2,1.0,0.0,1806,1848
2014-03-05,Republic of Ireland,Serbia,1,2,1,0.0,1.0,1899,1874
2014-03-05,Israel,Slovakia,1,3,2,0.0,1.0,1786,1793
2014-03-05,Japan,New Zealand,4,2,2,1.0,0.0,1968,1765
2014-03-05,Jordan,Syria,2,1,1,1.0,0.0,1840,1704
2014-03-05,Kazakhstan,Lithuania,1,1,0,0.5,0.5,1585,1626
2014-03-05,Kosovo,Haiti,0,0,0,0.5,0.5,1513,1672
2014-03-05,Luxembourg,Cape Verde,0,0,0,0.5,0.5,1459,1663
2014-03-05,North Macedonia,Latvia,2,1,1,1.0,0.0,1722,1631
2014-03-05,Malawi,Zimbabwe,1,4,3,0.0,1.0,1617,1688
2014-03-05,Mali,Senegal,1,1,0,0.5,0.5,1732,1794
2014-03-05,Mauritania,Niger,1,1,0,0.5,0.5,1477,1564
2014-03-05,Montenegro,Ghana,1,0,1,1.0,0.0,1725,1869
2014-03-05,Morocco,Gabon,1,1,0,0.5,0.5,1776,1723
2014-03-05,Mozambique,Angola,1,1,0,0.5,0.5,1644,1727
2014-03-05,Namibia,Tanzania,1,1,0,0.5,0.5,1576,1643
2014-03-05,Oman,Singapore,3,1,2,1.0,0.0,1834,1630
2014-03-05,Philippines,Azerbaijan,0,1,1,0.0,1.0,1532,1632
2014-03-05,Poland,Scotland,0,1,1,0.0,1.0,1870,1851
2014-03-05,Portugal,Cameroon,5,1,4,1.0,0.0,2008,1838
2014-03-05,Qatar,Bahrain,0,0,0,0.5,0.5,1798,1773
2014-03-05,Romania,Argentina,0,0,0,0.5,0.5,1883,2080
2014-03-05,Russia,Armenia,2,0,2,1.0,0.0,1944,1656
2014-03-05,Saudi Arabia,Indonesia,1,0,1,1.0,0.0,1820,1634
2014-03-05,South Africa,Brazil,0,5,5,0.0,1.0,1834,2162
2014-03-05,Spain,Italy,1,0,1,1.0,0.0,2176,2002
2014-03-05,Saint Lucia,Jamaica,0,5,5,0.0,1.0,1461,1768
2014-03-05,Switzerland,Croatia,2,2,0,0.5,0.5,1929,1960
2014-03-05,Thailand,Lebanon,2,5,3,0.0,1.0,1730,1662
2014-03-05,Turkey,Sweden,2,1,1,1.0,0.0,1891,1957
2014-03-05,Ukraine,United States,2,0,2,1.0,0.0,1939,1983
2014-03-05,Uzbekistan,United Arab Emirates,1,1,0,0.5,0.5,1814,1845
2014-03-05,Vietnam,Hong Kong,3,1,2,1.0,0.0,1629,1570
2014-03-05,Wales,Iceland,3,1,2,1.0,0.0,1773,1691
2014-03-05,Yemen,Malaysia,1,2,1,0.0,1.0,1528,1585
2014-03-05,Zambia,Uganda,2,1,1,1.0,0.0,1767,1751
2014-03-07,Lesotho,Eswatini,0,1,1,0.0,1.0,1496,1473
2014-03-09,Lesotho,Eswatini,0,0,0,0.5,0.5,1496,1474
2014-03-15,Alderney,Guernsey,0,4,4,0.0,1.0,1270,1725
2014-03-19,Saint Lucia,Martinique,0,0,0,0.5,0.5,1466,1682
2014-03-25,Yemen,Nepal,2,0,2,1.0,0.0,1534,1411
2014-03-26,Andorra,Indonesia,0,1,1,0.0,1.0,1347,1637
2014-03-27,Aruba,Guam,2,2,0,0.5,0.5,1394,1390
2014-03-29,Cuba,Indonesia,1,0,1,1.0,0.0,1691,1631
2014-03-30,Aruba,Guam,2,0,2,1.0,0.0,1402,1383
2014-04-06,Ellan Vannin,Monaco,10,0,10,1.0,0.0,1508,1483
2014-04-12,Mauritania,Mauritius,1,0,1,1.0,0.0,1485,1450
2014-04-13,Afghanistan,Kyrgyzstan,0,0,0,0.5,0.5,1441,1461
2014-04-15,Yemen,Chad,0,0,0,0.5,0.5,1534,1519
2014-04-17,Guadeloupe,French Guiana,3,2,1,1.0,0.0,1684,1525
2014-04-20,Mauritius,Mauritania,0,2,2,0.0,1.0,1443,1493
2014-04-26,Tanzania,Burundi,0,3,3,0.0,1.0,1634,1578
2014-04-27,Philippines,Malaysia,0,0,0,0.5,0.5,1534,1584
2014-05-02,Grenada,Saint Lucia,0,1,1,0.0,1.0,1535,1476
2014-05-04,Dominica,Grenada,3,5,2,0.0,1.0,1414,1541
2014-05-05,Sealand,Chagos Islands,1,1,0,0.5,0.5,1486,1508
2014-05-10,Vatican City,Monaco,0,2,2,0.0,1.0,1471,1491
2014-05-11,Jersey,Guernsey,1,4,3,0.0,1.0,1729,1734
2014-05-12,Afghanistan,Kyrgyzstan,1,0,1,1.0,0.0,1450,1453
2014-05-13,Germany,Poland,0,0,0,0.5,0.5,2098,1875
2014-05-14,Kuwait,Afghanistan,3,2,1,1.0,0.0,1813,1449
2014-05-16,Kuwait,Kyrgyzstan,2,2,0,0.5,0.5,1807,1460
2014-05-17,Malawi,Chad,2,0,2,1.0,0.0,1623,1514
2014-05-17,Mauritania,Equatorial Guinea,1,0,1,1.0,0.0,1503,1530
2014-05-17,Namibia,Congo,1,0,1,1.0,0.0,1586,1629
2014-05-17,Netherlands,Ecuador,1,1,0,0.5,0.5,2063,1926
2014-05-17,São Tomé and Príncipe,Benin,0,2,2,0.0,1.0,1455,1610
2014-05-17,Somaliland,Sealand,2,2,0,0.5,0.5,1500,1487
2014-05-18,Belarus,Iran,0,0,0,0.5,0.5,1744,1920
2014-05-18,Burundi,Botswana,0,0,0,0.5,0.5,1580,1662
2014-05-18,Central African Republic,Guinea-Bissau,0,0,0,0.5,0.5,1491,1511
2014-05-18,Eswatini,Sierra Leone,1,1,0,0.5,0.5,1478,1608
2014-05-18,Kenya,Comoros,1,0,1,1.0,0.0,1661,1391
2014-05-18,Liberia,Lesotho,1,0,1,1.0,0.0,1616,1491
2014-05-18,Libya,Rwanda,0,0,0,0.5,0.5,1759,1586
2014-05-18,Madagascar,Uganda,2,1,1,1.0,0.0,1559,1739
2014-05-18,Mozambique,South Sudan,5,0,5,1.0,0.0,1649,1469
2014-05-18,Tanzania,Zimbabwe,1,0,1,1.0,0.0,1644,1679
2014-05-19,Maldives,Myanmar,2,3,1,0.0,1.0,1479,1543
2014-05-19,Palestine,Kyrgyzstan,1,0,1,1.0,0.0,1597,1455
2014-05-20,French Guiana,Suriname,0,0,0,0.5,0.5,1527,1584
2014-05-20,Philippines,Afghanistan,0,0,0,0.5,0.5,1533,1451
2014-05-20,Turkmenistan,Laos,5,1,4,1.0,0.0,1616,1401
2014-05-21,Burkina Faso,Senegal,1,1,0,0.5,0.5,1705,1792
2014-05-21,Myanmar,Palestine,0,2,2,0.0,1.0,1537,1604
2014-05-21,Finland,Czech Republic,2,2,0,0.5,0.5,1811,1905
2014-05-21,Kosovo,Turkey,1,6,5,0.0,1.0,1512,1893
2014-05-21,Liechtenstein,Belarus,1,5,4,0.0,1.0,1421,1747
2014-05-21,Maldives,Kyrgyzstan,2,0,2,1.0,0.0,1487,1448
2014-05-22,Afghanistan,Turkmenistan,3,1,2,1.0,0.0,1463,1605
2014-05-22,Hungary,Denmark,2,2,0,0.5,0.5,1819,1909
2014-05-22,Laos,Philippines,0,2,2,0.0,1.0,1396,1539
2014-05-22,Ukraine,Niger,2,1,1,1.0,0.0,1941,1563
2014-05-23,Bulgaria,Canada,1,1,0,0.5,0.5,1810,1719
2014-05-23,Kyrgyzstan,Myanmar,1,0,1,1.0,0.0,1459,1527
2014-05-23,Maldives,Palestine,0,0,0,0.5,0.5,1490,1602
2014-05-23,Slovakia,Montenegro,2,0,2,1.0,0.0,1800,1719
2014-05-24,Afghanistan,Laos,0,0,0,0.5,0.5,1462,1398
2014-05-24,Moldova,Saudi Arabia,4,0,4,1.0,0.0,1608,1808
2014-05-24,Turkmenistan,Philippines,0,2,2,0.0,1.0,1596,1549
2014-05-25,Republic of Ireland,Turkey,1,2,1,0.0,1.0,1891,1902
2014-05-25,Kosovo,Senegal,1,3,2,0.0,1.0,1510,1795
2014-05-25,Mali,Guinea,1,2,1,0.0,1.0,1725,1764
2014-05-25,Thailand,Kuwait,1,1,0,0.5,0.5,1732,1806
2014-05-26,Australia,South Africa,1,1,0,0.5,0.5,1934,1837
2014-05-26,Belgium,Luxembourg,5,1,4,1.0,0.0,1904,1458
2014-05-26,Estonia,Gibraltar,1,1,0,0.5,0.5,1686,1585
2014-05-26,Jamaica,Serbia,1,2,1,0.0,1.0,1763,1880
2014-05-26,North Macedonia,Cameroon,0,2,2,0.0,1.0,1717,1844
2014-05-26,Montenegro,Iran,0,0,0,0.5,0.5,1724,1916
2014-05-26,Russia,Slovakia,1,0,1,1.0,0.0,1949,1796
2014-05-27,Armenia,United Arab Emirates,4,3,1,1.0,0.0,1668,1834
2014-05-27,France,Norway,4,0,4,1.0,0.0,2025,1838
2014-05-27,Japan,Cyprus,1,0,1,1.0,0.0,1971,1635
2014-05-27,Maldives,Philippines,2,3,1,0.0,1.0,1484,1556
2014-05-27,Moldova,Canada,1,1,0,0.5,0.5,1611,1717
2014-05-27,Palestine,Afghanistan,2,0,2,1.0,0.0,1607,1458
2014-05-27,Suriname,French Guiana,1,0,1,1.0,0.0,1591,1521
2014-05-27,Tanzania,Malawi,1,0,1,1.0,0.0,1652,1616
2014-05-27,Uzbekistan,Oman,0,1,1,0.0,1.0,1807,1842
2014-05-28,Angola,Morocco,2,0,2,1.0,0.0,1737,1767
2014-05-28,Denmark,Sweden,1,0,1,1.0,0.0,1919,1948
2014-05-28,South Korea,Tunisia,0,1,1,0.0,1.0,1920,1837
2014-05-28,Nigeria,Scotland,2,2,0,0.5,0.5,1894,1853
2014-05-29,Cameroon,Paraguay,1,2,1,0.0,1.0,1837,1893
2014-05-29,Finland,Lithuania,0,1,1,0.0,1.0,1800,1638
2014-05-29,Georgia,Saudi Arabia,2,0,2,1.0,0.0,1671,1797
2014-05-29,Latvia,Estonia,0,0,0,0.5,0.5,1633,1685
2014-05-29,Maldives,Afghanistan,1,1,0,0.5,0.5,1484,1459
2014-05-29,Uzbekistan,Oman,0,1,1,0.0,1.0,1800,1850
2014-05-29,Franconia,Raetia,4,2,2,1.0,0.0,1508,1471
2014-05-30,Angola,Iran,1,1,0,0.5,0.5,1741,1913
2014-05-30,Aruba,Turks and Caicos Islands,1,0,1,1.0,0.0,1412,1440
2014-05-30,Austria,Iceland,1,1,0,0.5,0.5,1807,1694
2014-05-30,Bosnia and Herzegovina,Ivory Coast,2,1,1,1.0,0.0,1832,1936
2014-05-30,Comoros,Kenya,1,1,0,0.5,0.5,1397,1656
2014-05-30,England,Peru,3,0,3,1.0,0.0,2060,1836
2014-05-30,French Guiana,British Virgin Islands,6,0,6,1.0,0.0,1526,1370
2014-05-30,North Macedonia,Qatar,0,0,0,0.5,0.5,1719,1797
2014-05-30,Montserrat,United States Virgin Islands,1,0,1,1.0,0.0,1393,1380
2014-05-30,New Zealand,South Africa,0,0,0,0.5,0.5,1767,1836
2014-05-30,Palestine,Philippines,1,0,1,1.0,0.0,1614,1550
2014-05-30,South Sudan,Mozambique,0,0,0,0.5,0.5,1473,1646
2014-05-30,Spain,Bolivia,2,0,2,1.0,0.0,2178,1737
2014-05-30,Switzerland,Jamaica,1,0,1,1.0,0.0,1934,1759
2014-05-30,Uruguay,Northern Ireland,1,0,1,1.0,0.0,1995,1654
2014-05-31,Albania,Romania,0,1,1,0.0,1.0,1688,1887
2014-05-31,Armenia,Algeria,1,3,2,0.0,1.0,1663,1803
2014-05-31,Chad,Malawi,3,1,2,1.0,0.0,1525,1606
2014-05-31,Colombia,Senegal,2,2,0,0.5,0.5,1968,1799
2014-05-31,Croatia,Mali,2,1,1,1.0,0.0,1964,1722
2014-05-31,Finland,Estonia,2,0,2,1.0,0.0,1806,1680
2014-05-31,Guinea-Bissau,Central African Republic,3,1,2,1.0,0.0,1519,1484
2014-05-31,Italy,Republic of Ireland,0,0,0,0.5,0.5,2000,1894
2014-05-31,Latvia,Lithuania,1,0,1,1.0,0.0,1642,1630
2014-05-31,Mexico,Ecuador,3,1,2,1.0,0.0,1979,1920
2014-05-31,Netherlands,Ghana,1,0,1,1.0,0.0,2067,1866
2014-05-31,Norway,Russia,1,1,0,0.5,0.5,1841,1947
2014-05-31,Portugal,Greece,0,0,0,0.5,0.5,2007,1932
2014-05-31,Rwanda,Libya,3,0,3,1.0,0.0,1598,1748
2014-05-31,Sierra Leone,Eswatini,1,0,1,1.0,0.0,1614,1473
2014-05-31,Uganda,Madagascar,1,0,1,1.0,0.0,1744,1555
2014-06-01,Aruba,British Virgin Islands,7,0,7,1.0,0.0,1420,1363
2014-06-01,Benin,São Tomé and Príncipe,2,0,2,1.0,0.0,1615,1451
2014-06-01,Botswana,Burundi,1,0,1,1.0,0.0,1669,1574
2014-06-01,Congo,Namibia,3,0,3,1.0,0.0,1637,1579
2014-06-01,Equatorial Guinea,Mauritania,3,0,3,1.0,0.0,1538,1496
2014-06-01,France,Paraguay,1,1,0,0.5,0.5,2023,1896
2014-06-01,Germany,Cameroon,2,2,0,0.5,0.5,2093,1843
2014-06-01,Honduras,Israel,2,4,2,0.0,1.0,1834,1796
2014-06-01,Lesotho,Liberia,2,0,2,1.0,0.0,1502,1606
2014-06-01,Sweden,Belgium,0,2,2,0.0,1.0,1939,1914
2014-06-01,Turks and Caicos Islands,French Guiana,0,6,6,0.0,1.0,1434,1533
2014-06-01,United States,Turkey,2,1,1,1.0,0.0,1990,1896
2014-06-01,United States Virgin Islands,Bonaire,1,2,1,0.0,1.0,1375,1492
2014-06-01,Zimbabwe,Tanzania,2,2,0,0.5,0.5,1679,1653
2014-06-01,Iraqi Kurdistan,Arameans Suryoye,1,2,1,0.0,1.0,1542,1513
2014-06-01,Abkhazia,Occitania,1,1,0,0.5,0.5,1494,1568
2014-06-01,Darfur,Padania,0,20,20,0.0,1.0,1473,1605
2014-06-01,Ellan Vannin,Artsakh,3,2,1,1.0,0.0,1516,1500
2014-06-02,Costa Rica,Japan,1,3,2,0.0,1.0,1849,1977
2014-06-02,Tamil Eelam,Arameans Suryoye,0,2,2,0.0,1.0,1491,1521
2014-06-02,Sápmi,Abkhazia,1,2,1,0.0,1.0,1508,1503
2014-06-02,Darfur,South Ossetia,0,19,19,0.0,1.0,1466,1508
2014-06-02,Ellan Vannin,County of Nice,4,2,2,1.0,0.0,1524,1493
2014-06-03,Aruba,French Guiana,0,2,2,0.0,1.0,1415,1539
2014-06-03,Brazil,Panama,4,0,4,1.0,0.0,2165,1842
2014-06-03,British Virgin Islands,Turks and Caicos Islands,0,2,2,0.0,1.0,1357,1441
2014-06-03,Czech Republic,Austria,1,2,1,0.0,1.0,1895,1818
2014-06-03,Georgia,United Arab Emirates,0,1,1,0.0,1.0,1667,1839
2014-06-03,Greece,Nigeria,0,0,0,0.5,0.5,1932,1895
2014-06-03,Mexico,Bosnia and Herzegovina,0,1,1,0.0,1.0,1968,1844
2014-06-03,Switzerland,Peru,2,0,2,1.0,0.0,1940,1831
2014-06-03,Tamil Eelam,Iraqi Kurdistan,0,9,9,0.0,1.0,1485,1549
2014-06-03,Sápmi,Occitania,0,1,1,0.0,1.0,1502,1575
2014-06-03,South Ossetia,Padania,1,3,2,0.0,1.0,1503,1611
2014-06-03,Artsakh,County of Nice,0,1,1,0.0,1.0,1492,1502
2014-06-04,Argentina,Trinidad and Tobago,3,0,3,1.0,0.0,2082,1735
2014-06-04,Ecuador,England,2,2,0,0.5,0.5,1924,2057
2014-06-04,El Salvador,Ivory Coast,1,2,1,0.0,1.0,1713,1940
2014-06-04,Gibraltar,Malta,1,0,1,1.0,0.0,1591,1488
2014-06-04,Hungary,Albania,1,0,1,1.0,0.0,1825,1683
2014-06-04,Iceland,Estonia,1,0,1,1.0,0.0,1702,1673
2014-06-04,Italy,Luxembourg,1,1,0,0.5,0.5,1993,1466
2014-06-04,Jamaica,Egypt,2,2,0,0.5,0.5,1763,1912
2014-06-04,Netherlands,Wales,2,0,2,1.0,0.0,2070,1771
2014-06-04,Romania,Algeria,1,2,1,0.0,1.0,1878,1813
2014-06-04,Padania,County of Nice,1,2,1,0.0,1.0,1601,1513
2014-06-04,Abkhazia,South Ossetia,0,0,0,0.5,0.5,1503,1503
2014-06-04,Arameans Suryoye,Occitania,0,0,0,0.5,0.5,1523,1574
2014-06-04,Ellan Vannin,Iraqi Kurdistan,1,1,0,0.5,0.5,1525,1549
2014-06-05,Sápmi,Tamil Eelam,4,2,2,1.0,0.0,1510,1478
2014-06-05,Darfur,Artsakh,0,12,12,0.0,1.0,1459,1500
2014-06-05,Padania,Abkhazia,3,3,0,0.5,0.5,1599,1506
2014-06-05,Occitania,Iraqi Kurdistan,2,2,0,0.5,0.5,1574,1550
2014-06-06,Bolivia,Greece,1,2,1,0.0,1.0,1734,1936
2014-06-06,Brazil,Serbia,1,0,1,1.0,0.0,2168,1878
2014-06-06,Colombia,Jordan,3,0,3,1.0,0.0,1974,1835
2014-06-06,Costa Rica,Republic of Ireland,1,1,0,0.5,0.5,1851,1893
2014-06-06,Croatia,Australia,1,0,1,1.0,0.0,1972,1927
2014-06-06,Germany,Armenia,6,1,5,1.0,0.0,2095,1662
2014-06-06,Japan,Zambia,4,3,1,1.0,0.0,1981,1764
2014-06-06,Mexico,Portugal,0,1,1,0.0,1.0,1961,2015
2014-06-06,Poland,Lithuania,2,1,1,1.0,0.0,1879,1627
2014-06-06,Russia,Morocco,2,0,2,1.0,0.0,1952,1763
2014-06-06,County of Nice,South Ossetia,3,0,3,1.0,0.0,1521,1496
2014-06-06,Arameans Suryoye,Ellan Vannin,1,4,3,0.0,1.0,1516,1533
2014-06-07,Argentina,Slovenia,2,0,2,1.0,0.0,2085,1776
2014-06-07,Belgium,Tunisia,1,0,1,1.0,0.0,1921,1831
2014-06-07,Cameroon,Moldova,1,0,1,1.0,0.0,1847,1608
2014-06-07,El Salvador,Spain,0,2,2,0.0,1.0,1712,2180
2014-06-07,Estonia,Tajikistan,2,1,1,1.0,0.0,1680,1604
2014-06-07,Honduras,England,0,0,0,0.5,0.5,1839,2053
2014-06-07,Hungary,Kazakhstan,3,0,3,1.0,0.0,1829,1582
2014-06-07,United States,Nigeria,2,1,1,1.0,0.0,1996,1890
2014-06-07,Sápmi,Artsakh,1,5,4,0.0,1.0,1502,1509
2014-06-07,Tamil Eelam,Darfur,10,0,10,1.0,0.0,1486,1452
2014-06-07,Abkhazia,Occitania,0,1,1,0.0,1.0,1500,1581
2014-06-07,Padania,Iraqi Kurdistan,1,1,0,0.5,0.5,1598,1552
2014-06-08,France,Jamaica,8,0,8,1.0,0.0,2026,1761
2014-06-08,Iran,Trinidad and Tobago,2,0,2,1.0,0.0,1918,1731
2014-06-08,San Marino,Albania,0,3,3,0.0,1.0,1329,1685
2014-06-08,South Ossetia,Arameans Suryoye,1,4,3,0.0,1.0,1489,1524
2014-06-08,County of Nice,Ellan Vannin,0,0,0,0.5,0.5,1522,1533
2014-06-09,Ghana,South Korea,4,0,4,1.0,0.0,1876,1911
2014-06-10,Republic of Ireland,Portugal,1,5,4,0.0,1.0,1888,2021
2014-06-12,Brazil,Croatia,3,1,2,1.0,0.0,2172,1969
2014-06-13,Chile,Australia,3,1,2,1.0,0.0,1991,1921
2014-06-13,Mexico,Cameroon,1,0,1,1.0,0.0,1967,1842
2014-06-13,Spain,Netherlands,1,5,4,0.0,1.0,2170,2081
2014-06-14,Colombia,Greece,3,0,3,1.0,0.0,1982,1929
2014-06-14,England,Italy,1,2,1,0.0,1.0,2044,2003
2014-06-14,Ivory Coast,Japan,2,1,1,1.0,0.0,1949,1973
2014-06-14,Uruguay,Costa Rica,1,3,2,0.0,1.0,1984,1863
2014-06-15,Argentina,Bosnia and Herzegovina,2,1,1,1.0,0.0,2089,1841
2014-06-15,France,Honduras,3,0,3,1.0,0.0,2031,1835
2014-06-15,Switzerland,Ecuador,2,1,1,1.0,0.0,1948,1917
2014-06-16,Germany,Portugal,4,0,4,1.0,0.0,2102,2015
2014-06-16,Ghana,United States,1,2,1,0.0,1.0,1871,2002
2014-06-16,Iran,Nigeria,0,0,0,0.5,0.5,1918,1891
2014-06-17,Belgium,Algeria,2,1,1,1.0,0.0,1927,1808
2014-06-17,Brazil,Mexico,0,0,0,0.5,0.5,2168,1972
2014-06-17,Russia,South Korea,1,1,0,0.5,0.5,1952,1912
2014-06-18,Australia,Netherlands,2,3,1,0.0,1.0,1917,2086
2014-06-18,Cameroon,Croatia,0,4,4,0.0,1.0,1837,1975
2014-06-18,China PR,North Macedonia,2,0,2,1.0,0.0,1854,1714
2014-06-18,Spain,Chile,0,2,2,0.0,1.0,2159,2003
2014-06-19,Colombia,Ivory Coast,2,1,1,1.0,0.0,1990,1942
2014-06-19,Japan,Greece,0,0,0,0.5,0.5,1972,1931
2014-06-19,Uruguay,England,2,1,1,1.0,0.0,1994,2035
2014-06-20,Honduras,Ecuador,1,2,1,0.0,1.0,1829,1924
2014-06-20,Italy,Costa Rica,0,1,1,0.0,1.0,1992,1875
2014-06-20,Switzerland,France,2,5,3,0.0,1.0,1942,2038
2014-06-21,Argentina,Iran,1,0,1,1.0,0.0,2094,1914
2014-06-21,Germany,Ghana,2,2,0,0.5,0.5,2098,1876
2014-06-21,Indonesia,Pakistan,4,0,4,1.0,0.0,1634,1374
2014-06-21,Nigeria,Bosnia and Herzegovina,1,0,1,1.0,0.0,1898,1835
2014-06-22,Belgium,Russia,1,0,1,1.0,0.0,1936,1944
2014-06-22,China PR,North Macedonia,0,0,0,0.5,0.5,1851,1718
2014-06-22,South Korea,Algeria,2,4,2,0.0,1.0,1902,1819
2014-06-22,United States,Portugal,2,2,0,0.5,0.5,2003,2015
2014-06-23,Australia,Spain,0,3,3,0.0,1.0,1914,2163
2014-06-23,Brazil,Cameroon,4,1,3,1.0,0.0,2171,1835
2014-06-23,Croatia,Mexico,1,3,2,0.0,1.0,1967,1981
2014-06-23,Netherlands,Chile,2,0,2,1.0,0.0,2093,1997
2014-06-24,Costa Rica,England,0,0,0,0.5,0.5,1879,2032
2014-06-24,Greece,Ivory Coast,2,1,1,1.0,0.0,1940,1934
2014-06-24,Italy,Uruguay,0,1,1,0.0,1.0,1985,2002
2014-06-24,Japan,Colombia,1,4,3,0.0,1.0,1965,1998
2014-06-25,Bosnia and Herzegovina,Iran,3,1,2,1.0,0.0,1845,1905
2014-06-25,Ecuador,France,0,0,0,0.5,0.5,1927,2036
2014-06-25,Honduras,Switzerland,0,3,3,0.0,1.0,1824,1948
2014-06-25,Indonesia,Nepal,2,0,2,1.0,0.0,1638,1408
2014-06-25,Nigeria,Argentina,2,3,1,0.0,1.0,1895,2098
2014-06-26,Algeria,Russia,1,1,0,0.5,0.5,1822,1942
2014-06-26,South Korea,Belgium,0,1,1,0.0,1.0,1895,1944
2014-06-26,Portugal,Ghana,2,1,1,1.0,0.0,2020,1872
2014-06-26,United States,Germany,0,1,1,0.0,1.0,1998,2104
2014-06-28,Brazil,Chile,1,1,0,0.5,0.5,2168,2001
2014-06-28,Colombia,Uruguay,2,0,2,1.0,0.0,2007,1994
2014-06-29,China PR,Mali,1,3,2,0.0,1.0,1841,1733
2014-06-29,Costa Rica,Greece,1,1,0,0.5,0.5,1881,1939
2014-06-29,Netherlands,Mexico,2,1,1,1.0,0.0,2099,1976
2014-06-30,France,Nigeria,2,0,2,1.0,0.0,2041,1891
2014-06-30,Germany,Algeria,2,1,1,1.0,0.0,2107,1820
2014-07-01,Argentina,Switzerland,1,0,1,1.0,0.0,2103,1944
2014-07-01,Belgium,United States,2,1,1,1.0,0.0,1954,1989
2014-07-02,Vietnam,Myanmar,6,0,6,1.0,0.0,1635,1522
2014-07-04,Brazil,Colombia,2,1,1,1.0,0.0,2173,2003
2014-07-04,France,Germany,0,1,1,0.0,1.0,2035,2114
2014-07-05,Argentina,Belgium,1,0,1,1.0,0.0,2108,1950
2014-07-05,Netherlands,Costa Rica,0,0,0,0.5,0.5,2095,1886
2014-07-06,Malawi,Mozambique,1,1,0,0.5,0.5,1607,1646
2014-07-08,Brazil,Germany,1,7,6,0.0,1.0,2164,2124
2014-07-09,Netherlands,Argentina,0,0,0,0.5,0.5,2096,2108
2014-07-11,Uganda,Seychelles,1,0,1,1.0,0.0,1747,1438
2014-07-12,Brazil,Netherlands,0,3,3,0.0,1.0,2155,2106
2014-07-12,Rwanda,Gabon,1,0,1,1.0,0.0,1609,1713
2014-07-13,Germany,Argentina,1,0,1,1.0,0.0,2132,2101
2014-07-14,Botswana,Lesotho,2,0,2,1.0,0.0,1674,1498
2014-07-14,Qatar,Indonesia,2,2,0,0.5,0.5,1794,1642
2014-07-15,Kenya,Burundi,0,0,0,0.5,0.5,1655,1576
2014-07-15,Uganda,Malawi,0,0,0,0.5,0.5,1744,1611
2014-07-19,Botswana,Guinea-Bissau,2,0,2,1.0,0.0,1679,1515
2014-07-19,Sierra Leone,Seychelles,2,0,2,1.0,0.0,1619,1434
2014-07-19,Uganda,Mauritania,2,0,2,1.0,0.0,1748,1493
2014-07-20,Benin,Malawi,1,0,1,1.0,0.0,1623,1604
2014-07-20,Congo,Rwanda,2,0,2,1.0,0.0,1645,1602
2014-07-20,Lesotho,Kenya,1,0,1,1.0,0.0,1510,1644
2014-07-20,Tanzania,Mozambique,2,2,0,0.5,0.5,1653,1647
2014-07-21,Guam,Macau,0,0,0,0.5,0.5,1381,1293
2014-07-21,Mongolia,Northern Mariana Islands,4,0,4,1.0,0.0,1418,1379
2014-07-23,Guam,Mongolia,2,0,2,1.0,0.0,1390,1410
2014-07-23,Northern Mariana Islands,Macau,2,1,1,1.0,0.0,1386,1287
2014-07-25,Guam,Northern Mariana Islands,5,0,5,1.0,0.0,1398,1379
2014-07-25,Macau,Mongolia,3,2,1,1.0,0.0,1298,1400
2014-07-27,Gabon,Rwanda,0,1,1,0.0,1.0,1703,1613
2014-08-02,Guinea-Bissau,Botswana,1,1,0,0.5,0.5,1519,1676
2014-08-02,Malawi,Benin,1,0,1,1.0,0.0,1613,1615
2014-08-02,Rwanda,Congo,2,0,2,1.0,0.0,1622,1637
2014-08-03,Kenya,Lesotho,0,0,0,0.5,0.5,1642,1513
2014-08-03,Mauritania,Uganda,0,1,1,0.0,1.0,1491,1751
2014-08-03,Mozambique,Tanzania,2,1,1,1.0,0.0,1656,1645
2014-08-06,Peru,Panama,3,0,3,1.0,0.0,1840,1834
2014-08-08,Tajikistan,Malaysia,4,1,3,1.0,0.0,1612,1577
2014-08-09,Raetia,Sealand,1,6,5,0.0,1.0,1464,1495
2014-08-10,Seborga,Sealand,2,3,1,0.0,1.0,1492,1504
2014-08-12,Kazakhstan,Tajikistan,2,1,1,1.0,0.0,1591,1604
2014-08-13,Angola,Botswana,0,0,0,0.5,0.5,1740,1678
2014-08-14,Guatemala,Nicaragua,3,0,3,1.0,0.0,1709,1403
2014-08-16,British Virgin Islands,Saint Martin,2,4,2,0.0,1.0,1351,1445
2014-08-20,Azerbaijan,Uzbekistan,0,0,0,0.5,0.5,1636,1797
2014-08-20,Panama,Cuba,4,0,4,1.0,0.0,1839,1687
2014-08-23,Guatemala,Cuba,1,0,1,1.0,0.0,1717,1680
2014-08-24,French Guiana,Suriname,0,1,1,0.0,1.0,1533,1598
2014-08-26,Seychelles,Sri Lanka,1,2,1,0.0,1.0,1425,1388
2014-08-26,Saint Lucia,Martinique,0,2,2,0.0,1.0,1473,1686
2014-08-27,Norway,United Arab Emirates,0,0,0,0.5,0.5,1841,1840
2014-08-28,Seychelles,Sri Lanka,3,0,3,1.0,0.0,1433,1381
2014-08-28,Saint Lucia,Martinique,0,1,1,0.0,1.0,1470,1690
2014-08-30,Egypt,Kenya,1,0,1,1.0,0.0,1915,1640
2014-08-30,El Salvador,Dominican Republic,2,0,2,1.0,0.0,1717,1545
2014-08-31,Zambia,Sudan,3,1,2,1.0,0.0,1770,1635
2014-09-02,Niger,Uganda,2,0,2,1.0,0.0,1575,1740
2014-09-03,Myanmar,Palestine,4,1,3,1.0,0.0,1533,1604
2014-09-03,Costa Rica,Nicaragua,3,0,3,1.0,0.0,1887,1403
2014-09-03,Czech Republic,United States,0,1,1,0.0,1.0,1890,1995
2014-09-03,Denmark,Turkey,1,2,1,0.0,1.0,1911,1905
2014-09-03,England,Norway,1,0,1,1.0,0.0,2036,1838
2014-09-03,Germany,Argentina,2,4,2,0.0,1.0,2124,2110
2014-09-03,Grenada,French Guiana,1,1,0,0.5,0.5,1541,1534
2014-09-03,Guyana,Dominica,0,0,0,0.5,0.5,1605,1419
2014-09-03,Republic of Ireland,Oman,2,0,2,1.0,0.0,1896,1843
2014-09-03,Latvia,Armenia,2,0,2,1.0,0.0,1651,1654
2014-09-03,Lithuania,United Arab Emirates,1,1,0,0.5,0.5,1632,1836
2014-09-03,Morocco,Qatar,0,0,0,0.5,0.5,1764,1794
2014-09-03,Philippines,Taiwan,5,1,4,1.0,0.0,1555,1409
2014-09-03,Puerto Rico,Curaçao,2,2,0,0.5,0.5,1440,1465
2014-09-03,Russia,Azerbaijan,4,0,4,1.0,0.0,1945,1634
2014-09-03,Ukraine,Moldova,1,0,1,1.0,0.0,1944,1606
2014-09-04,Belarus,Tajikistan,6,1,5,1.0,0.0,1752,1600
2014-09-04,Belgium,Australia,2,0,2,1.0,0.0,1958,1907
2014-09-04,Bosnia and Herzegovina,Liechtenstein,3,0,3,1.0,0.0,1847,1420
2014-09-04,China PR,Kuwait,3,1,2,1.0,0.0,1849,1799
2014-09-04,Croatia,Cyprus,2,0,2,1.0,0.0,1970,1633
2014-09-04,France,Spain,1,0,1,1.0,0.0,2046,2153
2014-09-04,Iraq,Peru,0,2,2,0.0,1.0,1799,1848
2014-09-04,Italy,Netherlands,2,0,2,1.0,0.0,1996,2096
2014-09-04,Slovakia,Malta,1,0,1,1.0,0.0,1799,1486
2014-09-04,Sweden,Estonia,2,0,2,1.0,0.0,1942,1678
2014-09-04,Uzbekistan,Jordan,2,0,2,1.0,0.0,1806,1827
2014-09-05,Curaçao,Grenada,2,1,1,1.0,0.0,1475,1532
2014-09-05,Guinea,Togo,2,1,1,1.0,0.0,1770,1656
2014-09-05,Japan,Uruguay,0,2,2,0.0,1.0,1958,2002
2014-09-05,Brazil,Colombia,1,0,1,1.0,0.0,2160,1999
2014-09-05,Kazakhstan,Kyrgyzstan,7,1,6,1.0,0.0,1597,1454
2014-09-05,South Korea,Venezuela,3,1,2,1.0,0.0,1902,1836
2014-09-05,Puerto Rico,French Guiana,1,2,1,0.0,1.0,1435,1540
2014-09-05,Senegal,Egypt,2,0,2,1.0,0.0,1810,1905
2014-09-05,Saint Kitts and Nevis,Dominica,5,0,5,1.0,0.0,1570,1415
2014-09-05,Saint Lucia,Guyana,2,0,2,1.0,0.0,1481,1595
2014-09-05,Saint Vincent and the Grenadines,Anguilla,4,0,4,1.0,0.0,1561,1318
2014-09-05,Sudan,South Africa,0,3,3,0.0,1.0,1632,1840
2014-09-05,Suriname,Bonaire,2,3,1,0.0,1.0,1588,1503
2014-09-06,Burkina Faso,Lesotho,2,0,2,1.0,0.0,1709,1510
2014-09-06,DR Congo,Cameroon,0,2,2,0.0,1.0,1683,1840
2014-09-06,Ethiopia,Algeria,1,2,1,0.0,1.0,1643,1825
2014-09-06,Gabon,Angola,1,0,1,1.0,0.0,1712,1732
2014-09-06,Ghana,Uganda,1,1,0,0.5,0.5,1870,1743
2014-09-06,Ivory Coast,Sierra Leone,2,1,1,1.0,0.0,1937,1617
2014-09-06,Mexico,Chile,0,0,0,0.5,0.5,1977,2001
2014-09-06,Niger,Cape Verde,1,3,2,0.0,1.0,1569,1670
2014-09-06,Nigeria,Congo,2,3,1,0.0,1.0,1879,1650
2014-09-06,Palestine,Taiwan,7,3,4,1.0,0.0,1608,1406
2014-09-06,Philippines,Myanmar,2,3,1,0.0,1.0,1547,1542
2014-09-06,Singapore,Papua New Guinea,2,1,1,1.0,0.0,1636,1510
2014-09-06,Tunisia,Botswana,2,1,1,1.0,0.0,1836,1674
2014-09-06,Vietnam,Hong Kong,3,1,2,1.0,0.0,1642,1564
2014-09-06,Zambia,Mozambique,0,0,0,0.5,0.5,1768,1659
2014-09-07,Bonaire,Barbados,1,4,3,0.0,1.0,1497,1559
2014-09-07,Burundi,Tanzania,2,0,2,1.0,0.0,1586,1636
2014-09-07,Costa Rica,Panama,2,2,0,0.5,0.5,1886,1841
2014-09-07,Denmark,Armenia,2,1,1,1.0,0.0,1914,1652
2014-09-07,Dominica,Saint Lucia,1,2,1,0.0,1.0,1409,1488
2014-09-07,Faroe Islands,Finland,1,3,2,0.0,1.0,1454,1808
2014-09-07,French Guiana,Curaçao,0,0,0,0.5,0.5,1539,1477
2014-09-07,Georgia,Republic of Ireland,1,2,1,0.0,1.0,1664,1900
2014-09-07,Germany,Scotland,2,1,1,1.0,0.0,2127,1851
2014-09-07,Gibraltar,Poland,0,7,7,0.0,1.0,1589,1882
2014-09-07,Greece,Romania,0,1,1,0.0,1.0,1930,1888
2014-09-07,Hungary,Northern Ireland,1,2,1,0.0,1.0,1818,1666
2014-09-07,Kosovo,Oman,1,0,1,1.0,0.0,1524,1830
2014-09-07,Mali,Malawi,2,0,2,1.0,0.0,1739,1608
2014-09-07,Morocco,Libya,3,0,3,1.0,0.0,1772,1741
2014-09-07,Paraguay,United Arab Emirates,0,0,0,0.5,0.5,1895,1838
2014-09-07,Portugal,Albania,0,1,1,0.0,1.0,2007,1699
2014-09-07,Puerto Rico,Grenada,2,2,0,0.5,0.5,1438,1530
2014-09-07,Serbia,France,1,1,0,0.5,0.5,1882,2043
2014-09-08,Australia,Saudi Arabia,3,2,1,1.0,0.0,1913,1792
2014-09-08,Austria,Sweden,1,1,0,0.5,0.5,1821,1940
2014-09-08,Estonia,Slovenia,1,0,1,1.0,0.0,1689,1766
2014-09-08,South Korea,Uruguay,0,1,1,0.0,1.0,1897,2008
2014-09-08,Luxembourg,Belarus,1,1,0,0.5,0.5,1472,1747
2014-09-08,Montenegro,Moldova,2,0,2,1.0,0.0,1730,1601
2014-09-08,Russia,Liechtenstein,4,0,4,1.0,0.0,1946,1420
2014-09-08,San Marino,Lithuania,0,2,2,0.0,1.0,1327,1635
2014-09-08,Spain,North Macedonia,5,1,4,1.0,0.0,2155,1717
2014-09-08,Switzerland,England,0,2,2,0.0,1.0,1939,2042
2014-09-08,Ukraine,Slovakia,0,1,1,0.0,1.0,1933,1811
2014-09-08,Uzbekistan,New Zealand,3,1,2,1.0,0.0,1814,1760
2014-09-09,Andorra,Wales,1,2,1,0.0,1.0,1346,1773
2014-09-09,Azerbaijan,Bulgaria,1,2,1,0.0,1.0,1630,1815
2014-09-09,Bosnia and Herzegovina,Cyprus,1,2,1,0.0,1.0,1835,1646
2014-09-09,China PR,Jordan,1,1,0,0.5,0.5,1849,1828
2014-09-09,Croatia,Malta,2,0,2,1.0,0.0,1971,1486
2014-09-09,Czech Republic,Netherlands,2,1,1,1.0,0.0,1903,2084
2014-09-09,Haiti,Chile,0,1,1,0.0,1.0,1670,2004
2014-09-09,Iceland,Turkey,3,0,3,1.0,0.0,1715,1893
2014-09-09,Indonesia,Yemen,0,0,0,0.5,0.5,1640,1537
2014-09-09,Japan,Venezuela,2,2,0,0.5,0.5,1956,1839
2014-09-09,Kazakhstan,Latvia,0,0,0,0.5,0.5,1599,1650
2014-09-09,Kuwait,Bahrain,0,1,1,0.0,1.0,1791,1782
2014-09-09,Mexico,Bolivia,1,0,1,1.0,0.0,1981,1731
2014-09-09,Norway,Italy,0,2,2,0.0,1.0,1834,2001
2014-09-09,Qatar,Peru,0,2,2,0.0,1.0,1788,1855
2014-09-09,Singapore,Hong Kong,0,0,0,0.5,0.5,1635,1566
2014-09-10,Algeria,Mali,1,0,1,1.0,0.0,1832,1733
2014-09-10,Angola,Burkina Faso,0,3,3,0.0,1.0,1724,1718
2014-09-10,Botswana,Senegal,0,2,2,0.0,1.0,1669,1816
2014-09-10,Cameroon,Ivory Coast,4,1,3,1.0,0.0,1851,1927
2014-09-10,Cape Verde,Zambia,2,1,1,1.0,0.0,1681,1758
2014-09-10,Congo,Sudan,2,0,2,1.0,0.0,1658,1625
2014-09-10,DR Congo,Sierra Leone,2,0,2,1.0,0.0,1690,1611
2014-09-10,Egypt,Tunisia,0,1,1,0.0,1.0,1896,1846
2014-09-10,Lesotho,Gabon,1,1,0,0.5,0.5,1515,1708
2014-09-10,Malawi,Ethiopia,3,2,1,1.0,0.0,1617,1635
2014-09-10,Mozambique,Niger,1,1,0,0.5,0.5,1657,1572
2014-09-10,South Africa,Nigeria,0,0,0,0.5,0.5,1841,1879
2014-09-10,Togo,Ghana,2,3,1,0.0,1.0,1653,1874
2014-09-10,Uganda,Guinea,2,0,2,1.0,0.0,1752,1762
2014-09-14,Indonesia,Malaysia,2,0,2,1.0,0.0,1647,1571
2014-09-20,Malaysia,Cambodia,4,1,3,1.0,0.0,1574,1299
2014-09-25,Indonesia,Cambodia,1,0,1,1.0,0.0,1649,1298
2014-09-30,Botswana,Zimbabwe,1,0,1,1.0,0.0,1678,1671
2014-10-06,India,Palestine,2,3,1,0.0,1.0,1558,1616
2014-10-06,Qatar,Uzbekistan,3,0,3,1.0,0.0,1797,1806
2014-10-08,Antigua and Barbuda,Saint Lucia,2,1,1,1.0,0.0,1578,1482
2014-10-08,Curaçao,Martinique,1,1,0,0.5,0.5,1482,1686
2014-10-08,Haiti,French Guiana,2,2,0,0.5,0.5,1668,1542
2014-10-08,Saint Kitts and Nevis,Barbados,2,3,1,0.0,1.0,1562,1568
2014-10-08,Trinidad and Tobago,Dominican Republic,6,1,5,1.0,0.0,1736,1541
2014-10-09,Belarus,Ukraine,0,2,2,0.0,1.0,1743,1938
2014-10-09,England,San Marino,5,0,5,1.0,0.0,2043,1327
2014-10-09,Liechtenstein,Montenegro,0,0,0,0.5,0.5,1426,1725
2014-10-09,Lithuania,Estonia,1,0,1,1.0,0.0,1645,1680
2014-10-09,North Macedonia,Luxembourg,3,2,1,1.0,0.0,1721,1469
2014-10-09,Moldova,Austria,1,2,1,0.0,1.0,1598,1825
2014-10-09,Morocco,Central African Republic,4,0,4,1.0,0.0,1775,1482
2014-10-09,Qatar,Lebanon,5,0,5,1.0,0.0,1803,1657
2014-10-09,Slovakia,Spain,2,1,1,1.0,0.0,1826,2141
2014-10-09,Slovenia,Switzerland,1,0,1,1.0,0.0,1778,1928
2014-10-09,Sweden,Russia,1,1,0,0.5,0.5,1941,1946
2014-10-10,Belgium,Andorra,6,0,6,1.0,0.0,1959,1346
2014-10-10,Botswana,Egypt,0,2,2,0.0,1.0,1675,1900
2014-10-10,Bulgaria,Croatia,0,1,1,0.0,1.0,1811,1976
2014-10-10,China PR,Thailand,3,0,3,1.0,0.0,1855,1727
2014-10-10,Cyprus,Israel,1,2,1,0.0,1.0,1642,1801
2014-10-10,French Guiana,Saint Kitts and Nevis,1,2,1,0.0,1.0,1535,1570
2014-10-10,Hong Kong,Singapore,2,1,1,1.0,0.0,1576,1626
2014-10-10,Italy,Azerbaijan,2,1,1,1.0,0.0,2003,1629
2014-10-10,Japan,Jamaica,1,0,1,1.0,0.0,1960,1758
2014-10-10,Jordan,Kuwait,0,1,1,0.0,1.0,1820,1800
2014-10-10,South Korea,Paraguay,2,0,2,1.0,0.0,1905,1888
2014-10-10,Latvia,Iceland,0,3,3,0.0,1.0,1644,1722
2014-10-10,Lesotho,Angola,0,0,0,0.5,0.5,1520,1720
2014-10-10,Malta,Norway,0,3,3,0.0,1.0,1485,1836
2014-10-10,Netherlands,Kazakhstan,3,1,2,1.0,0.0,2085,1599
2014-10-10,Oman,Costa Rica,3,4,1,0.0,1.0,1824,1893
2014-10-10,Saudi Arabia,Uruguay,1,1,0,0.5,0.5,1797,2004
2014-10-10,Senegal,Tunisia,0,0,0,0.5,0.5,1817,1846
2014-10-10,Saint Vincent and the Grenadines,Curaçao,1,0,1,1.0,0.0,1568,1476
2014-10-10,Trinidad and Tobago,Saint Lucia,2,0,2,1.0,0.0,1740,1479
2014-10-10,Turkey,Czech Republic,1,2,1,0.0,1.0,1886,1911
2014-10-10,United Arab Emirates,Australia,0,0,0,0.5,0.5,1840,1912
2014-10-10,Uzbekistan,Bahrain,0,0,0,0.5,0.5,1806,1783
2014-10-10,Wales,Bosnia and Herzegovina,0,0,0,0.5,0.5,1775,1834
2014-10-10,Yemen,Iraq,1,1,0,0.5,0.5,1543,1794
2014-10-10,Chile,Peru,3,0,3,1.0,0.0,2009,1851
2014-10-11,Albania,Denmark,1,1,0,0.5,0.5,1704,1910
2014-10-11,Argentina,Brazil,0,2,2,0.0,1.0,2104,2167
2014-10-11,Armenia,Serbia,1,1,0,0.5,0.5,1657,1878
2014-10-11,Cameroon,Sierra Leone,0,0,0,0.5,0.5,1847,1616
2014-10-11,Congo,South Africa,0,2,2,0.0,1.0,1654,1846
2014-10-11,DR Congo,Ivory Coast,1,2,1,0.0,1.0,1687,1931
2014-10-11,Ethiopia,Mali,0,2,2,0.0,1.0,1630,1739
2014-10-11,Finland,Greece,1,1,0,0.5,0.5,1811,1928
2014-10-11,France,Portugal,2,1,1,1.0,0.0,2051,2000
2014-10-11,Gabon,Burkina Faso,2,0,2,1.0,0.0,1717,1710
2014-10-11,Guinea,Ghana,1,1,0,0.5,0.5,1765,1872
2014-10-11,Republic of Ireland,Gibraltar,7,0,7,1.0,0.0,1903,1587
2014-10-11,Malawi,Algeria,0,2,2,0.0,1.0,1614,1836
2014-10-11,Mozambique,Cape Verde,2,0,2,1.0,0.0,1666,1673
2014-10-11,Niger,Zambia,0,0,0,0.5,0.5,1576,1755
2014-10-11,Northern Ireland,Faroe Islands,2,0,2,1.0,0.0,1670,1451
2014-10-11,Poland,Germany,2,0,2,1.0,0.0,1895,2115
2014-10-11,Romania,Hungary,1,1,0,0.5,0.5,1887,1820
2014-10-11,Scotland,Georgia,1,0,1,1.0,0.0,1856,1660
2014-10-11,Sudan,Nigeria,1,0,1,1.0,0.0,1638,1867
2014-10-11,Uganda,Togo,0,1,1,0.0,1.0,1742,1664
2014-10-12,Austria,Montenegro,1,0,1,1.0,0.0,1831,1720
2014-10-12,Barbados,French Guiana,0,2,2,0.0,1.0,1560,1544
2014-10-12,Belarus,Slovakia,1,3,2,0.0,1.0,1737,1833
2014-10-12,Timor-Leste,Brunei,4,2,2,1.0,0.0,1357,1290
2014-10-12,Estonia,England,0,1,1,0.0,1.0,1679,2045
2014-10-12,Guadeloupe,Curaçao,0,1,1,0.0,1.0,1672,1489
2014-10-12,Haiti,Saint Kitts and Nevis,0,0,0,0.5,0.5,1666,1573
2014-10-12,Laos,Cambodia,3,2,1,1.0,0.0,1404,1293
2014-10-12,Lithuania,Slovenia,0,2,2,0.0,1.0,1640,1784
2014-10-12,Luxembourg,Spain,0,4,4,0.0,1.0,1469,2142
2014-10-12,Mexico,Panama,1,0,1,1.0,0.0,1986,1837
2014-10-12,Pakistan,Palestine,0,2,2,0.0,1.0,1371,1620
2014-10-12,Philippines,Papua New Guinea,5,0,5,1.0,0.0,1555,1503
2014-10-12,Russia,Moldova,1,1,0,0.5,0.5,1940,1605
2014-10-12,Saint Lucia,Dominican Republic,2,3,1,0.0,1.0,1473,1548
2014-10-12,Sweden,Liechtenstein,2,0,2,1.0,0.0,1942,1426
2014-10-12,Tanzania,Benin,4,1,3,1.0,0.0,1644,1608
2014-10-12,Trinidad and Tobago,Antigua and Barbuda,1,0,1,1.0,0.0,1745,1574
2014-10-12,Ukraine,North Macedonia,1,0,1,1.0,0.0,1942,1718
2014-10-13,Andorra,Israel,1,4,3,0.0,1.0,1345,1803
2014-10-13,Bosnia and Herzegovina,Belgium,1,1,0,0.5,0.5,1837,1957
2014-10-13,Croatia,Azerbaijan,6,0,6,1.0,0.0,1978,1628
2014-10-13,Iceland,Netherlands,2,0,2,1.0,0.0,1737,2071
2014-10-13,Jordan,Kuwait,1,1,0,0.5,0.5,1820,1801
2014-10-13,Kazakhstan,Czech Republic,2,4,2,0.0,1.0,1597,1914
2014-10-13,Latvia,Turkey,1,1,0,0.5,0.5,1649,1882
2014-10-13,Malta,Italy,0,1,1,0.0,1.0,1485,2004
2014-10-13,Morocco,Kenya,3,0,3,1.0,0.0,1781,1635
2014-10-13,Norway,Bulgaria,2,1,1,1.0,0.0,1844,1804
2014-10-13,Oman,Uruguay,0,3,3,0.0,1.0,1820,2009
2014-10-13,Wales,Cyprus,2,1,1,1.0,0.0,1781,1637
2014-10-14,Armenia,France,0,3,3,0.0,1.0,1656,2053
2014-10-14,Bahrain,Iraq,0,0,0,0.5,0.5,1784,1794
2014-10-14,Myanmar,Timor-Leste,0,0,0,0.5,0.5,1539,1361
2014-10-14,China PR,Paraguay,2,1,1,1.0,0.0,1864,1880
2014-10-14,Denmark,Portugal,0,1,1,0.0,1.0,1905,2006
2014-10-14,Faroe Islands,Hungary,0,1,1,0.0,1.0,1450,1822
2014-10-14,Finland,Romania,0,2,2,0.0,1.0,1805,1894
2014-10-14,Germany,Republic of Ireland,1,1,0,0.5,0.5,2111,1908
2014-10-14,Gibraltar,Georgia,0,3,3,0.0,1.0,1581,1667
2014-10-14,Greece,Northern Ireland,0,2,2,0.0,1.0,1915,1684
2014-10-14,Hong Kong,Argentina,0,7,7,0.0,1.0,1576,2105
2014-10-14,Japan,Brazil,0,4,4,0.0,1.0,1957,2171
2014-10-14,South Korea,Costa Rica,1,3,2,0.0,1.0,1897,1902
2014-10-14,Laos,Brunei,4,2,2,1.0,0.0,1410,1285
2014-10-14,Macau,Singapore,2,2,0,0.5,0.5,1304,1621
2014-10-14,Poland,Scotland,2,2,0,0.5,0.5,1895,1857
2014-10-14,Qatar,Australia,1,0,1,1.0,0.0,1814,1902
2014-10-14,San Marino,Switzerland,0,4,4,0.0,1.0,1327,1929
2014-10-14,Saudi Arabia,Lebanon,1,1,0,0.5,0.5,1794,1661
2014-10-14,Serbia,Albania,0,3,3,0.0,1.0,1867,1716
2014-10-14,United Arab Emirates,Uzbekistan,0,4,4,0.0,1.0,1832,1815
2014-10-14,United States,Honduras,1,1,0,0.5,0.5,1992,1828
2014-10-14,Peru,Guatemala,1,0,1,1.0,0.0,1857,1712
2014-10-15,Algeria,Malawi,3,0,3,1.0,0.0,1840,1611
2014-10-15,Angola,Lesotho,4,0,4,1.0,0.0,1724,1517
2014-10-15,Burkina Faso,Gabon,1,1,0,0.5,0.5,1711,1717
2014-10-15,Cameroon,Sierra Leone,2,0,2,1.0,0.0,1851,1613
2014-10-15,Cape Verde,Mozambique,1,0,1,1.0,0.0,1681,1659
2014-10-15,Egypt,Botswana,2,0,2,1.0,0.0,1904,1672
2014-10-15,Ghana,Guinea,3,1,2,1.0,0.0,1878,1760
2014-10-15,Ivory Coast,DR Congo,3,4,1,0.0,1.0,1919,1700
2014-10-15,Mali,Ethiopia,2,3,1,0.0,1.0,1729,1641
2014-10-15,Nigeria,Sudan,3,1,2,1.0,0.0,1871,1635
2014-10-15,South Africa,Congo,0,0,0,0.5,0.5,1842,1659
2014-10-15,Eswatini,Zimbabwe,0,2,2,0.0,1.0,1470,1675
2014-10-15,Togo,Uganda,1,0,1,1.0,0.0,1674,1733
2014-10-15,Tunisia,Senegal,1,0,1,1.0,0.0,1854,1810
2014-10-15,Zambia,Niger,3,0,3,1.0,0.0,1760,1572
2014-10-16,Brunei,Myanmar,1,3,2,0.0,1.0,1282,1543
2014-10-16,Timor-Leste,Cambodia,2,3,1,0.0,1.0,1352,1303
2014-10-18,Cambodia,Myanmar,0,1,1,0.0,1.0,1300,1547
2014-10-18,Laos,Timor-Leste,2,0,2,1.0,0.0,1417,1346
2014-10-20,Cambodia,Brunei,1,0,1,1.0,0.0,1308,1275
2014-10-20,Laos,Myanmar,1,2,1,0.0,1.0,1412,1553
2014-10-24,Bangladesh,Sri Lanka,1,1,0,0.5,0.5,1434,1383
2014-10-25,Zambia,Ivory Coast,1,1,0,0.5,0.5,1764,1916
2014-10-27,Bangladesh,Sri Lanka,1,0,1,1.0,0.0,1441,1377
2014-10-31,North Korea,Kuwait,0,1,1,0.0,1.0,1776,1809
2014-10-31,Philippines,Nepal,3,0,3,1.0,0.0,1560,1404
2014-11-02,Bahrain,North Korea,2,2,0,0.5,0.5,1784,1777
2014-11-04,Kuwait,Yemen,1,1,0,0.5,0.5,1804,1549
2014-11-06,Qatar,North Korea,3,1,2,1.0,0.0,1822,1770
2014-11-06,Saudi Arabia,Palestine,2,0,2,1.0,0.0,1799,1616
2014-11-06,United Arab Emirates,Lebanon,3,2,1,1.0,0.0,1837,1657
2014-11-07,Bahrain,Singapore,2,0,2,1.0,0.0,1789,1617
2014-11-07,Oman,Yemen,2,0,2,1.0,0.0,1823,1547
2014-11-08,Székely Land,Raetia,3,0,3,1.0,0.0,1508,1457
2014-11-09,Thailand,Philippines,3,0,3,1.0,0.0,1732,1556
2014-11-09,Uganda,Ethiopia,3,0,3,1.0,0.0,1739,1636
2014-11-09,Vietnam,Palestine,1,3,2,0.0,1.0,1634,1625
2014-11-11,Cuba,French Guiana,1,1,0,0.5,0.5,1678,1547
2014-11-11,Curaçao,Trinidad and Tobago,2,3,1,0.0,1.0,1487,1748
2014-11-12,Argentina,Croatia,2,1,1,1.0,0.0,2111,1973
2014-11-12,Belgium,Iceland,3,1,2,1.0,0.0,1961,1734
2014-11-12,Haiti,Antigua and Barbuda,2,2,0,0.5,0.5,1664,1577
2014-11-12,Netherlands,Mexico,2,3,1,0.0,1.0,2062,1996
2014-11-12,Norway,Estonia,0,1,1,0.0,1.0,1833,1691
2014-11-12,Turkey,Brazil,0,4,4,0.0,1.0,1880,2174
2014-11-13,Curaçao,Cuba,2,3,1,0.0,1.0,1484,1682
2014-11-13,North Korea,Hong Kong,2,1,1,1.0,0.0,1774,1573
2014-11-13,Morocco,Benin,6,1,5,1.0,0.0,1786,1604
2014-11-13,Saudi Arabia,Qatar,1,1,0,0.5,0.5,1800,1822
2014-11-13,Singapore,Laos,2,0,2,1.0,0.0,1621,1409
2014-11-13,Trinidad and Tobago,French Guiana,4,2,2,1.0,0.0,1752,1544
2014-11-13,Uruguay,Costa Rica,3,3,0,0.5,0.5,2007,1905
2014-11-13,Yemen,Bahrain,0,0,0,0.5,0.5,1552,1785
2014-11-14,Botswana,Tunisia,0,0,0,0.5,0.5,1676,1851
2014-11-14,China PR,New Zealand,1,1,0,0.5,0.5,1862,1763
2014-11-14,France,Albania,1,1,0,0.5,0.5,2048,1722
2014-11-14,Georgia,Poland,0,4,4,0.0,1.0,1664,1899
2014-11-14,Germany,Gibraltar,4,0,4,1.0,0.0,2112,1581
2014-11-14,Greece,Faroe Islands,0,1,1,0.0,1.0,1901,1465
2014-11-14,Hungary,Finland,1,0,1,1.0,0.0,1830,1798
2014-11-14,Iraq,Kuwait,0,1,1,0.0,1.0,1787,1812
2014-11-14,Ivory Coast,Sierra Leone,5,1,4,1.0,0.0,1919,1611
2014-11-14,Japan,Honduras,6,0,6,1.0,0.0,1963,1823
2014-11-14,Jordan,South Korea,0,1,1,0.0,1.0,1814,1904
2014-11-14,Martinique,Haiti,0,3,3,0.0,1.0,1678,1673
2014-11-14,Paraguay,Peru,2,1,1,1.0,0.0,1888,1850
2014-11-14,Philippines,Cambodia,3,0,3,1.0,0.0,1560,1305
2014-11-14,Portugal,Armenia,1,0,1,1.0,0.0,2008,1655
2014-11-14,Romania,Northern Ireland,2,0,2,1.0,0.0,1898,1681
2014-11-14,Scotland,Republic of Ireland,1,0,1,1.0,0.0,1867,1899
2014-11-14,Serbia,Denmark,1,3,2,0.0,1.0,1860,1913
2014-11-14,United Arab Emirates,Oman,0,0,0,0.5,0.5,1837,1824
2014-11-14,United States,Colombia,1,2,1,0.0,1.0,1985,2007
2014-11-15,Algeria,Ethiopia,3,1,2,1.0,0.0,1844,1633
2014-11-15,Angola,Gabon,0,0,0,0.5,0.5,1724,1718
2014-11-15,Austria,Russia,1,0,1,1.0,0.0,1842,1930
2014-11-15,Cameroon,DR Congo,1,0,1,1.0,0.0,1856,1696
2014-11-15,Cape Verde,Niger,3,1,2,1.0,0.0,1687,1567
2014-11-15,Congo,Nigeria,0,2,2,0.0,1.0,1656,1875
2014-11-15,Egypt,Senegal,0,1,1,0.0,1.0,1894,1821
2014-11-15,England,Slovenia,3,1,2,1.0,0.0,2048,1782
2014-11-15,French Guiana,Curaçao,4,1,3,1.0,0.0,1551,1478
2014-11-15,Indonesia,Syria,0,2,2,0.0,1.0,1643,1711
2014-11-15,Lesotho,Burkina Faso,0,1,1,0.0,1.0,1514,1715
2014-11-15,Luxembourg,Ukraine,0,3,3,0.0,1.0,1469,1943
2014-11-15,North Macedonia,Slovakia,0,2,2,0.0,1.0,1713,1839
2014-11-15,Malawi,Mali,2,0,2,1.0,0.0,1622,1719
2014-11-15,Moldova,Liechtenstein,0,1,1,0.0,1.0,1594,1438
2014-11-15,Montenegro,Sweden,1,1,0,0.5,0.5,1725,1938
2014-11-15,Mozambique,Zambia,0,1,1,0.0,1.0,1654,1770
2014-11-15,San Marino,Estonia,0,0,0,0.5,0.5,1334,1685
2014-11-15,South Africa,Sudan,2,1,1,1.0,0.0,1846,1632
2014-11-15,Spain,Belarus,3,0,3,1.0,0.0,2144,1736
2014-11-15,Switzerland,Lithuania,4,0,4,1.0,0.0,1932,1638
2014-11-15,Togo,Guinea,1,4,3,0.0,1.0,1668,1767
2014-11-15,Uganda,Ghana,1,0,1,1.0,0.0,1751,1867
2014-11-16,Antigua and Barbuda,Martinique,0,2,2,0.0,1.0,1572,1684
2014-11-16,Azerbaijan,Norway,0,1,1,0.0,1.0,1625,1837
2014-11-16,Belgium,Wales,0,0,0,0.5,0.5,1958,1785
2014-11-16,Bulgaria,Malta,1,1,0,0.5,0.5,1799,1491
2014-11-16,Cyprus,Andorra,5,0,5,1.0,0.0,1640,1343
2014-11-16,Czech Republic,Iceland,2,1,1,1.0,0.0,1919,1730
2014-11-16,Guam,North Korea,1,5,4,0.0,1.0,1397,1776
2014-11-16,Israel,Bosnia and Herzegovina,3,0,3,1.0,0.0,1812,1829
2014-11-16,Italy,Croatia,1,1,0,0.5,0.5,2004,1974
2014-11-16,Morocco,Zimbabwe,2,1,1,1.0,0.0,1792,1670
2014-11-16,Netherlands,Latvia,6,0,6,1.0,0.0,2064,1648
2014-11-16,Saudi Arabia,Bahrain,3,0,3,1.0,0.0,1808,1778
2014-11-16,Eswatini,Tanzania,1,1,0,0.5,0.5,1474,1641
2014-11-16,Turkey,Kazakhstan,3,1,2,1.0,0.0,1883,1595
2014-11-16,Vietnam,Malaysia,3,1,2,1.0,0.0,1641,1568
2014-11-16,Yemen,Qatar,0,0,0,0.5,0.5,1558,1817
2014-11-17,Iraq,Oman,1,1,0,0.5,0.5,1788,1824
2014-11-17,Singapore,Cambodia,4,2,2,1.0,0.0,1624,1303
2014-11-17,United Arab Emirates,Kuwait,2,2,0,0.5,0.5,1837,1813
2014-11-18,Austria,Brazil,1,2,1,0.0,1.0,1840,2177
2014-11-18,Belarus,Mexico,3,2,1,1.0,0.0,1750,1983
2014-11-18,Bolivia,Venezuela,3,2,1,1.0,0.0,1742,1829
2014-11-18,Chile,Uruguay,1,2,1,0.0,1.0,2001,2016
2014-11-18,China PR,Honduras,0,0,0,0.5,0.5,1862,1824
2014-11-18,Cuba,Haiti,1,2,1,0.0,1.0,1674,1682
2014-11-18,Estonia,Jordan,1,0,1,1.0,0.0,1696,1804
2014-11-18,France,Sweden,1,0,1,1.0,0.0,2054,1933
2014-11-18,Greece,Serbia,0,2,2,0.0,1.0,1893,1869
2014-11-18,Hungary,Russia,1,2,1,0.0,1.0,1825,1936
2014-11-18,Iran,South Korea,1,0,1,1.0,0.0,1913,1897
2014-11-18,Republic of Ireland,United States,4,1,3,1.0,0.0,1909,1976
2014-11-18,Italy,Albania,1,0,1,1.0,0.0,2007,1720
2014-11-18,Jamaica,Trinidad and Tobago,0,0,0,0.5,0.5,1758,1753
2014-11-18,Japan,Australia,2,1,1,1.0,0.0,1970,1896
2014-11-18,Nicaragua,El Salvador,0,2,2,0.0,1.0,1401,1720
2014-11-18,Panama,Canada,0,0,0,0.5,0.5,1835,1720
2014-11-18,Peru,Paraguay,2,1,1,1.0,0.0,1859,1880
2014-11-18,Portugal,Argentina,1,0,1,1.0,0.0,2019,2101
2014-11-18,Romania,Denmark,2,0,2,1.0,0.0,1907,1905
2014-11-18,Scotland,England,1,3,2,0.0,1.0,1863,2053
2014-11-18,Slovakia,Finland,2,1,1,1.0,0.0,1847,1791
2014-11-18,Slovenia,Colombia,0,1,1,0.0,1.0,1779,2011
2014-11-18,Spain,Germany,0,1,1,0.0,1.0,2136,2121
2014-11-18,Thailand,New Zealand,2,0,2,1.0,0.0,1741,1755
2014-11-18,Ukraine,Lithuania,0,0,0,0.5,0.5,1938,1644
2014-11-19,Bahrain,Qatar,0,0,0,0.5,0.5,1779,1817
2014-11-19,Burkina Faso,Angola,1,1,0,0.5,0.5,1716,1724
2014-11-19,DR Congo,Sierra Leone,3,1,2,1.0,0.0,1703,1605
2014-11-19,Ethiopia,Malawi,0,0,0,0.5,0.5,1633,1623
2014-11-19,Gabon,Lesotho,4,2,2,1.0,0.0,1722,1511
2014-11-19,Ghana,Togo,3,1,2,1.0,0.0,1871,1665
2014-11-19,Guam,Hong Kong,0,0,0,0.5,0.5,1401,1570
2014-11-19,Guinea,Uganda,2,0,2,1.0,0.0,1775,1744
2014-11-19,Ivory Coast,Cameroon,0,0,0,0.5,0.5,1918,1858
2014-11-19,Mali,Algeria,2,0,2,1.0,0.0,1730,1834
2014-11-19,Niger,Mozambique,1,1,0,0.5,0.5,1569,1653
2014-11-19,Nigeria,South Africa,2,2,0,0.5,0.5,1875,1847
2014-11-19,Saudi Arabia,Yemen,1,0,1,1.0,0.0,1812,1555
2014-11-19,Senegal,Botswana,3,0,3,1.0,0.0,1826,1672
2014-11-19,Sudan,Congo,0,1,1,0.0,1.0,1625,1664
2014-11-19,Tunisia,Egypt,2,1,1,1.0,0.0,1860,1886
2014-11-19,Zambia,Cape Verde,1,0,1,1.0,0.0,1777,1681
2014-11-20,Kuwait,Oman,0,5,5,0.0,1.0,1806,1832
2014-11-20,United Arab Emirates,Iraq,2,0,2,1.0,0.0,1844,1782
2014-11-22,Philippines,Laos,4,1,3,1.0,0.0,1565,1405
2014-11-22,Vietnam,Indonesia,2,2,0,0.5,0.5,1642,1643
2014-11-23,Malaysia,Myanmar,0,0,0,0.5,0.5,1568,1554
2014-11-23,Oman,Qatar,1,3,2,0.0,1.0,1824,1826
2014-11-23,Saudi Arabia,United Arab Emirates,3,2,1,1.0,0.0,1821,1836
2014-11-23,Singapore,Thailand,1,2,1,0.0,1.0,1619,1747
2014-11-25,Philippines,Indonesia,4,0,4,1.0,0.0,1575,1634
2014-11-25,Vietnam,Laos,3,0,3,1.0,0.0,1646,1402
2014-11-25,United Arab Emirates,Oman,1,0,1,1.0,0.0,1844,1817
2014-11-26,Malaysia,Thailand,2,3,1,0.0,1.0,1564,1752
2014-11-26,Saudi Arabia,Qatar,1,2,1,0.0,1.0,1814,1834
2014-11-26,Singapore,Myanmar,4,2,2,1.0,0.0,1626,1548
2014-11-28,Indonesia,Laos,5,1,4,1.0,0.0,1638,1399
2014-11-28,Vietnam,Philippines,3,1,2,1.0,0.0,1653,1569
2014-11-29,Singapore,Malaysia,1,3,2,0.0,1.0,1617,1574
2014-11-29,Thailand,Myanmar,2,0,2,1.0,0.0,1756,1545
2014-11-30,South Africa,Ivory Coast,2,0,2,1.0,0.0,1857,1909
2014-12-06,Philippines,Thailand,0,0,0,0.5,0.5,1573,1753
2014-12-07,Malaysia,Vietnam,1,2,1,0.0,1.0,1568,1660
2014-12-10,Thailand,Philippines,3,0,3,1.0,0.0,1758,1569
2014-12-11,Vietnam,Malaysia,2,4,2,0.0,1.0,1650,1579
2014-12-13,Uzbekistan,Palestine,1,0,1,1.0,0.0,1820,1621
2014-12-17,Thailand,Malaysia,2,0,2,1.0,0.0,1763,1575
2014-12-20,Malaysia,Thailand,3,2,1,1.0,0.0,1587,1752
2014-12-21,China PR,Palestine,0,0,0,0.5,0.5,1858,1626
2014-12-21,Uzbekistan,Jordan,2,1,1,1.0,0.0,1828,1797
2014-12-22,Iraq,Kuwait,1,1,0,0.5,0.5,1783,1806
2014-12-25,Uzbekistan,Iraq,1,0,1,1.0,0.0,1835,1777
2014-12-27,Qatar,Estonia,3,0,3,1.0,0.0,1839,1692
2014-12-28,Uzbekistan,Iraq,0,0,0,0.5,0.5,1834,1779
2014-12-28,Basque Country,Catalonia,1,1,0,0.5,0.5,1753,1670
2014-12-30,Bahrain,Saudi Arabia,4,1,3,1.0,0.0,1788,1806
2014-12-30,United Arab Emirates,Jordan,1,0,1,1.0,0.0,1851,1791
2014-12-30,Occitania,Ellan Vannin,5,1,4,1.0,0.0,1588,1527
2014-12-31,Qatar,Oman,2,2,0,0.5,0.5,1839,1818
2015-01-04,Bahrain,Jordan,1,0,1,1.0,0.0,1797,1783
2015-01-04,Iran,Iraq,1,0,1,1.0,0.0,1919,1774
2015-01-04,South Korea,Saudi Arabia,2,0,2,1.0,0.0,1903,1801
2015-01-04,South Africa,Zambia,1,0,1,1.0,0.0,1864,1771
2015-01-05,China PR,Oman,4,1,3,1.0,0.0,1866,1811
2015-01-07,Cameroon,DR Congo,1,1,0,0.5,0.5,1855,1707
2015-01-09,Australia,Kuwait,4,1,3,1.0,0.0,1902,1801
2015-01-09,Senegal,Gabon,1,0,1,1.0,0.0,1832,1717
2015-01-10,Burkina Faso,Eswatini,5,1,4,1.0,0.0,1720,1471
2015-01-10,Cameroon,South Africa,1,1,0,0.5,0.5,1856,1864
2015-01-10,Cape Verde,Congo,3,2,1,1.0,0.0,1689,1657
2015-01-10,South Korea,Oman,1,0,1,1.0,0.0,1909,1806
2015-01-10,Saudi Arabia,China PR,0,1,1,0.0,1.0,1795,1873
2015-01-10,Uzbekistan,North Korea,1,0,1,1.0,0.0,1841,1770
2015-01-11,Iran,Bahrain,2,0,2,1.0,0.0,1925,1792
2015-01-11,Nigeria,Ivory Coast,0,1,1,0.0,1.0,1868,1917
2015-01-11,Tunisia,Algeria,1,1,0,0.5,0.5,1860,1835
2015-01-11,United Arab Emirates,Qatar,4,1,3,1.0,0.0,1859,1832
2015-01-12,Japan,Palestine,4,0,4,1.0,0.0,1972,1625
2015-01-12,Jordan,Iraq,0,1,1,0.0,1.0,1775,1783
2015-01-13,Australia,Oman,4,0,4,1.0,0.0,1908,1801
2015-01-13,Botswana,Burkina Faso,0,2,2,0.0,1.0,1666,1727
2015-01-13,Kuwait,South Korea,0,1,1,0.0,1.0,1796,1915
2015-01-13,Senegal,Guinea,5,2,3,1.0,0.0,1839,1769
2015-01-14,China PR,Uzbekistan,2,1,1,1.0,0.0,1881,1834
2015-01-14,North Korea,Saudi Arabia,1,4,3,0.0,1.0,1763,1803
2015-01-14,Mali,South Africa,0,3,3,0.0,1.0,1725,1870
2015-01-15,Bahrain,United Arab Emirates,1,2,1,0.0,1.0,1786,1866
2015-01-15,Qatar,Iran,0,1,1,0.0,1.0,1827,1931
2015-01-15,Sweden,Ivory Coast,2,0,2,1.0,0.0,1941,1910
2015-01-16,Canada,Iceland,1,2,1,0.0,1.0,1713,1738
2015-01-16,Iraq,Japan,0,1,1,0.0,1.0,1779,1977
2015-01-16,Palestine,Jordan,1,5,4,0.0,1.0,1621,1780
2015-01-17,Australia,South Korea,0,1,1,0.0,1.0,1901,1923
2015-01-17,Burkina Faso,Gabon,0,2,2,0.0,1.0,1719,1726
2015-01-17,Equatorial Guinea,Congo,1,1,0,0.5,0.5,1541,1655
2015-01-17,Oman,Kuwait,1,0,1,1.0,0.0,1809,1789
2015-01-17,Yemen,Nigeria,0,2,2,0.0,1.0,1553,1871
2015-01-18,China PR,North Korea,2,1,1,1.0,0.0,1887,1758
2015-01-18,Tunisia,Cape Verde,1,1,0,0.5,0.5,1857,1693
2015-01-18,Uzbekistan,Saudi Arabia,3,1,2,1.0,0.0,1842,1796
2015-01-18,Zambia,DR Congo,1,1,0,0.5,0.5,1770,1709
2015-01-19,Algeria,South Africa,3,1,2,1.0,0.0,1844,1862
2015-01-19,Canada,Iceland,1,1,0,0.5,0.5,1714,1738
2015-01-19,Finland,Sweden,1,0,1,1.0,0.0,1803,1930
2015-01-19,Ghana,Senegal,1,2,1,0.0,1.0,1863,1848
2015-01-19,Iran,United Arab Emirates,1,0,1,1.0,0.0,1938,1860
2015-01-19,Qatar,Bahrain,1,2,1,0.0,1.0,1819,1795
2015-01-20,Iraq,Palestine,2,0,2,1.0,0.0,1784,1617
2015-01-20,Ivory Coast,Guinea,1,1,0,0.5,0.5,1907,1773
2015-01-20,Japan,Jordan,2,0,2,1.0,0.0,1981,1777
2015-01-20,Mali,Cameroon,1,1,0,0.5,0.5,1728,1854
2015-01-21,Equatorial Guinea,Burkina Faso,0,0,0,0.5,0.5,1545,1716
2015-01-21,Gabon,Congo,0,1,1,0.0,1.0,1717,1665
2015-01-22,Australia,China PR,2,0,2,1.0,0.0,1909,1880
2015-01-22,Cape Verde,DR Congo,0,0,0,0.5,0.5,1694,1709
2015-01-22,South Korea,Uzbekistan,2,0,2,1.0,0.0,1930,1836
2015-01-22,Yemen,Finland,0,0,0,0.5,0.5,1558,1799
2015-01-22,Zambia,Tunisia,1,2,1,0.0,1.0,1764,1864
2015-01-23,Ghana,Algeria,1,0,1,1.0,0.0,1871,1837
2015-01-23,Iran,Iraq,3,3,0,0.5,0.5,1935,1788
2015-01-23,Japan,United Arab Emirates,1,1,0,0.5,0.5,1979,1863
2015-01-23,South Africa,Senegal,1,1,0,0.5,0.5,1862,1849
2015-01-24,Cameroon,Guinea,1,1,0,0.5,0.5,1853,1775
2015-01-24,Ivory Coast,Mali,1,1,0,0.5,0.5,1904,1732
2015-01-25,Congo,Burkina Faso,2,1,1,1.0,0.0,1675,1707
2015-01-25,Equatorial Guinea,Gabon,2,0,2,1.0,0.0,1557,1706
2015-01-26,Cape Verde,Zambia,0,0,0,0.5,0.5,1696,1763
2015-01-26,DR Congo,Tunisia,1,1,0,0.5,0.5,1713,1861
2015-01-26,South Korea,Iraq,2,0,2,1.0,0.0,1935,1784
2015-01-27,Australia,United Arab Emirates,2,0,2,1.0,0.0,1916,1857
2015-01-27,Senegal,Algeria,0,2,2,0.0,1.0,1841,1846
2015-01-27,South Africa,Ghana,1,2,1,0.0,1.0,1855,1879
2015-01-28,Cameroon,Ivory Coast,0,1,1,0.0,1.0,1847,1911
2015-01-28,Chile,United States,3,2,1,1.0,0.0,2009,1969
2015-01-28,Guinea,Mali,1,1,0,0.5,0.5,1775,1733
2015-01-30,Curaçao,Aruba,0,0,0,0.5,0.5,1477,1417
2015-01-30,Iraq,United Arab Emirates,2,3,1,0.0,1.0,1778,1864
2015-01-30,Suriname,Bonaire,3,0,3,1.0,0.0,1594,1492
2015-01-31,Australia,South Korea,2,1,1,1.0,0.0,1925,1927
2015-01-31,Congo,DR Congo,2,4,2,0.0,1.0,1668,1721
2015-01-31,Equatorial Guinea,Tunisia,2,1,1,1.0,0.0,1571,1848
2015-02-01,Curaçao,Bonaire,4,1,3,1.0,0.0,1486,1484
2015-02-01,Ghana,Guinea,3,0,3,1.0,0.0,1885,1770
2015-02-01,Ivory Coast,Algeria,3,1,2,1.0,0.0,1918,1840
2015-02-01,Suriname,Aruba,1,0,1,1.0,0.0,1599,1413
2015-02-02,Bangladesh,Sri Lanka,1,0,1,1.0,0.0,1448,1371
2015-02-04,DR Congo,Ivory Coast,1,3,2,0.0,1.0,1718,1922
2015-02-04,Honduras,Venezuela,2,3,1,0.0,1.0,1817,1837
2015-02-05,Equatorial Guinea,Ghana,0,3,3,0.0,1.0,1569,1888
2015-02-06,Pakistan,Afghanistan,2,1,1,1.0,0.0,1381,1450
2015-02-07,Equatorial Guinea,DR Congo,0,0,0,0.5,0.5,1573,1715
2015-02-08,Ivory Coast,Ghana,0,0,0,0.5,0.5,1922,1889
2015-02-08,United States,Panama,2,0,2,1.0,0.0,1975,1830
2015-02-18,Kazakhstan,Moldova,1,1,0,0.5,0.5,1595,1595
2015-03-08,Antigua and Barbuda,United States Virgin Islands,2,0,2,1.0,0.0,1576,1372
2015-03-08,Bermuda,Grenada,2,0,2,1.0,0.0,1571,1523
2015-03-12,Cambodia,Macau,3,0,3,1.0,0.0,1312,1296
2015-03-12,Timor-Leste,Mongolia,0,3,3,0.0,1.0,1340,1407
2015-03-12,India,Nepal,2,0,2,1.0,0.0,1563,1400
2015-03-12,Sri Lanka,Bhutan,0,1,1,0.0,1.0,1361,1273
2015-03-12,Yemen,Pakistan,3,1,2,1.0,0.0,1563,1377
2015-03-12,Taiwan,Brunei,0,1,1,0.0,1.0,1396,1286
2015-03-15,Antigua and Barbuda,Dominica,1,0,1,1.0,0.0,1581,1405
2015-03-17,Bhutan,Sri Lanka,2,1,1,1.0,0.0,1283,1352
2015-03-17,Brunei,Taiwan,0,2,2,0.0,1.0,1281,1402
2015-03-17,Macau,Cambodia,1,1,0,0.5,0.5,1297,1312
2015-03-17,Mongolia,Timor-Leste,3,0,3,1.0,0.0,1414,1334
2015-03-17,Nepal,India,0,0,0,0.5,0.5,1404,1560
2015-03-22,Antigua and Barbuda,British Virgin Islands,1,0,1,1.0,0.0,1585,1348
2015-03-22,Barbados,United States Virgin Islands,0,1,1,0.0,1.0,1549,1384
2015-03-23,Pakistan,Yemen,0,0,0,0.5,0.5,1381,1560
2015-03-23,Nicaragua,Anguilla,5,0,5,1.0,0.0,1408,1312
2015-03-23,Saint Kitts and Nevis,Turks and Caicos Islands,6,2,4,1.0,0.0,1579,1436
2015-03-25,Botswana,Lesotho,2,0,2,1.0,0.0,1671,1507
2015-03-25,Denmark,United States,3,2,1,1.0,0.0,1915,1966
2015-03-25,Dominican Republic,Cuba,0,3,3,0.0,1.0,1543,1680
2015-03-25,French Guiana,Honduras,3,1,2,1.0,0.0,1565,1804
2015-03-25,Gabon,Mali,4,3,1,1.0,0.0,1715,1725
2015-03-25,Georgia,Malta,2,0,2,1.0,0.0,1669,1487
2015-03-25,Germany,Australia,2,2,0,0.5,0.5,2117,1930
2015-03-25,Indonesia,Cameroon,0,1,1,0.0,1.0,1635,1851
2015-03-25,Mauritius,Burundi,2,2,0,0.5,0.5,1447,1583
2015-03-25,Nigeria,Uganda,0,1,1,0.0,1.0,1861,1755
2015-03-25,Scotland,Northern Ireland,1,0,1,1.0,0.0,1868,1677
2015-03-25,Eswatini,South Africa,1,3,2,0.0,1.0,1470,1857
2015-03-25,Bahamas,Bermuda,0,5,5,0.0,1.0,1472,1577
2015-03-26,Bahrain,Colombia,0,6,6,0.0,1.0,1792,2015
2015-03-26,Chile,Iran,0,2,2,0.0,1.0,2000,1945
2015-03-26,Egypt,Equatorial Guinea,2,0,2,1.0,0.0,1889,1571
2015-03-26,France,Brazil,1,3,2,0.0,1.0,2049,2183
2015-03-26,Ivory Coast,Angola,2,0,2,1.0,0.0,1926,1721
2015-03-26,Jordan,Syria,0,1,1,0.0,1.0,1768,1721
2015-03-26,Maldives,Tajikistan,0,2,2,0.0,1.0,1479,1606
2015-03-26,Oman,Malaysia,6,0,6,1.0,0.0,1813,1584
2015-03-26,Qatar,Algeria,1,0,1,1.0,0.0,1828,1832
2015-03-26,Thailand,Singapore,2,0,2,1.0,0.0,1758,1612
2015-03-26,United States Virgin Islands,Barbados,0,4,4,0.0,1.0,1380,1554
2015-03-26,Dominica,British Virgin Islands,3,2,1,1.0,0.0,1412,1342
2015-03-26,Turks and Caicos Islands,Saint Kitts and Nevis,2,6,4,0.0,1.0,1432,1584
2015-03-27,Canada,Guatemala,1,0,1,1.0,0.0,1722,1705
2015-03-27,China PR,Haiti,2,2,0,0.5,0.5,1876,1687
2015-03-27,Curaçao,Montserrat,2,1,1,1.0,0.0,1492,1388
2015-03-27,England,Lithuania,4,0,4,1.0,0.0,2055,1643
2015-03-27,Gambia,Mauritania,1,0,1,1.0,0.0,1580,1485
2015-03-27,Japan,Tunisia,2,0,2,1.0,0.0,1985,1843
2015-03-27,South Korea,Uzbekistan,1,1,0,0.5,0.5,1925,1839
2015-03-27,Liechtenstein,Austria,0,5,5,0.0,1.0,1437,1842
2015-03-27,North Macedonia,Belarus,1,2,1,0.0,1.0,1706,1758
2015-03-27,Moldova,Sweden,0,2,2,0.0,1.0,1593,1933
2015-03-27,Slovakia,Luxembourg,3,0,3,1.0,0.0,1849,1468
2015-03-27,Slovenia,San Marino,6,0,6,1.0,0.0,1781,1333
2015-03-27,Spain,Ukraine,1,0,1,1.0,0.0,2140,1935
2015-03-27,Switzerland,Estonia,3,0,3,1.0,0.0,1936,1689
2015-03-27,Trinidad and Tobago,Panama,0,1,1,0.0,1.0,1747,1837
2015-03-28,Argentina,El Salvador,2,0,2,1.0,0.0,2103,1719
2015-03-28,Andorra,Bosnia and Herzegovina,0,3,3,0.0,1.0,1343,1830
2015-03-28,Azerbaijan,Malta,2,0,2,1.0,0.0,1630,1483
2015-03-28,Belgium,Cyprus,5,0,5,1.0,0.0,1961,1638
2015-03-28,Bulgaria,Italy,2,2,0,0.5,0.5,1804,2003
2015-03-28,Croatia,Norway,5,1,4,1.0,0.0,1979,1833
2015-03-28,Czech Republic,Latvia,1,1,0,0.5,0.5,1914,1654
2015-03-28,Ghana,Senegal,1,2,1,0.0,1.0,1880,1851
2015-03-28,Hong Kong,Guam,1,0,1,1.0,0.0,1575,1397
2015-03-28,Iraq,DR Congo,2,1,1,1.0,0.0,1785,1709
2015-03-28,Israel,Wales,0,3,3,0.0,1.0,1804,1794
2015-03-28,Kazakhstan,Iceland,0,3,3,0.0,1.0,1591,1743
2015-03-28,Mauritius,Togo,1,1,0,0.5,0.5,1452,1661
2015-03-28,Morocco,Uruguay,0,1,1,0.0,1.0,1789,2020
2015-03-28,Netherlands,Turkey,1,1,0,0.5,0.5,2061,1887
2015-03-28,Alderney,Jersey,0,5,5,0.0,1.0,1269,1731
2015-03-29,Albania,Armenia,2,1,1,1.0,0.0,1727,1649
2015-03-29,Anguilla,Nicaragua,0,3,3,0.0,1.0,1307,1414
2015-03-29,Bermuda,Bahamas,3,0,3,1.0,0.0,1583,1467
2015-03-29,Botswana,Mozambique,1,2,1,0.0,1.0,1663,1662
2015-03-29,Brazil,Chile,1,0,1,1.0,0.0,2188,1996
2015-03-29,Dominica,British Virgin Islands,0,0,0,0.5,0.5,1411,1344
2015-03-29,France,Denmark,2,0,2,1.0,0.0,2055,1910
2015-03-29,Georgia,Germany,0,2,2,0.0,1.0,1668,2119
2015-03-29,Guyana,Grenada,2,0,2,1.0,0.0,1602,1517
2015-03-29,Honduras,French Guiana,3,0,3,1.0,0.0,1808,1562
2015-03-29,Hungary,Greece,0,0,0,0.5,0.5,1827,1892
2015-03-29,Republic of Ireland,Poland,1,1,0,0.5,0.5,1909,1900
2015-03-29,Ivory Coast,Equatorial Guinea,1,1,0,0.5,0.5,1920,1578
2015-03-29,Northern Ireland,Finland,2,1,1,1.0,0.0,1688,1789
2015-03-29,Portugal,Serbia,2,1,1,1.0,0.0,2024,1865
2015-03-29,Romania,Faroe Islands,1,0,1,1.0,0.0,1909,1464
2015-03-29,Scotland,Gibraltar,6,1,5,1.0,0.0,1871,1579
2015-03-29,South Africa,Nigeria,1,1,0,0.5,0.5,1858,1861
2015-03-29,Tanzania,Malawi,1,1,0,0.5,0.5,1641,1624
2015-03-29,Zambia,Rwanda,2,0,2,1.0,0.0,1768,1618
2015-03-29,Cayman Islands,Belize,1,1,0,0.5,0.5,1422,1489
2015-03-30,Bahrain,Philippines,2,1,1,1.0,0.0,1796,1566
2015-03-30,Belarus,Gabon,0,0,0,0.5,0.5,1758,1716
2015-03-30,Indonesia,Myanmar,2,1,1,1.0,0.0,1641,1540
2015-03-30,Jamaica,Cuba,3,0,3,1.0,0.0,1765,1674
2015-03-30,Kuwait,Colombia,1,3,2,0.0,1.0,1786,2019
2015-03-30,North Macedonia,Australia,0,0,0,0.5,0.5,1711,1926
2015-03-30,Oman,Algeria,1,4,3,0.0,1.0,1806,1840
2015-03-30,Qatar,Slovenia,1,0,1,1.0,0.0,1835,1775
2015-03-30,Saudi Arabia,Jordan,2,1,1,1.0,0.0,1804,1761
2015-03-30,Thailand,Cameroon,2,3,1,0.0,1.0,1753,1857
2015-03-31,Argentina,Ecuador,2,1,1,1.0,0.0,2108,1923
2015-03-31,Austria,Bosnia and Herzegovina,1,1,0,0.5,0.5,1842,1831
2015-03-31,China PR,Tunisia,1,1,0,0.5,0.5,1876,1844
2015-03-31,Estonia,Iceland,1,1,0,0.5,0.5,1691,1742
2015-03-31,Ghana,Mali,1,1,0,0.5,0.5,1877,1729
2015-03-31,Iraq,DR Congo,1,0,1,1.0,0.0,1792,1703
2015-03-31,Israel,Belgium,0,1,1,0.0,1.0,1800,1966
2015-03-31,Italy,England,1,1,0,0.5,0.5,2005,2054
2015-03-31,Japan,Uzbekistan,5,1,4,1.0,0.0,1990,1835
2015-03-31,South Korea,New Zealand,1,0,1,1.0,0.0,1930,1751
2015-03-31,Liechtenstein,San Marino,1,0,1,1.0,0.0,1443,1328
2015-03-31,Luxembourg,Turkey,1,2,1,0.0,1.0,1467,1889
2015-03-31,Mauritania,Niger,2,0,2,1.0,0.0,1495,1560
2015-03-31,Montserrat,Curaçao,2,2,0,0.5,0.5,1391,1490
2015-03-31,Netherlands,Spain,2,0,2,1.0,0.0,2071,2131
2015-03-31,Panama,Costa Rica,2,1,1,1.0,0.0,1847,1896
2015-03-31,Peru,Venezuela,0,1,1,0.0,1.0,1851,1846
2015-03-31,Portugal,Cape Verde,0,2,2,0.0,1.0,2011,1710
2015-03-31,Russia,Kazakhstan,0,0,0,0.5,0.5,1930,1598
2015-03-31,Singapore,Guam,2,2,0,0.5,0.5,1608,1402
2015-03-31,Slovakia,Czech Republic,1,0,1,1.0,0.0,1859,1905
2015-03-31,Sweden,Iran,3,1,2,1.0,0.0,1942,1937
2015-03-31,Switzerland,United States,1,1,0,0.5,0.5,1937,1966
2015-03-31,Tajikistan,Syria,2,3,1,0.0,1.0,1601,1727
2015-03-31,Ukraine,Latvia,1,1,0,0.5,0.5,1930,1660
2015-04-15,United States,Mexico,2,0,2,1.0,0.0,1975,1975
2015-05-05,Abkhazia,Luhansk PR,1,0,1,1.0,0.0,1508,1492
2015-05-10,Barbados,Saint Kitts and Nevis,1,3,2,0.0,1.0,1547,1592
2015-05-10,Zambia,Malawi,2,0,2,1.0,0.0,1773,1620
2015-05-12,Kazakhstan,Burkina Faso,0,0,0,0.5,0.5,1601,1705
2015-05-13,Dominican Republic,Cayman Islands,6,0,6,1.0,0.0,1549,1417
2015-05-14,Grenada,Dominica,1,2,1,0.0,1.0,1507,1422
2015-05-14,Lesotho,South Africa,0,0,0,0.5,0.5,1514,1852
2015-05-14,Saint Lucia,Saint Vincent and the Grenadines,1,2,1,0.0,1.0,1468,1574
2015-05-14,Abkhazia,Donetsk PR,1,0,1,1.0,0.0,1516,1493
2015-05-16,Lesotho,South Africa,1,1,0,0.5,0.5,1520,1847
2015-05-16,Saint Lucia,Grenada,0,2,2,0.0,1.0,1461,1515
2015-05-16,Guernsey,Jersey,2,3,1,0.0,1.0,1726,1740
2015-05-17,Namibia,Seychelles,0,0,0,0.5,0.5,1576,1437
2015-05-17,Vietnam,North Korea,1,1,0,0.5,0.5,1653,1756
2015-05-17,Zimbabwe,Mauritius,2,0,2,1.0,0.0,1674,1449
2015-05-18,Lesotho,Madagascar,1,2,1,0.0,1.0,1513,1563
2015-05-18,Tanzania,Eswatini,0,1,1,0.0,1.0,1630,1482
2015-05-19,Namibia,Mauritius,2,0,2,1.0,0.0,1582,1444
2015-05-19,Seychelles,Zimbabwe,0,1,1,0.0,1.0,1434,1678
2015-05-20,Lesotho,Eswatini,0,2,2,0.0,1.0,1505,1491
2015-05-20,Madagascar,Tanzania,2,0,2,1.0,0.0,1573,1621
2015-05-20,Thailand,North Korea,0,1,1,0.0,1.0,1746,1764
2015-05-21,Namibia,Zimbabwe,4,1,3,1.0,0.0,1593,1668
2015-05-21,Seychelles,Mauritius,0,1,1,0.0,1.0,1427,1452
2015-05-22,Lesotho,Tanzania,1,0,1,1.0,0.0,1516,1611
2015-05-22,Madagascar,Eswatini,1,1,0,0.5,0.5,1572,1493
2015-05-24,Lebanon,Syria,2,2,0,0.5,0.5,1659,1726
2015-05-24,South Africa,Botswana,0,0,0,0.5,0.5,1844,1667
2015-05-24,Thailand,Vietnam,1,0,1,1.0,0.0,1752,1648
2015-05-24,Zambia,Namibia,0,0,0,0.5,0.5,1770,1597
2015-05-25,Ghana,Madagascar,1,2,1,0.0,1.0,1864,1586
2015-05-25,Mozambique,Malawi,2,2,0,0.5,0.5,1662,1621
2015-05-27,South Africa,Malawi,0,0,0,0.5,0.5,1840,1626
2015-05-27,Zambia,Ghana,3,0,3,1.0,0.0,1781,1854
2015-05-28,Botswana,Mozambique,1,2,1,0.0,1.0,1659,1671
2015-05-28,Namibia,Madagascar,3,2,1,1.0,0.0,1605,1579
2015-05-29,Laos,Afghanistan,0,2,2,0.0,1.0,1393,1457
2015-05-29,Zambia,Malawi,0,1,1,0.0,1.0,1770,1638
2015-05-29,Corsica,Burkina Faso,1,0,1,1.0,0.0,1552,1694
2015-05-30,Bahrain,Oman,0,0,0,0.5,0.5,1797,1806
2015-05-30,Bangladesh,Singapore,1,2,1,0.0,1.0,1444,1613
2015-05-30,Jordan,Lebanon,0,0,0,0.5,0.5,1759,1662
2015-05-30,Madagascar,Botswana,2,1,1,1.0,0.0,1589,1650
2015-05-30,Mexico,Guatemala,3,0,3,1.0,0.0,1978,1703
2015-05-30,Namibia,Mozambique,2,0,2,1.0,0.0,1615,1662
2015-05-30,Alderney,Felvidék,1,2,1,0.0,1.0,1266,1504
2015-05-30,Ellan Vannin,Panjab,8,1,7,1.0,0.0,1535,1493
2015-05-31,Ellan Vannin,Felvidék,3,1,2,1.0,0.0,1543,1497
2015-05-31,El Salvador,Honduras,0,2,2,0.0,1.0,1714,1814
2015-05-31,Northern Ireland,Qatar,1,1,0,0.5,0.5,1692,1832
2015-05-31,Panjab,Alderney,9,1,8,1.0,0.0,1497,1263
2015-06-02,Bangladesh,Afghanistan,1,1,0,0.5,0.5,1445,1457
2015-06-02,Cambodia,Laos,1,1,0,0.5,0.5,1314,1392
2015-06-03,Panama,Ecuador,1,1,0,0.5,0.5,1849,1922
2015-06-03,Peru,Mexico,1,1,0,0.5,0.5,1854,1976
2015-06-05,Cambodia,Myanmar,1,0,1,1.0,0.0,1327,1528
2015-06-05,Curaçao,Trinidad and Tobago,1,0,1,1.0,0.0,1504,1734
2015-06-05,Hungary,Lithuania,4,0,4,1.0,0.0,1832,1639
2015-06-05,Jordan,Kuwait,2,2,0,0.5,0.5,1760,1786
2015-06-05,Netherlands,United States,3,4,1,0.0,1.0,2061,1986
2015-06-05,Oman,Syria,1,2,1,0.0,1.0,1797,1736
2015-06-05,Scotland,Qatar,1,0,1,1.0,0.0,1879,1825
2015-06-05,Thailand,Bahrain,1,1,0,0.5,0.5,1754,1796
2015-06-06,Argentina,Bolivia,5,0,5,1.0,0.0,2110,1741
2015-06-06,Andorra,Equatorial Guinea,0,1,1,0.0,1.0,1340,1582
2015-06-06,Burkina Faso,Cameroon,2,3,1,0.0,1.0,1690,1862
2015-06-06,Colombia,Costa Rica,1,0,1,1.0,0.0,2025,1891
2015-06-06,Ecuador,Panama,4,0,4,1.0,0.0,1929,1843
2015-06-06,Guinea,Chad,2,1,1,1.0,0.0,1774,1522
2015-06-06,Malaysia,Hong Kong,0,0,0,0.5,0.5,1584,1576
2015-06-06,Niger,Gabon,2,1,1,1.0,0.0,1572,1705
2015-06-06,Paraguay,Honduras,2,2,0,0.5,0.5,1879,1816
2015-06-06,Rwanda,Kenya,0,0,0,0.5,0.5,1619,1635
2015-06-06,Singapore,Brunei,5,1,4,1.0,0.0,1616,1279
2015-06-06,Uruguay,Guatemala,5,1,4,1.0,0.0,2023,1701
2015-06-07,Brazil,Mexico,2,0,2,1.0,0.0,2192,1973
2015-06-07,Croatia,Gibraltar,4,0,4,1.0,0.0,1981,1578
2015-06-07,Ethiopia,Zambia,0,1,1,0.0,1.0,1629,1775
2015-06-07,France,Belgium,3,4,1,0.0,1.0,2045,1977
2015-06-07,Republic of Ireland,England,0,0,0,0.5,0.5,1913,2051
2015-06-07,Kenya,South Sudan,2,0,2,1.0,0.0,1640,1469
2015-06-07,Russia,Belarus,4,2,2,1.0,0.0,1935,1754
2015-06-07,Rwanda,Tanzania,2,0,2,1.0,0.0,1627,1604
2015-06-07,Serbia,Azerbaijan,4,1,3,1.0,0.0,1869,1627
2015-06-07,Nicaragua,Suriname,1,0,1,1.0,0.0,1426,1588
2015-06-08,Denmark,Montenegro,2,1,1,1.0,0.0,1915,1721
2015-06-08,Egypt,Malawi,2,1,1,1.0,0.0,1893,1635
2015-06-08,Ghana,Togo,1,0,1,1.0,0.0,1858,1658
2015-06-08,Malta,Lithuania,2,0,2,1.0,0.0,1495,1628
2015-06-08,Norway,Sweden,0,0,0,0.5,0.5,1836,1940
2015-06-08,Turkey,Bulgaria,4,0,4,1.0,0.0,1896,1798
2015-06-09,DR Congo,Cameroon,1,1,0,0.5,0.5,1707,1859
2015-06-09,Finland,Estonia,0,2,2,0.0,1.0,1779,1702
2015-06-09,Georgia,Ukraine,1,2,1,0.0,1.0,1666,1933
2015-06-09,Luxembourg,Moldova,0,0,0,0.5,0.5,1470,1591
2015-06-09,Uganda,Gambia,1,1,0,0.5,0.5,1752,1584
2015-06-10,Brazil,Honduras,1,0,1,1.0,0.0,2194,1815
2015-06-10,Curaçao,Cuba,0,0,0,0.5,0.5,1508,1671
2015-06-10,Germany,United States,1,2,1,0.0,1.0,2109,1997
2015-06-10,Switzerland,Liechtenstein,3,0,3,1.0,0.0,1938,1443
2015-06-10,Antigua and Barbuda,Saint Lucia,1,3,2,0.0,1.0,1575,1472
2015-06-10,Aruba,Barbados,0,2,2,0.0,1.0,1408,1553
2015-06-10,Saint Vincent and the Grenadines,Guyana,2,2,0,0.5,0.5,1575,1602
2015-06-11,Afghanistan,Syria,0,6,6,0.0,1.0,1455,1739
2015-06-11,Bangladesh,Kyrgyzstan,1,3,2,0.0,1.0,1438,1462
2015-06-11,Cambodia,Singapore,0,4,4,0.0,1.0,1325,1619
2015-06-11,Chile,Ecuador,2,0,2,1.0,0.0,2003,1923
2015-06-11,Dominican Republic,Belize,1,2,1,0.0,1.0,1540,1499
2015-06-11,Guam,Turkmenistan,1,0,1,1.0,0.0,1415,1584
2015-06-11,Hong Kong,Bhutan,7,0,7,1.0,0.0,1579,1281
2015-06-11,India,Oman,1,2,1,0.0,1.0,1557,1801
2015-06-11,Japan,Iraq,4,0,4,1.0,0.0,1994,1789
2015-06-11,South Korea,United Arab Emirates,3,0,3,1.0,0.0,1937,1858
2015-06-11,Laos,Myanmar,2,2,0,0.5,0.5,1395,1526
2015-06-11,Lebanon,Kuwait,0,1,1,0.0,1.0,1657,1792
2015-06-11,Malaysia,Timor-Leste,3,0,3,1.0,0.0,1588,1331
2015-06-11,Maldives,Qatar,0,1,1,0.0,1.0,1478,1827
2015-06-11,Philippines,Bahrain,2,1,1,1.0,0.0,1579,1784
2015-06-11,Saudi Arabia,Palestine,3,2,1,1.0,0.0,1809,1613
2015-06-11,Spain,Costa Rica,2,1,1,1.0,0.0,2135,1888
2015-06-11,Tajikistan,Jordan,1,3,2,0.0,1.0,1597,1765
2015-06-11,Uzbekistan,Iran,0,1,1,0.0,1.0,1830,1943
2015-06-11,Yemen,North Korea,0,3,3,0.0,1.0,1557,1768
2015-06-11,Dominica,Canada,0,2,2,0.0,1.0,1420,1725
2015-06-11,Saint Kitts and Nevis,El Salvador,2,2,0,0.5,0.5,1595,1712
2015-06-12,Andorra,Cyprus,1,3,2,0.0,1.0,1338,1641
2015-06-12,Bosnia and Herzegovina,Israel,3,1,2,1.0,0.0,1839,1793
2015-06-12,Croatia,Italy,1,1,0,0.5,0.5,1982,2005
2015-06-12,Guinea,Eswatini,1,2,1,0.0,1.0,1761,1507
2015-06-12,Iceland,Czech Republic,2,1,1,1.0,0.0,1754,1894
2015-06-12,Kazakhstan,Turkey,0,1,1,0.0,1.0,1599,1899
2015-06-12,Latvia,Netherlands,0,2,2,0.0,1.0,1659,2063
2015-06-12,Malta,Bulgaria,0,1,1,0.0,1.0,1493,1801
2015-06-12,Mexico,Bolivia,0,0,0,0.5,0.5,1969,1746
2015-06-12,Morocco,Libya,1,0,1,1.0,0.0,1796,1735
2015-06-12,Norway,Azerbaijan,0,0,0,0.5,0.5,1832,1632
2015-06-12,Wales,Belgium,1,0,1,1.0,0.0,1806,1966
2015-06-12,Puerto Rico,Grenada,1,0,1,1.0,0.0,1448,1506
2015-06-12,Guatemala,Bermuda,0,0,0,0.5,0.5,1699,1586
2015-06-12,Tunisia,Djibouti,8,1,7,1.0,0.0,1845,1311
2015-06-13,Albania,France,1,0,1,1.0,0.0,1741,2032
2015-06-13,Algeria,Seychelles,4,0,4,1.0,0.0,1842,1426
2015-06-13,Angola,Central African Republic,4,0,4,1.0,0.0,1725,1479
2015-06-13,Argentina,Paraguay,2,2,0,0.5,0.5,2106,1884
2015-06-13,Armenia,Portugal,2,3,1,0.0,1.0,1648,2013
2015-06-13,Burkina Faso,Comoros,2,0,2,1.0,0.0,1693,1395
2015-06-13,Cape Verde,São Tomé and Príncipe,7,1,6,1.0,0.0,1713,1449
2015-06-13,Denmark,Serbia,2,0,2,1.0,0.0,1922,1863
2015-06-13,Faroe Islands,Greece,2,1,1,1.0,0.0,1479,1878
2015-06-13,Finland,Hungary,0,1,1,0.0,1.0,1773,1839
2015-06-13,Gibraltar,Germany,0,7,7,0.0,1.0,1578,2110
2015-06-13,Republic of Ireland,Scotland,1,1,0,0.5,0.5,1913,1880
2015-06-13,Malawi,Zimbabwe,1,2,1,0.0,1.0,1628,1676
2015-06-13,Mali,South Sudan,2,0,2,1.0,0.0,1732,1467
2015-06-13,Northern Ireland,Romania,0,0,0,0.5,0.5,1697,1905
2015-06-13,Poland,Georgia,4,0,4,1.0,0.0,1904,1663
2015-06-13,Senegal,Burundi,3,1,2,1.0,0.0,1854,1581
2015-06-13,South Africa,Gambia,0,0,0,0.5,0.5,1835,1590
2015-06-13,Uganda,Botswana,2,0,2,1.0,0.0,1758,1645
2015-06-13,Uruguay,Jamaica,1,0,1,1.0,0.0,2026,1763
2015-06-13,Zambia,Guinea-Bissau,0,0,0,0.5,0.5,1770,1525
2015-06-14,Barbados,Aruba,0,3,3,0.0,1.0,1542,1420
2015-06-14,Belarus,Spain,0,1,1,0.0,1.0,1753,2137
2015-06-14,Brazil,Peru,2,1,1,1.0,0.0,2196,1853
2015-06-14,Cameroon,Mauritania,1,0,1,1.0,0.0,1861,1494
2015-06-14,Colombia,Venezuela,0,1,1,0.0,1.0,2014,1858
2015-06-14,Congo,Kenya,1,1,0,0.5,0.5,1668,1641
2015-06-14,DR Congo,Madagascar,2,1,1,1.0,0.0,1713,1584
2015-06-14,Cuba,Curaçao,1,1,0,0.5,0.5,1668,1512
2015-06-14,Egypt,Tanzania,3,0,3,1.0,0.0,1896,1602
2015-06-14,Equatorial Guinea,Benin,1,1,0,0.5,0.5,1583,1604
2015-06-14,Estonia,San Marino,2,0,2,1.0,0.0,1704,1327
2015-06-14,Gabon,Ivory Coast,0,0,0,0.5,0.5,1710,1916
2015-06-14,Ghana,Mauritius,7,1,6,1.0,0.0,1860,1451
2015-06-14,Liechtenstein,Moldova,1,1,0,0.5,0.5,1447,1588
2015-06-14,Lithuania,Switzerland,1,2,1,0.0,1.0,1626,1941
2015-06-14,Mozambique,Rwanda,0,1,1,0.0,1.0,1654,1636
2015-06-14,Niger,Namibia,1,0,1,1.0,0.0,1581,1607
2015-06-14,Russia,Austria,0,1,1,0.0,1.0,1925,1853
2015-06-14,Slovakia,North Macedonia,2,1,1,1.0,0.0,1864,1707
2015-06-14,Slovenia,England,2,3,1,0.0,1.0,1773,2054
2015-06-14,Sudan,Sierra Leone,1,0,1,1.0,0.0,1633,1598
2015-06-14,Sweden,Montenegro,3,1,2,1.0,0.0,1944,1718
2015-06-14,Togo,Liberia,2,1,1,1.0,0.0,1665,1600
2015-06-14,Ukraine,Luxembourg,3,0,3,1.0,0.0,1935,1469
2015-06-14,Belize,Dominican Republic,3,0,3,1.0,0.0,1508,1532
2015-06-14,Guyana,Saint Vincent and the Grenadines,4,4,0,0.5,0.5,1602,1576
2015-06-14,Antigua and Barbuda,Saint Lucia,4,1,3,1.0,0.0,1581,1467
2015-06-14,Ethiopia,Lesotho,2,1,1,1.0,0.0,1635,1511
2015-06-15,Chile,Mexico,3,3,0,0.5,0.5,2003,1970
2015-06-15,Ecuador,Bolivia,2,3,1,0.0,1.0,1912,1758
2015-06-15,Bermuda,Guatemala,0,1,1,0.0,1.0,1581,1705
2015-06-16,Argentina,Uruguay,1,0,1,1.0,0.0,2113,2020
2015-06-16,Bangladesh,Tajikistan,1,1,0,0.5,0.5,1442,1594
2015-06-16,Bhutan,China PR,0,6,6,0.0,1.0,1281,1877
2015-06-16,Myanmar,South Korea,0,2,2,0.0,1.0,1525,1939
2015-06-16,Cambodia,Afghanistan,0,1,1,0.0,1.0,1320,1461
2015-06-16,Timor-Leste,United Arab Emirates,0,3,3,0.0,1.0,1331,1859
2015-06-16,Grenada,Puerto Rico,2,0,2,1.0,0.0,1513,1442
2015-06-16,Guam,India,2,1,1,1.0,0.0,1427,1546
2015-06-16,Hong Kong,Maldives,2,0,2,1.0,0.0,1585,1473
2015-06-16,Italy,Portugal,0,1,1,0.0,1.0,1998,2021
2015-06-16,Japan,Singapore,0,0,0,0.5,0.5,1988,1626
2015-06-16,Jordan,Trinidad and Tobago,3,0,3,1.0,0.0,1773,1727
2015-06-16,North Korea,Uzbekistan,4,2,2,1.0,0.0,1778,1821
2015-06-16,Kyrgyzstan,Australia,1,2,1,0.0,1.0,1461,1928
2015-06-16,Laos,Lebanon,0,2,2,0.0,1.0,1393,1660
2015-06-16,Malaysia,Palestine,0,6,6,0.0,1.0,1581,1621
2015-06-16,Paraguay,Jamaica,1,0,1,1.0,0.0,1890,1758
2015-06-16,Poland,Greece,0,0,0,0.5,0.5,1904,1879
2015-06-16,South Africa,Angola,2,1,1,1.0,0.0,1841,1720
2015-06-16,Suriname,Nicaragua,1,3,2,0.0,1.0,1577,1438
2015-06-16,Turkmenistan,Iran,1,1,0,0.5,0.5,1591,1937
2015-06-16,Yemen,Philippines,0,2,2,0.0,1.0,1550,1587
2015-06-16,Canada,Dominica,4,0,4,1.0,0.0,1728,1418
2015-06-16,El Salvador,Saint Kitts and Nevis,4,1,3,1.0,0.0,1718,1590
2015-06-16,Taiwan,Thailand,0,2,2,0.0,1.0,1401,1756
2015-06-17,Brazil,Colombia,0,1,1,0.0,1.0,2185,2026
2015-06-17,Székely Land,County of Nice,2,3,1,0.0,1.0,1501,1530
2015-06-17,Padania,Romani people,3,2,1,1.0,0.0,1604,1495
2015-06-18,Peru,Venezuela,1,0,1,1.0,0.0,1862,1850
2015-06-18,Székely Land,Felvidék,1,3,2,0.0,1.0,1493,1506
2015-06-18,Romani people,Ellan Vannin,1,3,2,0.0,1.0,1489,1550
2015-06-19,Chile,Bolivia,5,0,5,1.0,0.0,2007,1755
2015-06-19,Mexico,Ecuador,1,2,1,0.0,1.0,1961,1922
2015-06-19,Felvidék,County of Nice,1,4,3,0.0,1.0,1499,1538
2015-06-19,Padania,Ellan Vannin,1,0,1,1.0,0.0,1611,1544
2015-06-19,Székely Land,Romani people,2,4,2,0.0,1.0,1485,1498
2015-06-20,Argentina,Jamaica,1,0,1,1.0,0.0,2115,1757
2015-06-20,Uruguay,Paraguay,1,1,0,0.5,0.5,2018,1893
2015-06-20,County of Nice,Ellan Vannin,3,1,2,1.0,0.0,1547,1536
2015-06-20,Padania,Felvidék,5,0,5,1.0,0.0,1617,1494
2015-06-21,Brazil,Venezuela,2,1,1,1.0,0.0,2188,1848
2015-06-21,Colombia,Peru,0,0,0,0.5,0.5,2023,1866
2015-06-21,Ellan Vannin,Felvidék,1,1,0,0.5,0.5,1536,1495
2015-06-21,County of Nice,Padania,1,4,3,0.0,1.0,1541,1624
2015-06-24,Chile,Uruguay,1,0,1,1.0,0.0,2016,2010
2015-06-25,Bolivia,Peru,1,3,2,0.0,1.0,1750,1872
2015-06-26,Argentina,Colombia,0,0,0,0.5,0.5,2113,2026
2015-06-27,Brazil,Paraguay,1,1,0,0.5,0.5,2183,1899
2015-06-27,Mexico,Costa Rica,2,2,0,0.5,0.5,1960,1890
2015-06-28,Greenland,Menorca,2,2,0,0.5,0.5,1460,1531
2015-06-28,Saare County,Åland Islands,1,2,1,0.0,1.0,1406,1551
2015-06-28,Gibraltar,Gotland,2,1,1,1.0,0.0,1585,1506
2015-06-28,Ynys Môn,Guernsey,2,5,3,0.0,1.0,1566,1731
2015-06-28,Falkland Islands,Hitra,2,1,1,1.0,0.0,1449,1451
2015-06-28,Shetland,Isle of Wight,0,0,0,0.5,0.5,1510,1593
2015-06-28,Western Isles,Isle of Man,0,9,9,0.0,1.0,1502,1566
2015-06-28,Jersey,Alderney,6,0,6,1.0,0.0,1741,1263
2015-06-29,Chile,Peru,2,1,1,1.0,0.0,2021,1868
2015-06-29,Isle of Man,Alderney,7,0,7,1.0,0.0,1569,1261
2015-06-29,Jersey,Western Isles,3,0,3,1.0,0.0,1745,1499
2015-06-29,Åland Islands,Greenland,0,2,2,0.0,1.0,1541,1471
2015-06-29,Menorca,Saare County,3,0,3,1.0,0.0,1537,1401
2015-06-29,Guernsey,Gotland,3,0,3,1.0,0.0,1735,1503
2015-06-29,Gibraltar,Ynys Môn,1,1,0,0.5,0.5,1585,1567
2015-06-29,Isle of Wight,Falkland Islands,3,0,3,1.0,0.0,1598,1445
2015-06-29,Hitra,Shetland,1,4,3,0.0,1.0,1445,1517
2015-06-30,Argentina,Paraguay,6,1,5,1.0,0.0,2117,1896
2015-06-30,Åland Islands,Menorca,1,3,2,0.0,1.0,1533,1546
2015-06-30,Greenland,Saare County,2,1,1,1.0,0.0,1478,1395
2015-06-30,Gotland,Ynys Môn,2,3,1,0.0,1.0,1497,1574
2015-06-30,Gibraltar,Guernsey,0,4,4,0.0,1.0,1581,1740
2015-06-30,Isle of Wight,Hitra,3,1,2,1.0,0.0,1603,1441
2015-06-30,Falkland Islands,Shetland,0,5,5,0.0,1.0,1439,1524
2015-06-30,Jersey,Isle of Man,1,2,1,0.0,1.0,1734,1581
2015-06-30,Alderney,Western Isles,2,3,1,0.0,1.0,1258,1503
2015-07-01,Honduras,Mexico,0,0,0,0.5,0.5,1819,1957
2015-07-02,Hitra,Alderney,5,1,4,1.0,0.0,1446,1254
2015-07-02,Gotland,Saare County,2,3,1,0.0,1.0,1487,1406
2015-07-02,Falkland Islands,Western Isles,1,2,1,0.0,1.0,1433,1510
2015-07-02,Gibraltar,Åland Islands,0,0,0,0.5,0.5,1580,1535
2015-07-02,Jersey,Ynys Môn,1,0,1,1.0,0.0,1739,1570
2015-07-02,Isle of Wight,Greenland,1,2,1,0.0,1.0,1593,1489
2015-07-02,Menorca,Guernsey,1,2,1,0.0,1.0,1543,1744
2015-07-02,Shetland,Isle of Man,1,3,2,0.0,1.0,1518,1588
2015-07-03,Peru,Paraguay,2,0,2,1.0,0.0,1877,1888
2015-07-03,Menorca,Shetland,1,0,1,1.0,0.0,1551,1511
2015-07-03,Guernsey,Isle of Man,3,0,3,1.0,0.0,1749,1584
2015-07-04,Chile,Argentina,0,0,0,0.5,0.5,2024,2115
2015-07-06,Malawi,Uganda,1,0,1,1.0,0.0,1639,1748
2015-07-07,Panama,Haiti,1,1,0,0.5,0.5,1840,1691
2015-07-07,United States,Honduras,2,1,1,1.0,0.0,2002,1815
2015-07-08,Costa Rica,Jamaica,2,2,0,0.5,0.5,1888,1760
2015-07-08,El Salvador,Canada,0,0,0,0.5,0.5,1719,1728
2015-07-09,Mexico,Cuba,6,0,6,1.0,0.0,1960,1666
2015-07-09,Trinidad and Tobago,Guatemala,3,1,2,1.0,0.0,1735,1698
2015-07-09,Luhansk PR,Donetsk PR,3,1,2,1.0,0.0,1501,1485
2015-07-10,Honduras,Panama,1,1,0,0.5,0.5,1816,1840
2015-07-10,United States,Haiti,1,0,1,1.0,0.0,2005,1689
2015-07-11,Costa Rica,El Salvador,1,1,0,0.5,0.5,1885,1723
2015-07-11,Jamaica,Canada,1,0,1,1.0,0.0,1768,1721
2015-07-12,Guatemala,Mexico,0,0,0,0.5,0.5,1704,1955
2015-07-12,Trinidad and Tobago,Cuba,2,0,2,1.0,0.0,1742,1660
2015-07-13,Honduras,Haiti,0,1,1,0.0,1.0,1806,1700
2015-07-13,United States,Panama,1,1,0,0.5,0.5,2002,1844
2015-07-14,Canada,Costa Rica,0,0,0,0.5,0.5,1725,1882
2015-07-14,Jamaica,El Salvador,1,0,1,1.0,0.0,1775,1717
2015-07-15,Guatemala,Cuba,0,1,1,0.0,1.0,1695,1670
2015-07-15,Trinidad and Tobago,Mexico,4,4,0,0.5,0.5,1747,1951
2015-07-18,Haiti,Jamaica,0,1,1,0.0,1.0,1694,1782
2015-07-18,United States,Cuba,6,0,6,1.0,0.0,2005,1668
2015-07-19,Mexico,Costa Rica,1,0,1,1.0,0.0,1958,1876
2015-07-19,Trinidad and Tobago,Panama,1,1,0,0.5,0.5,1750,1842
2015-07-22,Panama,Mexico,1,2,1,0.0,1.0,1837,1964
2015-07-22,United States,Jamaica,1,2,1,0.0,1.0,1993,1795
2015-07-25,United States,Panama,1,1,0,0.5,0.5,1990,1841
2015-07-26,Jamaica,Mexico,1,3,2,0.0,1.0,1791,1969
2015-07-31,Seychelles,Madagascar,3,0,3,1.0,0.0,1438,1573
2015-07-31,Maldives,Mayotte,1,3,2,0.0,1.0,1466,1508
2015-07-31,Réunion,Mauritius,1,0,1,1.0,0.0,1635,1447
2015-08-02,China PR,South Korea,0,2,2,0.0,1.0,1871,1946
2015-08-02,North Korea,Japan,2,1,1,1.0,0.0,1791,1976
2015-08-02,Seychelles,Maldives,1,2,1,0.0,1.0,1431,1474
2015-08-02,Mayotte,Madagascar,1,1,0,0.5,0.5,1510,1572
2015-08-02,Comoros,Mauritius,0,3,3,0.0,1.0,1389,1454
2015-08-04,Maldives,Madagascar,0,4,4,0.0,1.0,1469,1578
2015-08-04,Seychelles,Mayotte,0,1,1,0.0,1.0,1425,1517
2015-08-04,Réunion,Comoros,3,0,3,1.0,0.0,1639,1386
2015-08-05,China PR,North Korea,2,0,2,1.0,0.0,1878,1785
2015-08-05,Japan,South Korea,1,1,0,0.5,0.5,1976,1947
2015-08-06,Mayotte,Mauritius,2,1,1,1.0,0.0,1524,1448
2015-08-06,Réunion,Madagascar,1,0,1,1.0,0.0,1646,1572
2015-08-07,Mauritius,Madagascar,3,1,2,1.0,0.0,1459,1562
2015-08-08,Donetsk PR,Luhansk PR,4,1,3,1.0,0.0,1494,1493
2015-08-08,Réunion,Mayotte,3,1,2,1.0,0.0,1652,1519
2015-08-09,China PR,Japan,1,1,0,0.5,0.5,1881,1974
2015-08-09,South Korea,North Korea,0,0,0,0.5,0.5,1944,1789
2015-08-19,Fiji,Tonga,5,0,5,1.0,0.0,1690,1449
2015-08-20,Cambodia,Bhutan,2,0,2,1.0,0.0,1328,1274
2015-08-26,Lebanon,Iraq,2,3,1,0.0,1.0,1655,1795
2015-08-27,Fiji,American Samoa,6,0,6,1.0,0.0,1692,1343
2015-08-28,Oman,Yemen,1,0,1,1.0,0.0,1805,1547
2015-08-28,Qatar,Singapore,4,0,4,1.0,0.0,1831,1623
2015-08-28,Rwanda,Ethiopia,3,1,2,1.0,0.0,1644,1628
2015-08-28,Tanzania,Libya,1,2,1,0.0,1.0,1597,1741
2015-08-28,United Arab Emirates,Myanmar,1,0,1,1.0,0.0,1862,1523
2015-08-29,Laos,Cambodia,2,1,1,1.0,0.0,1400,1322
2015-08-29,Malaysia,Bangladesh,0,0,0,0.5,0.5,1578,1446
2015-08-30,Niger,Burkina Faso,0,0,0,0.5,0.5,1584,1691
2015-08-31,India,Nepal,0,0,0,0.5,0.5,1543,1408
2015-08-31,Lebanon,Palestine,0,0,0,0.5,0.5,1655,1622
2015-08-31,Samoa,American Samoa,3,2,1,1.0,0.0,1468,1338
2015-08-31,Tonga,Cook Islands,0,3,3,0.0,1.0,1441,1439
2015-09-01,Congo,Ghana,2,3,1,0.0,1.0,1665,1864
2015-09-02,Cook Islands,Samoa,1,0,1,1.0,0.0,1448,1460
2015-09-02,Tonga,American Samoa,1,2,1,0.0,1.0,1431,1349
2015-09-03,Australia,Bangladesh,5,0,5,1.0,0.0,1929,1446
2015-09-03,Azerbaijan,Croatia,0,0,0,0.5,0.5,1639,1976
2015-09-03,Bahrain,North Korea,0,1,1,0.0,1.0,1777,1797
2015-09-03,Belgium,Bosnia and Herzegovina,3,1,2,1.0,0.0,1972,1834
2015-09-03,Bulgaria,Norway,0,1,1,0.0,1.0,1794,1840
2015-09-03,China PR,Hong Kong,0,0,0,0.5,0.5,1876,1591
2015-09-03,Cyprus,Wales,0,1,1,0.0,1.0,1637,1811
2015-09-03,Czech Republic,Kazakhstan,2,1,1,1.0,0.0,1897,1597
2015-09-03,Iran,Guam,6,0,6,1.0,0.0,1938,1427
2015-09-03,Iraq,Taiwan,5,1,4,1.0,0.0,1797,1400
2015-09-03,Israel,Andorra,4,0,4,1.0,0.0,1795,1337
2015-09-03,Italy,Malta,1,0,1,1.0,0.0,1999,1493
2015-09-03,Japan,Cambodia,3,0,3,1.0,0.0,1975,1322
2015-09-03,Jordan,Kyrgyzstan,0,0,0,0.5,0.5,1768,1467
2015-09-03,South Korea,Laos,8,0,8,1.0,0.0,1945,1400
2015-09-03,Kuwait,Myanmar,9,0,9,1.0,0.0,1795,1521
2015-09-03,Netherlands,Iceland,0,1,1,0.0,1.0,2050,1768
2015-09-03,Oman,Turkmenistan,3,1,2,1.0,0.0,1809,1588
2015-09-03,Philippines,Maldives,2,0,2,1.0,0.0,1593,1464
2015-09-03,Qatar,Bhutan,15,0,15,1.0,0.0,1832,1274
2015-09-03,Saudi Arabia,Timor-Leste,7,0,7,1.0,0.0,1810,1331
2015-09-03,Syria,Singapore,1,0,1,1.0,0.0,1745,1618
2015-09-03,Thailand,Afghanistan,2,0,2,1.0,0.0,1759,1459
2015-09-03,Turkey,Latvia,1,1,0,0.5,0.5,1895,1664
2015-09-03,United Arab Emirates,Malaysia,10,0,10,1.0,0.0,1865,1576
2015-09-03,Uzbekistan,Yemen,1,0,1,1.0,0.0,1824,1545
2015-09-04,American Samoa,Cook Islands,2,0,2,1.0,0.0,1360,1438
2015-09-04,Curaçao,El Salvador,0,1,1,0.0,1.0,1509,1721
2015-09-04,Denmark,Albania,0,0,0,0.5,0.5,1919,1745
2015-09-04,Djibouti,Togo,0,2,2,0.0,1.0,1310,1667
2015-09-04,Faroe Islands,Northern Ireland,1,3,2,0.0,1.0,1476,1701
2015-09-04,Georgia,Scotland,1,0,1,1.0,0.0,1676,1868
2015-09-04,Germany,Poland,3,1,2,1.0,0.0,2114,1901
2015-09-04,Gibraltar,Republic of Ireland,0,4,4,0.0,1.0,1578,1916
2015-09-04,Greece,Finland,0,1,1,0.0,1.0,1869,1784
2015-09-04,Grenada,Haiti,1,3,2,0.0,1.0,1509,1699
2015-09-04,Hungary,Romania,0,0,0,0.5,0.5,1841,1904
2015-09-04,Portugal,France,0,1,1,0.0,1.0,2014,2040
2015-09-04,Serbia,Armenia,2,0,2,1.0,0.0,1867,1645
2015-09-04,Tonga,Samoa,0,3,3,0.0,1.0,1424,1468
2015-09-04,Venezuela,Honduras,0,3,3,0.0,1.0,1840,1815
2015-09-04,Antigua and Barbuda,Guatemala,1,0,1,1.0,0.0,1592,1685
2015-09-04,Canada,Belize,3,0,3,1.0,0.0,1729,1505
2015-09-04,Jamaica,Nicaragua,2,3,1,0.0,1.0,1777,1453
2015-09-04,Saint Vincent and the Grenadines,Aruba,2,0,2,1.0,0.0,1581,1416
2015-09-04,United States,Peru,2,1,1,1.0,0.0,1996,1872
2015-09-05,Argentina,Bolivia,7,0,7,1.0,0.0,2117,1749
2015-09-05,Austria,Moldova,1,0,1,1.0,0.0,1856,1586
2015-09-05,Botswana,Burkina Faso,1,0,1,1.0,0.0,1655,1682
2015-09-05,Burundi,Niger,2,0,2,1.0,0.0,1590,1576
2015-09-05,Chile,Paraguay,3,2,1,1.0,0.0,2030,1883
2015-09-05,Comoros,Uganda,0,1,1,0.0,1.0,1385,1750
2015-09-05,Costa Rica,Brazil,0,1,1,0.0,1.0,1874,2186
2015-09-05,Estonia,Lithuania,1,0,1,1.0,0.0,1711,1620
2015-09-05,Gabon,Sudan,4,0,4,1.0,0.0,1717,1627
2015-09-05,Guinea-Bissau,Congo,2,4,2,0.0,1.0,1521,1670
2015-09-05,Liberia,Tunisia,1,0,1,1.0,0.0,1613,1833
2015-09-05,Luxembourg,North Macedonia,1,0,1,1.0,0.0,1482,1695
2015-09-05,Mauritania,South Africa,3,1,2,1.0,0.0,1509,1827
2015-09-05,Montenegro,Liechtenstein,2,0,2,1.0,0.0,1721,1445
2015-09-05,Namibia,Senegal,0,2,2,0.0,1.0,1604,1858
2015-09-05,Russia,Sweden,1,0,1,1.0,0.0,1934,1936
2015-09-05,Rwanda,Ghana,0,1,1,0.0,1.0,1641,1868
2015-09-05,San Marino,England,0,6,6,0.0,1.0,1327,2055
2015-09-05,São Tomé and Príncipe,Morocco,0,3,3,0.0,1.0,1448,1798
2015-09-05,Seychelles,Ethiopia,1,1,0,0.5,0.5,1430,1624
2015-09-05,South Sudan,Equatorial Guinea,1,0,1,1.0,0.0,1478,1573
2015-09-05,Spain,Slovakia,2,0,2,1.0,0.0,2140,1862
2015-09-05,Switzerland,Slovenia,3,2,1,1.0,0.0,1946,1769
2015-09-05,Tanzania,Nigeria,0,0,0,0.5,0.5,1603,1856
2015-09-05,Ukraine,Belarus,3,1,2,1.0,0.0,1940,1749
2015-09-06,Raetia,Franconia,6,0,6,1.0,0.0,1467,1499
2015-09-06,Bosnia and Herzegovina,Andorra,3,0,3,1.0,0.0,1835,1337
2015-09-06,Central African Republic,DR Congo,2,0,2,1.0,0.0,1492,1701
2015-09-06,Benin,Mali,1,1,0,0.5,0.5,1607,1730
2015-09-06,Cyprus,Belgium,0,1,1,0.0,1.0,1635,1975
2015-09-06,Iceland,Kazakhstan,0,0,0,0.5,0.5,1765,1601
2015-09-06,Italy,Bulgaria,1,0,1,1.0,0.0,2003,1791
2015-09-06,Latvia,Czech Republic,1,2,1,0.0,1.0,1661,1901
2015-09-06,Gambia,Cameroon,0,1,1,0.0,1.0,1588,1864
2015-09-06,Kenya,Zambia,1,2,1,0.0,1.0,1636,1776
2015-09-06,Lesotho,Algeria,1,3,2,0.0,1.0,1509,1845
2015-09-06,Libya,Cape Verde,1,2,1,0.0,1.0,1733,1722
2015-09-06,Madagascar,Angola,0,0,0,0.5,0.5,1566,1717
2015-09-06,Malta,Azerbaijan,2,2,0,0.5,0.5,1497,1636
2015-09-06,Mauritius,Mozambique,1,0,1,1.0,0.0,1472,1642
2015-09-06,Norway,Croatia,2,0,2,1.0,0.0,1851,1966
2015-09-06,Sierra Leone,Ivory Coast,0,0,0,0.5,0.5,1604,1911
2015-09-06,Eswatini,Malawi,2,2,0,0.5,0.5,1510,1637
2015-09-06,Zimbabwe,Guinea,1,1,0,0.5,0.5,1678,1760
2015-09-06,Turkey,Netherlands,3,0,3,1.0,0.0,1907,2039
2015-09-06,Wales,Israel,0,0,0,0.5,0.5,1811,1796
2015-09-07,Albania,Portugal,0,1,1,0.0,1.0,1743,2017
2015-09-07,Armenia,Denmark,0,0,0,0.5,0.5,1651,1914
2015-09-07,Myanmar,New Zealand,1,1,0,0.5,0.5,1526,1747
2015-09-07,Finland,Faroe Islands,1,0,1,1.0,0.0,1787,1474
2015-09-07,France,Serbia,2,1,1,1.0,0.0,2045,1863
2015-09-07,Republic of Ireland,Georgia,1,0,1,1.0,0.0,1920,1673
2015-09-07,Northern Ireland,Hungary,1,1,0,0.5,0.5,1705,1838
2015-09-07,Poland,Gibraltar,8,1,7,1.0,0.0,1904,1576
2015-09-07,Romania,Greece,0,0,0,0.5,0.5,1904,1870
2015-09-07,Scotland,Germany,2,3,1,0.0,1.0,1865,2118
2015-09-08,United States,Brazil,1,4,3,0.0,1.0,1992,2191
2015-09-08,Afghanistan,Japan,0,6,6,0.0,1.0,1459,1976
2015-09-08,Bangladesh,Jordan,0,4,4,0.0,1.0,1444,1771
2015-09-08,Belarus,Luxembourg,2,0,2,1.0,0.0,1752,1480
2015-09-08,Cambodia,Syria,0,6,6,0.0,1.0,1321,1747
2015-09-08,China PR,Maldives,3,0,3,1.0,0.0,1878,1463
2015-09-08,Ecuador,Honduras,2,0,2,1.0,0.0,1928,1810
2015-09-08,El Salvador,Curaçao,1,0,1,1.0,0.0,1725,1506
2015-09-08,England,Switzerland,2,0,2,1.0,0.0,2061,1941
2015-09-08,Guam,Oman,0,0,0,0.5,0.5,1434,1803
2015-09-08,Hong Kong,Qatar,2,3,1,0.0,1.0,1588,1836
2015-09-08,India,Iran,0,3,3,0.0,1.0,1542,1940
2015-09-08,Laos,Kuwait,0,2,2,0.0,1.0,1399,1797
2015-09-08,Lebanon,South Korea,0,3,3,0.0,1.0,1653,1948
2015-09-08,Liechtenstein,Russia,0,7,7,0.0,1.0,1445,1935
2015-09-08,Lithuania,San Marino,2,1,1,1.0,0.0,1623,1325
2015-09-08,North Macedonia,Spain,0,1,1,0.0,1.0,1694,2142
2015-09-08,Malaysia,Saudi Arabia,0,3,3,0.0,1.0,1573,1814
2015-09-08,Mexico,Argentina,2,2,0,0.5,0.5,1973,2114
2015-09-08,Moldova,Montenegro,0,2,2,0.0,1.0,1581,1727
2015-09-08,Nigeria,Niger,2,0,2,1.0,0.0,1859,1574
2015-09-08,Palestine,United Arab Emirates,0,0,0,0.5,0.5,1627,1861
2015-09-08,Philippines,Uzbekistan,1,5,4,0.0,1.0,1590,1828
2015-09-08,Slovakia,Ukraine,0,0,0,0.5,0.5,1864,1939
2015-09-08,Slovenia,Estonia,1,0,1,1.0,0.0,1776,1705
2015-09-08,South Africa,Senegal,1,0,1,1.0,0.0,1836,1850
2015-09-08,Sweden,Austria,1,4,3,0.0,1.0,1927,1866
2015-09-08,Tajikistan,Australia,0,3,3,0.0,1.0,1592,1932
2015-09-08,Thailand,Iraq,2,2,0,0.5,0.5,1760,1797
2015-09-08,Venezuela,Panama,1,1,0,0.5,0.5,1841,1841
2015-09-08,Yemen,Bahrain,0,4,4,0.0,1.0,1542,1781
2015-09-08,Zambia,Gabon,1,1,0,0.5,0.5,1775,1719
2015-09-08,Aruba,Saint Vincent and the Grenadines,2,1,1,1.0,0.0,1428,1570
2015-09-08,Belize,Canada,1,1,0,0.5,0.5,1510,1725
2015-09-08,Guatemala,Antigua and Barbuda,2,0,2,1.0,0.0,1691,1587
2015-09-08,Haiti,Grenada,3,0,3,1.0,0.0,1704,1505
2015-09-08,Nicaragua,Jamaica,0,2,2,0.0,1.0,1451,1780
2015-09-08,Taiwan,Vietnam,1,2,1,0.0,1.0,1397,1652
2015-09-08,Colombia,Peru,1,1,0,0.5,0.5,2023,1876
2015-09-12,Rwanda,Gabon,0,1,1,0.0,1.0,1635,1726
2015-09-30,Botswana,Ethiopia,2,3,1,0.0,1.0,1647,1633
2015-10-02,Oman,Syria,2,1,1,1.0,0.0,1810,1741
2015-10-03,Jordan,Iraq,3,0,3,1.0,0.0,1780,1789
2015-10-07,Comoros,Lesotho,0,0,0,0.5,0.5,1388,1507
2015-10-07,Mauritius,Kenya,2,5,3,0.0,1.0,1468,1641
2015-10-07,Seychelles,Burundi,0,1,1,0.0,1.0,1426,1595
2015-10-07,South Sudan,Mauritania,1,1,0,0.5,0.5,1479,1509
2015-10-07,Tanzania,Malawi,2,0,2,1.0,0.0,1612,1629
2015-10-08,Albania,Serbia,0,2,2,0.0,1.0,1738,1869
2015-10-08,Argentina,Ecuador,0,2,2,0.0,1.0,2103,1940
2015-10-08,Bahrain,Uzbekistan,0,4,4,0.0,1.0,1775,1835
2015-10-08,Bhutan,Maldives,3,4,1,0.0,1.0,1270,1468
2015-10-08,Bolivia,Uruguay,0,2,2,0.0,1.0,1747,2013
2015-10-08,Myanmar,Lebanon,0,2,2,0.0,1.0,1521,1659
2015-10-08,Chile,Brazil,2,0,2,1.0,0.0,2042,2180
2015-10-08,Colombia,Peru,2,0,2,1.0,0.0,2028,1872
2015-10-08,Timor-Leste,Palestine,0,3,3,0.0,1.0,1329,1630
2015-10-08,France,Armenia,4,0,4,1.0,0.0,2047,1650
2015-10-08,Georgia,Gibraltar,4,0,4,1.0,0.0,1679,1571
2015-10-08,Hungary,Faroe Islands,2,1,1,1.0,0.0,1840,1473
2015-10-08,Republic of Ireland,Germany,1,0,1,1.0,0.0,1933,2106
2015-10-08,Jordan,Australia,2,0,2,1.0,0.0,1792,1921
2015-10-08,North Korea,Philippines,0,0,0,0.5,0.5,1793,1595
2015-10-08,Kuwait,South Korea,0,1,1,0.0,1.0,1793,1953
2015-10-08,Kyrgyzstan,Tajikistan,2,2,0,0.5,0.5,1470,1590
2015-10-08,Laos,Malaysia,1,3,2,0.0,1.0,1395,1578
2015-10-08,Liberia,Guinea-Bissau,1,1,0,0.5,0.5,1611,1524
2015-10-08,Nigeria,DR Congo,0,2,2,0.0,1.0,1848,1713
2015-10-08,Northern Ireland,Greece,3,1,2,1.0,0.0,1717,1859
2015-10-08,Oman,Iran,1,1,0,0.5,0.5,1813,1938
2015-10-08,Portugal,Denmark,1,0,1,1.0,0.0,2023,1909
2015-10-08,Qatar,China PR,1,0,1,1.0,0.0,1845,1870
2015-10-08,Romania,Finland,1,1,0,0.5,0.5,1902,1790
2015-10-08,São Tomé and Príncipe,Ethiopia,1,0,1,1.0,0.0,1460,1622
2015-10-08,Saudi Arabia,United Arab Emirates,2,1,1,1.0,0.0,1824,1852
2015-10-08,Scotland,Poland,2,2,0,0.5,0.5,1866,1904
2015-10-08,Singapore,Afghanistan,1,0,1,1.0,0.0,1623,1455
2015-10-08,Syria,Japan,0,3,3,0.0,1.0,1738,1980
2015-10-08,Turkmenistan,India,2,1,1,1.0,0.0,1595,1536
2015-10-08,Venezuela,Paraguay,0,1,1,0.0,1.0,1834,1891
2015-10-08,Vietnam,Iraq,1,1,0,0.5,0.5,1656,1786
2015-10-09,Algeria,Guinea,1,2,1,0.0,1.0,1836,1770
2015-10-09,Burkina Faso,Mali,1,4,3,0.0,1.0,1676,1737
2015-10-09,Djibouti,Eswatini,0,6,6,0.0,1.0,1307,1514
2015-10-09,England,Estonia,2,0,2,1.0,0.0,2063,1704
2015-10-09,Gambia,Namibia,1,1,0,0.5,0.5,1589,1604
2015-10-09,Liechtenstein,Sweden,0,2,2,0.0,1.0,1445,1928
2015-10-09,North Macedonia,Ukraine,0,2,2,0.0,1.0,1691,1943
2015-10-09,Moldova,Russia,1,2,1,0.0,1.0,1580,1937
2015-10-09,Montenegro,Austria,2,3,1,0.0,1.0,1723,1871
2015-10-09,Morocco,Ivory Coast,0,1,1,0.0,1.0,1793,1917
2015-10-09,Slovakia,Belarus,0,1,1,0.0,1.0,1854,1763
2015-10-09,Slovenia,Lithuania,1,1,0,0.5,0.5,1773,1627
2015-10-09,Somalia,Niger,0,2,2,0.0,1.0,1328,1578
2015-10-09,Spain,Luxembourg,4,0,4,1.0,0.0,2143,1480
2015-10-09,Switzerland,San Marino,7,0,7,1.0,0.0,1942,1325
2015-10-09,Thailand,Hong Kong,1,0,1,1.0,0.0,1765,1584
2015-10-09,Tunisia,Gabon,3,3,0,0.5,0.5,1831,1729
2015-10-10,Andorra,Belgium,1,4,3,0.0,1.0,1337,1976
2015-10-10,Azerbaijan,Italy,1,3,2,0.0,1.0,1635,2005
2015-10-10,Bosnia and Herzegovina,Wales,2,0,2,1.0,0.0,1843,1804
2015-10-10,Chad,Sierra Leone,1,0,1,1.0,0.0,1532,1595
2015-10-10,Croatia,Bulgaria,3,0,3,1.0,0.0,1971,1787
2015-10-10,Czech Republic,Turkey,0,2,2,0.0,1.0,1894,1915
2015-10-10,Eritrea,Botswana,0,2,2,0.0,1.0,1460,1652
2015-10-10,Iceland,Latvia,2,2,0,0.5,0.5,1763,1664
2015-10-10,Israel,Cyprus,1,2,1,0.0,1.0,1785,1647
2015-10-10,Kazakhstan,Netherlands,1,2,1,0.0,1.0,1600,2041
2015-10-10,Kosovo,Equatorial Guinea,2,0,2,1.0,0.0,1534,1564
2015-10-10,Madagascar,Central African Republic,3,0,3,1.0,0.0,1573,1486
2015-10-10,Norway,Malta,2,0,2,1.0,0.0,1853,1496
2015-10-10,United States,Mexico,2,3,1,0.0,1.0,1984,1982
2015-10-11,Armenia,Albania,0,3,3,0.0,1.0,1644,1745
2015-10-11,Denmark,France,1,2,1,0.0,1.0,1905,2052
2015-10-11,Egypt,Zambia,3,0,3,1.0,0.0,1902,1770
2015-10-11,Ethiopia,São Tomé and Príncipe,3,0,3,1.0,0.0,1627,1456
2015-10-11,Faroe Islands,Romania,0,3,3,0.0,1.0,1472,1904
2015-10-11,Finland,Northern Ireland,1,1,0,0.5,0.5,1789,1719
2015-10-11,Germany,Georgia,2,1,1,1.0,0.0,2108,1678
2015-10-11,Gibraltar,Scotland,0,6,6,0.0,1.0,1569,1869
2015-10-11,Greece,Hungary,4,3,1,1.0,0.0,1867,1833
2015-10-11,Kenya,Mauritius,0,0,0,0.5,0.5,1638,1472
2015-10-11,Malawi,Tanzania,1,0,1,1.0,0.0,1637,1605
2015-10-11,Nigeria,Cameroon,3,0,3,1.0,0.0,1857,1856
2015-10-11,Poland,Republic of Ireland,2,1,1,1.0,0.0,1913,1925
2015-10-11,Serbia,Portugal,1,2,1,0.0,1.0,1865,2028
2015-10-12,Austria,Liechtenstein,3,0,3,1.0,0.0,1873,1444
2015-10-12,Belarus,North Macedonia,0,0,0,0.5,0.5,1762,1693
2015-10-12,Estonia,Switzerland,0,1,1,0.0,1.0,1701,1946
2015-10-12,Gabon,DR Congo,1,2,1,0.0,1.0,1721,1722
2015-10-12,Lithuania,England,0,3,3,0.0,1.0,1626,2065
2015-10-12,Luxembourg,Slovakia,2,4,2,0.0,1.0,1479,1856
2015-10-12,Morocco,Guinea,1,1,0,0.5,0.5,1793,1771
2015-10-12,Russia,Montenegro,2,0,2,1.0,0.0,1941,1720
2015-10-12,San Marino,Slovenia,0,2,2,0.0,1.0,1324,1775
2015-10-12,Sweden,Moldova,2,0,2,1.0,0.0,1930,1579
2015-10-12,Ukraine,Spain,0,1,1,0.0,1.0,1940,2147
2015-10-13,Algeria,Senegal,1,0,1,1.0,0.0,1845,1842
2015-10-13,Bahrain,Philippines,2,0,2,1.0,0.0,1780,1591
2015-10-13,Belgium,Israel,3,1,2,1.0,0.0,1980,1782
2015-10-13,Bhutan,Hong Kong,0,1,1,0.0,1.0,1268,1587
2015-10-13,Botswana,Eritrea,3,1,2,1.0,0.0,1656,1457
2015-10-13,Brazil,Venezuela,3,1,2,1.0,0.0,2182,1833
2015-10-13,Bulgaria,Azerbaijan,2,0,2,1.0,0.0,1792,1631
2015-10-13,Myanmar,Laos,3,1,2,1.0,0.0,1527,1390
2015-10-13,Burundi,Seychelles,2,0,2,1.0,0.0,1600,1422
2015-10-13,Congo,Benin,2,1,1,1.0,0.0,1677,1601
2015-10-13,Cyprus,Bosnia and Herzegovina,2,3,1,0.0,1.0,1644,1847
2015-10-13,Timor-Leste,Malaysia,0,3,3,0.0,1.0,1326,1582
2015-10-13,Ecuador,Bolivia,2,0,2,1.0,0.0,1944,1744
2015-10-13,El Salvador,Guatemala,1,1,0,0.5,0.5,1725,1692
2015-10-13,Guinea-Bissau,Liberia,1,3,2,0.0,1.0,1518,1618
2015-10-13,Iran,Japan,1,1,0,0.5,0.5,1939,1980
2015-10-13,Italy,Norway,2,1,1,1.0,0.0,2010,1849
2015-10-13,Jordan,Tajikistan,3,0,3,1.0,0.0,1796,1587
2015-10-13,North Korea,Yemen,1,0,1,1.0,0.0,1797,1539
2015-10-13,South Korea,Jamaica,3,0,3,1.0,0.0,1958,1776
2015-10-13,Kuwait,Lebanon,0,0,0,0.5,0.5,1791,1662
2015-10-13,Kyrgyzstan,Bangladesh,2,0,2,1.0,0.0,1478,1437
2015-10-13,Latvia,Kazakhstan,0,1,1,0.0,1.0,1655,1610
2015-10-13,Lesotho,Comoros,1,1,0,0.5,0.5,1505,1391
2015-10-13,Madagascar,Central African Republic,2,2,0,0.5,0.5,1572,1488
2015-10-13,Malta,Croatia,0,1,1,0.0,1.0,1496,1972
2015-10-13,Mauritania,South Sudan,4,0,4,1.0,0.0,1517,1472
2015-10-13,Namibia,Gambia,2,1,1,1.0,0.0,1612,1582
2015-10-13,Netherlands,Czech Republic,2,3,1,0.0,1.0,2030,1906
2015-10-13,Niger,Somalia,4,0,4,1.0,0.0,1582,1325
2015-10-13,Oman,India,3,0,3,1.0,0.0,1816,1534
2015-10-13,Paraguay,Argentina,0,0,0,0.5,0.5,1896,2099
2015-10-13,Peru,Chile,3,4,1,0.0,1.0,1868,2047
2015-10-13,Qatar,Maldives,4,0,4,1.0,0.0,1847,1467
2015-10-13,Sierra Leone,Chad,2,1,1,1.0,0.0,1602,1526
2015-10-13,Singapore,Cambodia,2,1,1,1.0,0.0,1626,1319
2015-10-13,Syria,Afghanistan,5,2,3,1.0,0.0,1741,1453
2015-10-13,Turkey,Iceland,1,0,1,1.0,0.0,1920,1759
2015-10-13,Turkmenistan,Guam,1,0,1,1.0,0.0,1600,1430
2015-10-13,Uruguay,Colombia,3,0,3,1.0,0.0,2022,2020
2015-10-13,Vietnam,Thailand,0,3,3,0.0,1.0,1651,1771
2015-10-13,Wales,Andorra,2,0,2,1.0,0.0,1806,1336
2015-10-17,Eswatini,Djibouti,2,1,1,1.0,0.0,1518,1304
2015-11-03,Cambodia,Brunei,6,1,5,1.0,0.0,1327,1272
2015-11-05,United Arab Emirates,Turkmenistan,5,1,4,1.0,0.0,1856,1597
2015-11-06,Angola,Namibia,1,0,1,1.0,0.0,1723,1607
2015-11-06,DR Congo,Zambia,3,0,3,1.0,0.0,1732,1761
2015-11-07,Angola,DR Congo,1,0,1,1.0,0.0,1732,1724
2015-11-07,Hong Kong,Myanmar,5,0,5,1.0,0.0,1594,1521
2015-11-07,Namibia,Zambia,0,0,0,0.5,0.5,1611,1758
2015-11-07,Vanuatu,Fiji,1,1,0,0.5,0.5,1602,1690
2015-11-09,Palestine,Saudi Arabia,0,0,0,0.5,0.5,1635,1820
2015-11-10,Vanuatu,Fiji,2,1,1,1.0,0.0,1612,1681
2015-11-11,Estonia,Georgia,3,0,3,1.0,0.0,1709,1671
2015-11-11,Jordan,Malta,2,0,2,1.0,0.0,1799,1494
2015-11-11,Mozambique,Gabon,1,0,1,1.0,0.0,1652,1712
2015-11-11,Sudan,Zambia,0,1,1,0.0,1.0,1622,1764
2015-11-12,Afghanistan,Cambodia,3,0,3,1.0,0.0,1459,1322
2015-11-12,Andorra,Saint Kitts and Nevis,0,1,1,0.0,1.0,1333,1594
2015-11-12,Australia,Kyrgyzstan,3,0,3,1.0,0.0,1923,1477
2015-11-12,Benin,Burkina Faso,2,1,1,1.0,0.0,1611,1667
2015-11-12,Bolivia,Venezuela,4,2,2,1.0,0.0,1755,1823
2015-11-12,Burundi,DR Congo,2,3,1,0.0,1.0,1595,1730
2015-11-12,Chile,Colombia,1,1,0,0.5,0.5,2047,2021
2015-11-12,China PR,Bhutan,12,0,12,1.0,0.0,1871,1268
2015-11-12,Ecuador,Uruguay,2,1,1,1.0,0.0,1954,2013
2015-11-12,India,Guam,1,0,1,1.0,0.0,1540,1425
2015-11-12,Iran,Turkmenistan,3,1,2,1.0,0.0,1941,1596
2015-11-12,South Korea,Myanmar,4,0,4,1.0,0.0,1960,1520
2015-11-12,Lebanon,Laos,7,0,7,1.0,0.0,1665,1388
2015-11-12,North Macedonia,Montenegro,4,1,3,1.0,0.0,1702,1712
2015-11-12,Maldives,Hong Kong,0,1,1,0.0,1.0,1462,1600
2015-11-12,Morocco,Equatorial Guinea,2,0,2,1.0,0.0,1797,1561
2015-11-12,Namibia,Guinea,0,1,1,0.0,1.0,1607,1776
2015-11-12,Norway,Hungary,0,1,1,0.0,1.0,1841,1842
2015-11-12,Oman,New Zealand,0,1,1,0.0,1.0,1807,1757
2015-11-12,Palestine,Malaysia,6,0,6,1.0,0.0,1642,1576
2015-11-12,Philippines,Yemen,0,1,1,0.0,1.0,1582,1549
2015-11-12,Singapore,Japan,0,3,3,0.0,1.0,1625,1982
2015-11-12,Tajikistan,Bangladesh,5,0,5,1.0,0.0,1592,1433
2015-11-12,Thailand,Taiwan,4,2,2,1.0,0.0,1773,1396
2015-11-12,Togo,Uganda,0,1,1,0.0,1.0,1661,1757
2015-11-12,United Arab Emirates,Timor-Leste,8,0,8,1.0,0.0,1857,1326
2015-11-12,Uzbekistan,North Korea,3,1,2,1.0,0.0,1843,1790
2015-11-13,Angola,South Africa,1,3,2,0.0,1.0,1727,1842
2015-11-13,Argentina,Brazil,1,1,0,0.5,0.5,2101,2181
2015-11-13,Belgium,Italy,3,1,2,1.0,0.0,1989,2002
2015-11-13,Bosnia and Herzegovina,Republic of Ireland,1,1,0,0.5,0.5,1849,1924
2015-11-13,Comoros,Ghana,0,0,0,0.5,0.5,1399,1861
2015-11-13,Costa Rica,Haiti,1,0,1,1.0,0.0,1879,1700
2015-11-13,Czech Republic,Serbia,4,1,3,1.0,0.0,1914,1858
2015-11-13,France,Germany,2,0,2,1.0,0.0,2062,2099
2015-11-13,Kenya,Cape Verde,1,0,1,1.0,0.0,1648,1713
2015-11-13,Kosovo,Albania,2,2,0,0.5,0.5,1539,1741
2015-11-13,Liberia,Ivory Coast,0,1,1,0.0,1.0,1616,1920
2015-11-13,Libya,Rwanda,1,0,1,1.0,0.0,1739,1630
2015-11-13,Luxembourg,Greece,1,0,1,1.0,0.0,1494,1853
2015-11-13,Madagascar,Senegal,2,2,0,0.5,0.5,1578,1837
2015-11-13,Mauritania,Tunisia,1,2,1,0.0,1.0,1515,1834
2015-11-13,Niger,Cameroon,0,3,3,0.0,1.0,1580,1859
2015-11-13,Northern Ireland,Latvia,1,0,1,1.0,0.0,1726,1649
2015-11-13,Peru,Paraguay,1,0,1,1.0,0.0,1877,1888
2015-11-13,Poland,Iceland,4,2,2,1.0,0.0,1918,1755
2015-11-13,Qatar,Turkey,1,2,1,0.0,1.0,1841,1927
2015-11-13,Slovakia,Switzerland,3,2,1,1.0,0.0,1867,1936
2015-11-13,Spain,England,2,0,2,1.0,0.0,2154,2059
2015-11-13,Eswatini,Nigeria,0,0,0,0.5,0.5,1525,1851
2015-11-13,Wales,Netherlands,2,3,1,0.0,1.0,1803,2034
2015-11-13,Canada,Honduras,1,0,1,1.0,0.0,1735,1801
2015-11-13,Guatemala,Trinidad and Tobago,1,2,1,0.0,1.0,1686,1757
2015-11-13,Jamaica,Panama,0,2,2,0.0,1.0,1770,1848
2015-11-13,Mexico,El Salvador,3,0,3,1.0,0.0,1985,1723
2015-11-13,United States,Saint Vincent and the Grenadines,6,1,5,1.0,0.0,1986,1569
2015-11-14,Botswana,Mali,2,1,1,1.0,0.0,1666,1728
2015-11-14,Chad,Egypt,1,0,1,1.0,0.0,1541,1888
2015-11-14,Ethiopia,Congo,3,4,1,0.0,1.0,1621,1684
2015-11-14,Gabon,Mozambique,1,0,1,1.0,0.0,1719,1646
2015-11-14,Hong Kong,Macau,2,0,2,1.0,0.0,1603,1295
2015-11-14,Russia,Portugal,1,0,1,1.0,0.0,1951,2019
2015-11-14,Sweden,Denmark,2,1,1,1.0,0.0,1938,1898
2015-11-14,Tanzania,Algeria,2,2,0,0.5,0.5,1610,1841
2015-11-14,Ukraine,Slovenia,2,0,2,1.0,0.0,1945,1771
2015-11-15,DR Congo,Burundi,3,0,3,1.0,0.0,1736,1590
2015-11-15,Equatorial Guinea,Morocco,1,0,1,1.0,0.0,1574,1785
2015-11-15,Guinea,Namibia,2,0,2,1.0,0.0,1781,1603
2015-11-15,Hungary,Norway,2,1,1,1.0,0.0,1850,1834
2015-11-15,Uganda,Togo,3,0,3,1.0,0.0,1763,1656
2015-11-15,Zambia,Sudan,2,0,2,1.0,0.0,1769,1618
2015-11-16,Albania,Georgia,2,2,0,0.5,0.5,1740,1673
2015-11-16,Republic of Ireland,Bosnia and Herzegovina,2,0,2,1.0,0.0,1931,1843
2015-11-17,Algeria,Tanzania,7,0,7,1.0,0.0,1845,1607
2015-11-17,Austria,Switzerland,1,2,1,0.0,1.0,1867,1943
2015-11-17,Azerbaijan,Moldova,2,1,1,1.0,0.0,1638,1573
2015-11-17,Bangladesh,Australia,0,4,4,0.0,1.0,1433,1924
2015-11-17,Bhutan,Qatar,0,3,3,0.0,1.0,1268,1842
2015-11-17,Brazil,Peru,3,0,3,1.0,0.0,2184,1875
2015-11-17,Burkina Faso,Benin,2,0,2,1.0,0.0,1674,1605
2015-11-17,Myanmar,Kuwait,3,0,3,1.0,0.0,1534,1778
2015-11-17,Cambodia,Japan,0,2,2,0.0,1.0,1322,1983
2015-11-17,Cameroon,Niger,0,0,0,0.5,0.5,1854,1586
2015-11-17,Cape Verde,Kenya,2,0,2,1.0,0.0,1720,1642
2015-11-17,Colombia,Argentina,0,1,1,0.0,1.0,2015,2108
2015-11-17,Congo,Ethiopia,2,1,1,1.0,0.0,1691,1615
2015-11-17,Denmark,Sweden,2,2,0,0.5,0.5,1899,1938
2015-11-17,Timor-Leste,Saudi Arabia,0,10,10,0.0,1.0,1326,1821
2015-11-17,Egypt,Chad,4,0,4,1.0,0.0,1890,1540
2015-11-17,England,France,2,0,2,1.0,0.0,2068,2054
2015-11-17,Estonia,Saint Kitts and Nevis,3,0,3,1.0,0.0,1715,1589
2015-11-17,Ghana,Comoros,2,0,2,1.0,0.0,1863,1398
2015-11-17,Guam,Iran,0,6,6,0.0,1.0,1425,1942
2015-11-17,Honduras,Mexico,0,2,2,0.0,1.0,1797,1990
2015-11-17,Hong Kong,China PR,0,0,0,0.5,0.5,1609,1866
2015-11-17,Italy,Romania,2,2,0,0.5,0.5,2000,1907
2015-11-17,Ivory Coast,Liberia,3,0,3,1.0,0.0,1923,1614
2015-11-17,North Korea,Bahrain,2,0,2,1.0,0.0,1798,1773
2015-11-17,Kyrgyzstan,Jordan,1,0,1,1.0,0.0,1491,1786
2015-11-17,Laos,South Korea,0,5,5,0.0,1.0,1388,1961
2015-11-17,Luxembourg,Portugal,0,2,2,0.0,1.0,1494,2020
2015-11-17,North Macedonia,Lebanon,0,1,1,0.0,1.0,1694,1674
2015-11-17,Malaysia,United Arab Emirates,1,2,1,0.0,1.0,1574,1860
2015-11-17,Mali,Botswana,2,0,2,1.0,0.0,1735,1660
2015-11-17,Nigeria,Eswatini,2,0,2,1.0,0.0,1854,1523
2015-11-17,Paraguay,Bolivia,2,1,1,1.0,0.0,1894,1750
2015-11-17,Poland,Czech Republic,3,1,2,1.0,0.0,1926,1907
2015-11-17,Russia,Croatia,1,3,2,0.0,1.0,1944,1980
2015-11-17,Rwanda,Libya,1,3,2,0.0,1.0,1625,1745
2015-11-17,Senegal,Madagascar,3,0,3,1.0,0.0,1840,1576
2015-11-17,Singapore,Syria,1,2,1,0.0,1.0,1620,1747
2015-11-17,Slovakia,Iceland,3,1,2,1.0,0.0,1873,1750
2015-11-17,Slovenia,Ukraine,1,1,0,0.5,0.5,1775,1942
2015-11-17,South Africa,Angola,1,0,1,1.0,0.0,1848,1722
2015-11-17,Tunisia,Mauritania,2,1,1,1.0,0.0,1837,1513
2015-11-17,Turkey,Greece,0,0,0,0.5,0.5,1926,1855
2015-11-17,Turkmenistan,Oman,2,1,1,1.0,0.0,1609,1795
2015-11-17,Uruguay,Chile,3,0,3,1.0,0.0,2022,2039
2015-11-17,Venezuela,Ecuador,1,3,2,0.0,1.0,1818,1960
2015-11-17,Yemen,Uzbekistan,1,3,2,0.0,1.0,1547,1846
2015-11-17,Haiti,Jamaica,0,1,1,0.0,1.0,1694,1777
2015-11-17,Panama,Costa Rica,1,2,1,0.0,1.0,1841,1887
2015-11-17,Saint Vincent and the Grenadines,Guatemala,0,4,4,0.0,1.0,1564,1692
2015-11-17,Taiwan,Iraq,0,2,2,0.0,1.0,1395,1788
2015-11-21,Burundi,Zanzibar,1,0,1,1.0,0.0,1597,1537
2015-11-21,Ethiopia,Rwanda,0,1,1,0.0,1.0,1608,1633
2015-11-22,Kenya,Uganda,2,0,2,1.0,0.0,1653,1753
2015-11-22,Somalia,Tanzania,0,4,4,0.0,1.0,1323,1610
2015-11-23,South Sudan,Djibouti,2,0,2,1.0,0.0,1477,1300
2015-11-23,Sudan,Malawi,1,2,1,0.0,1.0,1611,1645
2015-11-24,Rwanda,Tanzania,1,2,1,0.0,1.0,1625,1619
2015-11-24,Zanzibar,Uganda,0,4,4,0.0,1.0,1534,1757
2015-11-25,Ethiopia,Somalia,2,0,2,1.0,0.0,1611,1321
2015-11-25,Kenya,Burundi,1,1,0,0.5,0.5,1652,1599
2015-11-25,Malawi,Djibouti,3,0,3,1.0,0.0,1647,1299
2015-11-25,South Sudan,Sudan,0,0,0,0.5,0.5,1480,1609
2015-11-27,Djibouti,Sudan,0,4,4,0.0,1.0,1297,1612
2015-11-27,Rwanda,Somalia,3,0,3,1.0,0.0,1628,1319
2015-11-27,South Sudan,Malawi,2,0,2,1.0,0.0,1492,1636
2015-11-27,Zanzibar,Kenya,3,1,2,1.0,0.0,1545,1642
2015-11-28,Ethiopia,Tanzania,1,1,0,0.5,0.5,1612,1619
2015-11-28,Uganda,Burundi,1,0,1,1.0,0.0,1762,1595
2015-11-30,Ethiopia,Tanzania,1,1,0,0.5,0.5,1613,1619
2015-11-30,Uganda,Malawi,2,0,2,1.0,0.0,1768,1631
2015-12-01,Rwanda,Kenya,0,0,0,0.5,0.5,1629,1642
2015-12-01,South Sudan,Sudan,0,0,0,0.5,0.5,1495,1610
2015-12-03,Ethiopia,Uganda,0,0,0,0.5,0.5,1617,1765
2015-12-03,Rwanda,Sudan,1,1,0,0.5,0.5,1629,1611
2015-12-05,Ethiopia,Sudan,1,1,0,0.5,0.5,1617,1612
2015-12-05,Uganda,Rwanda,1,0,1,1.0,0.0,1771,1624
2015-12-08,Nicaragua,Cuba,5,0,5,1.0,0.0,1464,1656
2015-12-11,Nicaragua,Cuba,1,0,1,1.0,0.0,1477,1644
2015-12-16,Honduras,Cuba,2,0,2,1.0,0.0,1802,1640
2015-12-17,Bangladesh,Nepal,1,0,1,1.0,0.0,1441,1401
2015-12-20,Panjab,Chagos Islands,4,1,3,1.0,0.0,1506,1500
2015-12-23,Nepal,Sri Lanka,0,1,1,0.0,1.0,1392,1362
2015-12-24,Afghanistan,Bangladesh,4,0,4,1.0,0.0,1467,1434
2015-12-24,Maldives,Bhutan,3,1,2,1.0,0.0,1466,1265
2015-12-25,India,Sri Lanka,2,0,2,1.0,0.0,1545,1358
2015-12-26,Bangladesh,Maldives,1,3,2,0.0,1.0,1427,1474
2015-12-26,Bhutan,Afghanistan,0,3,3,0.0,1.0,1262,1471
2015-12-26,Martinique,Guadeloupe,2,0,2,1.0,0.0,1692,1665
2015-12-26,Catalonia,Basque Country,0,1,1,0.0,1.0,1664,1760
2015-12-27,India,Nepal,4,1,3,1.0,0.0,1550,1388
2015-12-28,Afghanistan,Maldives,4,1,3,1.0,0.0,1480,1466
2015-12-28,Bhutan,Bangladesh,0,3,3,0.0,1.0,1258,1432
2015-12-31,Afghanistan,Sri Lanka,5,0,5,1.0,0.0,1486,1353
2015-12-31,India,Maldives,3,2,1,1.0,0.0,1557,1460
2016-01-03,India,Afghanistan,2,1,1,1.0,0.0,1564,1480
2016-01-06,Rwanda,Cameroon,1,1,0,0.5,0.5,1629,1850
2016-01-06,Sweden,Estonia,1,1,0,0.5,0.5,1934,1720
2016-01-08,Bangladesh,Sri Lanka,4,2,2,1.0,0.0,1439,1347
2016-01-08,Trinidad and Tobago,Haiti,0,1,1,0.0,1.0,1748,1704
2016-01-08,Panama,Cuba,4,0,4,1.0,0.0,1845,1637
2016-01-10,Rwanda,DR Congo,1,0,1,1.0,0.0,1640,1726
2016-01-10,Sweden,Finland,3,0,3,1.0,0.0,1939,1785
2016-01-11,Maldives,Cambodia,3,2,1,1.0,0.0,1465,1318
2016-01-13,Finland,Iceland,0,1,1,0.0,1.0,1777,1759
2016-01-13,Nepal,Sri Lanka,1,0,1,1.0,0.0,1396,1340
2016-01-13,Uganda,Cameroon,0,0,0,0.5,0.5,1773,1849
2016-01-15,Bangladesh,Nepal,0,0,0,0.5,0.5,1439,1397
2016-01-16,United Arab Emirates,Iceland,2,1,1,1.0,0.0,1866,1754
2016-01-19,Maldives,Nepal,1,4,3,0.0,1.0,1456,1407
2016-01-27,Egypt,Jordan,0,1,1,0.0,1.0,1880,1797
2016-01-29,Egypt,Libya,2,0,2,1.0,0.0,1886,1740
2016-01-31,United States,Iceland,3,2,1,1.0,0.0,1990,1751
2016-02-05,Bahrain,Lebanon,2,0,2,1.0,0.0,1779,1669
2016-02-06,Guadeloupe,Martinique,1,1,0,0.5,0.5,1666,1692
2016-02-14,Uzbekistan,Lebanon,2,0,2,1.0,0.0,1851,1665
2016-02-21,Guyana,Suriname,2,0,2,1.0,0.0,1610,1570
2016-02-25,French Guiana,Suriname,2,3,1,0.0,1.0,1555,1578
2016-02-27,Egypt,Burkina Faso,2,0,2,1.0,0.0,1890,1671
2016-03-13,Sint Maarten,Anguilla,2,0,2,1.0,0.0,1494,1303
2016-03-13,Tamil Eelam,Romani people,4,1,3,1.0,0.0,1495,1490
2016-03-18,Iraq,Syria,0,1,1,0.0,1.0,1780,1756
2016-03-18,United Arab Emirates,Bangladesh,6,1,5,1.0,0.0,1868,1438
2016-03-22,Cuba,Bermuda,2,1,1,1.0,0.0,1644,1575
2016-03-23,Antigua and Barbuda,Aruba,2,1,1,1.0,0.0,1592,1424
2016-03-23,Barbados,Curaçao,1,0,1,1.0,0.0,1550,1499
2016-03-23,Croatia,Israel,2,0,2,1.0,0.0,1984,1779
2016-03-23,Gibraltar,Liechtenstein,0,0,0,0.5,0.5,1567,1447
2016-03-23,Guadeloupe,Suriname,0,0,0,0.5,0.5,1665,1580
2016-03-23,Guinea-Bissau,Kenya,1,0,1,1.0,0.0,1529,1632
2016-03-23,Martinique,British Virgin Islands,3,0,3,1.0,0.0,1694,1343
2016-03-23,Poland,Serbia,1,0,1,1.0,0.0,1933,1852
2016-03-23,Romania,Lithuania,1,0,1,1.0,0.0,1910,1624
2016-03-23,São Tomé and Príncipe,Libya,2,1,1,1.0,0.0,1470,1727
2016-03-23,Slovenia,North Macedonia,1,0,1,1.0,0.0,1782,1688
2016-03-23,South Sudan,Benin,1,2,1,0.0,1.0,1490,1611
2016-03-23,Zambia,Congo,1,1,0,0.5,0.5,1768,1693
2016-03-24,Australia,Tajikistan,7,0,7,1.0,0.0,1927,1590
2016-03-24,Bahrain,Yemen,3,0,3,1.0,0.0,1783,1544
2016-03-24,Bolivia,Colombia,2,3,1,0.0,1.0,1748,2018
2016-03-24,Chile,Argentina,1,2,1,0.0,1.0,2033,2115
2016-03-24,China PR,Maldives,4,0,4,1.0,0.0,1868,1455
2016-03-24,Comoros,Botswana,1,0,1,1.0,0.0,1412,1647
2016-03-24,Czech Republic,Scotland,0,1,1,0.0,1.0,1899,1878
2016-03-24,Denmark,Iceland,2,1,1,1.0,0.0,1904,1747
2016-03-24,Djibouti,Liberia,0,1,1,0.0,1.0,1295,1617
2016-03-24,Ecuador,Paraguay,2,2,0,0.5,0.5,1959,1896
2016-03-24,Estonia,Norway,0,0,0,0.5,0.5,1723,1832
2016-03-24,Ghana,Mozambique,3,1,2,1.0,0.0,1867,1643
2016-03-24,Greece,Montenegro,2,1,1,1.0,0.0,1860,1708
2016-03-24,Iran,India,4,0,4,1.0,0.0,1944,1563
2016-03-24,Iraq,Thailand,2,2,0,0.5,0.5,1780,1774
2016-03-24,Italy,Spain,1,1,0,0.5,0.5,2004,2151
2016-03-24,Japan,Afghanistan,5,0,5,1.0,0.0,1984,1480
2016-03-24,Jordan,Bangladesh,8,0,8,1.0,0.0,1799,1437
2016-03-24,South Korea,Lebanon,1,0,1,1.0,0.0,1964,1663
2016-03-24,Madagascar,Central African Republic,1,1,0,0.5,0.5,1575,1490
2016-03-24,Malta,Moldova,0,0,0,0.5,0.5,1496,1572
2016-03-24,Oman,Guam,1,0,1,1.0,0.0,1797,1424
2016-03-24,Peru,Venezuela,2,2,0,0.5,0.5,1874,1820
2016-03-24,Qatar,Hong Kong,2,0,2,1.0,0.0,1846,1606
2016-03-24,Saudi Arabia,Malaysia,2,0,2,1.0,0.0,1825,1571
2016-03-24,Singapore,Myanmar,2,1,1,1.0,0.0,1627,1528
2016-03-24,Solomon Islands,Papua New Guinea,2,0,2,1.0,0.0,1634,1498
2016-03-24,Syria,Cambodia,6,0,6,1.0,0.0,1758,1317
2016-03-24,Turkey,Sweden,2,1,1,1.0,0.0,1935,1931
2016-03-24,Ukraine,Cyprus,1,0,1,1.0,0.0,1945,1642
2016-03-24,United Arab Emirates,Palestine,2,0,2,1.0,0.0,1872,1639
2016-03-24,Uzbekistan,Philippines,1,0,1,1.0,0.0,1854,1580
2016-03-24,Vietnam,Taiwan,4,1,3,1.0,0.0,1654,1393
2016-03-24,Wales,Northern Ireland,1,1,0,0.5,0.5,1802,1728
2016-03-25,Algeria,Ethiopia,7,1,6,1.0,0.0,1849,1614
2016-03-25,Armenia,Belarus,0,0,0,0.5,0.5,1647,1760
2016-03-25,Brazil,Uruguay,2,2,0,0.5,0.5,2181,2026
2016-03-25,Canada,Mexico,0,3,3,0.0,1.0,1733,1993
2016-03-25,El Salvador,Honduras,2,2,0,0.5,0.5,1725,1801
2016-03-25,Gabon,Sierra Leone,2,1,1,1.0,0.0,1725,1597
2016-03-25,Guatemala,United States,2,0,2,1.0,0.0,1706,1977
2016-03-25,Guinea,Malawi,0,0,0,0.5,0.5,1778,1635
2016-03-25,Haiti,Panama,0,0,0,0.5,0.5,1708,1842
2016-03-25,Republic of Ireland,Switzerland,1,0,1,1.0,0.0,1940,1935
2016-03-25,Ivory Coast,Sudan,1,0,1,1.0,0.0,1926,1610
2016-03-25,Jamaica,Costa Rica,1,1,0,0.5,0.5,1780,1885
2016-03-25,Luxembourg,Bosnia and Herzegovina,0,3,3,0.0,1.0,1493,1845
2016-03-25,Mali,Equatorial Guinea,1,0,1,1.0,0.0,1740,1570
2016-03-25,Mauritania,Gambia,2,1,1,1.0,0.0,1523,1573
2016-03-25,Netherlands,France,2,3,1,0.0,1.0,2027,2062
2016-03-25,Nigeria,Egypt,1,1,0,0.5,0.5,1855,1890
2016-03-25,Portugal,Bulgaria,0,1,1,0.0,1.0,2008,1805
2016-03-25,Slovakia,Latvia,0,0,0,0.5,0.5,1869,1654
2016-03-25,Eswatini,Zimbabwe,1,1,0,0.5,0.5,1527,1675
2016-03-25,Tunisia,Togo,1,0,1,1.0,0.0,1842,1652
2016-03-25,Saint Vincent and the Grenadines,Trinidad and Tobago,2,3,1,0.0,1.0,1560,1753
2016-03-26,Anguilla,Puerto Rico,0,4,4,0.0,1.0,1299,1447
2016-03-26,Aruba,Saint Kitts and Nevis,0,2,2,0.0,1.0,1420,1594
2016-03-26,Austria,Albania,2,1,1,1.0,0.0,1873,1735
2016-03-26,Azerbaijan,Kazakhstan,0,1,1,0.0,1.0,1630,1619
2016-03-26,Bermuda,French Guiana,2,1,1,1.0,0.0,1583,1548
2016-03-26,British Virgin Islands,Dominica,0,7,7,0.0,1.0,1337,1425
2016-03-26,Burkina Faso,Uganda,1,0,1,1.0,0.0,1682,1763
2016-03-26,Burundi,Namibia,1,3,2,0.0,1.0,1588,1611
2016-03-26,Cameroon,South Africa,2,2,0,0.5,0.5,1849,1849
2016-03-26,Cape Verde,Morocco,0,1,1,0.0,1.0,1714,1792
2016-03-26,DR Congo,Angola,2,1,1,1.0,0.0,1734,1715
2016-03-26,Zimbabwe,Eswatini,4,0,4,1.0,0.0,1680,1523
2016-03-26,Curaçao,Dominican Republic,2,1,1,1.0,0.0,1508,1524
2016-03-26,Germany,England,2,3,1,0.0,1.0,2091,2077
2016-03-26,Hungary,Croatia,1,1,0,0.5,0.5,1853,1982
2016-03-26,Mauritius,Rwanda,1,0,1,1.0,0.0,1484,1629
2016-03-26,Poland,Finland,5,0,5,1.0,0.0,1938,1773
2016-03-26,Russia,Lithuania,3,0,3,1.0,0.0,1947,1622
2016-03-26,Senegal,Niger,2,0,2,1.0,0.0,1844,1583
2016-03-26,Seychelles,Lesotho,2,0,2,1.0,0.0,1432,1496
2016-03-26,Sint Maarten,United States Virgin Islands,1,2,1,0.0,1.0,1484,1391
2016-03-27,Benin,South Sudan,4,1,3,1.0,0.0,1617,1485
2016-03-27,Botswana,Comoros,2,1,1,1.0,0.0,1651,1409
2016-03-27,Congo,Zambia,1,1,0,0.5,0.5,1695,1767
2016-03-27,Kenya,Guinea-Bissau,0,1,1,0.0,1.0,1622,1540
2016-03-27,Mozambique,Ghana,0,0,0,0.5,0.5,1648,1863
2016-03-27,Romania,Spain,0,0,0,0.5,0.5,1915,2147
2016-03-27,Thailand,South Korea,0,1,1,0.0,1.0,1770,1969
2016-03-28,Andorra,Moldova,0,1,1,0.0,1.0,1330,1576
2016-03-28,Central African Republic,Madagascar,2,1,1,1.0,0.0,1500,1566
2016-03-28,Equatorial Guinea,Mali,0,1,1,0.0,1.0,1566,1745
2016-03-28,Libya,São Tomé and Príncipe,4,0,4,1.0,0.0,1730,1468
2016-03-28,Liechtenstein,Faroe Islands,2,3,1,0.0,1.0,1440,1480
2016-03-28,Northern Ireland,Slovenia,1,0,1,1.0,0.0,1738,1773
2016-03-28,Sierra Leone,Gabon,1,0,1,1.0,0.0,1608,1715
2016-03-28,Ukraine,Wales,1,0,1,1.0,0.0,1950,1798
2016-03-29,Afghanistan,Singapore,2,1,1,1.0,0.0,1492,1616
2016-03-29,Angola,DR Congo,0,2,2,0.0,1.0,1708,1742
2016-03-29,Argentina,Bolivia,2,0,2,1.0,0.0,2117,1747
2016-03-29,Australia,Jordan,5,1,4,1.0,0.0,1933,1794
2016-03-29,Austria,Turkey,1,2,1,0.0,1.0,1867,1942
2016-03-29,China PR,Qatar,2,0,2,1.0,0.0,1876,1839
2016-03-29,Colombia,Ecuador,3,1,2,1.0,0.0,2025,1953
2016-03-29,Costa Rica,Jamaica,3,0,3,1.0,0.0,1891,1775
2016-03-29,Dominica,Martinique,1,4,3,0.0,1.0,1423,1697
2016-03-29,Dominican Republic,Barbados,2,0,2,1.0,0.0,1533,1542
2016-03-29,Egypt,Nigeria,1,0,1,1.0,0.0,1898,1848
2016-03-29,England,Netherlands,1,2,1,0.0,1.0,2068,2037
2016-03-29,Estonia,Serbia,0,1,1,0.0,1.0,1718,1858
2016-03-29,Ethiopia,Algeria,3,3,0,0.5,0.5,1619,1845
2016-03-29,France,Russia,4,2,2,1.0,0.0,2068,1942
2016-03-29,French Guiana,Cuba,3,0,3,1.0,0.0,1559,1634
2016-03-29,Gambia,Mauritania,0,0,0,0.5,0.5,1572,1525
2016-03-29,Georgia,Kazakhstan,1,1,0,0.5,0.5,1672,1621
2016-03-29,Germany,Italy,4,1,3,1.0,0.0,2098,1998
2016-03-29,Gibraltar,Latvia,0,5,5,0.0,1.0,1561,1661
2016-03-29,Greece,Iceland,2,3,1,0.0,1.0,1850,1758
2016-03-29,Honduras,El Salvador,2,0,2,1.0,0.0,1808,1719
2016-03-29,India,Turkmenistan,1,2,1,0.0,1.0,1557,1616
2016-03-29,Iran,Oman,2,0,2,1.0,0.0,1949,1793
2016-03-29,Iraq,Vietnam,1,0,1,1.0,0.0,1786,1649
2016-03-29,Republic of Ireland,Slovakia,2,2,0,0.5,0.5,1939,1871
2016-03-29,Japan,Syria,5,0,5,1.0,0.0,1988,1755
2016-03-29,Lebanon,Myanmar,1,1,0,0.5,0.5,1661,1531
2016-03-29,Lesotho,Seychelles,2,1,1,1.0,0.0,1503,1426
2016-03-29,Liberia,Djibouti,5,0,5,1.0,0.0,1620,1293
2016-03-29,Luxembourg,Albania,0,2,2,0.0,1.0,1490,1739
2016-03-29,North Macedonia,Bulgaria,0,2,2,0.0,1.0,1683,1811
2016-03-29,Malawi,Guinea,1,2,1,0.0,1.0,1631,1783
2016-03-29,Malaysia,Macau,0,0,0,0.5,0.5,1566,1301
2016-03-29,Maldives,Bhutan,4,2,2,1.0,0.0,1459,1255
2016-03-29,Mexico,Canada,2,0,2,1.0,0.0,1996,1731
2016-03-29,Montenegro,Belarus,0,0,0,0.5,0.5,1710,1759
2016-03-29,Morocco,Cape Verde,2,0,2,1.0,0.0,1799,1708
2016-03-29,Namibia,Burundi,1,3,2,0.0,1.0,1603,1597
2016-03-29,Niger,Senegal,1,2,1,0.0,1.0,1581,1847
2016-03-29,Norway,Finland,2,0,2,1.0,0.0,1839,1767
2016-03-29,Palestine,Timor-Leste,7,0,7,1.0,0.0,1642,1324
2016-03-29,Panama,Haiti,1,0,1,1.0,0.0,1848,1703
2016-03-29,Paraguay,Brazil,2,2,0,0.5,0.5,1902,2176
2016-03-29,Philippines,North Korea,3,2,1,1.0,0.0,1593,1786
2016-03-29,Portugal,Belgium,2,1,1,1.0,0.0,2016,1982
2016-03-29,Rwanda,Mauritius,5,0,5,1.0,0.0,1634,1480
2016-03-29,Scotland,Denmark,1,0,1,1.0,0.0,1887,1896
2016-03-29,South Africa,Cameroon,0,0,0,0.5,0.5,1849,1849
2016-03-29,Saint Kitts and Nevis,Antigua and Barbuda,1,0,1,1.0,0.0,1602,1585
2016-03-29,Sudan,Ivory Coast,1,1,0,0.5,0.5,1616,1921
2016-03-29,Suriname,Guadeloupe,3,2,1,1.0,0.0,1590,1656
2016-03-29,Sweden,Czech Republic,1,1,0,0.5,0.5,1931,1900
2016-03-29,Switzerland,Bosnia and Herzegovina,0,2,2,0.0,1.0,1925,1856
2016-03-29,Tajikistan,Kyrgyzstan,0,1,1,0.0,1.0,1580,1502
2016-03-29,Togo,Tunisia,0,0,0,0.5,0.5,1656,1839
2016-03-29,Uganda,Burkina Faso,0,0,0,0.5,0.5,1762,1684
2016-03-29,United Arab Emirates,Saudi Arabia,1,1,0,0.5,0.5,1871,1827
2016-03-29,Uruguay,Peru,1,0,1,1.0,0.0,2031,1870
2016-03-29,United States,Guatemala,4,0,4,1.0,0.0,1980,1704
2016-03-29,Uzbekistan,Bahrain,1,0,1,1.0,0.0,1861,1777
2016-03-29,Venezuela,Chile,1,4,3,0.0,1.0,1817,2037
2016-03-29,United States Virgin Islands,Grenada,1,2,1,0.0,1.0,1386,1511
2016-03-29,Trinidad and Tobago,Saint Vincent and the Grenadines,6,0,6,1.0,0.0,1757,1557
2016-04-02,Alderney,Guernsey,0,1,1,0.0,1.0,1254,1750
2016-04-24,Panjab,Jersey,0,2,2,0.0,1.0,1503,1743
2016-04-27,Martinique,Panama,0,2,2,0.0,1.0,1693,1853
2016-05-14,Jersey,Guernsey,1,0,1,1.0,0.0,1752,1742
2016-05-16,Romani people,Padania,0,2,2,0.0,1.0,1485,1630
2016-05-20,Hungary,Ivory Coast,0,0,0,0.5,0.5,1855,1920
2016-05-20,Galicia,Venezuela,1,1,0,0.5,0.5,1542,1812
2016-05-21,Botswana,Lesotho,2,1,1,1.0,0.0,1656,1499
2016-05-21,Abkhazia,Donetsk PR,0,0,0,0.5,0.5,1516,1495
2016-05-22,England,Turkey,2,1,1,1.0,0.0,2074,1937
2016-05-22,Puerto Rico,United States,1,3,2,0.0,1.0,1447,1981
2016-05-23,Peru,Trinidad and Tobago,4,0,4,1.0,0.0,1876,1752
2016-05-25,Romania,DR Congo,1,1,0,0.5,0.5,1912,1746
2016-05-25,Serbia,Cyprus,2,1,1,1.0,0.0,1862,1639
2016-05-26,Azerbaijan,Andorra,0,0,0,0.5,0.5,1625,1336
2016-05-27,Croatia,Moldova,1,0,1,1.0,0.0,1984,1575
2016-05-27,Czech Republic,Malta,6,0,6,1.0,0.0,1902,1495
2016-05-27,England,Australia,2,1,1,1.0,0.0,2079,1929
2016-05-27,Republic of Ireland,Netherlands,1,1,0,0.5,0.5,1942,2035
2016-05-27,Morocco,Congo,2,0,2,1.0,0.0,1805,1690
2016-05-27,Nigeria,Mali,1,0,1,1.0,0.0,1854,1740
2016-05-27,Northern Ireland,Belarus,3,0,3,1.0,0.0,1747,1751
2016-05-27,Slovakia,Georgia,3,1,2,1.0,0.0,1875,1669
2016-05-27,Togo,Zambia,1,0,1,1.0,0.0,1667,1757
2016-05-27,Corsica,Basque Country,1,1,0,0.5,0.5,1557,1756
2016-05-28,Myanmar,Malaysia,0,0,0,0.5,0.5,1532,1566
2016-05-28,Costa Rica,Venezuela,2,1,1,1.0,0.0,1898,1806
2016-05-28,El Salvador,Peru,1,3,2,0.0,1.0,1715,1881
2016-05-28,Gabon,Mauritania,0,2,2,0.0,1.0,1704,1537
2016-05-28,Guatemala,Armenia,1,7,6,0.0,1.0,1695,1657
2016-05-28,Mexico,Paraguay,1,0,1,1.0,0.0,2002,1897
2016-05-28,New Zealand,Fiji,3,1,2,1.0,0.0,1764,1675
2016-05-28,Rwanda,Senegal,0,2,2,0.0,1.0,1631,1851
2016-05-28,Switzerland,Belgium,1,2,1,0.0,1.0,1919,1989
2016-05-28,Vanuatu,Solomon Islands,0,1,1,0.0,1.0,1605,1642
2016-05-29,Albania,Qatar,3,1,2,1.0,0.0,1750,1829
2016-05-29,Azerbaijan,North Macedonia,1,3,2,0.0,1.0,1619,1690
2016-05-29,Bosnia and Herzegovina,Spain,1,3,2,0.0,1.0,1854,2150
2016-05-29,Cambodia,Timor-Leste,2,0,2,1.0,0.0,1326,1316
2016-05-29,Germany,Slovakia,1,3,2,0.0,1.0,2086,1888
2016-05-29,Italy,Scotland,1,0,1,1.0,0.0,2004,1882
2016-05-29,Kenya,Tanzania,1,1,0,0.5,0.5,1622,1620
2016-05-29,Laos,Nepal,1,1,0,0.5,0.5,1389,1407
2016-05-29,Lithuania,Estonia,2,0,2,1.0,0.0,1633,1708
2016-05-29,Papua New Guinea,New Caledonia,1,1,0,0.5,0.5,1502,1664
2016-05-29,Portugal,Norway,3,0,3,1.0,0.0,2021,1835
2016-05-29,Romania,Ukraine,3,4,1,0.0,1.0,1905,1958
2016-05-29,Tahiti,Samoa,4,0,4,1.0,0.0,1653,1464
2016-05-29,Turkey,Montenegro,1,0,1,1.0,0.0,1941,1707
2016-05-29,Abkhazia,Chagos Islands,9,0,9,1.0,0.0,1524,1493
2016-05-29,Iraqi Kurdistan,Székely Land,3,0,3,1.0,0.0,1559,1479
2016-05-29,Padania,Northern Cyprus,1,2,1,0.0,1.0,1621,1552
2016-05-29,Sápmi,Somaliland,5,0,5,1.0,0.0,1510,1493
2016-05-30,France,Cameroon,3,2,1,1.0,0.0,2072,1846
2016-05-30,Gambia,Zambia,0,0,0,0.5,0.5,1576,1754
2016-05-30,Sweden,Slovenia,0,0,0,0.5,0.5,1928,1777
2016-05-30,Chagos Islands,Western Armenia,0,12,12,0.0,1.0,1486,1508
2016-05-30,United Koreans in Japan,Székely Land,1,0,1,1.0,0.0,1508,1472
2016-05-30,Raetia,Padania,0,6,6,0.0,1.0,1463,1626
2016-05-30,Sápmi,Panjab,0,1,1,0.0,1.0,1502,1512
2016-05-31,Austria,Malta,2,1,1,1.0,0.0,1869,1494
2016-05-31,Republic of Ireland,Belarus,1,2,1,0.0,1.0,1930,1764
2016-05-31,Kenya,Sudan,1,1,0,0.5,0.5,1622,1617
2016-05-31,Luxembourg,Nigeria,1,3,2,0.0,1.0,1489,1856
2016-05-31,Serbia,Israel,3,1,2,1.0,0.0,1869,1773
2016-05-31,Solomon Islands,Fiji,0,1,1,0.0,1.0,1635,1683
2016-05-31,Vanuatu,New Zealand,0,5,5,0.0,1.0,1601,1769
2016-05-31,Vietnam,Syria,2,0,2,1.0,0.0,1660,1745
2016-05-31,Zimbabwe,Uganda,2,0,2,1.0,0.0,1690,1753
2016-05-31,Abkhazia,Western Armenia,1,0,1,1.0,0.0,1532,1501
2016-05-31,United Koreans in Japan,Iraqi Kurdistan,0,3,3,0.0,1.0,1502,1566
2016-05-31,Northern Cyprus,Raetia,7,0,7,1.0,0.0,1558,1458
2016-05-31,Somaliland,Panjab,0,5,5,0.0,1.0,1486,1520
2016-06-01,Belgium,Finland,1,1,0,0.5,0.5,1985,1772
2016-06-01,Curaçao,Guyana,5,2,3,1.0,0.0,1519,1600
2016-06-01,Czech Republic,Russia,2,1,1,1.0,0.0,1911,1934
2016-06-01,El Salvador,Armenia,0,4,4,0.0,1.0,1706,1667
2016-06-01,Estonia,Andorra,2,0,2,1.0,0.0,1710,1335
2016-06-01,Grenada,Puerto Rico,3,3,0,0.5,0.5,1510,1449
2016-06-01,Latvia,Lithuania,2,1,1,1.0,0.0,1669,1626
2016-06-01,Martinique,Guadeloupe,2,0,2,1.0,0.0,1701,1649
2016-06-01,New Caledonia,Samoa,7,0,7,1.0,0.0,1668,1461
2016-06-01,Norway,Iceland,3,2,1,1.0,0.0,1842,1752
2016-06-01,Papua New Guinea,Tahiti,2,2,0,0.5,0.5,1506,1650
2016-06-01,Poland,Netherlands,1,2,1,0.0,1.0,1933,2041
2016-06-01,Spain,South Korea,6,1,5,1.0,0.0,2155,1965
2016-06-01,Saint Kitts and Nevis,Suriname,1,0,1,1.0,0.0,1610,1583
2016-06-01,United Koreans in Japan,Northern Cyprus,1,1,0,0.5,0.5,1504,1557
2016-06-01,Abkhazia,Sápmi,2,0,2,1.0,0.0,1540,1495
2016-06-02,England,Portugal,1,0,1,1.0,0.0,2086,2015
2016-06-02,Laos,India,0,1,1,0.0,1.0,1385,1562
2016-06-02,North Macedonia,Iran,1,3,2,0.0,1.0,1688,1952
2016-06-02,Malaysia,Timor-Leste,3,0,3,1.0,0.0,1570,1313
2016-06-02,Maldives,Yemen,0,2,2,0.0,1.0,1453,1551
2016-06-02,Seychelles,Algeria,0,2,2,0.0,1.0,1425,1847
2016-06-02,Tajikistan,Bangladesh,5,0,5,1.0,0.0,1585,1433
2016-06-02,Iraqi Kurdistan,Padania,2,2,0,0.5,0.5,1568,1625
2016-06-02,Western Armenia,Panjab,2,3,1,0.0,1.0,1494,1528
2016-06-02,Chagos Islands,Somaliland,2,3,1,0.0,1.0,1478,1494
2016-06-02,Székely Land,Raetia,7,0,7,1.0,0.0,1480,1451
2016-06-03,Albania,Ukraine,1,3,2,0.0,1.0,1747,1962
2016-06-03,Azerbaijan,Canada,1,1,0,0.5,0.5,1622,1729
2016-06-03,Bosnia and Herzegovina,Denmark,2,2,0,0.5,0.5,1855,1896
2016-06-03,Myanmar,Singapore,0,1,1,0.0,1.0,1526,1623
2016-06-03,China PR,Trinidad and Tobago,4,2,2,1.0,0.0,1882,1747
2016-06-03,Djibouti,Tunisia,0,3,3,0.0,1.0,1293,1840
2016-06-03,Faroe Islands,Kosovo,0,2,2,0.0,1.0,1474,1546
2016-06-03,Japan,Bulgaria,7,2,5,1.0,0.0,1993,1807
2016-06-03,Libya,Morocco,1,1,0,0.5,0.5,1732,1804
2016-06-03,Mauritania,Cameroon,0,1,1,0.0,1.0,1535,1849
2016-06-03,Romania,Georgia,5,1,4,1.0,0.0,1909,1666
2016-06-03,Sierra Leone,Sudan,1,0,1,1.0,0.0,1617,1609
2016-06-03,Switzerland,Moldova,2,1,1,1.0,0.0,1921,1574
2016-06-03,Thailand,Syria,2,2,0,0.5,0.5,1770,1746
2016-06-03,United Arab Emirates,Jordan,1,3,2,0.0,1.0,1862,1804
2016-06-03,United States,Colombia,0,2,2,0.0,1.0,1975,2032
2016-06-03,Vietnam,Hong Kong,2,2,0,0.5,0.5,1659,1608
2016-06-03,United Koreans in Japan,Sápmi,1,2,1,0.0,1.0,1496,1504
2016-06-03,Iraqi Kurdistan,Western Armenia,0,0,0,0.5,0.5,1567,1496
2016-06-03,Chagos Islands,Raetia,3,3,0,0.5,0.5,1478,1452
2016-06-03,Somaliland,Székely Land,7,0,7,1.0,0.0,1502,1473
2016-06-04,Australia,Greece,1,0,1,1.0,0.0,1936,1844
2016-06-04,Austria,Netherlands,0,2,2,0.0,1.0,1865,2046
2016-06-04,Botswana,Uganda,1,2,1,0.0,1.0,1651,1759
2016-06-04,Burundi,Senegal,0,2,2,0.0,1.0,1594,1855
2016-06-04,Brazil,Ecuador,0,0,0,0.5,0.5,2172,1958
2016-06-04,Costa Rica,Paraguay,0,0,0,0.5,0.5,1898,1898
2016-06-04,Croatia,San Marino,10,0,10,1.0,0.0,1985,1324
2016-06-04,Estonia,Latvia,0,0,0,0.5,0.5,1710,1670
2016-06-04,Fiji,Vanuatu,2,3,1,0.0,1.0,1674,1611
2016-06-04,France,Scotland,3,0,3,1.0,0.0,2077,1878
2016-06-04,Gambia,South Africa,0,4,4,0.0,1.0,1574,1852
2016-06-04,Germany,Hungary,2,0,2,1.0,0.0,2090,1852
2016-06-04,Guadeloupe,Dominica,2,1,1,1.0,0.0,1653,1420
2016-06-04,Haiti,Peru,0,1,1,0.0,1.0,1699,1886
2016-06-04,Ivory Coast,Gabon,2,1,1,1.0,0.0,1924,1701
2016-06-04,New Zealand,Solomon Islands,1,0,1,1.0,0.0,1775,1630
2016-06-04,Rwanda,Mozambique,2,3,1,0.0,1.0,1624,1656
2016-06-04,Namibia,Niger,1,0,1,1.0,0.0,1611,1574
2016-06-04,Guinea-Bissau,Zambia,3,2,1,1.0,0.0,1553,1742
2016-06-04,Slovakia,Northern Ireland,0,0,0,0.5,0.5,1885,1751
2016-06-04,São Tomé and Príncipe,Cape Verde,1,2,1,0.0,1.0,1465,1712
2016-06-04,South Sudan,Mali,0,3,3,0.0,1.0,1483,1743
2016-06-04,Tanzania,Egypt,0,2,2,0.0,1.0,1618,1901
2016-06-04,United States Virgin Islands,Guyana,0,7,7,0.0,1.0,1383,1604
2016-06-04,Abkhazia,Northern Cyprus,2,0,2,1.0,0.0,1549,1549
2016-06-04,Padania,Panjab,1,0,1,1.0,0.0,1631,1523
2016-06-04,United Koreans in Japan,Iraqi Kurdistan,1,1,0,0.5,0.5,1498,1566
2016-06-04,Sápmi,Western Armenia,3,0,3,1.0,0.0,1512,1489
2016-06-05,Belgium,Norway,3,2,1,1.0,0.0,1990,1838
2016-06-05,Central African Republic,Angola,3,0,3,1.0,0.0,1513,1696
2016-06-05,Comoros,Burkina Faso,0,1,1,0.0,1.0,1407,1687
2016-06-05,Czech Republic,South Korea,1,2,1,0.0,1.0,1905,1972
2016-06-05,Jamaica,Venezuela,0,1,1,0.0,1.0,1768,1814
2016-06-05,Kenya,Congo,2,1,1,1.0,0.0,1632,1681
2016-06-05,Lesotho,Ethiopia,1,2,1,0.0,1.0,1494,1625
2016-06-05,Liberia,Togo,2,2,0,0.5,0.5,1622,1666
2016-06-05,Madagascar,DR Congo,1,6,5,0.0,1.0,1562,1751
2016-06-05,Mauritius,Ghana,0,2,2,0.0,1.0,1479,1865
2016-06-05,Mexico,Uruguay,3,1,2,1.0,0.0,2011,2023
2016-06-05,Papua New Guinea,Samoa,8,0,8,1.0,0.0,1513,1455
2016-06-05,Russia,Serbia,1,1,0,0.5,0.5,1933,1871
2016-06-05,Slovenia,Turkey,0,1,1,0.0,1.0,1773,1946
2016-06-05,Eswatini,Guinea,1,0,1,1.0,0.0,1537,1770
2016-06-05,Sweden,Wales,3,0,3,1.0,0.0,1934,1793
2016-06-05,Tahiti,New Caledonia,1,1,0,0.5,0.5,1651,1668
2016-06-05,Thailand,Jordan,2,0,2,1.0,0.0,1779,1796
2016-06-05,United Arab Emirates,Syria,0,1,1,0.0,1.0,1852,1757
2016-06-05,Zimbabwe,Malawi,3,0,3,1.0,0.0,1697,1625
2016-06-05,Padania,Northern Cyprus,0,2,2,0.0,1.0,1622,1559
2016-06-05,Abkhazia,Panjab,1,1,0,0.5,0.5,1549,1524
2016-06-06,Argentina,Chile,2,1,1,1.0,0.0,2124,2031
2016-06-06,Myanmar,Hong Kong,3,0,3,1.0,0.0,1536,1599
2016-06-06,Iceland,Liechtenstein,4,0,4,1.0,0.0,1755,1438
2016-06-06,Italy,Finland,2,0,2,1.0,0.0,2008,1769
2016-06-06,Malaysia,Timor-Leste,3,0,3,1.0,0.0,1573,1311
2016-06-06,Panama,Bolivia,2,1,1,1.0,0.0,1859,1742
2016-06-06,Poland,Lithuania,0,0,0,0.5,0.5,1928,1632
2016-06-06,Singapore,Vietnam,0,3,3,0.0,1.0,1616,1667
2016-06-07,Australia,Greece,1,2,1,0.0,1.0,1926,1855
2016-06-07,Bangladesh,Tajikistan,0,1,1,0.0,1.0,1429,1590
2016-06-07,Bulgaria,Denmark,0,4,4,0.0,1.0,1802,1902
2016-06-07,Cambodia,Taiwan,2,0,2,1.0,0.0,1336,1384
2016-06-07,Canada,Uzbekistan,2,1,1,1.0,0.0,1740,1851
2016-06-07,China PR,Kazakhstan,0,1,1,0.0,1.0,1869,1635
2016-06-07,Colombia,Paraguay,2,1,1,1.0,0.0,2038,1893
2016-06-07,Curaçao,United States Virgin Islands,7,0,7,1.0,0.0,1525,1378
2016-06-07,Dominican Republic,French Guiana,2,1,1,1.0,0.0,1542,1551
2016-06-07,India,Laos,6,1,5,1.0,0.0,1567,1381
2016-06-07,Iran,Kyrgyzstan,6,0,6,1.0,0.0,1954,1501
2016-06-07,Japan,Bosnia and Herzegovina,1,2,1,0.0,1.0,1982,1867
2016-06-07,Spain,Georgia,0,1,1,0.0,1.0,2140,1682
2016-06-07,Saint Vincent and the Grenadines,Saint Kitts and Nevis,0,1,1,0.0,1.0,1551,1617
2016-06-07,United States,Costa Rica,4,0,4,1.0,0.0,1982,1892
2016-06-07,Yemen,Maldives,2,0,2,1.0,0.0,1557,1448
2016-06-08,Brazil,Haiti,7,1,6,1.0,0.0,2173,1699
2016-06-08,Ecuador,Peru,2,2,0,0.5,0.5,1957,1888
2016-06-08,New Zealand,New Caledonia,1,0,1,1.0,0.0,1781,1663
2016-06-08,Papua New Guinea,Solomon Islands,2,1,1,1.0,0.0,1524,1620
2016-06-08,Portugal,Estonia,7,0,7,1.0,0.0,2018,1708
2016-06-09,Mexico,Jamaica,2,0,2,1.0,0.0,2015,1765
2016-06-09,Uruguay,Venezuela,0,1,1,0.0,1.0,2011,1827
2016-06-10,Argentina,Panama,5,0,5,1.0,0.0,2127,1857
2016-06-10,Chile,Bolivia,2,1,1,1.0,0.0,2034,1740
2016-06-10,France,Romania,2,1,1,1.0,0.0,2082,1905
2016-06-11,Albania,Switzerland,0,1,1,0.0,1.0,1743,1926
2016-06-11,Colombia,Costa Rica,2,3,1,0.0,1.0,2027,1904
2016-06-11,England,Russia,1,1,0,0.5,0.5,2083,1937
2016-06-11,Papua New Guinea,New Zealand,0,0,0,0.5,0.5,1530,1776
2016-06-11,Seychelles,Madagascar,0,1,1,0.0,1.0,1421,1567
2016-06-11,United States,Paraguay,1,0,1,1.0,0.0,1988,1888
2016-06-11,Wales,Slovakia,2,1,1,1.0,0.0,1804,1875
2016-06-11,Zimbabwe,Eswatini,2,2,0,0.5,0.5,1694,1541
2016-06-12,Benin,Equatorial Guinea,2,1,1,1.0,0.0,1624,1560
2016-06-12,Brazil,Peru,0,1,1,0.0,1.0,2160,1902
2016-06-12,Ecuador,Haiti,4,0,4,1.0,0.0,1960,1697
2016-06-12,Germany,Ukraine,2,0,2,1.0,0.0,2096,1957
2016-06-12,Lesotho,Mauritius,3,0,3,1.0,0.0,1502,1472
2016-06-12,Malawi,Angola,3,0,3,1.0,0.0,1635,1687
2016-06-12,Poland,Northern Ireland,1,0,1,1.0,0.0,1933,1747
2016-06-12,Turkey,Croatia,0,1,1,0.0,1.0,1939,1993
2016-06-13,Belgium,Italy,0,2,2,0.0,1.0,1983,2016
2016-06-13,Republic of Ireland,Sweden,1,1,0,0.5,0.5,1931,1934
2016-06-13,Madagascar,Zimbabwe,0,0,0,0.5,0.5,1570,1692
2016-06-13,Mexico,Venezuela,1,1,0,0.5,0.5,2012,1831
2016-06-13,Spain,Czech Republic,1,0,1,1.0,0.0,2144,1902
2016-06-13,Eswatini,Seychelles,4,0,4,1.0,0.0,1547,1416
2016-06-13,Uruguay,Jamaica,3,0,3,1.0,0.0,2015,1762
2016-06-14,Angola,Lesotho,0,2,2,0.0,1.0,1676,1514
2016-06-14,Argentina,Bolivia,3,0,3,1.0,0.0,2129,1739
2016-06-14,Austria,Hungary,0,2,2,0.0,1.0,1857,1861
2016-06-14,Chile,Panama,4,2,2,1.0,0.0,2039,1853
2016-06-14,Mauritius,Malawi,0,1,1,0.0,1.0,1468,1640
2016-06-14,Portugal,Iceland,1,1,0,0.5,0.5,2013,1761
2016-06-15,France,Albania,2,0,2,1.0,0.0,2084,1742
2016-06-15,Romania,Switzerland,1,1,0,0.5,0.5,1906,1926
2016-06-15,Russia,Slovakia,1,2,1,0.0,1.0,1928,1885
2016-06-15,Eswatini,Madagascar,1,0,1,1.0,0.0,1556,1562
2016-06-15,Zimbabwe,Seychelles,5,0,5,1.0,0.0,1695,1414
2016-06-16,Angola,Mauritius,0,2,2,0.0,1.0,1664,1481
2016-06-16,England,Wales,2,1,1,1.0,0.0,2086,1802
2016-06-16,Germany,Poland,0,0,0,0.5,0.5,2093,1937
2016-06-16,Malawi,Lesotho,0,1,1,0.0,1.0,1630,1525
2016-06-16,Ukraine,Northern Ireland,0,2,2,0.0,1.0,1945,1760
2016-06-16,United States,Ecuador,2,1,1,1.0,0.0,1996,1953
2016-06-17,Czech Republic,Croatia,2,2,0,0.5,0.5,1905,1991
2016-06-17,Italy,Sweden,1,0,1,1.0,0.0,2023,1928
2016-06-17,Peru,Colombia,0,0,0,0.5,0.5,1905,2025
2016-06-17,Spain,Turkey,3,0,3,1.0,0.0,2148,1936
2016-06-18,Argentina,Venezuela,4,1,3,1.0,0.0,2132,1829
2016-06-18,Belgium,Republic of Ireland,3,0,3,1.0,0.0,1990,1925
2016-06-18,Iceland,Hungary,1,1,0,0.5,0.5,1764,1859
2016-06-18,Mexico,Chile,0,7,7,0.0,1.0,2005,2047
2016-06-18,Namibia,Botswana,1,1,0,0.5,0.5,1612,1651
2016-06-18,Portugal,Austria,0,0,0,0.5,0.5,2010,1861
2016-06-18,South Africa,Lesotho,1,1,0,0.5,0.5,1847,1531
2016-06-19,DR Congo,Mozambique,1,0,1,1.0,0.0,1757,1651
2016-06-19,France,Switzerland,0,0,0,0.5,0.5,2081,1930
2016-06-19,French Guiana,Bermuda,3,0,3,1.0,0.0,1560,1575
2016-06-19,Romania,Albania,0,1,1,0.0,1.0,1895,1754
2016-06-19,Zambia,Eswatini,0,0,0,0.5,0.5,1739,1560
2016-06-20,Russia,Wales,0,3,3,0.0,1.0,1918,1813
2016-06-20,Slovakia,England,0,0,0,0.5,0.5,1890,2082
2016-06-21,Croatia,Spain,2,1,1,1.0,0.0,2003,2137
2016-06-21,Czech Republic,Turkey,0,2,2,0.0,1.0,1898,1944
2016-06-21,Lesotho,Zambia,2,3,1,0.0,1.0,1528,1743
2016-06-21,Namibia,Mozambique,3,0,3,1.0,0.0,1621,1643
2016-06-21,Northern Ireland,Germany,0,1,1,0.0,1.0,1758,2096
2016-06-21,Ukraine,Poland,0,1,1,0.0,1.0,1937,1946
2016-06-21,United States,Argentina,0,4,4,0.0,1.0,1991,2138
2016-06-22,Botswana,DR Congo,0,0,0,0.5,0.5,1654,1755
2016-06-22,Colombia,Chile,0,2,2,0.0,1.0,2018,2055
2016-06-22,Hungary,Portugal,3,3,0,0.5,0.5,1863,2007
2016-06-22,Iceland,Austria,2,1,1,1.0,0.0,1775,1851
2016-06-22,Italy,Republic of Ireland,0,1,1,0.0,1.0,2013,1936
2016-06-22,New Caledonia,Malaysia,1,2,1,0.0,1.0,1653,1584
2016-06-22,South Africa,Eswatini,5,1,4,1.0,0.0,1850,1558
2016-06-22,Sweden,Belgium,0,1,1,0.0,1.0,1922,1997
2016-06-24,Namibia,Zambia,1,0,1,1.0,0.0,1632,1733
2016-06-25,Croatia,Portugal,0,1,1,0.0,1.0,1996,2015
2016-06-25,South Africa,Botswana,3,2,1,1.0,0.0,1854,1651
2016-06-25,Eswatini,DR Congo,1,0,1,1.0,0.0,1571,1743
2016-06-25,Switzerland,Poland,1,1,0,0.5,0.5,1931,1946
2016-06-25,United States,Colombia,0,1,1,0.0,1.0,1984,2026
2016-06-25,Wales,Northern Ireland,1,0,1,1.0,0.0,1820,1752
2016-06-26,Argentina,Chile,0,0,0,0.5,0.5,2137,2057
2016-06-26,Fiji,Malaysia,1,1,0,0.5,0.5,1672,1587
2016-06-26,France,Republic of Ireland,2,1,1,1.0,0.0,2086,1932
2016-06-26,Germany,Slovakia,3,0,3,1.0,0.0,2100,1887
2016-06-26,Hungary,Belgium,0,4,4,0.0,1.0,1858,2003
2016-06-27,England,Iceland,1,2,1,0.0,1.0,2069,1789
2016-06-27,Italy,Spain,2,0,2,1.0,0.0,2024,2127
2016-06-30,Macau,Mongolia,2,2,0,0.5,0.5,1304,1412
2016-06-30,Poland,Portugal,1,1,0,0.5,0.5,1948,2014
2016-07-01,Wales,Belgium,3,1,2,1.0,0.0,1832,1992
2016-07-02,Germany,Italy,1,1,0,0.5,0.5,2099,2026
2016-07-02,Mongolia,Taiwan,0,2,2,0.0,1.0,1404,1393
2016-07-02,Northern Mariana Islands,Macau,1,3,2,0.0,1.0,1370,1314
2016-07-03,France,Iceland,5,2,3,1.0,0.0,2089,1787
2016-07-04,Northern Mariana Islands,Mongolia,0,8,8,0.0,1.0,1363,1412
2016-07-06,Portugal,Wales,2,0,2,1.0,0.0,2019,1828
2016-07-07,France,Germany,2,0,2,1.0,0.0,2098,2091
2016-07-10,France,Portugal,0,1,1,0.0,1.0,2089,2029
2016-07-24,Uzbekistan,Iraq,2,1,1,1.0,0.0,1858,1780
2016-07-28,Cambodia,Singapore,2,1,1,1.0,0.0,1350,1603
2016-08-01,Felvidék,Kárpátalja,1,1,0,0.5,0.5,1496,1500
2016-08-01,Délvidék,Székely Land,3,1,2,1.0,0.0,1508,1466
2016-08-03,Délvidék,Felvidék,1,2,1,0.0,1.0,1500,1505
2016-08-08,Oman,Turkmenistan,1,0,1,1.0,0.0,1798,1612
2016-08-08,Qatar,Iraq,2,1,1,1.0,0.0,1836,1774
2016-08-13,Bhutan,India,0,3,3,0.0,1.0,1253,1570
2016-08-13,Donetsk PR,Luhansk PR,1,1,0,0.5,0.5,1495,1494
2016-08-18,Jordan,Qatar,2,3,1,0.0,1.0,1789,1844
2016-08-21,Iraq,North Korea,1,1,0,0.5,0.5,1775,1786
2016-08-24,Honduras,Nicaragua,1,0,1,1.0,0.0,1811,1475
2016-08-24,North Korea,United Arab Emirates,2,0,2,1.0,0.0,1796,1843
2016-08-24,Saudi Arabia,Laos,4,0,4,1.0,0.0,1829,1380
2016-08-24,Uzbekistan,Burkina Faso,1,0,1,1.0,0.0,1863,1683
2016-08-25,Barawa,Tamil Eelam,0,5,5,0.0,1.0,1492,1504
2016-08-26,Barawa,Chagos Islands,2,3,1,0.0,1.0,1484,1487
2016-08-27,Tajikistan,Syria,0,0,0,0.5,0.5,1594,1754
2016-08-28,Dominican Republic,Puerto Rico,5,0,5,1.0,0.0,1548,1444
2016-08-28,Chagos Islands,Tamil Eelam,1,5,4,0.0,1.0,1480,1512
2016-08-30,Egypt,Guinea,1,1,0,0.5,0.5,1899,1773
2016-08-30,Kyrgyzstan,Kazakhstan,2,0,2,1.0,0.0,1512,1625
2016-08-30,Uganda,Kenya,0,0,0,0.5,0.5,1757,1635
2016-08-31,Albania,Morocco,0,0,0,0.5,0.5,1756,1803
2016-08-31,Czech Republic,Armenia,3,0,3,1.0,0.0,1902,1664
2016-08-31,Denmark,Liechtenstein,5,0,5,1.0,0.0,1904,1437
2016-08-31,Estonia,Malta,1,1,0,0.5,0.5,1704,1499
2016-08-31,Germany,Finland,2,0,2,1.0,0.0,2094,1767
2016-08-31,Republic of Ireland,Oman,4,0,4,1.0,0.0,1938,1793
2016-08-31,Lebanon,Jordan,1,1,0,0.5,0.5,1664,1787
2016-08-31,Norway,Belarus,0,1,1,0.0,1.0,1829,1774
2016-08-31,Turkey,Russia,0,0,0,0.5,0.5,1944,1919
2016-09-01,Argentina,Uruguay,1,0,1,1.0,0.0,2143,2010
2016-09-01,Australia,Iraq,2,0,2,1.0,0.0,1931,1771
2016-09-01,Bahrain,Singapore,3,1,2,1.0,0.0,1782,1599
2016-09-01,Belgium,Spain,0,2,2,0.0,1.0,1987,2133
2016-09-01,Bolivia,Peru,0,3,3,0.0,1.0,1735,1910
2016-09-01,Colombia,Venezuela,2,0,2,1.0,0.0,2030,1826
2016-09-01,Ecuador,Brazil,0,3,3,0.0,1.0,1950,2164
2016-09-01,Hong Kong,Cambodia,4,2,2,1.0,0.0,1603,1347
2016-09-01,Iran,Qatar,2,0,2,1.0,0.0,1960,1839
2016-09-01,Italy,France,1,3,2,0.0,1.0,2020,2096
2016-09-01,Japan,United Arab Emirates,1,2,1,0.0,1.0,1971,1855
2016-09-01,South Korea,China PR,3,2,1,1.0,0.0,1978,1864
2016-09-01,Maldives,Bangladesh,5,0,5,1.0,0.0,1456,1422
2016-09-01,Netherlands,Greece,1,2,1,0.0,1.0,2034,1868
2016-09-01,Paraguay,Chile,2,1,1,1.0,0.0,1900,2046
2016-09-01,Portugal,Gibraltar,5,0,5,1.0,0.0,2031,1560
2016-09-01,Saudi Arabia,Thailand,1,0,1,1.0,0.0,1836,1773
2016-09-01,Uzbekistan,Syria,1,0,1,1.0,0.0,1869,1749
2016-09-02,El Salvador,Mexico,1,3,2,0.0,1.0,1704,2008
2016-09-02,Haiti,Costa Rica,0,1,1,0.0,1.0,1694,1908
2016-09-02,Honduras,Canada,2,1,1,1.0,0.0,1818,1734
2016-09-02,Latvia,Luxembourg,3,1,2,1.0,0.0,1675,1485
2016-09-02,Panama,Jamaica,2,0,2,1.0,0.0,1859,1757
2016-09-02,South Africa,Mauritania,1,1,0,0.5,0.5,1849,1541
2016-09-02,Saint Vincent and the Grenadines,United States,0,6,6,0.0,1.0,1550,1986
2016-09-02,Sudan,Gabon,1,2,1,0.0,1.0,1604,1707
2016-09-02,Trinidad and Tobago,Guatemala,2,2,0,0.5,0.5,1746,1697
2016-09-03,Angola,Madagascar,1,1,0,0.5,0.5,1662,1565
2016-09-03,Cameroon,Gambia,2,0,2,1.0,0.0,1852,1572
2016-09-03,Cape Verde,Libya,0,1,1,0.0,1.0,1705,1740
2016-09-03,Ethiopia,Seychelles,2,1,1,1.0,0.0,1629,1411
2016-09-03,Ghana,Rwanda,1,1,0,0.5,0.5,1861,1629
2016-09-03,India,Puerto Rico,4,1,3,1.0,0.0,1576,1439
2016-09-03,Ivory Coast,Sierra Leone,1,1,0,0.5,0.5,1919,1623
2016-09-03,Mozambique,Mauritius,1,0,1,1.0,0.0,1648,1477
2016-09-03,Nigeria,Tanzania,1,0,1,1.0,0.0,1860,1615
2016-09-03,Senegal,Namibia,2,0,2,1.0,0.0,1859,1629
2016-09-04,Algeria,Lesotho,6,0,6,1.0,0.0,1850,1526
2016-09-04,Bahrain,Jordan,0,0,0,0.5,0.5,1783,1787
2016-09-04,Burkina Faso,Botswana,2,1,1,1.0,0.0,1691,1644
2016-09-04,Congo,Guinea-Bissau,1,0,1,1.0,0.0,1687,1548
2016-09-04,DR Congo,Central African Republic,4,1,3,1.0,0.0,1747,1510
2016-09-04,Czech Republic,Northern Ireland,0,0,0,0.5,0.5,1899,1756
2016-09-04,Denmark,Armenia,1,0,1,1.0,0.0,1908,1661
2016-09-04,Equatorial Guinea,South Sudan,4,0,4,1.0,0.0,1567,1477
2016-09-04,Guinea,Zimbabwe,1,0,1,1.0,0.0,1780,1689
2016-09-04,Kazakhstan,Poland,2,2,0,0.5,0.5,1631,1943
2016-09-04,Lithuania,Slovenia,2,2,0,0.5,0.5,1636,1770
2016-09-04,Malawi,Eswatini,1,0,1,1.0,0.0,1637,1565
2016-09-04,Mali,Benin,5,2,3,1.0,0.0,1749,1619
2016-09-04,Morocco,São Tomé and Príncipe,2,0,2,1.0,0.0,1806,1463
2016-09-04,Niger,Burundi,3,1,2,1.0,0.0,1583,1586
2016-09-04,Malta,Scotland,1,5,4,0.0,1.0,1498,1880
2016-09-04,Norway,Germany,0,3,3,0.0,1.0,1827,2097
2016-09-04,Romania,Montenegro,1,1,0,0.5,0.5,1892,1711
2016-09-04,San Marino,Azerbaijan,0,1,1,0.0,1.0,1322,1625
2016-09-04,Slovakia,England,0,1,1,0.0,1.0,1883,2074
2016-09-04,Togo,Djibouti,5,0,5,1.0,0.0,1668,1292
2016-09-04,Tunisia,Liberia,4,1,3,1.0,0.0,1844,1619
2016-09-04,Uganda,Comoros,1,0,1,1.0,0.0,1759,1406
2016-09-04,Zambia,Kenya,1,1,0,0.5,0.5,1731,1638
2016-09-05,Albania,North Macedonia,2,1,1,1.0,0.0,1763,1682
2016-09-05,Croatia,Turkey,1,1,0,0.5,0.5,1995,1946
2016-09-05,Finland,Kosovo,1,1,0,0.5,0.5,1763,1551
2016-09-05,Georgia,Austria,1,2,1,0.0,1.0,1678,1856
2016-09-05,Israel,Italy,1,3,2,0.0,1.0,1770,2024
2016-09-05,Lebanon,Afghanistan,2,0,2,1.0,0.0,1669,1488
2016-09-05,Serbia,Republic of Ireland,2,2,0,0.5,0.5,1873,1937
2016-09-05,Spain,Liechtenstein,8,0,8,1.0,0.0,2134,1437
2016-09-05,Ukraine,Iceland,1,1,0,0.5,0.5,1934,1791
2016-09-05,Wales,Moldova,4,0,4,1.0,0.0,1832,1571
2016-09-06,Andorra,Latvia,0,1,1,0.0,1.0,1334,1677
2016-09-06,Bangladesh,Bhutan,0,0,0,0.5,0.5,1419,1257
2016-09-06,Belarus,France,0,0,0,0.5,0.5,1780,2091
2016-09-06,Bosnia and Herzegovina,Estonia,5,0,5,1.0,0.0,1872,1700
2016-09-06,Brazil,Colombia,2,1,1,1.0,0.0,2170,2025
2016-09-06,Bulgaria,Luxembourg,4,3,1,1.0,0.0,1805,1483
2016-09-06,Cameroon,Gabon,2,1,1,1.0,0.0,1857,1703
2016-09-06,Canada,El Salvador,3,1,2,1.0,0.0,1742,1697
2016-09-06,Chile,Bolivia,3,0,3,1.0,0.0,2049,1733
2016-09-06,China PR,Iran,0,0,0,0.5,0.5,1867,1958
2016-09-06,Costa Rica,Panama,3,1,2,1.0,0.0,1915,1853
2016-09-06,Cyprus,Belgium,0,3,3,0.0,1.0,1638,1989
2016-09-06,Faroe Islands,Hungary,0,0,0,0.5,0.5,1481,1852
2016-09-06,Gibraltar,Greece,1,4,3,0.0,1.0,1558,1871
2016-09-06,Indonesia,Malaysia,3,0,3,1.0,0.0,1648,1581
2016-09-06,Iraq,Saudi Arabia,1,2,1,0.0,1.0,1765,1843
2016-09-06,Jamaica,Haiti,0,2,2,0.0,1.0,1748,1704
2016-09-06,Kyrgyzstan,Philippines,1,2,1,0.0,1.0,1506,1600
2016-09-06,Maldives,Laos,4,0,4,1.0,0.0,1463,1374
2016-09-06,Mexico,Honduras,0,0,0,0.5,0.5,2005,1822
2016-09-06,Palestine,Tajikistan,1,1,0,0.5,0.5,1641,1596
2016-09-06,Peru,Ecuador,2,1,1,1.0,0.0,1919,1942
2016-09-06,Qatar,Uzbekistan,0,1,1,0.0,1.0,1832,1877
2016-09-06,Russia,Ghana,1,0,1,1.0,0.0,1926,1855
2016-09-06,South Africa,Egypt,1,0,1,1.0,0.0,1859,1890
2016-09-06,Sweden,Netherlands,1,1,0,0.5,0.5,1925,2032
2016-09-06,Switzerland,Portugal,2,0,2,1.0,0.0,1942,2021
2016-09-06,Syria,South Korea,0,0,0,0.5,0.5,1754,1974
2016-09-06,Thailand,Japan,0,2,2,0.0,1.0,1770,1975
2016-09-06,United Arab Emirates,Australia,0,1,1,0.0,1.0,1849,1938
2016-09-06,Uruguay,Paraguay,4,0,4,1.0,0.0,2016,1895
2016-09-06,United States,Trinidad and Tobago,4,0,4,1.0,0.0,1990,1743
2016-09-06,Venezuela,Argentina,2,2,0,0.5,0.5,1832,2138
2016-09-06,Guatemala,Saint Vincent and the Grenadines,9,3,6,1.0,0.0,1702,1546
2016-09-29,Qatar,Serbia,3,0,3,1.0,0.0,1841,1865
2016-09-30,Botswana,Angola,1,1,0,0.5,0.5,1645,1662
2016-10-04,DR Congo,Kenya,0,1,1,0.0,1.0,1737,1649
2016-10-04,Togo,Uganda,1,0,1,1.0,0.0,1679,1749
2016-10-05,Curaçao,Antigua and Barbuda,3,0,3,1.0,0.0,1535,1576
2016-10-05,Solomon Islands,New Caledonia,0,3,3,0.0,1.0,1613,1661
2016-10-05,Tajikistan,Palestine,3,3,0,0.5,0.5,1598,1640
2016-10-05,Trinidad and Tobago,Dominican Republic,4,0,4,1.0,0.0,1747,1545
2016-10-06,Austria,Wales,2,2,0,0.5,0.5,1856,1833
2016-10-06,Brazil,Bolivia,5,0,5,1.0,0.0,2172,1732
2016-10-06,Cambodia,Hong Kong,0,2,2,0.0,1.0,1345,1606
2016-10-06,China PR,Syria,0,1,1,0.0,1.0,1857,1765
2016-10-06,Ecuador,Chile,3,0,3,1.0,0.0,1953,2039
2016-10-06,Iceland,Finland,3,2,1,1.0,0.0,1799,1756
2016-10-06,Republic of Ireland,Georgia,1,0,1,1.0,0.0,1940,1676
2016-10-06,Italy,Spain,1,1,0,0.5,0.5,2027,2132
2016-10-06,Japan,Iraq,2,1,1,1.0,0.0,1979,1762
2016-10-06,South Korea,Qatar,3,2,1,1.0,0.0,1980,1836
2016-10-06,Kosovo,Croatia,0,6,6,0.0,1.0,1550,1997
2016-10-06,Kyrgyzstan,Lebanon,0,0,0,0.5,0.5,1510,1666
2016-10-06,Liechtenstein,Albania,0,2,2,0.0,1.0,1435,1766
2016-10-06,North Macedonia,Israel,1,2,1,0.0,1.0,1676,1777
2016-10-06,Mauritania,Canada,0,4,4,0.0,1.0,1538,1746
2016-10-06,Moldova,Serbia,0,3,3,0.0,1.0,1569,1868
2016-10-06,Paraguay,Colombia,0,1,1,0.0,1.0,1890,2031
2016-10-06,Peru,Argentina,2,2,0,0.5,0.5,1924,2134
2016-10-06,Saudi Arabia,Australia,2,2,0,0.5,0.5,1846,1936
2016-10-06,Turkey,Ukraine,2,2,0,0.5,0.5,1946,1935
2016-10-06,United Arab Emirates,Thailand,3,1,2,1.0,0.0,1856,1764
2016-10-06,Uruguay,Venezuela,3,0,3,1.0,0.0,2021,1828
2016-10-06,Uzbekistan,Iran,0,1,1,0.0,1.0,1871,1965
2016-10-06,Vietnam,North Korea,5,2,3,1.0,0.0,1678,1786
2016-10-07,Belgium,Bosnia and Herzegovina,4,0,4,1.0,0.0,1995,1867
2016-10-07,Cuba,United States,0,2,2,0.0,1.0,1633,1992
2016-10-07,Estonia,Gibraltar,4,0,4,1.0,0.0,1705,1554
2016-10-07,France,Bulgaria,4,1,3,1.0,0.0,2094,1803
2016-10-07,Ghana,Uganda,0,0,0,0.5,0.5,1853,1752
2016-10-07,Greece,Cyprus,2,0,2,1.0,0.0,1875,1635
2016-10-07,Hungary,Switzerland,2,3,1,0.0,1.0,1847,1948
2016-10-07,Latvia,Faroe Islands,0,2,2,0.0,1.0,1665,1494
2016-10-07,Luxembourg,Sweden,0,1,1,0.0,1.0,1482,1927
2016-10-07,Netherlands,Belarus,4,1,3,1.0,0.0,2036,1777
2016-10-07,Oman,Jordan,1,1,0,0.5,0.5,1793,1788
2016-10-07,Philippines,Bahrain,1,3,2,0.0,1.0,1596,1788
2016-10-07,Portugal,Andorra,6,0,6,1.0,0.0,2022,1334
2016-10-07,Singapore,Malaysia,0,0,0,0.5,0.5,1599,1582
2016-10-08,Armenia,Romania,0,5,5,0.0,1.0,1658,1896
2016-10-08,Azerbaijan,Norway,1,0,1,1.0,0.0,1638,1815
2016-10-08,Belize,Honduras,1,2,1,0.0,1.0,1508,1825
2016-10-08,Burkina Faso,South Africa,1,1,0,0.5,0.5,1695,1856
2016-10-08,DR Congo,Libya,4,0,4,1.0,0.0,1746,1732
2016-10-08,Dominican Republic,Martinique,1,2,1,0.0,1.0,1541,1706
2016-10-08,England,Malta,2,0,2,1.0,0.0,2075,1498
2016-10-08,French Guiana,Saint Kitts and Nevis,1,0,1,1.0,0.0,1570,1608
2016-10-08,Gabon,Morocco,0,0,0,0.5,0.5,1706,1804
2016-10-08,Germany,Czech Republic,3,0,3,1.0,0.0,2101,1896
2016-10-08,Ivory Coast,Mali,3,1,2,1.0,0.0,1924,1745
2016-10-08,Mexico,New Zealand,2,1,1,1.0,0.0,2009,1773
2016-10-08,Montenegro,Kazakhstan,5,0,5,1.0,0.0,1718,1625
2016-10-08,Northern Ireland,San Marino,4,0,4,1.0,0.0,1758,1321
2016-10-08,Poland,Denmark,3,2,1,1.0,0.0,1951,1901
2016-10-08,Scotland,Lithuania,1,1,0,0.5,0.5,1876,1641
2016-10-08,Senegal,Cape Verde,2,0,2,1.0,0.0,1864,1701
2016-10-08,Slovenia,Slovakia,1,0,1,1.0,0.0,1781,1873
2016-10-08,Solomon Islands,New Caledonia,0,1,1,0.0,1.0,1607,1668
2016-10-08,Suriname,Guyana,3,2,1,1.0,0.0,1592,1596
2016-10-08,Taiwan,Timor-Leste,2,1,1,1.0,0.0,1400,1305
2016-10-09,Albania,Spain,0,2,2,0.0,1.0,1765,2134
2016-10-09,Algeria,Cameroon,1,1,0,0.5,0.5,1851,1857
2016-10-09,Cambodia,Sri Lanka,4,0,4,1.0,0.0,1353,1333
2016-10-09,Congo,Egypt,1,2,1,0.0,1.0,1684,1894
2016-10-09,Finland,Croatia,0,1,1,0.0,1.0,1753,2001
2016-10-09,Iceland,Turkey,2,0,2,1.0,0.0,1811,1935
2016-10-09,Indonesia,Vietnam,2,2,0,0.5,0.5,1649,1678
2016-10-09,Israel,Liechtenstein,2,1,1,1.0,0.0,1779,1434
2016-10-09,North Macedonia,Italy,2,3,1,0.0,1.0,1675,2029
2016-10-09,Moldova,Republic of Ireland,1,3,2,0.0,1.0,1568,1942
2016-10-09,Russia,Costa Rica,3,4,1,0.0,1.0,1918,1924
2016-10-09,Serbia,Austria,3,2,1,1.0,0.0,1876,1849
2016-10-09,Togo,Mozambique,2,0,2,1.0,0.0,1687,1641
2016-10-09,Tunisia,Guinea,2,0,2,1.0,0.0,1851,1774
2016-10-09,Ukraine,Kosovo,3,0,3,1.0,0.0,1937,1549
2016-10-09,Wales,Georgia,1,1,0,0.5,0.5,1830,1680
2016-10-09,Zambia,Nigeria,1,2,1,0.0,1.0,1726,1866
2016-10-10,Andorra,Switzerland,1,2,1,0.0,1.0,1334,1949
2016-10-10,Belarus,Luxembourg,1,1,0,0.5,0.5,1772,1488
2016-10-10,Bhutan,Bangladesh,3,1,2,1.0,0.0,1269,1408
2016-10-10,Bosnia and Herzegovina,Cyprus,2,0,2,1.0,0.0,1871,1632
2016-10-10,Estonia,Greece,0,2,2,0.0,1.0,1701,1880
2016-10-10,Faroe Islands,Portugal,0,6,6,0.0,1.0,1494,2023
2016-10-10,Gibraltar,Belgium,0,6,6,0.0,1.0,1553,1997
2016-10-10,Latvia,Hungary,0,2,2,0.0,1.0,1661,1852
2016-10-10,Netherlands,France,0,1,1,0.0,1.0,2030,2101
2016-10-10,Philippines,North Korea,1,3,2,0.0,1.0,1592,1791
2016-10-10,Sweden,Bulgaria,3,0,3,1.0,0.0,1933,1798
2016-10-11,Argentina,Paraguay,0,1,1,0.0,1.0,2122,1903
2016-10-11,Australia,Japan,1,1,0,0.5,0.5,1937,1979
2016-10-11,Bolivia,Ecuador,2,2,0,0.5,0.5,1737,1949
2016-10-11,Chile,Peru,2,1,1,1.0,0.0,2045,1919
2016-10-11,Colombia,Uruguay,2,2,0,0.5,0.5,2031,2022
2016-10-11,Czech Republic,Azerbaijan,0,0,0,0.5,0.5,1891,1644
2016-10-11,Denmark,Montenegro,0,1,1,0.0,1.0,1890,1730
2016-10-11,Germany,Northern Ireland,2,0,2,1.0,0.0,2103,1757
2016-10-11,Hong Kong,Singapore,2,0,2,1.0,0.0,1614,1592
2016-10-11,Iran,South Korea,1,0,1,1.0,0.0,1974,1972
2016-10-11,Iraq,Thailand,4,0,4,1.0,0.0,1771,1756
2016-10-11,Kazakhstan,Romania,0,0,0,0.5,0.5,1631,1891
2016-10-11,Kyrgyzstan,Turkmenistan,1,0,1,1.0,0.0,1521,1602
2016-10-11,Laos,Maldives,1,1,0,0.5,0.5,1377,1461
2016-10-11,Lebanon,Equatorial Guinea,1,1,0,0.5,0.5,1664,1570
2016-10-11,Lithuania,Malta,2,0,2,1.0,0.0,1646,1494
2016-10-11,Malaysia,Afghanistan,1,1,0,0.5,0.5,1580,1491
2016-10-11,Mexico,Panama,1,0,1,1.0,0.0,2014,1849
2016-10-11,Morocco,Canada,4,0,4,1.0,0.0,1811,1740
2016-10-11,Norway,San Marino,4,1,3,1.0,0.0,1816,1321
2016-10-11,Oman,Bahrain,2,2,0,0.5,0.5,1793,1789
2016-10-11,Poland,Armenia,2,1,1,1.0,0.0,1954,1656
2016-10-11,Puerto Rico,Curaçao,2,4,2,0.0,1.0,1434,1541
2016-10-11,Qatar,Syria,1,0,1,1.0,0.0,1843,1759
2016-10-11,Saudi Arabia,United Arab Emirates,3,0,3,1.0,0.0,1855,1848
2016-10-11,Slovakia,Scotland,3,0,3,1.0,0.0,1882,1868
2016-10-11,Slovenia,England,0,0,0,0.5,0.5,1787,2070
2016-10-11,South Africa,Ghana,1,1,0,0.5,0.5,1856,1854
2016-10-11,Uzbekistan,China PR,2,0,2,1.0,0.0,1879,1850
2016-10-11,Venezuela,Brazil,0,2,2,0.0,1.0,1827,2174
2016-10-15,Brunei,Timor-Leste,2,1,1,1.0,0.0,1281,1297
2016-10-15,Cambodia,Laos,2,1,1,1.0,0.0,1362,1369
2016-10-18,Cambodia,Brunei,3,0,3,1.0,0.0,1369,1275
2016-10-18,Timor-Leste,Laos,1,2,1,0.0,1.0,1291,1376
2016-10-21,Cambodia,Timor-Leste,3,2,1,1.0,0.0,1376,1285
2016-10-21,Laos,Brunei,4,3,1,1.0,0.0,1382,1270
2016-11-02,Brunei,Timor-Leste,4,0,4,1.0,0.0,1279,1277
2016-11-03,Macau,Mongolia,2,1,1,1.0,0.0,1325,1402
2016-11-03,Sri Lanka,Laos,1,2,1,0.0,1.0,1327,1389
2016-11-04,Myanmar,Indonesia,0,0,0,0.5,0.5,1539,1647
2016-11-05,Timor-Leste,Nepal,0,0,0,0.5,0.5,1280,1405
2016-11-05,Zimbabwe,Zambia,1,0,1,1.0,0.0,1698,1718
2016-11-06,Hong Kong,Guam,3,2,1,1.0,0.0,1619,1420
2016-11-06,Jordan,Iraq,0,0,0,0.5,0.5,1788,1772
2016-11-06,North Korea,Taiwan,2,0,2,1.0,0.0,1793,1399
2016-11-06,Laos,Macau,1,4,3,0.0,1.0,1380,1335
2016-11-06,Mongolia,Sri Lanka,2,0,2,1.0,0.0,1409,1321
2016-11-07,Tahiti,Solomon Islands,3,0,3,1.0,0.0,1658,1601
2016-11-08,Nepal,Brunei,3,0,3,1.0,0.0,1411,1274
2016-11-08,Uganda,Zambia,0,1,1,0.0,1.0,1744,1727
2016-11-08,Vietnam,Indonesia,3,2,1,1.0,0.0,1686,1640
2016-11-09,Greece,Belarus,0,1,1,0.0,1.0,1870,1783
2016-11-09,Guam,North Korea,0,2,2,0.0,1.0,1419,1795
2016-11-09,Haiti,French Guiana,2,5,3,0.0,1.0,1694,1581
2016-11-09,Hong Kong,Taiwan,4,2,2,1.0,0.0,1623,1396
2016-11-09,Mongolia,Laos,0,3,3,0.0,1.0,1401,1389
2016-11-09,Netherlands,Belgium,1,1,0,0.5,0.5,2030,1998
2016-11-09,Philippines,Kyrgyzstan,1,0,1,1.0,0.0,1599,1515
2016-11-09,Sri Lanka,Macau,1,1,0,0.5,0.5,1322,1335
2016-11-09,Syria,Singapore,2,0,2,1.0,0.0,1764,1588
2016-11-09,Tajikistan,Turkmenistan,3,0,3,1.0,0.0,1607,1594
2016-11-09,United Arab Emirates,Bahrain,2,0,2,1.0,0.0,1855,1783
2016-11-10,Brazil,Argentina,3,0,3,1.0,0.0,2181,2116
2016-11-10,Colombia,Chile,0,0,0,0.5,0.5,2032,2045
2016-11-10,Iran,Papua New Guinea,8,1,7,1.0,0.0,1976,1529
2016-11-10,Lebanon,Palestine,1,1,0,0.5,0.5,1664,1641
2016-11-10,Paraguay,Peru,1,4,3,0.0,1.0,1896,1927
2016-11-10,Qatar,Russia,2,1,1,1.0,0.0,1853,1909
2016-11-10,Uruguay,Ecuador,2,1,1,1.0,0.0,2029,1943
2016-11-10,Uzbekistan,Jordan,1,0,1,1.0,0.0,1885,1783
2016-11-10,Venezuela,Bolivia,5,0,5,1.0,0.0,1833,1732
2016-11-11,Armenia,Montenegro,3,2,1,1.0,0.0,1666,1721
2016-11-11,Czech Republic,Norway,2,1,1,1.0,0.0,1898,1810
2016-11-11,Denmark,Kazakhstan,4,1,3,1.0,0.0,1893,1629
2016-11-11,England,Scotland,3,0,3,1.0,0.0,2074,1865
2016-11-11,France,Sweden,2,1,1,1.0,0.0,2106,1929
2016-11-11,Honduras,Panama,0,1,1,0.0,1.0,1818,1857
2016-11-11,Japan,Oman,4,0,4,1.0,0.0,1984,1789
2016-11-11,South Korea,Canada,2,0,2,1.0,0.0,1976,1737
2016-11-11,Libya,Tunisia,0,1,1,0.0,1.0,1727,1857
2016-11-11,Malta,Slovenia,0,1,1,0.0,1.0,1492,1790
2016-11-11,Northern Ireland,Azerbaijan,4,0,4,1.0,0.0,1763,1639
2016-11-11,Romania,Poland,0,3,3,0.0,1.0,1885,1961
2016-11-11,San Marino,Germany,0,8,8,0.0,1.0,1321,2104
2016-11-11,Slovakia,Lithuania,4,0,4,1.0,0.0,1886,1643
2016-11-11,Togo,Comoros,2,2,0,0.5,0.5,1682,1412
2016-11-11,Trinidad and Tobago,Costa Rica,0,2,2,0.0,1.0,1743,1929
2016-11-11,United States,Mexico,1,2,1,0.0,1.0,1985,2022
2016-11-12,Albania,Israel,0,3,3,0.0,1.0,1758,1787
2016-11-12,Austria,Republic of Ireland,0,1,1,0.0,1.0,1844,1948
2016-11-12,Cameroon,Zambia,1,1,0,0.5,0.5,1855,1730
2016-11-12,Cape Verde,Burkina Faso,0,2,2,0.0,1.0,1693,1704
2016-11-12,Croatia,Iceland,2,0,2,1.0,0.0,2006,1807
2016-11-12,Georgia,Moldova,1,1,0,0.5,0.5,1678,1571
2016-11-12,Hong Kong,North Korea,0,1,1,0.0,1.0,1619,1800
2016-11-12,Kenya,Mozambique,1,0,1,1.0,0.0,1657,1634
2016-11-12,Liechtenstein,Italy,0,4,4,0.0,1.0,1434,2030
2016-11-12,Macau,Brunei,1,1,0,0.5,0.5,1334,1276
2016-11-12,Mali,Gabon,0,0,0,0.5,0.5,1745,1707
2016-11-12,Morocco,Ivory Coast,0,0,0,0.5,0.5,1814,1922
2016-11-12,Nepal,Laos,2,2,0,0.5,0.5,1411,1390
2016-11-12,New Zealand,New Caledonia,2,0,2,1.0,0.0,1779,1663
2016-11-12,Nigeria,Algeria,3,1,2,1.0,0.0,1874,1844
2016-11-12,Spain,North Macedonia,4,0,4,1.0,0.0,2136,1674
2016-11-12,Turkey,Kosovo,2,0,2,1.0,0.0,1937,1548
2016-11-12,Uganda,Congo,1,0,1,1.0,0.0,1751,1678
2016-11-12,Ukraine,Finland,1,0,1,1.0,0.0,1942,1749
2016-11-12,Wales,Serbia,1,1,0,0.5,0.5,1832,1875
2016-11-13,Belgium,Estonia,8,1,7,1.0,0.0,2001,1699
2016-11-13,Bulgaria,Belarus,1,0,1,1.0,0.0,1806,1776
2016-11-13,Cyprus,Gibraltar,3,1,2,1.0,0.0,1639,1547
2016-11-13,Egypt,Ghana,2,0,2,1.0,0.0,1902,1847
2016-11-13,Greece,Bosnia and Herzegovina,1,1,0,0.5,0.5,1871,1871
2016-11-13,Guinea,DR Congo,1,2,1,0.0,1.0,1766,1755
2016-11-13,Hungary,Andorra,4,0,4,1.0,0.0,1853,1334
2016-11-13,Jamaica,Suriname,1,0,1,1.0,0.0,1753,1588
2016-11-13,Luxembourg,Netherlands,1,3,2,0.0,1.0,1488,2031
2016-11-13,Portugal,Latvia,4,1,3,1.0,0.0,2025,1660
2016-11-13,Singapore,Cambodia,1,0,1,1.0,0.0,1592,1373
2016-11-13,Solomon Islands,Tahiti,1,0,1,1.0,0.0,1611,1649
2016-11-13,Saint Kitts and Nevis,Haiti,0,2,2,0.0,1.0,1602,1701
2016-11-13,Switzerland,Faroe Islands,2,0,2,1.0,0.0,1951,1493
2016-11-13,Tajikistan,Afghanistan,1,0,1,1.0,0.0,1613,1486
2016-11-13,Zimbabwe,Tanzania,3,0,3,1.0,0.0,1705,1609
2016-11-14,Myanmar,Oman,0,3,3,0.0,1.0,1536,1793
2016-11-14,Laos,Brunei,3,2,1,1.0,0.0,1396,1271
2016-11-14,Malaysia,Papua New Guinea,2,1,1,1.0,0.0,1587,1523
2016-11-14,Poland,Slovenia,1,1,0,0.5,0.5,1958,1794
2016-11-15,Argentina,Colombia,3,0,3,1.0,0.0,2123,2026
2016-11-15,Austria,Slovakia,0,0,0,0.5,0.5,1845,1886
2016-11-15,Bahrain,Kyrgyzstan,0,0,0,0.5,0.5,1778,1521
2016-11-15,Bolivia,Paraguay,1,0,1,1.0,0.0,1744,1885
2016-11-15,Chile,Uruguay,3,1,2,1.0,0.0,2053,2022
2016-11-15,China PR,Qatar,0,0,0,0.5,0.5,1851,1853
2016-11-15,Costa Rica,United States,4,0,4,1.0,0.0,1939,1976
2016-11-15,Czech Republic,Denmark,1,1,0,0.5,0.5,1898,1894
2016-11-15,Ecuador,Venezuela,3,0,3,1.0,0.0,1949,1828
2016-11-15,England,Spain,2,2,0,0.5,0.5,2076,2135
2016-11-15,France,Ivory Coast,0,0,0,0.5,0.5,2103,1926
2016-11-15,Gabon,Comoros,1,1,0,0.5,0.5,1702,1418
2016-11-15,Honduras,Trinidad and Tobago,3,1,2,1.0,0.0,1825,1737
2016-11-15,Italy,Germany,0,0,0,0.5,0.5,2032,2103
2016-11-15,Japan,Saudi Arabia,2,1,1,1.0,0.0,1990,1850
2016-11-15,Jordan,Lebanon,0,0,0,0.5,0.5,1781,1667
2016-11-15,Kenya,Liberia,1,0,1,1.0,0.0,1665,1612
2016-11-15,South Korea,Uzbekistan,2,1,1,1.0,0.0,1982,1880
2016-11-15,Malta,Iceland,0,2,2,0.0,1.0,1490,1810
2016-11-15,Morocco,Togo,2,1,1,1.0,0.0,1820,1677
2016-11-15,Mozambique,South Africa,1,1,0,0.5,0.5,1639,1852
2016-11-15,Nepal,Macau,1,0,1,1.0,0.0,1418,1328
2016-11-15,New Caledonia,New Zealand,0,0,0,0.5,0.5,1666,1777
2016-11-15,Northern Ireland,Croatia,0,3,3,0.0,1.0,1760,2010
2016-11-15,Panama,Mexico,0,0,0,0.5,0.5,1861,2019
2016-11-15,Peru,Brazil,0,2,2,0.0,1.0,1924,2185
2016-11-15,Russia,Romania,1,0,1,1.0,0.0,1917,1878
2016-11-15,Syria,Iran,0,0,0,0.5,0.5,1769,1972
2016-11-15,Thailand,Australia,2,2,0,0.5,0.5,1760,1934
2016-11-15,Tunisia,Mauritania,0,0,0,0.5,0.5,1852,1544
2016-11-15,Ukraine,Serbia,2,0,2,1.0,0.0,1949,1869
2016-11-15,United Arab Emirates,Iraq,2,0,2,1.0,0.0,1862,1766
2016-11-19,Philippines,Singapore,0,0,0,0.5,0.5,1599,1593
2016-11-19,Saint Kitts and Nevis,Estonia,1,1,0,0.5,0.5,1605,1697
2016-11-19,Thailand,Indonesia,4,2,2,1.0,0.0,1766,1635
2016-11-20,Myanmar,Vietnam,1,2,1,0.0,1.0,1532,1691
2016-11-20,Malaysia,Cambodia,3,2,1,1.0,0.0,1591,1370
2016-11-22,Antigua and Barbuda,Estonia,0,1,1,0.0,1.0,1571,1703
2016-11-22,Philippines,Indonesia,2,2,0,0.5,0.5,1600,1635
2016-11-22,Thailand,Singapore,1,0,1,1.0,0.0,1771,1589
2016-11-23,Myanmar,Cambodia,3,1,2,1.0,0.0,1537,1366
2016-11-23,Malaysia,Vietnam,0,1,1,0.0,1.0,1586,1697
2016-11-25,Philippines,Thailand,0,1,1,0.0,1.0,1596,1776
2016-11-25,Singapore,Indonesia,1,2,1,0.0,1.0,1583,1642
2016-11-26,Ryūkyū,United Koreans in Japan,0,9,9,0.0,1.0,1492,1507
2016-11-26,Myanmar,Malaysia,1,0,1,1.0,0.0,1547,1577
2016-11-26,Vietnam,Cambodia,2,1,1,1.0,0.0,1700,1364
2016-12-03,Indonesia,Vietnam,2,1,1,1.0,0.0,1652,1691
2016-12-04,Myanmar,Thailand,0,2,2,0.0,1.0,1544,1780
2016-12-07,Vietnam,Indonesia,2,2,0,0.5,0.5,1691,1653
2016-12-08,Thailand,Myanmar,4,0,4,1.0,0.0,1784,1541
2016-12-14,Indonesia,Thailand,2,1,1,1.0,0.0,1664,1774
2016-12-17,Thailand,Indonesia,2,0,2,1.0,0.0,1780,1659
2016-12-26,Ivory Coast,Zimbabwe,0,0,0,0.5,0.5,1922,1710
2016-12-27,Nicaragua,Trinidad and Tobago,2,1,1,1.0,0.0,1489,1724
2016-12-28,Catalonia,Tunisia,3,3,0,0.5,0.5,1668,1849
2016-12-30,Nicaragua,Trinidad and Tobago,1,3,2,0.0,1.0,1486,1728
2016-12-30,Basque Country,Tunisia,3,1,2,1.0,0.0,1767,1839
2017-01-04,Trinidad and Tobago,Suriname,1,2,1,0.0,1.0,1717,1600
2017-01-04,Tunisia,Uganda,2,0,2,1.0,0.0,1846,1745
2017-01-05,Cameroon,DR Congo,2,0,2,1.0,0.0,1861,1750
2017-01-06,Suriname,Haiti,2,4,2,0.0,1.0,1595,1707
2017-01-07,Algeria,Mauritania,3,1,2,1.0,0.0,1847,1542
2017-01-07,Burkina Faso,Mali,2,1,1,1.0,0.0,1713,1737
2017-01-08,Egypt,Tunisia,1,0,1,1.0,0.0,1909,1840
2017-01-08,Ivory Coast,Sweden,2,1,1,1.0,0.0,1931,1921
2017-01-08,Libya,Senegal,1,2,1,0.0,1.0,1723,1869
2017-01-08,Trinidad and Tobago,Haiti,3,4,1,0.0,1.0,1709,1716
2017-01-09,Morocco,Finland,0,1,1,0.0,1.0,1811,1759
2017-01-10,Algeria,Mauritania,6,0,6,1.0,0.0,1850,1540
2017-01-10,Cameroon,Zimbabwe,1,1,0,0.5,0.5,1858,1714
2017-01-10,China PR,Iceland,0,2,2,0.0,1.0,1843,1819
2017-01-11,Chile,Croatia,1,1,0,0.5,0.5,2053,2011
2017-01-11,Congo,Senegal,0,2,2,0.0,1.0,1675,1873
2017-01-11,Ivory Coast,Uganda,3,0,3,1.0,0.0,1936,1741
2017-01-13,Honduras,Nicaragua,2,1,1,1.0,0.0,1827,1485
2017-01-14,Burkina Faso,Cameroon,1,1,0,0.5,0.5,1717,1855
2017-01-14,Cambodia,Saudi Arabia,2,7,5,0.0,1.0,1364,1851
2017-01-14,China PR,Croatia,1,1,0,0.5,0.5,1847,2008
2017-01-14,Gabon,Guinea-Bissau,1,1,0,0.5,0.5,1699,1552
2017-01-15,Algeria,Zimbabwe,2,2,0,0.5,0.5,1848,1717
2017-01-15,Belize,Costa Rica,0,3,3,0.0,1.0,1507,1941
2017-01-15,El Salvador,Honduras,1,2,1,0.0,1.0,1692,1833
2017-01-15,Iceland,Chile,0,1,1,0.0,1.0,1816,2057
2017-01-15,Tunisia,Senegal,0,2,2,0.0,1.0,1833,1881
2017-01-16,DR Congo,Morocco,1,0,1,1.0,0.0,1760,1802
2017-01-16,Ivory Coast,Togo,0,0,0,0.5,0.5,1931,1683
2017-01-17,El Salvador,Belize,3,1,2,1.0,0.0,1697,1503
2017-01-17,Ghana,Uganda,1,0,1,1.0,0.0,1853,1736
2017-01-17,Mali,Egypt,0,0,0,0.5,0.5,1741,1906
2017-01-17,Qatar,Moldova,1,1,0,0.5,0.5,1848,1577
2017-01-18,Cameroon,Guinea-Bissau,2,1,1,1.0,0.0,1858,1550
2017-01-18,Gabon,Burkina Faso,1,1,0,0.5,0.5,1700,1717
2017-01-19,Algeria,Tunisia,1,2,1,0.0,1.0,1840,1842
2017-01-19,Senegal,Zimbabwe,2,0,2,1.0,0.0,1886,1713
2017-01-20,Ivory Coast,DR Congo,2,2,0,0.5,0.5,1928,1764
2017-01-20,Morocco,Togo,3,1,2,1.0,0.0,1808,1678
2017-01-20,Nicaragua,Belize,3,1,2,1.0,0.0,1494,1495
2017-01-21,Egypt,Uganda,1,0,1,1.0,0.0,1911,1732
2017-01-21,Ghana,Mali,1,0,1,1.0,0.0,1859,1736
2017-01-22,Belize,Honduras,0,1,1,0.0,1.0,1493,1836
2017-01-22,Bermuda,Canada,2,4,2,0.0,1.0,1571,1742
2017-01-22,El Salvador,Nicaragua,1,0,1,1.0,0.0,1701,1491
2017-01-22,Gabon,Cameroon,0,0,0,0.5,0.5,1704,1855
2017-01-22,Guinea-Bissau,Burkina Faso,0,2,2,0.0,1.0,1546,1722
2017-01-22,Panama,Costa Rica,1,0,1,1.0,0.0,1871,1932
2017-01-23,Senegal,Algeria,2,2,0,0.5,0.5,1885,1842
2017-01-23,Uzbekistan,Georgia,2,2,0,0.5,0.5,1876,1683
2017-01-23,Zimbabwe,Tunisia,2,4,2,0.0,1.0,1708,1848
2017-01-24,Morocco,Ivory Coast,1,0,1,1.0,0.0,1819,1918
2017-01-24,Togo,DR Congo,1,3,2,0.0,1.0,1672,1771
2017-01-25,Egypt,Ghana,1,0,1,1.0,0.0,1918,1853
2017-01-25,Jordan,Georgia,1,0,1,1.0,0.0,1787,1678
2017-01-25,Uganda,Mali,1,1,0,0.5,0.5,1733,1736
2017-01-26,Brazil,Colombia,1,0,1,1.0,0.0,2190,2022
2017-01-28,Burkina Faso,Tunisia,2,0,2,1.0,0.0,1733,1838
2017-01-28,Senegal,Cameroon,0,0,0,0.5,0.5,1885,1856
2017-01-29,DR Congo,Ghana,1,2,1,0.0,1.0,1765,1860
2017-01-29,Egypt,Morocco,1,0,1,1.0,0.0,1924,1814
2017-01-29,United States,Serbia,0,0,0,0.5,0.5,1974,1872
2017-02-01,Burkina Faso,Egypt,1,1,0,0.5,0.5,1738,1920
2017-02-02,Cameroon,Ghana,2,0,2,1.0,0.0,1865,1852
2017-02-04,Burkina Faso,Ghana,1,0,1,1.0,0.0,1749,1842
2017-02-05,Egypt,Cameroon,1,2,1,0.0,1.0,1911,1875
2017-02-08,Mexico,Iceland,1,0,1,1.0,0.0,2023,1813
2017-02-22,Ecuador,Honduras,3,1,2,1.0,0.0,1955,1831
2017-03-09,Qatar,Azerbaijan,1,2,1,0.0,1.0,1836,1652
2017-03-10,Trinidad and Tobago,Barbados,2,0,2,1.0,0.0,1714,1538
2017-03-11,Burundi,Djibouti,7,0,7,1.0,0.0,1589,1290
2017-03-12,Raetia,Tamil Eelam,0,5,5,0.0,1.0,1446,1519
2017-03-13,Burundi,Djibouti,1,0,1,1.0,0.0,1592,1288
2017-03-16,Honduras,Nicaragua,2,0,2,1.0,0.0,1833,1490
2017-03-18,Iran,Iraq,0,1,1,0.0,1.0,1960,1779
2017-03-19,San Marino,Moldova,0,2,2,0.0,1.0,1319,1580
2017-03-21,Indonesia,Myanmar,1,3,2,0.0,1.0,1649,1552
2017-03-22,Cambodia,India,2,3,1,0.0,1.0,1361,1580
2017-03-22,Curaçao,El Salvador,1,1,0,0.5,0.5,1545,1698
2017-03-22,Cyprus,Kazakhstan,3,1,2,1.0,0.0,1647,1622
2017-03-22,Czech Republic,Lithuania,3,0,3,1.0,0.0,1901,1641
2017-03-22,Djibouti,South Sudan,2,0,2,1.0,0.0,1300,1466
2017-03-22,Germany,England,1,0,1,1.0,0.0,2111,2069
2017-03-22,Philippines,Malaysia,0,0,0,0.5,0.5,1596,1578
2017-03-22,São Tomé and Príncipe,Madagascar,0,1,1,0.0,1.0,1458,1571
2017-03-22,Scotland,Canada,1,1,0,0.5,0.5,1863,1745
2017-03-22,Vietnam,Taiwan,1,1,0,0.5,0.5,1686,1402
2017-03-22,Yemen,Palestine,0,1,1,0.0,1.0,1551,1648
2017-03-23,Afghanistan,Singapore,2,1,1,1.0,0.0,1497,1573
2017-03-23,Argentina,Chile,1,0,1,1.0,0.0,2130,2051
2017-03-23,Bahrain,Tajikistan,1,1,0,0.5,0.5,1775,1617
2017-03-23,China PR,South Korea,1,0,1,1.0,0.0,1858,1972
2017-03-23,Colombia,Bolivia,1,0,1,1.0,0.0,2025,1742
2017-03-23,Iraq,Australia,1,1,0,0.5,0.5,1783,1931
2017-03-23,Jordan,Hong Kong,4,0,4,1.0,0.0,1792,1615
2017-03-23,Kenya,Uganda,1,1,0,0.5,0.5,1667,1732
2017-03-23,Nigeria,Senegal,1,1,0,0.5,0.5,1875,1885
2017-03-23,Papua New Guinea,Tahiti,1,3,2,0.0,1.0,1518,1655
2017-03-23,Paraguay,Ecuador,2,1,1,1.0,0.0,1895,1946
2017-03-23,Qatar,Iran,0,1,1,0.0,1.0,1831,1966
2017-03-23,Syria,Uzbekistan,1,0,1,1.0,0.0,1780,1866
2017-03-23,Thailand,Saudi Arabia,0,3,3,0.0,1.0,1774,1858
2017-03-23,United Arab Emirates,Japan,0,2,2,0.0,1.0,1857,1996
2017-03-23,Uruguay,Brazil,1,4,3,0.0,1.0,2018,2195
2017-03-23,Venezuela,Peru,2,2,0,0.5,0.5,1831,1922
2017-03-24,Austria,Moldova,2,0,2,1.0,0.0,1848,1578
2017-03-24,Comoros,Mauritius,2,0,2,1.0,0.0,1428,1468
2017-03-24,Croatia,Ukraine,1,0,1,1.0,0.0,2015,1943
2017-03-24,Georgia,Serbia,1,3,2,0.0,1.0,1675,1876
2017-03-24,Guinea,Gabon,2,2,0,0.5,0.5,1765,1706
2017-03-24,Republic of Ireland,Wales,0,0,0,0.5,0.5,1946,1835
2017-03-24,Italy,Albania,2,0,2,1.0,0.0,2035,1756
2017-03-24,Kosovo,Iceland,1,2,1,0.0,1.0,1546,1816
2017-03-24,Libya,Togo,0,0,0,0.5,0.5,1722,1674
2017-03-24,Liechtenstein,North Macedonia,0,3,3,0.0,1.0,1431,1678
2017-03-24,Mauritania,Benin,1,0,1,1.0,0.0,1550,1610
2017-03-24,Mexico,Costa Rica,2,0,2,1.0,0.0,2029,1927
2017-03-24,Morocco,Burkina Faso,2,0,2,1.0,0.0,1821,1743
2017-03-24,Russia,Ivory Coast,0,2,2,0.0,1.0,1910,1926
2017-03-24,Spain,Israel,4,1,3,1.0,0.0,2137,1786
2017-03-24,Trinidad and Tobago,Panama,1,0,1,1.0,0.0,1726,1860
2017-03-24,Tunisia,Cameroon,0,1,1,0.0,1.0,1831,1883
2017-03-24,Turkey,Finland,2,0,2,1.0,0.0,1942,1755
2017-03-24,United States,Honduras,6,0,6,1.0,0.0,1979,1829
2017-03-25,Andorra,Faroe Islands,0,0,0,0.5,0.5,1338,1490
2017-03-25,Belgium,Greece,1,1,0,0.5,0.5,1999,1874
2017-03-25,Bosnia and Herzegovina,Gibraltar,5,0,5,1.0,0.0,1874,1545
2017-03-25,Bulgaria,Netherlands,2,0,2,1.0,0.0,1819,2019
2017-03-25,Cyprus,Estonia,0,0,0,0.5,0.5,1649,1702
2017-03-25,Fiji,New Zealand,0,2,2,0.0,1.0,1667,1783
2017-03-25,Luxembourg,France,1,3,2,0.0,1.0,1488,2104
2017-03-25,Mozambique,Angola,2,0,2,1.0,0.0,1648,1654
2017-03-25,Portugal,Hungary,3,0,3,1.0,0.0,2030,1849
2017-03-25,South Africa,Guinea-Bissau,3,1,2,1.0,0.0,1855,1544
2017-03-25,Sweden,Belarus,4,0,4,1.0,0.0,1926,1772
2017-03-25,Switzerland,Latvia,1,0,1,1.0,0.0,1954,1658
2017-03-25,Tanzania,Botswana,2,0,2,1.0,0.0,1618,1637
2017-03-25,Alderney,Jersey,1,2,1,0.0,1.0,1254,1753
2017-03-26,Armenia,Kazakhstan,2,0,2,1.0,0.0,1673,1616
2017-03-26,Azerbaijan,Germany,1,4,3,0.0,1.0,1651,2113
2017-03-26,Barbados,Martinique,2,1,1,1.0,0.0,1550,1695
2017-03-26,England,Lithuania,2,0,2,1.0,0.0,2071,1640
2017-03-26,Kenya,DR Congo,2,1,1,1.0,0.0,1678,1755
2017-03-26,Madagascar,São Tomé and Príncipe,3,2,1,1.0,0.0,1577,1453
2017-03-26,Malta,Slovakia,1,3,2,0.0,1.0,1489,1888
2017-03-26,Montenegro,Poland,1,2,1,0.0,1.0,1718,1962
2017-03-26,Northern Ireland,Norway,2,0,2,1.0,0.0,1770,1801
2017-03-26,Romania,Denmark,0,0,0,0.5,0.5,1879,1894
2017-03-26,San Marino,Czech Republic,0,6,6,0.0,1.0,1319,1902
2017-03-26,Scotland,Slovenia,1,0,1,1.0,0.0,1870,1788
2017-03-26,Zimbabwe,Zambia,0,0,0,0.5,0.5,1709,1730
2017-03-27,Central African Republic,Gambia,1,2,1,0.0,1.0,1504,1579
2017-03-27,Ivory Coast,Senegal,1,1,0,0.5,0.5,1926,1886
2017-03-27,Mauritania,Congo,2,1,1,1.0,0.0,1561,1665
2017-03-27,Turkey,Moldova,3,1,2,1.0,0.0,1944,1577
2017-03-28,Afghanistan,Vietnam,1,1,0,0.5,0.5,1501,1683
2017-03-28,Albania,Bosnia and Herzegovina,1,2,1,0.0,1.0,1751,1880
2017-03-28,Australia,United Arab Emirates,2,0,2,1.0,0.0,1938,1851
2017-03-28,Austria,Finland,1,1,0,0.5,0.5,1846,1758
2017-03-28,Bahrain,Singapore,0,0,0,0.5,0.5,1771,1578
2017-03-28,Bolivia,Argentina,2,0,2,1.0,0.0,1757,2116
2017-03-28,Brazil,Paraguay,3,0,3,1.0,0.0,2198,1893
2017-03-28,Myanmar,India,0,1,1,0.0,1.0,1545,1588
2017-03-28,Cameroon,Guinea,1,2,1,0.0,1.0,1873,1776
2017-03-28,Chile,Venezuela,3,1,2,1.0,0.0,2055,1828
2017-03-28,Ecuador,Colombia,0,2,2,0.0,1.0,1940,2032
2017-03-28,Egypt,Togo,3,0,3,1.0,0.0,1915,1671
2017-03-28,Estonia,Croatia,3,0,3,1.0,0.0,1716,2002
2017-03-28,France,Spain,0,2,2,0.0,1.0,2097,2145
2017-03-28,Georgia,Latvia,5,0,5,1.0,0.0,1683,1651
2017-03-28,Guyana,Martinique,0,0,0,0.5,0.5,1599,1693
2017-03-28,Honduras,Costa Rica,1,1,0,0.5,0.5,1832,1925
2017-03-28,Iran,China PR,1,0,1,1.0,0.0,1972,1853
2017-03-28,Republic of Ireland,Iceland,0,1,1,0.0,1.0,1936,1827
2017-03-28,Japan,Thailand,4,0,4,1.0,0.0,2000,1771
2017-03-28,Jordan,Cambodia,7,0,7,1.0,0.0,1794,1360
2017-03-28,South Korea,Syria,1,0,1,1.0,0.0,1976,1777
2017-03-28,Kyrgyzstan,Macau,1,0,1,1.0,0.0,1525,1325
2017-03-28,Lebanon,Hong Kong,2,0,2,1.0,0.0,1674,1609
2017-03-28,Luxembourg,Cape Verde,0,2,2,0.0,1.0,1485,1697
2017-03-28,North Macedonia,Belarus,3,0,3,1.0,0.0,1689,1762
2017-03-28,Maldives,Palestine,0,3,3,0.0,1.0,1457,1653
2017-03-28,Mauritius,Comoros,1,1,0,0.5,0.5,1468,1429
2017-03-28,Morocco,Tunisia,1,0,1,1.0,0.0,1830,1823
2017-03-28,Mozambique,Lesotho,1,0,1,1.0,0.0,1654,1521
2017-03-28,Netherlands,Italy,1,2,1,0.0,1.0,2012,2043
2017-03-28,New Zealand,Fiji,2,0,2,1.0,0.0,1789,1662
2017-03-28,Oman,Bhutan,14,0,14,1.0,0.0,1794,1269
2017-03-28,Panama,United States,1,1,0,0.5,0.5,1863,1977
2017-03-28,Peru,Uruguay,2,1,1,1.0,0.0,1933,2008
2017-03-28,Philippines,Nepal,4,1,3,1.0,0.0,1601,1414
2017-03-28,Portugal,Sweden,2,3,1,0.0,1.0,2020,1937
2017-03-28,Russia,Belgium,3,3,0,0.5,0.5,1913,1997
2017-03-28,Saudi Arabia,Iraq,1,0,1,1.0,0.0,1865,1777
2017-03-28,South Africa,Angola,0,0,0,0.5,0.5,1851,1659
2017-03-28,South Sudan,Djibouti,6,0,6,1.0,0.0,1471,1296
2017-03-28,Tanzania,Burundi,2,1,1,1.0,0.0,1626,1585
2017-03-28,Trinidad and Tobago,Mexico,0,1,1,0.0,1.0,1724,2032
2017-03-28,Uzbekistan,Qatar,1,0,1,1.0,0.0,1874,1824
2017-03-28,Yemen,Tajikistan,2,1,1,1.0,0.0,1561,1608
2017-03-28,Tahiti,Papua New Guinea,1,2,1,0.0,1.0,1644,1530
2017-04-23,Jersey,Panjab,0,2,2,0.0,1.0,1741,1537
2017-04-26,Martinique,Guadeloupe,4,1,3,1.0,0.0,1701,1646
2017-04-29,Vatican City,Monaco,0,0,0,0.5,0.5,1472,1491
2017-05-04,Burkina Faso,Benin,1,1,0,0.5,0.5,1741,1613
2017-05-07,Saint Kitts and Nevis,Barbados,2,1,1,1.0,0.0,1612,1544
2017-05-11,Senegal,Mauritania,2,0,2,1.0,0.0,1889,1559
2017-05-13,Egypt,Libya,1,0,1,1.0,0.0,1919,1719
2017-05-13,Guernsey,Jersey,2,1,1,1.0,0.0,1750,1734
2017-05-17,Guadeloupe,Dominica,2,2,0,0.5,0.5,1642,1425
2017-05-21,Benin,Burkina Faso,2,2,0,0.5,0.5,1616,1739
2017-05-25,Fiji,Solomon Islands,1,1,0,0.5,0.5,1661,1613
2017-05-25,Ghana,Benin,1,1,0,0.5,0.5,1838,1621
2017-05-26,Corsica,Nigeria,1,1,0,0.5,0.5,1563,1870
2017-05-28,El Salvador,Honduras,2,2,0,0.5,0.5,1701,1830
2017-05-28,Fiji,Solomon Islands,1,0,1,1.0,0.0,1668,1607
2017-05-28,Mexico,Croatia,1,2,1,0.0,1.0,2024,2011
2017-05-31,Italy,San Marino,8,0,8,1.0,0.0,2044,1319
2017-05-31,Ivory Coast,Benin,1,1,0,0.5,0.5,1921,1627
2017-05-31,Morocco,Netherlands,1,2,1,0.0,1.0,1826,2017
2017-06-01,Iraq,Jordan,1,0,1,1.0,0.0,1786,1786
2017-06-01,Mexico,Republic of Ireland,3,1,2,1.0,0.0,2031,1930
2017-06-01,Nigeria,Togo,3,0,3,1.0,0.0,1874,1668
2017-06-01,Switzerland,Belarus,1,0,1,1.0,0.0,1958,1759
2017-06-02,Chile,Burkina Faso,3,0,3,1.0,0.0,2058,1737
2017-06-02,France,Paraguay,5,0,5,1.0,0.0,2101,1890
2017-06-02,Nicaragua,Bolivia,0,1,1,0.0,1.0,1488,1760
2017-06-02,Northern Ireland,New Zealand,1,0,1,1.0,0.0,1779,1781
2017-06-02,Oman,Syria,1,1,0,0.5,0.5,1794,1778
2017-06-03,Ethiopia,Uganda,0,0,0,0.5,0.5,1632,1730
2017-06-03,Portugal,Cyprus,4,0,4,1.0,0.0,2022,1648
2017-06-03,United States,Venezuela,1,1,0,0.5,0.5,1974,1832
2017-06-04,Armenia,Saint Kitts and Nevis,5,0,5,1.0,0.0,1680,1606
2017-06-04,Gabon,Zambia,0,0,0,0.5,0.5,1707,1730
2017-06-04,Republic of Ireland,Uruguay,3,1,2,1.0,0.0,1940,1999
2017-06-04,Lesotho,Mauritania,1,0,1,1.0,0.0,1530,1551
2017-06-04,Luxembourg,Albania,2,1,1,1.0,0.0,1499,1738
2017-06-04,Montenegro,Iran,1,2,1,0.0,1.0,1715,1976
2017-06-04,Netherlands,Ivory Coast,5,0,5,1.0,0.0,2023,1916
2017-06-04,Togo,Comoros,2,0,2,1.0,0.0,1672,1426
2017-06-04,Northern Cyprus,Kárpátalja,1,0,1,1.0,0.0,1566,1494
2017-06-05,Belgium,Czech Republic,2,1,1,1.0,0.0,2003,1897
2017-06-05,DR Congo,Botswana,2,0,2,1.0,0.0,1761,1632
2017-06-05,Egypt,Libya,1,0,1,1.0,0.0,1923,1716
2017-06-05,Hungary,Russia,0,3,3,0.0,1.0,1843,1920
2017-06-05,North Macedonia,Turkey,0,0,0,0.5,0.5,1695,1939
2017-06-05,Senegal,Uganda,0,0,0,0.5,0.5,1886,1734
2017-06-05,Abkhazia,South Ossetia,2,1,1,1.0,0.0,1556,1483
2017-06-05,Padania,Ellan Vannin,1,0,1,1.0,0.0,1629,1530
2017-06-05,Felvidék,Székely Land,1,0,1,1.0,0.0,1513,1459
2017-06-06,Afghanistan,Maldives,2,1,1,1.0,0.0,1508,1451
2017-06-06,Algeria,Guinea,2,1,1,1.0,0.0,1849,1770
2017-06-06,Bahrain,Palestine,0,2,2,0.0,1.0,1761,1664
2017-06-06,Denmark,Germany,1,1,0,0.5,0.5,1899,2109
2017-06-06,India,Nepal,2,0,2,1.0,0.0,1593,1410
2017-06-06,Israel,Moldova,1,1,0,0.5,0.5,1782,1582
2017-06-06,Malta,Ukraine,1,0,1,1.0,0.0,1504,1929
2017-06-06,Qatar,North Korea,2,2,0,0.5,0.5,1824,1801
2017-06-06,Uzbekistan,Thailand,2,0,2,1.0,0.0,1880,1766
2017-06-06,Northern Cyprus,South Ossetia,8,0,8,1.0,0.0,1573,1477
2017-06-06,Kárpátalja,Abkhazia,2,2,0,0.5,0.5,1496,1555
2017-06-06,Székely Land,Padania,1,1,0,0.5,0.5,1463,1626
2017-06-06,Ellan Vannin,Felvidék,1,0,1,1.0,0.0,1538,1506
2017-06-07,Bolivia,Nicaragua,3,2,1,1.0,0.0,1763,1486
2017-06-07,China PR,Philippines,8,1,7,1.0,0.0,1857,1598
2017-06-07,Fiji,New Caledonia,2,2,0,0.5,0.5,1668,1667
2017-06-07,Finland,Liechtenstein,1,1,0,0.5,0.5,1753,1437
2017-06-07,Georgia,Saint Kitts and Nevis,3,0,3,1.0,0.0,1690,1600
2017-06-07,Hong Kong,Jordan,0,0,0,0.5,0.5,1613,1783
2017-06-07,Iraq,South Korea,0,0,0,0.5,0.5,1790,1973
2017-06-07,Italy,Uruguay,3,0,3,1.0,0.0,2051,1993
2017-06-07,Japan,Syria,1,1,0,0.5,0.5,1996,1783
2017-06-07,Spain,Colombia,2,2,0,0.5,0.5,2143,2035
2017-06-07,United Arab Emirates,Laos,4,0,4,1.0,0.0,1853,1395
2017-06-07,Northern Cyprus,Abkhazia,0,0,0,0.5,0.5,1573,1556
2017-06-07,South Ossetia,Kárpátalja,1,4,3,0.0,1.0,1470,1504
2017-06-07,Ellan Vannin,Székely Land,2,4,2,0.0,1.0,1529,1473
2017-06-07,Padania,Felvidék,2,0,2,1.0,0.0,1632,1501
2017-06-08,Australia,Saudi Arabia,3,2,1,1.0,0.0,1945,1859
2017-06-08,Cambodia,Indonesia,0,2,2,0.0,1.0,1358,1652
2017-06-08,Costa Rica,Panama,0,0,0,0.5,0.5,1924,1865
2017-06-08,Ecuador,Venezuela,1,1,0,0.5,0.5,1938,1835
2017-06-08,Mexico,Honduras,3,0,3,1.0,0.0,2035,1827
2017-06-08,Peru,Paraguay,1,0,1,1.0,0.0,1941,1883
2017-06-08,United States,Trinidad and Tobago,2,0,2,1.0,0.0,1978,1721
2017-06-09,Andorra,Hungary,1,0,1,1.0,0.0,1354,1828
2017-06-09,Argentina,Brazil,1,0,1,1.0,0.0,2126,2189
2017-06-09,Belarus,Bulgaria,2,1,1,1.0,0.0,1769,1810
2017-06-09,Bosnia and Herzegovina,Greece,0,0,0,0.5,0.5,1880,1875
2017-06-09,Estonia,Belgium,0,2,2,0.0,1.0,1714,2006
2017-06-09,Faroe Islands,Switzerland,0,2,2,0.0,1.0,1489,1960
2017-06-09,Gibraltar,Cyprus,1,2,1,0.0,1.0,1540,1654
2017-06-09,Latvia,Portugal,0,3,3,0.0,1.0,1650,2024
2017-06-09,Libya,Seychelles,5,1,4,1.0,0.0,1719,1409
2017-06-09,Netherlands,Luxembourg,5,0,5,1.0,0.0,2024,1499
2017-06-09,Russia,Chile,1,1,0,0.5,0.5,1924,2055
2017-06-09,Solomon Islands,Papua New Guinea,3,2,1,1.0,0.0,1614,1524
2017-06-09,Sudan,Madagascar,1,3,2,0.0,1.0,1596,1586
2017-06-09,Sweden,France,2,1,1,1.0,0.0,1949,2090
2017-06-09,South Ossetia,Felvidék,0,2,2,0.0,1.0,1463,1509
2017-06-09,Kárpátalja,Ellan Vannin,3,3,0,0.5,0.5,1505,1529
2017-06-09,Northern Cyprus,Székely Land,2,1,1,1.0,0.0,1579,1468
2017-06-09,Padania,Abkhazia,0,0,0,0.5,0.5,1631,1558
2017-06-10,Azerbaijan,Northern Ireland,0,1,1,0.0,1.0,1646,1785
2017-06-10,Burkina Faso,Angola,3,1,2,1.0,0.0,1744,1653
2017-06-10,Burundi,South Sudan,3,0,3,1.0,0.0,1591,1466
2017-06-10,Cameroon,Morocco,1,0,1,1.0,0.0,1880,1820
2017-06-10,DR Congo,Congo,3,1,2,1.0,0.0,1767,1660
2017-06-10,Germany,San Marino,7,0,7,1.0,0.0,2110,1319
2017-06-10,Grenada,Bermuda,1,2,1,0.0,1.0,1504,1578
2017-06-10,Guinea-Bissau,Namibia,1,0,1,1.0,0.0,1554,1620
2017-06-10,Ivory Coast,Guinea,2,3,1,0.0,1.0,1905,1782
2017-06-10,Kazakhstan,Denmark,1,3,2,0.0,1.0,1614,1902
2017-06-10,Lithuania,Slovakia,1,2,1,0.0,1.0,1637,1892
2017-06-10,Malawi,Comoros,1,0,1,1.0,0.0,1641,1423
2017-06-10,Mali,Gabon,2,1,1,1.0,0.0,1744,1700
2017-06-10,Montenegro,Armenia,4,1,3,1.0,0.0,1723,1673
2017-06-10,Niger,Eswatini,0,0,0,0.5,0.5,1583,1566
2017-06-10,Nigeria,South Africa,0,2,2,0.0,1.0,1866,1860
2017-06-10,Norway,Czech Republic,1,1,0,0.5,0.5,1804,1895
2017-06-10,Poland,Romania,3,1,2,1.0,0.0,1969,1873
2017-06-10,Scotland,England,2,2,0,0.5,0.5,1875,2067
2017-06-10,Senegal,Equatorial Guinea,3,0,3,1.0,0.0,1889,1568
2017-06-10,Singapore,Taiwan,1,2,1,0.0,1.0,1567,1414
2017-06-10,Slovenia,Malta,2,0,2,1.0,0.0,1791,1502
2017-06-10,Tanzania,Lesotho,1,1,0,0.5,0.5,1624,1533
2017-06-10,Zambia,Mozambique,0,1,1,0.0,1.0,1721,1664
2017-06-10,Székely Land,Abkhazia,3,1,2,1.0,0.0,1479,1548
2017-06-10,Northern Cyprus,Padania,1,1,0,0.5,0.5,1581,1630
2017-06-10,Botswana,Mauritania,0,1,1,0.0,1.0,1623,1561
2017-06-11,Algeria,Togo,1,0,1,1.0,0.0,1854,1668
2017-06-11,Benin,Gambia,1,0,1,1.0,0.0,1634,1573
2017-06-11,Cape Verde,Uganda,0,1,1,0.0,1.0,1690,1742
2017-06-11,Central African Republic,Rwanda,2,1,1,1.0,0.0,1515,1619
2017-06-11,Finland,Ukraine,1,2,1,0.0,1.0,1749,1934
2017-06-11,Ghana,Ethiopia,5,0,5,1.0,0.0,1842,1629
2017-06-11,Iceland,Croatia,1,0,1,1.0,0.0,1839,2000
2017-06-11,Republic of Ireland,Austria,1,1,0,0.5,0.5,1938,1849
2017-06-11,Israel,Albania,0,3,3,0.0,1.0,1773,1748
2017-06-11,Italy,Liechtenstein,5,0,5,1.0,0.0,2052,1437
2017-06-11,Kosovo,Turkey,1,4,3,0.0,1.0,1545,1941
2017-06-11,North Macedonia,Spain,1,2,1,0.0,1.0,1694,2145
2017-06-11,Mexico,United States,1,1,0,0.5,0.5,2034,1980
2017-06-11,Moldova,Georgia,2,2,0,0.5,0.5,1585,1688
2017-06-11,New Caledonia,Fiji,2,1,1,1.0,0.0,1676,1660
2017-06-11,Serbia,Wales,1,1,0,0.5,0.5,1876,1836
2017-06-11,Zimbabwe,Liberia,3,0,3,1.0,0.0,1715,1607
2017-06-11,Tunisia,Egypt,1,0,1,1.0,0.0,1834,1913
2017-06-12,Belarus,New Zealand,1,0,1,1.0,0.0,1778,1773
2017-06-12,Iran,Uzbekistan,2,0,2,1.0,0.0,1982,1875
2017-06-12,Latvia,Estonia,1,2,1,0.0,1.0,1644,1721
2017-06-13,Australia,Brazil,0,4,4,0.0,1.0,1942,2193
2017-06-13,Bhutan,Maldives,0,2,2,0.0,1.0,1265,1456
2017-06-13,Cambodia,Afghanistan,1,0,1,1.0,0.0,1370,1497
2017-06-13,Cameroon,Colombia,0,4,4,0.0,1.0,1876,2040
2017-06-13,Canada,Curaçao,2,1,1,1.0,0.0,1749,1542
2017-06-13,Costa Rica,Trinidad and Tobago,2,1,1,1.0,0.0,1928,1718
2017-06-13,El Salvador,Ecuador,0,3,3,0.0,1.0,1698,1942
2017-06-13,France,England,3,2,1,1.0,0.0,2098,2060
2017-06-13,Hong Kong,North Korea,1,1,0,0.5,0.5,1617,1798
2017-06-13,India,Kyrgyzstan,1,0,1,1.0,0.0,1600,1519
2017-06-13,Indonesia,Puerto Rico,0,0,0,0.5,0.5,1648,1439
2017-06-13,Iraq,Japan,1,1,0,0.5,0.5,1795,1992
2017-06-13,Macau,Myanmar,0,4,4,0.0,1.0,1322,1549
2017-06-13,Malaysia,Lebanon,1,2,1,0.0,1.0,1573,1680
2017-06-13,Nepal,Yemen,0,0,0,0.5,0.5,1414,1558
2017-06-13,Norway,Sweden,1,1,0,0.5,0.5,1808,1946
2017-06-13,Palestine,Oman,2,1,1,1.0,0.0,1675,1784
2017-06-13,Panama,Honduras,2,2,0,0.5,0.5,1865,1828
2017-06-13,Papua New Guinea,Solomon Islands,1,2,1,0.0,1.0,1519,1620
2017-06-13,Qatar,South Korea,3,2,1,1.0,0.0,1836,1962
2017-06-13,Romania,Chile,3,2,1,1.0,0.0,1885,2044
2017-06-13,Singapore,Argentina,0,6,6,0.0,1.0,1567,2127
2017-06-13,South Africa,Zambia,1,2,1,0.0,1.0,1849,1733
2017-06-13,Syria,China PR,2,2,0,0.5,0.5,1785,1856
2017-06-13,Tajikistan,Philippines,3,4,1,0.0,1.0,1600,1607
2017-06-13,Thailand,United Arab Emirates,1,1,0,0.5,0.5,1768,1852
2017-06-13,Turkmenistan,Bahrain,1,2,1,0.0,1.0,1590,1766
2017-06-13,Vietnam,Jordan,0,0,0,0.5,0.5,1686,1781
2017-06-13,Peru,Jamaica,3,1,2,1.0,0.0,1946,1749
2017-06-17,Curaçao,Nicaragua,0,0,0,0.5,0.5,1541,1488
2017-06-17,French Guiana,Barbados,3,0,3,1.0,0.0,1589,1537
2017-06-17,Russia,New Zealand,2,0,2,1.0,0.0,1929,1769
2017-06-18,Cameroon,Chile,0,2,2,0.0,1.0,1872,2049
2017-06-18,Portugal,Mexico,2,2,0,0.5,0.5,2025,2034
2017-06-19,Australia,Germany,2,3,1,0.0,1.0,1938,2115
2017-06-21,Mexico,New Zealand,2,1,1,1.0,0.0,2037,1767
2017-06-21,Russia,Portugal,0,1,1,0.0,1.0,1924,2031
2017-06-22,Cameroon,Australia,1,1,0,0.5,0.5,1874,1937
2017-06-22,Germany,Chile,1,1,0,0.5,0.5,2114,2051
2017-06-22,Jamaica,French Guiana,1,1,0,0.5,0.5,1746,1593
2017-06-22,Martinique,Curaçao,1,2,1,0.0,1.0,1690,1553
2017-06-24,New Zealand,Portugal,0,4,4,0.0,1.0,1765,2034
2017-06-24,Russia,Mexico,1,2,1,0.0,1.0,1919,2043
2017-06-25,Chile,Australia,1,1,0,0.5,0.5,2049,1940
2017-06-25,Germany,Cameroon,3,1,2,1.0,0.0,2118,1871
2017-06-25,Jamaica,Curaçao,1,2,1,0.0,1.0,1734,1566
2017-06-25,Martinique,French Guiana,0,1,1,0.0,1.0,1680,1604
2017-06-25,Mauritius,Angola,0,1,1,0.0,1.0,1464,1658
2017-06-25,Tanzania,Malawi,2,0,2,1.0,0.0,1633,1633
2017-06-25,Menorca,Orkney,1,0,1,1.0,0.0,1557,1444
2017-06-25,Alderney,Jersey,0,3,3,0.0,1.0,1254,1735
2017-06-25,Gotland,Frøya,7,1,6,1.0,0.0,1494,1429
2017-06-25,Western Isles,Greenland,0,3,3,0.0,1.0,1502,1498
2017-06-25,Guernsey,Åland Islands,1,1,0,0.5,0.5,1746,1540
2017-06-25,Saare County,Shetland,4,5,1,0.0,1.0,1401,1517
2017-06-25,Isle of Man,Hitra,5,0,5,1.0,0.0,1589,1442
2017-06-25,Ynys Môn,Falkland Islands,3,0,3,1.0,0.0,1575,1429
2017-06-26,Madagascar,Seychelles,2,0,2,1.0,0.0,1591,1405
2017-06-26,Mozambique,Zimbabwe,0,4,4,0.0,1.0,1658,1722
2017-06-26,Jersey,Menorca,3,3,0,0.5,0.5,1732,1561
2017-06-26,Orkney,Alderney,3,0,3,1.0,0.0,1449,1250
2017-06-26,Gotland,Western Isles,8,0,8,1.0,0.0,1503,1494
2017-06-26,Frøya,Greenland,2,2,0,0.5,0.5,1431,1497
2017-06-26,Shetland,Guernsey,0,3,3,0.0,1.0,1514,1750
2017-06-26,Åland Islands,Saare County,0,0,0,0.5,0.5,1537,1405
2017-06-26,Falkland Islands,Isle of Man,2,5,3,0.0,1.0,1425,1594
2017-06-26,Hitra,Ynys Môn,1,5,4,0.0,1.0,1437,1581
2017-06-27,Angola,Tanzania,0,0,0,0.5,0.5,1658,1634
2017-06-27,Malawi,Mauritius,0,0,0,0.5,0.5,1630,1468
2017-06-27,Menorca,Alderney,6,0,6,1.0,0.0,1564,1248
2017-06-27,Orkney,Jersey,0,3,3,0.0,1.0,1447,1735
2017-06-27,Gotland,Greenland,0,1,1,0.0,1.0,1495,1506
2017-06-27,Frøya,Western Isles,2,4,2,0.0,1.0,1425,1501
2017-06-27,Guernsey,Saare County,1,1,0,0.5,0.5,1744,1412
2017-06-27,Åland Islands,Shetland,2,1,1,1.0,0.0,1545,1507
2017-06-27,Isle of Man,Ynys Môn,4,0,4,1.0,0.0,1602,1574
2017-06-27,Hitra,Falkland Islands,2,1,1,1.0,0.0,1445,1418
2017-06-28,Portugal,Chile,0,0,0,0.5,0.5,2035,2049
2017-06-28,Seychelles,Mozambique,1,2,1,0.0,1.0,1402,1662
2017-06-28,Saint Lucia,Saint Vincent and the Grenadines,2,1,1,1.0,0.0,1477,1537
2017-06-28,Zimbabwe,Madagascar,0,0,0,0.5,0.5,1720,1594
2017-06-29,Germany,Mexico,4,1,3,1.0,0.0,2125,2037
2017-06-29,Malawi,Angola,0,0,0,0.5,0.5,1631,1658
2017-06-29,Tanzania,Mauritius,1,1,0,0.5,0.5,1631,1472
2017-06-29,Falkland Islands,Alderney,0,3,3,0.0,1.0,1407,1260
2017-06-29,Saare County,Frøya,4,2,2,1.0,0.0,1421,1417
2017-06-29,Hitra,Western Isles,1,1,0,0.5,0.5,1447,1500
2017-06-29,Orkney,Shetland,3,1,2,1.0,0.0,1457,1498
2017-06-29,Ynys Môn,Åland Islands,0,2,2,0.0,1.0,1566,1554
2017-06-29,Gotland,Jersey,2,3,1,0.0,1.0,1492,1739
2017-06-29,Greenland,Menorca,1,1,0,0.5,0.5,1508,1563
2017-06-29,Guernsey,Isle of Man,3,4,1,0.0,1.0,1733,1614
2017-06-30,Dominica,Barbados,2,1,1,1.0,0.0,1436,1527
2017-06-30,Mozambique,Madagascar,1,4,3,0.0,1.0,1653,1604
2017-06-30,Zimbabwe,Seychelles,6,0,6,1.0,0.0,1723,1400
2017-06-30,Menorca,Guernsey,0,1,1,0.0,1.0,1559,1738
2017-06-30,Greenland,Isle of Man,0,6,6,0.0,1.0,1503,1620
2017-07-01,Botswana,Zambia,1,2,1,0.0,1.0,1618,1739
2017-07-01,Gambia,Guinea-Bissau,0,0,0,0.5,0.5,1573,1555
2017-07-01,Mexico,Paraguay,2,1,1,1.0,0.0,2042,1879
2017-07-01,Namibia,Lesotho,0,0,0,0.5,0.5,1619,1535
2017-07-01,United States,Ghana,2,1,1,1.0,0.0,1985,1838
2017-07-02,Chile,Germany,0,1,1,0.0,1.0,2043,2132
2017-07-02,Portugal,Mexico,2,1,1,1.0,0.0,2044,2034
2017-07-02,South Africa,Tanzania,0,1,1,0.0,1.0,1837,1644
2017-07-02,Eswatini,Zimbabwe,1,2,1,0.0,1.0,1562,1728
2017-07-03,Barbados,Saint Lucia,1,1,0,0.5,0.5,1526,1479
2017-07-03,Grenada,Saint Vincent and the Grenadines,4,3,1,1.0,0.0,1513,1529
2017-07-04,Namibia,Eswatini,1,0,1,1.0,0.0,1626,1556
2017-07-04,South Africa,Botswana,2,0,2,1.0,0.0,1841,1615
2017-07-04,Saint Lucia,Dominica,0,0,0,0.5,0.5,1479,1437
2017-07-04,Saint Vincent and the Grenadines,Barbados,4,2,2,1.0,0.0,1537,1519
2017-07-05,Lesotho,Zimbabwe,3,4,1,0.0,1.0,1532,1732
2017-07-05,Zambia,Tanzania,4,2,2,1.0,0.0,1745,1639
2017-07-06,Dominica,Saint Vincent and the Grenadines,2,2,0,0.5,0.5,1440,1535
2017-07-06,Grenada,Barbados,0,2,2,0.0,1.0,1506,1527
2017-07-07,French Guiana,Canada,2,4,2,0.0,1.0,1600,1754
2017-07-07,Honduras,Costa Rica,0,1,1,0.0,1.0,1823,1934
2017-07-07,South Africa,Namibia,1,0,1,1.0,0.0,1845,1623
2017-07-07,Tanzania,Lesotho,0,0,0,0.5,0.5,1637,1535
2017-07-08,Guinea-Bissau,Gambia,0,1,1,0.0,1.0,1548,1581
2017-07-08,Martinique,Nicaragua,2,0,2,1.0,0.0,1684,1485
2017-07-08,United States,Panama,1,1,0,0.5,0.5,1983,1868
2017-07-09,Curaçao,Jamaica,0,2,2,0.0,1.0,1562,1739
2017-07-09,Mexico,El Salvador,3,1,2,1.0,0.0,2037,1696
2017-07-09,Zambia,Zimbabwe,1,3,2,0.0,1.0,1737,1741
2017-07-11,Costa Rica,Canada,1,1,0,0.5,0.5,1931,1758
2017-07-11,Honduras,French Guiana,0,0,0,0.5,0.5,1819,1605
2017-07-12,Panama,Nicaragua,2,1,1,1.0,0.0,1870,1484
2017-07-12,United States,Martinique,3,2,1,1.0,0.0,1986,1682
2017-07-13,El Salvador,Curaçao,2,0,2,1.0,0.0,1702,1557
2017-07-13,Mexico,Jamaica,0,0,0,0.5,0.5,2032,1745
2017-07-14,Canada,Honduras,0,0,0,0.5,0.5,1760,1818
2017-07-14,Costa Rica,French Guiana,3,0,3,1.0,0.0,1934,1603
2017-07-14,Thailand,North Korea,3,0,3,1.0,0.0,1777,1790
2017-07-15,Panama,Martinique,3,0,3,1.0,0.0,1875,1678
2017-07-15,United States,Nicaragua,3,0,3,1.0,0.0,1987,1484
2017-07-16,Burkina Faso,North Korea,3,3,0,0.5,0.5,1746,1789
2017-07-16,Curaçao,Mexico,0,2,2,0.0,1.0,1557,2033
2017-07-16,Jamaica,El Salvador,1,1,0,0.5,0.5,1745,1703
2017-07-16,Thailand,Belarus,0,0,0,0.5,0.5,1778,1778
2017-07-19,Costa Rica,Panama,1,0,1,1.0,0.0,1941,1869
2017-07-19,United States,El Salvador,2,0,2,1.0,0.0,1990,1701
2017-07-20,Jamaica,Canada,2,1,1,1.0,0.0,1754,1752
2017-07-20,Mexico,Honduras,1,0,1,1.0,0.0,2037,1815
2017-07-22,United States,Costa Rica,2,0,2,1.0,0.0,1997,1935
2017-07-23,Mexico,Jamaica,0,1,1,0.0,1.0,2024,1768
2017-07-26,Ecuador,Trinidad and Tobago,3,1,2,1.0,0.0,1946,1715
2017-07-26,United States,Jamaica,2,1,1,1.0,0.0,2001,1765
2017-08-05,Zambia,Ethiopia,0,0,0,0.5,0.5,1735,1632
2017-08-07,Rwanda,Sudan,2,1,1,1.0,0.0,1627,1589
2017-08-16,Andorra,Qatar,0,1,1,0.0,1.0,1354,1837
2017-08-19,India,Mauritius,2,1,1,1.0,0.0,1606,1467
2017-08-22,Malaysia,Syria,1,2,1,0.0,1.0,1570,1789
2017-08-22,Mauritius,Saint Kitts and Nevis,1,1,0,0.5,0.5,1470,1598
2017-08-23,Qatar,Turkmenistan,2,1,1,1.0,0.0,1841,1587
2017-08-24,India,Saint Kitts and Nevis,1,1,0,0.5,0.5,1606,1599
2017-08-24,Trinidad and Tobago,Jamaica,1,2,1,0.0,1.0,1709,1772
2017-08-26,Iraq,Syria,1,1,0,0.5,0.5,1795,1790
2017-08-29,Bahrain,Jordan,0,0,0,0.5,0.5,1767,1781
2017-08-29,Myanmar,Malaysia,1,0,1,1.0,0.0,1558,1562
2017-08-29,United Arab Emirates,Saudi Arabia,2,1,1,1.0,0.0,1861,1851
2017-08-30,Oman,Afghanistan,2,0,2,1.0,0.0,1787,1495
2017-08-31,Belgium,Gibraltar,9,0,9,1.0,0.0,2008,1539
2017-08-31,Brazil,Ecuador,2,0,2,1.0,0.0,2197,1943
2017-08-31,Bulgaria,Sweden,3,2,1,1.0,0.0,1821,1936
2017-08-31,Chile,Paraguay,0,3,3,0.0,1.0,2032,1891
2017-08-31,China PR,Uzbekistan,1,0,1,1.0,0.0,1865,1867
2017-08-31,Cyprus,Bosnia and Herzegovina,3,2,1,1.0,0.0,1667,1868
2017-08-31,France,Netherlands,4,0,4,1.0,0.0,2105,2018
2017-08-31,Greece,Estonia,0,0,0,0.5,0.5,1872,1725
2017-08-31,Guinea,Libya,3,2,1,1.0,0.0,1789,1713
2017-08-31,Hungary,Latvia,3,1,2,1.0,0.0,1833,1640
2017-08-31,Japan,Australia,2,0,2,1.0,0.0,1999,1934
2017-08-31,Kenya,Mauritania,1,1,0,0.5,0.5,1676,1564
2017-08-31,South Korea,Iran,0,0,0,0.5,0.5,1963,1982
2017-08-31,Luxembourg,Belarus,1,0,1,1.0,0.0,1513,1765
2017-08-31,Niger,Togo,0,2,2,0.0,1.0,1577,1675
2017-08-31,Peru,Bolivia,2,1,1,1.0,0.0,1951,1759
2017-08-31,Portugal,Faroe Islands,5,1,4,1.0,0.0,2045,1489
2017-08-31,Singapore,Hong Kong,1,1,0,0.5,0.5,1569,1616
2017-08-31,Switzerland,Andorra,3,0,3,1.0,0.0,1961,1354
2017-08-31,Syria,Qatar,3,1,2,1.0,0.0,1800,1832
2017-08-31,Thailand,Iraq,1,2,1,0.0,1.0,1771,1803
2017-08-31,Uganda,Egypt,1,0,1,1.0,0.0,1754,1902
2017-08-31,Uruguay,Argentina,0,0,0,0.5,0.5,1996,2125
2017-08-31,Venezuela,Colombia,0,0,0,0.5,0.5,1840,2036
2017-08-31,Abkhazia,Donetsk PR,1,2,1,0.0,1.0,1539,1505
2017-09-01,Cape Verde,South Africa,2,1,1,1.0,0.0,1702,1834
2017-09-01,Czech Republic,Germany,1,2,1,0.0,1.0,1892,2136
2017-09-01,Denmark,Poland,4,0,4,1.0,0.0,1912,1960
2017-09-01,Ghana,Congo,1,1,0,0.5,0.5,1835,1664
2017-09-01,Kazakhstan,Montenegro,0,3,3,0.0,1.0,1609,1729
2017-09-01,Lithuania,Scotland,0,3,3,0.0,1.0,1634,1879
2017-09-01,Malta,England,0,4,4,0.0,1.0,1502,2061
2017-09-01,Mexico,Panama,1,0,1,1.0,0.0,2029,1865
2017-09-01,Morocco,Mali,6,0,6,1.0,0.0,1827,1738
2017-09-01,New Zealand,Solomon Islands,6,1,5,1.0,0.0,1770,1616
2017-09-01,Nigeria,Cameroon,4,0,4,1.0,0.0,1875,1863
2017-09-01,Norway,Azerbaijan,2,0,2,1.0,0.0,1813,1642
2017-09-01,Romania,Armenia,1,0,1,1.0,0.0,1889,1670
2017-09-01,San Marino,Northern Ireland,0,3,3,0.0,1.0,1318,1787
2017-09-01,Slovakia,Slovenia,1,0,1,1.0,0.0,1898,1786
2017-09-01,Trinidad and Tobago,Honduras,1,2,1,0.0,1.0,1704,1821
2017-09-01,Tunisia,DR Congo,2,1,1,1.0,0.0,1841,1761
2017-09-01,United States,Costa Rica,0,2,2,0.0,1.0,1992,1945
2017-09-02,Albania,Liechtenstein,2,0,2,1.0,0.0,1751,1435
2017-09-02,Canada,Jamaica,2,0,2,1.0,0.0,1761,1764
2017-09-02,Croatia,Kosovo,1,0,1,1.0,0.0,2002,1544
2017-09-02,Finland,Iceland,1,0,1,1.0,0.0,1760,1829
2017-09-02,Gabon,Ivory Coast,0,3,3,0.0,1.0,1697,1909
2017-09-02,Georgia,Republic of Ireland,1,1,0,0.5,0.5,1693,1934
2017-09-02,Indonesia,Fiji,0,0,0,0.5,0.5,1649,1660
2017-09-02,Israel,North Macedonia,0,1,1,0.0,1.0,1764,1704
2017-09-02,Mozambique,Kenya,1,1,0,0.5,0.5,1654,1676
2017-09-02,Senegal,Burkina Faso,0,0,0,0.5,0.5,1886,1750
2017-09-02,Serbia,Moldova,3,0,3,1.0,0.0,1879,1583
2017-09-02,Spain,Italy,3,0,3,1.0,0.0,2151,2047
2017-09-02,Ukraine,Turkey,2,0,2,1.0,0.0,1943,1933
2017-09-02,Wales,Austria,1,0,1,1.0,0.0,1845,1841
2017-09-02,Zambia,Algeria,3,1,2,1.0,0.0,1746,1844
2017-09-03,Belarus,Sweden,0,4,4,0.0,1.0,1761,1941
2017-09-03,Equatorial Guinea,Benin,1,2,1,0.0,1.0,1562,1641
2017-09-03,Estonia,Cyprus,1,0,1,1.0,0.0,1732,1661
2017-09-03,Faroe Islands,Andorra,1,0,1,1.0,0.0,1495,1349
2017-09-03,France,Luxembourg,0,0,0,0.5,0.5,2098,1521
2017-09-03,Gibraltar,Bosnia and Herzegovina,0,4,4,0.0,1.0,1537,1871
2017-09-03,Greece,Belgium,1,2,1,0.0,1.0,1867,2014
2017-09-03,Hungary,Portugal,0,1,1,0.0,1.0,1830,2049
2017-09-03,Latvia,Switzerland,0,3,3,0.0,1.0,1638,1964
2017-09-03,Netherlands,Bulgaria,3,1,2,1.0,0.0,2022,1818
2017-09-04,Armenia,Denmark,1,4,3,0.0,1.0,1667,1916
2017-09-04,Azerbaijan,San Marino,5,1,4,1.0,0.0,1645,1316
2017-09-04,Cameroon,Nigeria,1,1,0,0.5,0.5,1864,1875
2017-09-04,England,Slovakia,2,1,1,1.0,0.0,2066,1894
2017-09-04,Germany,Norway,6,0,6,1.0,0.0,2139,1811
2017-09-04,Libya,Guinea,1,0,1,1.0,0.0,1723,1780
2017-09-04,Malawi,Togo,1,0,1,1.0,0.0,1641,1666
2017-09-04,Montenegro,Romania,1,0,1,1.0,0.0,1741,1878
2017-09-04,Northern Ireland,Czech Republic,2,0,2,1.0,0.0,1798,1882
2017-09-04,Poland,Kazakhstan,3,0,3,1.0,0.0,1962,1608
2017-09-04,Scotland,Malta,2,0,2,1.0,0.0,1881,1501
2017-09-04,Slovenia,Lithuania,4,0,4,1.0,0.0,1791,1630
2017-09-05,Algeria,Zambia,0,1,1,0.0,1.0,1834,1757
2017-09-05,Argentina,Venezuela,1,1,0,0.5,0.5,2120,1846
2017-09-05,Australia,Thailand,2,1,1,1.0,0.0,1939,1767
2017-09-05,Austria,Georgia,1,1,0,0.5,0.5,1838,1697
2017-09-05,Bahrain,Taiwan,5,0,5,1.0,0.0,1769,1413
2017-09-05,Bhutan,Palestine,0,2,2,0.0,1.0,1264,1677
2017-09-05,Bolivia,Chile,1,0,1,1.0,0.0,1773,2019
2017-09-05,Burkina Faso,Senegal,2,2,0,0.5,0.5,1753,1884
2017-09-05,Cambodia,Vietnam,1,2,1,0.0,1.0,1368,1689
2017-09-05,Colombia,Brazil,1,1,0,0.5,0.5,2040,2194
2017-09-05,Congo,Ghana,1,5,4,0.0,1.0,1660,1840
2017-09-05,DR Congo,Tunisia,2,2,0,0.5,0.5,1763,1840
2017-09-05,Costa Rica,Mexico,1,1,0,0.5,0.5,1947,2028
2017-09-05,Ecuador,Peru,1,2,1,0.0,1.0,1936,1959
2017-09-05,Egypt,Uganda,1,0,1,1.0,0.0,1907,1750
2017-09-05,Honduras,United States,1,1,0,0.5,0.5,1825,1989
2017-09-05,Iceland,Ukraine,2,0,2,1.0,0.0,1840,1933
2017-09-05,Iran,Syria,2,2,0,0.5,0.5,1979,1804
2017-09-05,Iraq,United Arab Emirates,1,0,1,1.0,0.0,1813,1852
2017-09-05,Republic of Ireland,Serbia,0,1,1,0.0,1.0,1925,1889
2017-09-05,Italy,Israel,1,0,1,1.0,0.0,2050,1762
2017-09-05,Ivory Coast,Gabon,1,2,1,0.0,1.0,1897,1710
2017-09-05,Jordan,Afghanistan,4,1,3,1.0,0.0,1784,1493
2017-09-05,North Korea,Lebanon,2,2,0,0.5,0.5,1787,1683
2017-09-05,Kosovo,Finland,0,1,1,0.0,1.0,1541,1764
2017-09-05,Liechtenstein,Spain,0,8,8,0.0,1.0,1435,2152
2017-09-05,Macau,India,0,2,2,0.0,1.0,1320,1609
2017-09-05,North Macedonia,Albania,1,1,0,0.5,0.5,1706,1750
2017-09-05,Malaysia,Hong Kong,1,1,0,0.5,0.5,1564,1615
2017-09-05,Mali,Morocco,0,0,0,0.5,0.5,1741,1825
2017-09-05,Mauritania,Niger,0,2,2,0.0,1.0,1557,1585
2017-09-05,Moldova,Wales,0,2,2,0.0,1.0,1581,1848
2017-09-05,Nepal,Tajikistan,1,2,1,0.0,1.0,1410,1605
2017-09-05,Oman,Maldives,5,0,5,1.0,0.0,1790,1454
2017-09-05,Panama,Trinidad and Tobago,3,0,3,1.0,0.0,1870,1700
2017-09-05,Paraguay,Uruguay,1,2,1,0.0,1.0,1886,2002
2017-09-05,Philippines,Yemen,2,2,0,0.5,0.5,1606,1560
2017-09-05,Qatar,China PR,1,2,1,0.0,1.0,1825,1873
2017-09-05,Saudi Arabia,Japan,1,0,1,1.0,0.0,1863,1988
2017-09-05,Singapore,Turkmenistan,1,1,0,0.5,0.5,1570,1587
2017-09-05,Solomon Islands,New Zealand,2,2,0,0.5,0.5,1620,1767
2017-09-05,South Africa,Cape Verde,1,2,1,0.0,1.0,1824,1713
2017-09-05,Turkey,Croatia,1,0,1,1.0,0.0,1943,1993
2017-09-05,Uzbekistan,South Korea,0,0,0,0.5,0.5,1870,1961
2017-10-02,Macau,Laos,3,1,2,1.0,0.0,1330,1386
2017-10-05,Argentina,Peru,0,0,0,0.5,0.5,2117,1963
2017-10-05,Armenia,Poland,1,6,5,0.0,1.0,1665,1965
2017-10-05,Azerbaijan,Czech Republic,1,2,1,0.0,1.0,1642,1886
2017-10-05,Bolivia,Brazil,0,0,0,0.5,0.5,1780,2188
2017-10-05,Myanmar,Thailand,1,3,2,0.0,1.0,1555,1771
2017-10-05,Chile,Ecuador,2,1,1,1.0,0.0,2026,1930
2017-10-05,Colombia,Paraguay,1,2,1,0.0,1.0,2029,1898
2017-10-05,England,Slovenia,1,0,1,1.0,0.0,2069,1789
2017-10-05,Hong Kong,Laos,4,0,4,1.0,0.0,1619,1383
2017-10-05,Iran,Togo,2,0,2,1.0,0.0,1982,1664
2017-10-05,Iraq,Kenya,2,1,1,1.0,0.0,1818,1672
2017-10-05,Malta,Lithuania,1,1,0,0.5,0.5,1504,1628
2017-10-05,Montenegro,Denmark,0,1,1,0.0,1.0,1737,1921
2017-10-05,Northern Ireland,Germany,1,3,2,0.0,1.0,1797,2141
2017-10-05,Qatar,Singapore,3,1,2,1.0,0.0,1828,1568
2017-10-05,Romania,Kazakhstan,3,1,2,1.0,0.0,1881,1606
2017-10-05,San Marino,Norway,0,8,8,0.0,1.0,1316,1812
2017-10-05,Scotland,Slovakia,1,0,1,1.0,0.0,1890,1886
2017-10-05,Syria,Australia,1,1,0,0.5,0.5,1807,1937
2017-10-05,Taiwan,Mongolia,4,2,2,1.0,0.0,1421,1394
2017-10-05,Venezuela,Uruguay,0,0,0,0.5,0.5,1850,1999
2017-10-06,Austria,Serbia,3,2,1,1.0,0.0,1848,1880
2017-10-06,Croatia,Finland,1,1,0,0.5,0.5,1989,1769
2017-10-06,Georgia,Wales,0,1,1,0.0,1.0,1693,1853
2017-10-06,Republic of Ireland,Moldova,2,0,2,1.0,0.0,1927,1580
2017-10-06,Italy,North Macedonia,1,1,0,0.5,0.5,2044,1713
2017-10-06,Japan,New Zealand,2,1,1,1.0,0.0,1992,1764
2017-10-06,Kosovo,Ukraine,0,2,2,0.0,1.0,1540,1935
2017-10-06,Liechtenstein,Israel,0,1,1,0.0,1.0,1433,1765
2017-10-06,Mali,Ivory Coast,0,0,0,0.5,0.5,1745,1894
2017-10-06,Mauritania,Comoros,0,1,1,0.0,1.0,1547,1434
2017-10-06,Mexico,Trinidad and Tobago,3,1,2,1.0,0.0,2031,1698
2017-10-06,Spain,Albania,3,0,3,1.0,0.0,2154,1749
2017-10-06,Turkey,Iceland,0,3,3,0.0,1.0,1933,1851
2017-10-06,United States,Panama,4,0,4,1.0,0.0,1995,1865
2017-10-07,Andorra,Portugal,0,2,2,0.0,1.0,1349,2050
2017-10-07,Belarus,Netherlands,1,3,2,0.0,1.0,1759,2025
2017-10-07,Bosnia and Herzegovina,Belgium,3,4,1,0.0,1.0,1867,2019
2017-10-07,Bulgaria,France,0,1,1,0.0,1.0,1816,2101
2017-10-07,Cameroon,Algeria,2,0,2,1.0,0.0,1872,1827
2017-10-07,Cape Verde,Senegal,0,2,2,0.0,1.0,1709,1889
2017-10-07,Costa Rica,Honduras,1,1,0,0.5,0.5,1945,1828
2017-10-07,Cyprus,Greece,1,2,1,0.0,1.0,1658,1871
2017-10-07,Faroe Islands,Latvia,0,0,0,0.5,0.5,1499,1635
2017-10-07,Gibraltar,Estonia,0,6,6,0.0,1.0,1534,1736
2017-10-07,Grenada,Guyana,1,0,1,1.0,0.0,1517,1589
2017-10-07,Guinea,Tunisia,1,4,3,0.0,1.0,1774,1847
2017-10-07,Libya,DR Congo,1,2,1,0.0,1.0,1716,1771
2017-10-07,Morocco,Gabon,3,0,3,1.0,0.0,1831,1705
2017-10-07,Nigeria,Zambia,1,0,1,1.0,0.0,1881,1752
2017-10-07,Russia,South Korea,4,2,2,1.0,0.0,1928,1953
2017-10-07,Saudi Arabia,Jamaica,5,2,3,1.0,0.0,1869,1759
2017-10-07,South Africa,Burkina Faso,3,1,2,1.0,0.0,1831,1747
2017-10-07,Sweden,Luxembourg,8,0,8,1.0,0.0,1943,1520
2017-10-07,Switzerland,Hungary,5,2,3,1.0,0.0,1970,1825
2017-10-07,Tanzania,Malawi,1,1,0,0.5,0.5,1638,1641
2017-10-07,Uganda,Ghana,0,0,0,0.5,0.5,1753,1838
2017-10-08,Czech Republic,San Marino,5,0,5,1.0,0.0,1887,1316
2017-10-08,Denmark,Romania,1,1,0,0.5,0.5,1921,1882
2017-10-08,Egypt,Congo,2,1,1,1.0,0.0,1911,1657
2017-10-08,El Salvador,Canada,1,0,1,1.0,0.0,1711,1752
2017-10-08,Germany,Azerbaijan,5,1,4,1.0,0.0,2142,1642
2017-10-08,Kazakhstan,Armenia,1,1,0,0.5,0.5,1608,1664
2017-10-08,Lithuania,England,0,1,1,0.0,1.0,1627,2071
2017-10-08,Norway,Northern Ireland,1,0,1,1.0,0.0,1820,1790
2017-10-08,Poland,Montenegro,4,2,2,1.0,0.0,1969,1734
2017-10-08,Slovakia,Malta,3,0,3,1.0,0.0,1888,1503
2017-10-08,Slovenia,Scotland,2,2,0,0.5,0.5,1792,1888
2017-10-08,Thailand,Kenya,1,0,1,1.0,0.0,1777,1667
2017-10-09,Albania,Italy,0,1,1,0.0,1.0,1747,2047
2017-10-09,Equatorial Guinea,Mauritius,3,1,2,1.0,0.0,1568,1465
2017-10-09,Finland,Turkey,2,2,0,0.5,0.5,1773,1930
2017-10-09,Iceland,Kosovo,2,0,2,1.0,0.0,1854,1538
2017-10-09,Israel,Spain,0,1,1,0.0,1.0,1764,2156
2017-10-09,North Macedonia,Liechtenstein,4,0,4,1.0,0.0,1716,1431
2017-10-09,Moldova,Austria,0,1,1,0.0,1.0,1578,1851
2017-10-09,Serbia,Georgia,1,0,1,1.0,0.0,1885,1689
2017-10-09,Ukraine,Croatia,0,2,2,0.0,1.0,1929,1996
2017-10-09,Wales,Republic of Ireland,0,1,1,0.0,1.0,1847,1934
2017-10-10,Afghanistan,Jordan,3,3,0,0.5,0.5,1499,1779
2017-10-10,Australia,Syria,2,1,1,1.0,0.0,1943,1802
2017-10-10,Belgium,Cyprus,4,0,4,1.0,0.0,2021,1657
2017-10-10,Benin,Gabon,1,0,1,1.0,0.0,1651,1696
2017-10-10,Brazil,Chile,3,0,3,1.0,0.0,2193,2022
2017-10-10,Myanmar,Kyrgyzstan,2,2,0,0.5,0.5,1555,1520
2017-10-10,Ecuador,Argentina,1,3,2,0.0,1.0,1926,2122
2017-10-10,Estonia,Bosnia and Herzegovina,1,2,1,0.0,1.0,1731,1873
2017-10-10,France,Belarus,2,1,1,1.0,0.0,2103,1758
2017-10-10,Greece,Gibraltar,4,0,4,1.0,0.0,1874,1532
2017-10-10,Honduras,Mexico,3,2,1,1.0,0.0,1841,2019
2017-10-10,Hong Kong,Malaysia,2,0,2,1.0,0.0,1626,1558
2017-10-10,Hungary,Faroe Islands,1,0,1,1.0,0.0,1828,1497
2017-10-10,Japan,Haiti,3,3,0,0.5,0.5,1987,1722
2017-10-10,South Korea,Morocco,1,3,2,0.0,1.0,1943,1842
2017-10-10,Latvia,Andorra,4,0,4,1.0,0.0,1638,1347
2017-10-10,Lebanon,North Korea,5,0,5,1.0,0.0,1694,1777
2017-10-10,Luxembourg,Bulgaria,1,1,0,0.5,0.5,1526,1811
2017-10-10,Maldives,Oman,1,3,2,0.0,1.0,1452,1793
2017-10-10,Netherlands,Sweden,2,0,2,1.0,0.0,2032,1937
2017-10-10,Palestine,Bhutan,10,0,10,1.0,0.0,1679,1263
2017-10-10,Panama,Costa Rica,2,1,1,1.0,0.0,1875,1936
2017-10-10,Paraguay,Venezuela,0,1,1,0.0,1.0,1889,1860
2017-10-10,Peru,Colombia,1,1,0,0.5,0.5,1965,2028
2017-10-10,Portugal,Switzerland,2,0,2,1.0,0.0,2057,1964
2017-10-10,Qatar,Curaçao,1,2,1,0.0,1.0,1815,1571
2017-10-10,Russia,Iran,1,1,0,0.5,0.5,1930,1981
2017-10-10,Saudi Arabia,Ghana,0,3,3,0.0,1.0,1861,1847
2017-10-10,Taiwan,Bahrain,2,1,1,1.0,0.0,1436,1755
2017-10-10,Tajikistan,Nepal,3,0,3,1.0,0.0,1609,1407
2017-10-10,Trinidad and Tobago,United States,2,1,1,1.0,0.0,1712,1982
2017-10-10,Turkmenistan,Singapore,2,1,1,1.0,0.0,1595,1561
2017-10-10,Uruguay,Bolivia,4,2,2,1.0,0.0,2003,1777
2017-10-10,Vietnam,Cambodia,5,0,5,1.0,0.0,1692,1366
2017-10-10,Yemen,Philippines,1,1,0,0.5,0.5,1562,1605
2017-10-11,India,Macau,4,1,3,1.0,0.0,1612,1328
2017-10-24,Grenada,Panama,0,5,5,0.0,1.0,1516,1877
2017-10-28,Bermuda,Barbados,2,3,1,0.0,1.0,1569,1537
2017-11-08,Congo,Benin,1,1,0,0.5,0.5,1657,1652
2017-11-08,Iceland,Czech Republic,1,2,1,0.0,1.0,1847,1895
2017-11-08,Nicaragua,Dominican Republic,0,3,3,0.0,1.0,1478,1548
2017-11-09,Armenia,Belarus,4,1,3,1.0,0.0,1675,1748
2017-11-09,Cambodia,Myanmar,1,2,1,0.0,1.0,1362,1560
2017-11-09,Croatia,Greece,4,1,3,1.0,0.0,2002,1869
2017-11-09,Finland,Estonia,3,0,3,1.0,0.0,1781,1724
2017-11-09,Hong Kong,Bahrain,0,2,2,0.0,1.0,1621,1761
2017-11-09,Iran,Panama,2,1,1,1.0,0.0,1987,1872
2017-11-09,Luxembourg,Hungary,2,1,1,1.0,0.0,1540,1815
2017-11-09,Northern Ireland,Switzerland,0,1,1,0.0,1.0,1786,1969
2017-11-09,Romania,Turkey,2,0,2,1.0,0.0,1892,1921
2017-11-09,Scotland,Netherlands,0,1,1,0.0,1.0,1884,2037
2017-11-09,Singapore,Lebanon,0,1,1,0.0,1.0,1556,1700
2017-11-10,Algeria,Nigeria,3,0,3,1.0,0.0,1837,1872
2017-11-10,Belgium,Mexico,3,3,0,0.5,0.5,2021,2020
2017-11-10,China PR,Serbia,0,2,2,0.0,1.0,1866,1893
2017-11-10,England,Germany,0,0,0,0.5,0.5,2073,2141
2017-11-10,France,Wales,2,0,2,1.0,0.0,2106,1845
2017-11-10,Georgia,Cyprus,1,0,1,1.0,0.0,1697,1650
2017-11-10,Honduras,Australia,0,0,0,0.5,0.5,1844,1941
2017-11-10,Japan,Brazil,1,3,2,0.0,1.0,1984,2197
2017-11-10,North Korea,Malaysia,4,1,3,1.0,0.0,1781,1555
2017-11-10,South Korea,Colombia,2,1,1,1.0,0.0,1953,2019
2017-11-10,Poland,Uruguay,0,0,0,0.5,0.5,1970,2003
2017-11-10,Portugal,Saudi Arabia,3,0,3,1.0,0.0,2061,1858
2017-11-10,South Africa,Senegal,0,2,2,0.0,1.0,1825,1896
2017-11-10,Sweden,Italy,1,0,1,1.0,0.0,1948,2037
2017-11-10,Ukraine,Slovakia,2,1,1,1.0,0.0,1937,1881
2017-11-11,Comoros,Madagascar,1,1,0,0.5,0.5,1438,1601
2017-11-11,DR Congo,Guinea,3,1,2,1.0,0.0,1780,1766
2017-11-11,Denmark,Republic of Ireland,0,0,0,0.5,0.5,1922,1934
2017-11-11,Dominican Republic,Nicaragua,1,0,1,1.0,0.0,1555,1472
2017-11-11,Gabon,Mali,0,0,0,0.5,0.5,1698,1744
2017-11-11,Ivory Coast,Morocco,0,2,2,0.0,1.0,1885,1852
2017-11-11,North Macedonia,Norway,2,0,2,1.0,0.0,1727,1810
2017-11-11,Malawi,Lesotho,1,1,0,0.5,0.5,1639,1538
2017-11-11,Namibia,Zimbabwe,3,1,2,1.0,0.0,1634,1731
2017-11-11,New Zealand,Peru,0,0,0,0.5,0.5,1769,1961
2017-11-11,Qatar,Czech Republic,0,1,1,0.0,1.0,1809,1902
2017-11-11,Russia,Argentina,0,1,1,0.0,1.0,1927,2126
2017-11-11,Spain,Costa Rica,5,0,5,1.0,0.0,2160,1933
2017-11-11,Trinidad and Tobago,Grenada,2,2,0,0.5,0.5,1708,1521
2017-11-11,Tunisia,Libya,0,0,0,0.5,0.5,1845,1719
2017-11-11,Zambia,Cameroon,2,2,0,0.5,0.5,1755,1870
2017-11-12,Benin,Tanzania,1,1,0,0.5,0.5,1652,1639
2017-11-12,Congo,Uganda,1,1,0,0.5,0.5,1660,1751
2017-11-12,Ghana,Egypt,1,1,0,0.5,0.5,1849,1910
2017-11-12,Greece,Croatia,0,0,0,0.5,0.5,1872,2000
2017-11-12,Malta,Estonia,0,3,3,0.0,1.0,1500,1728
2017-11-12,Switzerland,Northern Ireland,0,0,0,0.5,0.5,1966,1790
2017-11-12,Togo,Mauritius,6,0,6,1.0,0.0,1668,1462
2017-11-13,Armenia,Cyprus,3,2,1,1.0,0.0,1683,1643
2017-11-13,Bulgaria,Saudi Arabia,1,0,1,1.0,0.0,1821,1849
2017-11-13,Georgia,Belarus,2,2,0,0.5,0.5,1699,1747
2017-11-13,Iran,Venezuela,1,0,1,1.0,0.0,1993,1855
2017-11-13,Iraq,Syria,1,1,0,0.5,0.5,1818,1803
2017-11-13,Italy,Sweden,0,0,0,0.5,0.5,2035,1951
2017-11-13,Kosovo,Latvia,4,3,1,1.0,0.0,1549,1628
2017-11-13,Malaysia,North Korea,1,4,3,0.0,1.0,1552,1785
2017-11-13,Poland,Mexico,0,1,1,0.0,1.0,1964,2027
2017-11-13,Turkey,Albania,2,3,1,0.0,1.0,1910,1759
2017-11-14,Algeria,Central African Republic,3,0,3,1.0,0.0,1840,1513
2017-11-14,Argentina,Nigeria,2,4,2,0.0,1.0,2114,1885
2017-11-14,Austria,Uruguay,2,1,1,1.0,0.0,1863,1992
2017-11-14,Belgium,Japan,1,0,1,1.0,0.0,2029,1977
2017-11-14,Bhutan,Oman,2,4,2,0.0,1.0,1263,1794
2017-11-14,Burkina Faso,Cape Verde,4,0,4,1.0,0.0,1755,1702
2017-11-14,Cambodia,Jordan,0,1,1,0.0,1.0,1361,1781
2017-11-14,China PR,Colombia,0,4,4,0.0,1.0,1862,2024
2017-11-14,England,Brazil,0,0,0,0.5,0.5,2076,2195
2017-11-14,Gabon,Botswana,0,0,0,0.5,0.5,1697,1617
2017-11-14,Germany,France,2,2,0,0.5,0.5,2141,2107
2017-11-14,Hong Kong,Lebanon,0,1,1,0.0,1.0,1615,1707
2017-11-14,Hungary,Costa Rica,1,0,1,1.0,0.0,1826,1923
2017-11-14,India,Myanmar,2,2,0,0.5,0.5,1611,1562
2017-11-14,Republic of Ireland,Denmark,1,5,4,0.0,1.0,1926,1931
2017-11-14,South Korea,Serbia,1,1,0,0.5,0.5,1952,1895
2017-11-14,Macau,Kyrgyzstan,3,4,1,0.0,1.0,1325,1524
2017-11-14,Nepal,Philippines,0,0,0,0.5,0.5,1412,1601
2017-11-14,Palestine,Maldives,8,1,7,1.0,0.0,1683,1449
2017-11-14,Portugal,United States,1,1,0,0.5,0.5,2060,1984
2017-11-14,Qatar,Iceland,1,1,0,0.5,0.5,1810,1847
2017-11-14,Romania,Netherlands,0,3,3,0.0,1.0,1888,2042
2017-11-14,Russia,Spain,3,3,0,0.5,0.5,1932,2156
2017-11-14,Senegal,South Africa,2,1,1,1.0,0.0,1903,1819
2017-11-14,Singapore,Bahrain,0,3,3,0.0,1.0,1553,1765
2017-11-14,Slovakia,Norway,1,0,1,1.0,0.0,1888,1804
2017-11-14,Tajikistan,Yemen,0,0,0,0.5,0.5,1608,1564
2017-11-14,Trinidad and Tobago,Guyana,1,1,0,0.5,0.5,1706,1592
2017-11-14,Turkmenistan,Taiwan,2,1,1,1.0,0.0,1600,1432
2017-11-14,United Arab Emirates,Uzbekistan,1,0,1,1.0,0.0,1861,1862
2017-11-14,Vietnam,Afghanistan,0,0,0,0.5,0.5,1688,1504
2017-11-14,Wales,Panama,1,1,0,0.5,0.5,1846,1872
2017-11-15,Australia,Honduras,3,1,2,1.0,0.0,1947,1839
2017-11-15,Peru,New Zealand,2,0,2,1.0,0.0,1965,1766
2017-11-18,Fiji,Estonia,0,2,2,0.0,1.0,1654,1735
2017-11-22,Vanuatu,Estonia,0,1,1,0.0,1.0,1606,1741
2017-11-25,Indonesia,Guyana,2,1,1,1.0,0.0,1656,1586
2017-11-26,New Caledonia,Estonia,1,1,0,0.5,0.5,1678,1740
2017-12-01,Laos,Philippines,1,3,2,0.0,1.0,1380,1605
2017-12-02,Fiji,Tuvalu,8,0,8,1.0,0.0,1659,1462
2017-12-02,Indonesia,Brunei,4,0,4,1.0,0.0,1658,1270
2017-12-02,Kyrgyzstan,Mongolia,3,0,3,1.0,0.0,1530,1389
2017-12-02,Tonga,Solomon Islands,0,8,8,0.0,1.0,1421,1624
2017-12-02,Vanuatu,New Caledonia,2,1,1,1.0,0.0,1616,1669
2017-12-03,Kenya,Rwanda,2,0,2,1.0,0.0,1675,1620
2017-12-03,Laos,Timor-Leste,2,1,1,1.0,0.0,1386,1275
2017-12-03,Libya,Tanzania,0,0,0,0.5,0.5,1718,1641
2017-12-03,Saint Kitts and Nevis,Grenada,1,0,1,1.0,0.0,1606,1515
2017-12-03,Taiwan,Philippines,3,0,3,1.0,0.0,1444,1594
2017-12-04,Brunei,Kyrgyzstan,0,4,4,0.0,1.0,1268,1533
2017-12-04,Indonesia,Mongolia,3,2,1,1.0,0.0,1661,1387
2017-12-04,Taiwan,Timor-Leste,3,1,2,1.0,0.0,1449,1271
2017-12-04,Uganda,Burundi,0,0,0,0.5,0.5,1748,1595
2017-12-05,Timor-Leste,Philippines,1,0,1,1.0,0.0,1285,1581
2017-12-05,Kenya,Libya,0,0,0,0.5,0.5,1676,1718
2017-12-05,Tuvalu,New Caledonia,2,1,1,1.0,0.0,1475,1657
2017-12-05,South Sudan,Ethiopia,0,3,3,0.0,1.0,1462,1637
2017-12-05,Taiwan,Laos,2,0,2,1.0,0.0,1456,1380
2017-12-05,Zanzibar,Rwanda,3,1,2,1.0,0.0,1555,1611
2017-12-06,Indonesia,Kyrgyzstan,0,1,1,0.0,1.0,1651,1544
2017-12-06,Solomon Islands,Fiji,0,0,0,0.5,0.5,1625,1659
2017-12-06,Vanuatu,Tonga,5,0,5,1.0,0.0,1620,1418
2017-12-07,Burundi,Ethiopia,4,1,3,1.0,0.0,1604,1629
2017-12-07,Rwanda,Libya,0,0,0,0.5,0.5,1614,1716
2017-12-07,Tanzania,Zanzibar,1,2,1,0.0,1.0,1632,1565
2017-12-08,Uganda,South Sudan,5,1,4,1.0,0.0,1751,1460
2017-12-09,Tonga,New Caledonia,2,4,2,0.0,1.0,1415,1661
2017-12-09,Japan,North Korea,1,0,1,1.0,0.0,1981,1782
2017-12-09,Kenya,Zanzibar,0,0,0,0.5,0.5,1674,1568
2017-12-09,South Korea,China PR,2,2,0,0.5,0.5,1950,1865
2017-12-09,Rwanda,Tanzania,2,1,1,1.0,0.0,1623,1624
2017-12-09,Solomon Islands,Tuvalu,6,0,6,1.0,0.0,1630,1471
2017-12-09,Vanuatu,Fiji,1,1,0,0.5,0.5,1621,1659
2017-12-10,Ethiopia,Uganda,1,1,0,0.5,0.5,1632,1749
2017-12-11,Kenya,Tanzania,1,0,1,1.0,0.0,1681,1618
2017-12-11,Libya,Zanzibar,1,0,1,1.0,0.0,1721,1564
2017-12-11,South Sudan,Burundi,0,0,0,0.5,0.5,1464,1601
2017-12-12,Fiji,Tonga,4,0,4,1.0,0.0,1663,1412
2017-12-12,New Caledonia,Solomon Islands,0,0,0,0.5,0.5,1661,1631
2017-12-12,Japan,China PR,2,1,1,1.0,0.0,1987,1860
2017-12-12,North Korea,South Korea,0,1,1,0.0,1.0,1778,1955
2017-12-12,Vanuatu,Tuvalu,10,0,10,1.0,0.0,1626,1467
2017-12-14,Kenya,Burundi,1,0,1,1.0,0.0,1688,1595
2017-12-14,Qatar,Liechtenstein,1,2,1,0.0,1.0,1796,1446
2017-12-15,Tuvalu,Tonga,4,3,1,1.0,0.0,1474,1406
2017-12-15,Uganda,Zanzibar,1,2,1,0.0,1.0,1738,1576
2017-12-15,Fiji,New Caledonia,4,1,3,1.0,0.0,1671,1654
2017-12-15,Vanuatu,Solomon Islands,3,2,1,1.0,0.0,1635,1623
2017-12-16,China PR,North Korea,1,1,0,0.5,0.5,1859,1780
2017-12-16,Japan,South Korea,1,4,3,0.0,1.0,1979,1964
2017-12-17,Burundi,Uganda,1,2,1,0.0,1.0,1591,1743
2017-12-17,Kenya,Zanzibar,2,2,0,0.5,0.5,1686,1579
2017-12-18,Bahrain,Kuwait,0,0,0,0.5,0.5,1766,1778
2017-12-22,Kuwait,Saudi Arabia,1,2,1,0.0,1.0,1772,1856
2017-12-22,Oman,United Arab Emirates,0,1,1,0.0,1.0,1788,1868
2017-12-23,Bahrain,Iraq,1,1,0,0.5,0.5,1768,1817
2017-12-23,Qatar,Yemen,4,0,4,1.0,0.0,1800,1561
2017-12-25,Jordan,Libya,1,1,0,0.5,0.5,1780,1723
2017-12-25,Kuwait,Oman,0,1,1,0.0,1.0,1765,1796
2017-12-25,United Arab Emirates,Saudi Arabia,0,0,0,0.5,0.5,1868,1857
2017-12-26,Iraq,Qatar,2,1,1,1.0,0.0,1825,1793
2017-12-26,Yemen,Bahrain,0,1,1,0.0,1.0,1558,1772
2017-12-28,Kuwait,United Arab Emirates,0,0,0,0.5,0.5,1768,1866
2017-12-28,Saudi Arabia,Oman,0,2,2,0.0,1.0,1848,1806
2017-12-29,Iraq,Yemen,3,0,3,1.0,0.0,1828,1556
2017-12-29,Qatar,Bahrain,1,1,0,0.5,0.5,1793,1773
2018-01-02,Iraq,United Arab Emirates,0,0,0,0.5,0.5,1829,1866
2018-01-02,Oman,Bahrain,1,0,1,1.0,0.0,1814,1766
2018-01-05,Oman,United Arab Emirates,0,0,0,0.5,0.5,1816,1865
2018-01-07,Estonia,Sweden,1,1,0,0.5,0.5,1745,1947
2018-01-11,Denmark,Sweden,0,1,1,0.0,1.0,1924,1955
2018-01-11,Indonesia,Iceland,0,6,6,0.0,1.0,1648,1851
2018-01-11,Jordan,Finland,1,2,1,0.0,1.0,1773,1789
2018-01-14,Indonesia,Iceland,1,4,3,0.0,1.0,1645,1855
2018-01-27,Moldova,South Korea,0,1,1,0.0,1.0,1577,1966
2018-01-28,United States,Bosnia and Herzegovina,0,0,0,0.5,0.5,1982,1876
2018-01-28,Yorkshire,Ellan Vannin,1,1,0,0.5,0.5,1501,1529
2018-01-30,Azerbaijan,Moldova,0,0,0,0.5,0.5,1641,1579
2018-01-30,Jamaica,South Korea,2,2,0,0.5,0.5,1764,1962
2018-01-31,Mexico,Bosnia and Herzegovina,1,0,1,1.0,0.0,2032,1872
2018-02-03,Latvia,South Korea,0,1,1,0.0,1.0,1626,1965
2018-02-26,Saudi Arabia,Moldova,3,0,3,1.0,0.0,1851,1577
2018-02-28,Iraq,Saudi Arabia,4,1,3,1.0,0.0,1838,1843
2018-03-17,Iran,Sierra Leone,4,0,4,1.0,0.0,1995,1622
2018-03-21,Andorra,Liechtenstein,1,0,1,1.0,0.0,1358,1436
2018-03-21,Antigua and Barbuda,Bermuda,3,2,1,1.0,0.0,1579,1562
2018-03-21,Iraq,Qatar,2,3,1,0.0,1.0,1829,1803
2018-03-21,Jordan,Kuwait,1,0,1,1.0,0.0,1781,1761
2018-03-21,Laos,Cambodia,0,1,1,0.0,1.0,1372,1370
2018-03-21,Madagascar,Togo,0,0,0,0.5,0.5,1603,1667
2018-03-21,South Africa,Angola,1,1,0,0.5,0.5,1816,1662
2018-03-21,Tahiti,New Caledonia,0,0,0,0.5,0.5,1645,1654
2018-03-21,Zambia,Zimbabwe,2,2,0,0.5,0.5,1755,1732
2018-03-22,Algeria,Tanzania,4,1,3,1.0,0.0,1844,1615
2018-03-22,Bahrain,Palestine,0,0,0,0.5,0.5,1765,1685
2018-03-22,Belize,Grenada,4,2,2,1.0,0.0,1502,1507
2018-03-22,Burkina Faso,Guinea-Bissau,2,0,2,1.0,0.0,1759,1545
2018-03-22,China PR,Wales,0,6,6,0.0,1.0,1851,1855
2018-03-22,Denmark,Panama,1,0,1,1.0,0.0,1931,1866
2018-03-22,Dominican Republic,Turks and Caicos Islands,4,0,4,1.0,0.0,1561,1427
2018-03-22,Faroe Islands,Latvia,1,1,0,0.5,0.5,1500,1624
2018-03-22,Kyrgyzstan,Myanmar,5,1,4,1.0,0.0,1553,1554
2018-03-22,Macau,Mauritius,0,1,1,0.0,1.0,1321,1467
2018-03-22,Malaysia,Mongolia,2,2,0,0.5,0.5,1549,1391
2018-03-22,Malta,Luxembourg,0,1,1,0.0,1.0,1493,1548
2018-03-22,Nicaragua,Cuba,3,1,2,1.0,0.0,1484,1622
2018-03-22,Philippines,Fiji,3,2,1,1.0,0.0,1592,1661
2018-03-22,Slovakia,United Arab Emirates,2,1,1,1.0,0.0,1896,1858
2018-03-22,Thailand,Gabon,0,0,0,0.5,0.5,1776,1699
2018-03-23,Austria,Slovenia,3,0,3,1.0,0.0,1870,1786
2018-03-23,Azerbaijan,Belarus,0,1,1,0.0,1.0,1636,1753
2018-03-23,Bulgaria,Bosnia and Herzegovina,0,1,1,0.0,1.0,1815,1879
2018-03-23,Curaçao,Bolivia,1,1,0,0.5,0.5,1576,1773
2018-03-23,Cyprus,Montenegro,0,0,0,0.5,0.5,1646,1732
2018-03-23,Finland,North Macedonia,0,0,0,0.5,0.5,1788,1729
2018-03-23,France,Colombia,2,3,1,0.0,1.0,2098,2034
2018-03-23,Gambia,Central African Republic,1,1,0,0.5,0.5,1580,1515
2018-03-23,Germany,Spain,1,1,0,0.5,0.5,2142,2156
2018-03-23,Greece,Switzerland,0,1,1,0.0,1.0,1867,1972
2018-03-23,Guadeloupe,Trinidad and Tobago,0,1,1,0.0,1.0,1636,1713
2018-03-23,Hungary,Kazakhstan,2,3,1,0.0,1.0,1814,1621
2018-03-23,Italy,Argentina,0,2,2,0.0,1.0,2029,2121
2018-03-23,Japan,Mali,1,1,0,0.5,0.5,1975,1749
2018-03-23,Mexico,Iceland,3,0,3,1.0,0.0,2037,1851
2018-03-23,Netherlands,England,0,1,1,0.0,1.0,2035,2084
2018-03-23,Norway,Australia,4,1,3,1.0,0.0,1816,1936
2018-03-23,Peru,Croatia,2,0,2,1.0,0.0,1974,1992
2018-03-23,Poland,Nigeria,0,1,1,0.0,1.0,1955,1895
2018-03-23,Portugal,Egypt,2,1,1,1.0,0.0,2065,1906
2018-03-23,Russia,Brazil,0,3,3,0.0,1.0,1930,2198
2018-03-23,Scotland,Costa Rica,0,1,1,0.0,1.0,1877,1931
2018-03-23,Senegal,Uzbekistan,1,1,0,0.5,0.5,1903,1863
2018-03-23,Serbia,Morocco,1,2,1,0.0,1.0,1887,1861
2018-03-23,Singapore,Maldives,3,2,1,1.0,0.0,1559,1444
2018-03-23,Tunisia,Iran,1,0,1,1.0,0.0,1857,1984
2018-03-23,Turkey,Republic of Ireland,1,0,1,1.0,0.0,1919,1918
2018-03-23,Ukraine,Saudi Arabia,1,1,0,0.5,0.5,1935,1846
2018-03-23,Uruguay,Czech Republic,2,0,2,1.0,0.0,1998,1897
2018-03-24,Angola,Zimbabwe,2,2,0,0.5,0.5,1664,1731
2018-03-24,Armenia,Estonia,0,0,0,0.5,0.5,1685,1744
2018-03-24,Botswana,Lesotho,1,0,1,1.0,0.0,1624,1532
2018-03-24,Canada,New Zealand,1,0,1,1.0,0.0,1761,1758
2018-03-24,Comoros,Kenya,2,2,0,0.5,0.5,1443,1682
2018-03-24,Georgia,Lithuania,4,0,4,1.0,0.0,1706,1621
2018-03-24,Israel,Romania,1,2,1,0.0,1.0,1759,1894
2018-03-24,Ivory Coast,Togo,2,2,0,0.5,0.5,1881,1672
2018-03-24,Kosovo,Madagascar,1,0,1,1.0,0.0,1559,1594
2018-03-24,Mauritania,Guinea,2,0,2,1.0,0.0,1560,1754
2018-03-24,Northern Ireland,South Korea,2,1,1,1.0,0.0,1802,1954
2018-03-24,Qatar,Syria,2,2,0,0.5,0.5,1803,1803
2018-03-24,Sweden,Chile,1,2,1,0.0,1.0,1949,2029
2018-03-24,Tahiti,New Caledonia,4,3,1,1.0,0.0,1654,1646
2018-03-24,Uganda,São Tomé and Príncipe,3,1,2,1.0,0.0,1746,1451
2018-03-24,Zambia,South Africa,0,2,2,0.0,1.0,1749,1823
2018-03-24,Alderney,Guernsey,0,2,2,0.0,1.0,1260,1739
2018-03-25,Barbados,Bermuda,0,0,0,0.5,0.5,1538,1562
2018-03-25,Dominican Republic,Saint Kitts and Nevis,2,1,1,1.0,0.0,1571,1597
2018-03-25,Faroe Islands,Liechtenstein,3,0,3,1.0,0.0,1507,1430
2018-03-25,Gibraltar,Latvia,1,0,1,1.0,0.0,1543,1614
2018-03-25,Jamaica,Antigua and Barbuda,1,1,0,0.5,0.5,1761,1583
2018-03-25,Kuwait,Cameroon,1,3,2,0.0,1.0,1756,1876
2018-03-25,Martinique,Trinidad and Tobago,0,0,0,0.5,0.5,1679,1713
2018-03-25,Nicaragua,Cuba,3,3,0,0.5,0.5,1488,1619
2018-03-25,Thailand,Slovakia,2,3,1,0.0,1.0,1771,1902
2018-03-25,Yorkshire,Chagos Islands,6,0,6,1.0,0.0,1509,1473
2018-03-26,Albania,Norway,0,1,1,0.0,1.0,1753,1823
2018-03-26,Bulgaria,Kazakhstan,2,1,1,1.0,0.0,1819,1618
2018-03-26,China PR,Czech Republic,1,4,3,0.0,1.0,1845,1904
2018-03-26,Curaçao,Bolivia,1,0,1,1.0,0.0,1589,1761
2018-03-26,Finland,Malta,5,0,5,1.0,0.0,1791,1491
2018-03-26,Portugal,Netherlands,0,3,3,0.0,1.0,2057,2044
2018-03-26,Wales,Uruguay,0,1,1,0.0,1.0,1851,2003
2018-03-27,Afghanistan,Cambodia,2,1,1,1.0,0.0,1510,1365
2018-03-27,Algeria,Iran,1,2,1,0.0,1.0,1840,1989
2018-03-27,Armenia,Lithuania,0,1,1,0.0,1.0,1676,1631
2018-03-27,Australia,Colombia,0,0,0,0.5,0.5,1939,2032
2018-03-27,Azerbaijan,North Macedonia,1,1,0,0.5,0.5,1639,1727
2018-03-27,Bahrain,Turkmenistan,4,0,4,1.0,0.0,1770,1596
2018-03-27,Belgium,Saudi Arabia,4,0,4,1.0,0.0,2034,1842
2018-03-27,Bosnia and Herzegovina,Senegal,0,0,0,0.5,0.5,1880,1903
2018-03-27,Myanmar,Macau,1,0,1,1.0,0.0,1558,1318
2018-03-27,Central African Republic,Kenya,3,2,1,1.0,0.0,1527,1671
2018-03-27,Denmark,Chile,0,0,0,0.5,0.5,1934,2027
2018-03-27,England,Italy,1,1,0,0.5,0.5,2083,2031
2018-03-27,Georgia,Estonia,2,0,2,1.0,0.0,1715,1736
2018-03-27,Germany,Brazil,0,1,1,0.0,1.0,2136,2205
2018-03-27,Greece,Egypt,1,0,1,1.0,0.0,1876,1898
2018-03-27,Hungary,Scotland,0,1,1,0.0,1.0,1808,1884
2018-03-27,Iraq,Syria,1,1,0,0.5,0.5,1829,1804
2018-03-27,Jordan,Vietnam,1,1,0,0.5,0.5,1779,1691
2018-03-27,North Korea,Hong Kong,2,0,2,1.0,0.0,1785,1611
2018-03-27,Kosovo,Burkina Faso,2,0,2,1.0,0.0,1572,1747
2018-03-27,Kyrgyzstan,India,2,1,1,1.0,0.0,1563,1602
2018-03-27,Laos,Bangladesh,2,2,0,0.5,0.5,1373,1408
2018-03-27,Lebanon,Malaysia,2,1,1,1.0,0.0,1712,1545
2018-03-27,Luxembourg,Austria,0,4,4,0.0,1.0,1546,1873
2018-03-27,Maldives,Bhutan,7,0,7,1.0,0.0,1449,1259
2018-03-27,Mexico,Croatia,0,1,1,0.0,1.0,2028,2002
2018-03-27,Moldova,Ivory Coast,1,2,1,0.0,1.0,1575,1884
2018-03-27,Mongolia,Mauritius,0,2,2,0.0,1.0,1385,1474
2018-03-27,Montenegro,Turkey,2,2,0,0.5,0.5,1736,1916
2018-03-27,Morocco,Uzbekistan,2,0,2,1.0,0.0,1870,1855
2018-03-27,Namibia,Lesotho,2,1,1,1.0,0.0,1640,1527
2018-03-27,Oman,Palestine,1,0,1,1.0,0.0,1822,1680
2018-03-27,Peru,Iceland,3,1,2,1.0,0.0,1980,1846
2018-03-27,Philippines,Tajikistan,2,1,1,1.0,0.0,1601,1600
2018-03-27,Poland,South Korea,3,2,1,1.0,0.0,1963,1947
2018-03-27,Romania,Sweden,1,0,1,1.0,0.0,1904,1940
2018-03-27,Russia,France,1,3,2,0.0,1.0,1926,2103
2018-03-27,Serbia,Nigeria,2,0,2,1.0,0.0,1896,1887
2018-03-27,Seychelles,Eswatini,0,0,0,0.5,0.5,1404,1553
2018-03-27,Slovenia,Belarus,0,2,2,0.0,1.0,1778,1762
2018-03-27,Spain,Argentina,6,1,5,1.0,0.0,2164,2114
2018-03-27,Switzerland,Panama,6,0,6,1.0,0.0,1978,1861
2018-03-27,Taiwan,Singapore,1,0,1,1.0,0.0,1467,1549
2018-03-27,Tanzania,DR Congo,2,0,2,1.0,0.0,1627,1769
2018-03-27,Tunisia,Costa Rica,1,0,1,1.0,0.0,1867,1922
2018-03-27,Uganda,Malawi,0,0,0,0.5,0.5,1744,1642
2018-03-27,Ukraine,Japan,2,1,1,1.0,0.0,1944,1967
2018-03-27,United States,Paraguay,1,0,1,1.0,0.0,1988,1884
2018-03-27,Yemen,Nepal,2,1,1,1.0,0.0,1561,1408
2018-04-01,Malaysia,Bhutan,7,0,7,1.0,0.0,1548,1257
2018-04-08,Barawa,Chagos Islands,4,1,3,1.0,0.0,1492,1466
2018-04-15,Barawa,Yorkshire,2,7,5,0.0,1.0,1485,1517
2018-04-18,Trinidad and Tobago,Panama,0,1,1,0.0,1.0,1709,1866
2018-04-18,Zimbabwe,Botswana,0,1,1,0.0,1.0,1721,1635
2018-04-26,Saint Kitts and Nevis,Jamaica,1,3,2,0.0,1.0,1593,1766
2018-04-29,Ellan Vannin,Panjab,2,1,1,1.0,0.0,1538,1529
2018-04-29,Saint Barthélemy,Saint Martin,3,2,1,1.0,0.0,1495,1438
2018-04-30,Antigua and Barbuda,Jamaica,0,2,2,0.0,1.0,1579,1771
2018-05-06,Barawa,Surrey,1,3,2,0.0,1.0,1478,1508
2018-05-08,Iraq,Palestine,0,0,0,0.5,0.5,1826,1684
2018-05-09,Algeria,Saudi Arabia,0,2,2,0.0,1.0,1833,1850
2018-05-11,Kuwait,Palestine,2,0,2,1.0,0.0,1763,1678
2018-05-12,Jersey,Guernsey,1,0,1,1.0,0.0,1747,1731
2018-05-15,Saudi Arabia,Greece,2,0,2,1.0,0.0,1859,1868
2018-05-19,Iran,Uzbekistan,1,0,1,1.0,0.0,1995,1850
2018-05-20,Jordan,Cyprus,3,0,3,1.0,0.0,1785,1641
2018-05-25,Kuwait,Egypt,1,1,0,0.5,0.5,1766,1896
2018-05-25,Kenya,Eswatini,0,1,1,0.0,1.0,1661,1564
2018-05-26,China PR,Myanmar,1,0,1,1.0,0.0,1848,1556
2018-05-26,Saint Barthélemy,Sint Maarten,5,3,2,1.0,0.0,1503,1477
2018-05-27,Cameroon,Burkina Faso,0,1,1,0.0,1.0,1866,1758
2018-05-27,Niger,Central African Republic,3,3,0,0.5,0.5,1584,1529
2018-05-27,Madagascar,Mozambique,2,1,1,1.0,0.0,1604,1645
2018-05-27,Comoros,Seychelles,1,1,0,0.5,0.5,1443,1405
2018-05-28,United States,Bolivia,3,0,3,1.0,0.0,1992,1758
2018-05-28,Nigeria,DR Congo,1,1,0,0.5,0.5,1885,1772
2018-05-28,Kenya,Equatorial Guinea,1,0,1,1.0,0.0,1667,1563
2018-05-28,Portugal,Tunisia,2,2,0,0.5,0.5,2054,1871
2018-05-28,Italy,Saudi Arabia,2,1,1,1.0,0.0,2036,1855
2018-05-28,France,Republic of Ireland,2,0,2,1.0,0.0,2108,1914
2018-05-28,Mexico,Wales,0,0,0,0.5,0.5,2025,1855
2018-05-28,Turkey,Iran,2,1,1,1.0,0.0,1926,1986
2018-05-28,South Korea,Honduras,2,0,2,1.0,0.0,1953,1834
2018-05-28,Bosnia and Herzegovina,Montenegro,0,0,0,0.5,0.5,1877,1740
2018-05-28,Malawi,Mauritius,0,1,1,0.0,1.0,1631,1486
2018-05-28,Angola,Botswana,1,2,1,0.0,1.0,1656,1644
2018-05-29,Argentina,Haiti,4,0,4,1.0,0.0,2116,1721
2018-05-29,Albania,Kosovo,0,3,3,0.0,1.0,1742,1584
2018-05-29,Armenia,Malta,1,1,0,0.5,0.5,1673,1495
2018-05-29,Azerbaijan,Kyrgyzstan,3,0,3,1.0,0.0,1646,1557
2018-05-29,Peru,Scotland,2,0,2,1.0,0.0,1986,1879
2018-05-29,Panama,Northern Ireland,0,0,0,0.5,0.5,1865,1804
2018-05-29,Madagascar,Seychelles,1,1,0,0.5,0.5,1600,1410
2018-05-29,Comoros,Mozambique,0,3,3,0.0,1.0,1440,1649
2018-05-30,Japan,Ghana,0,2,2,0.0,1.0,1957,1860
2018-05-30,Central African Republic,Uganda,1,0,1,1.0,0.0,1542,1732
2018-05-30,Austria,Russia,1,0,1,1.0,0.0,1883,1917
2018-05-30,Malawi,Botswana,1,1,0,0.5,0.5,1632,1644
2018-05-30,Angola,Mauritius,1,0,1,1.0,0.0,1661,1482
2018-05-30,Estonia,Lithuania,2,0,2,1.0,0.0,1742,1626
2018-05-31,Ukraine,Morocco,0,0,0,0.5,0.5,1943,1872
2018-05-31,Romania,Chile,3,2,1,1.0,0.0,1915,2017
2018-05-31,Luxembourg,Senegal,0,0,0,0.5,0.5,1553,1897
2018-05-31,Mozambique,Seychelles,2,1,1,1.0,0.0,1653,1407
2018-05-31,Comoros,Madagascar,0,1,1,0.0,1.0,1436,1605
2018-05-31,Slovakia,Netherlands,1,1,0,0.5,0.5,1906,2041
2018-05-31,Ellan Vannin,Cascadia,4,1,3,1.0,0.0,1546,1493
2018-05-31,Barawa,Tamil Eelam,4,0,4,1.0,0.0,1487,1511
2018-05-31,Abkhazia,Tibet,3,0,3,1.0,0.0,1545,1438
2018-05-31,Northern Cyprus,Kárpátalja,1,1,0,0.5,0.5,1580,1507
2018-05-31,Székely Land,Tuvalu,4,0,4,1.0,0.0,1487,1467
2018-05-31,Padania,Matabeleland,6,1,5,1.0,0.0,1636,1495
2018-05-31,United Koreans in Japan,Western Armenia,0,0,0,0.5,0.5,1507,1490
2018-05-31,Panjab,Kabylia,8,0,8,1.0,0.0,1537,1493
2018-06-01,France,Italy,3,1,2,1.0,0.0,2115,2030
2018-06-01,Turkey,Tunisia,2,2,0,0.5,0.5,1925,1873
2018-06-01,South Korea,Bosnia and Herzegovina,1,3,2,0.0,1.0,1944,1887
2018-06-01,Czech Republic,Australia,0,4,4,0.0,1.0,1897,1947
2018-06-01,Algeria,Cape Verde,2,3,1,0.0,1.0,1823,1713
2018-06-01,Colombia,Egypt,0,0,0,0.5,0.5,2030,1899
2018-06-01,Malta,Georgia,0,1,1,0.0,1.0,1492,1719
2018-06-01,Botswana,Mauritius,6,0,6,1.0,0.0,1649,1478
2018-06-01,Angola,Malawi,0,0,0,0.5,0.5,1661,1633
2018-06-01,India,Taiwan,5,0,5,1.0,0.0,1608,1462
2018-06-02,El Salvador,Honduras,1,0,1,1.0,0.0,1722,1824
2018-06-02,Thailand,China PR,0,2,2,0.0,1.0,1765,1855
2018-06-02,England,Nigeria,2,1,1,1.0,0.0,2087,1882
2018-06-02,Montenegro,Slovenia,0,2,2,0.0,1.0,1733,1786
2018-06-02,Mexico,Scotland,1,0,1,1.0,0.0,2030,1875
2018-06-02,Sweden,Denmark,0,0,0,0.5,0.5,1940,1935
2018-06-02,Republic of Ireland,United States,2,1,1,1.0,0.0,1924,1983
2018-06-02,Belgium,Portugal,0,0,0,0.5,0.5,2035,2054
2018-06-02,Austria,Germany,2,1,1,1.0,0.0,1896,2124
2018-06-02,Niger,Uganda,2,1,1,1.0,0.0,1596,1721
2018-06-02,Iceland,Norway,2,3,1,0.0,1.0,1838,1832
2018-06-02,Zambia,Namibia,0,0,0,0.5,0.5,1747,1643
2018-06-02,Lesotho,Eswatini,1,0,1,1.0,0.0,1536,1556
2018-06-02,Latvia,Estonia,1,0,1,1.0,0.0,1625,1732
2018-06-02,Kenya,New Zealand,2,1,1,1.0,0.0,1678,1748
2018-06-02,Ellan Vannin,Tamil Eelam,2,0,2,1.0,0.0,1554,1504
2018-06-02,Barawa,Cascadia,1,2,1,0.0,1.0,1480,1501
2018-06-02,Abkhazia,Kárpátalja,0,2,2,0.0,1.0,1537,1516
2018-06-02,Northern Cyprus,Tibet,3,1,2,1.0,0.0,1585,1434
2018-06-02,Székely Land,Matabeleland,5,0,5,1.0,0.0,1496,1487
2018-06-02,Padania,Tuvalu,8,0,8,1.0,0.0,1641,1463
2018-06-02,United Koreans in Japan,Kabylia,0,0,0,0.5,0.5,1507,1494
2018-06-02,Panjab,Western Armenia,0,1,1,0.0,1.0,1528,1500
2018-06-03,Albania,Ukraine,1,4,3,0.0,1.0,1739,1947
2018-06-03,Saudi Arabia,Peru,0,3,3,0.0,1.0,1850,1992
2018-06-03,Spain,Switzerland,1,1,0,0.5,0.5,2161,1982
2018-06-03,Croatia,Brazil,0,2,2,0.0,1.0,1999,2209
2018-06-03,Costa Rica,Northern Ireland,3,0,3,1.0,0.0,1928,1799
2018-06-03,Barbados,Belize,0,0,0,0.5,0.5,1538,1503
2018-06-03,Andorra,Cape Verde,0,0,0,0.5,0.5,1365,1707
2018-06-03,South Africa,Madagascar,0,0,0,0.5,0.5,1819,1610
2018-06-03,Zimbabwe,Botswana,1,1,0,0.5,0.5,1720,1651
2018-06-03,Tamil Eelam,Cascadia,0,6,6,0.0,1.0,1496,1510
2018-06-03,Barawa,Ellan Vannin,2,0,2,1.0,0.0,1490,1545
2018-06-03,Abkhazia,Northern Cyprus,2,2,0,0.5,0.5,1539,1584
2018-06-03,Kárpátalja,Tibet,5,1,4,1.0,0.0,1523,1428
2018-06-03,Padania,Székely Land,3,1,2,1.0,0.0,1646,1492
2018-06-03,Tuvalu,Matabeleland,1,3,2,0.0,1.0,1456,1495
2018-06-03,Panjab,United Koreans in Japan,1,1,0,0.5,0.5,1528,1508
2018-06-03,Western Armenia,Kabylia,4,0,4,1.0,0.0,1508,1487
2018-06-04,Italy,Netherlands,1,1,0,0.5,0.5,2031,2041
2018-06-04,Serbia,Chile,0,1,1,0.0,1.0,1891,2023
2018-06-04,Slovakia,Morocco,1,2,1,0.0,1.0,1898,1881
2018-06-04,Armenia,Moldova,0,0,0,0.5,0.5,1671,1578
2018-06-04,India,Kenya,3,0,3,1.0,0.0,1618,1669
2018-06-05,Russia,Turkey,1,1,0,0.5,0.5,1918,1925
2018-06-05,Romania,Finland,2,0,2,1.0,0.0,1921,1786
2018-06-05,Luxembourg,Georgia,1,0,1,1.0,0.0,1565,1708
2018-06-05,Kazakhstan,Azerbaijan,3,0,3,1.0,0.0,1627,1638
2018-06-05,Martinique,French Guiana,3,0,3,1.0,0.0,1686,1597
2018-06-05,Lithuania,Latvia,1,1,0,0.5,0.5,1626,1626
2018-06-05,Taiwan,New Zealand,0,1,1,0.0,1.0,1460,1751
2018-06-05,South Africa,Namibia,4,1,3,1.0,0.0,1824,1639
2018-06-05,Eswatini,Botswana,0,2,2,0.0,1.0,1551,1657
2018-06-05,Matabeleland,Kabylia,0,0,0,0.5,0.5,1495,1488
2018-06-05,Abkhazia,Tamil Eelam,6,0,6,1.0,0.0,1547,1489
2018-06-05,United Koreans in Japan,Tuvalu,5,0,5,1.0,0.0,1515,1450
2018-06-05,Barawa,Northern Cyprus,0,8,8,0.0,1.0,1485,1590
2018-06-05,Padania,Panjab,2,0,2,1.0,0.0,1652,1523
2018-06-05,Kárpátalja,Cascadia,3,1,2,1.0,0.0,1531,1503
2018-06-05,Western Armenia,Székely Land,0,4,4,0.0,1.0,1500,1501
2018-06-06,Norway,Panama,1,0,1,1.0,0.0,1841,1857
2018-06-06,Czech Republic,Nigeria,1,0,1,1.0,0.0,1905,1875
2018-06-06,Belgium,Egypt,3,0,3,1.0,0.0,2041,1894
2018-06-06,Belarus,Hungary,1,1,0,0.5,0.5,1764,1807
2018-06-06,Zambia,Madagascar,1,0,1,1.0,0.0,1752,1606
2018-06-06,Lesotho,Zimbabwe,0,0,0,0.5,0.5,1540,1717
2018-06-07,England,Costa Rica,2,0,2,1.0,0.0,2092,1924
2018-06-07,Uruguay,Uzbekistan,3,0,3,1.0,0.0,2008,1846
2018-06-07,Portugal,Algeria,3,0,3,1.0,0.0,2058,1820
2018-06-07,South Korea,Bolivia,0,0,0,0.5,0.5,1941,1762
2018-06-07,Iceland,Ghana,2,2,0,0.5,0.5,1839,1860
2018-06-07,Guadeloupe,French Guiana,0,2,2,0.0,1.0,1628,1606
2018-06-07,India,New Zealand,1,2,1,0.0,1.0,1613,1757
2018-06-07,Tamil Eelam,Tuvalu,4,3,1,1.0,0.0,1497,1443
2018-06-07,Tibet,Kabylia,1,8,7,0.0,1.0,1422,1495
2018-06-07,Abkhazia,United Koreans in Japan,2,0,2,1.0,0.0,1555,1508
2018-06-07,Barawa,Panjab,0,5,5,0.0,1.0,1478,1531
2018-06-07,Cascadia,Western Armenia,4,0,4,1.0,0.0,1511,1493
2018-06-07,Northern Cyprus,Padania,3,2,1,1.0,0.0,1600,1643
2018-06-07,Kárpátalja,Székely Land,4,2,2,1.0,0.0,1539,1494
2018-06-08,Germany,Saudi Arabia,2,1,1,1.0,0.0,2127,1848
2018-06-08,Croatia,Senegal,2,1,1,1.0,0.0,2005,1892
2018-06-08,Switzerland,Japan,2,0,2,1.0,0.0,1990,1950
2018-06-08,Lithuania,Iran,0,1,1,0.0,1.0,1625,1988
2018-06-08,Poland,Chile,2,2,0,0.5,0.5,1965,2022
2018-06-08,Taiwan,Kenya,0,4,4,0.0,1.0,1457,1673
2018-06-08,South Africa,Botswana,3,0,3,1.0,0.0,1829,1653
2018-06-08,Madagascar,Lesotho,0,1,1,0.0,1.0,1597,1550
2018-06-09,Zambia,Zimbabwe,2,4,2,0.0,1.0,1744,1726
2018-06-09,Serbia,Bolivia,5,1,4,1.0,0.0,1897,1757
2018-06-09,Denmark,Mexico,2,0,2,1.0,0.0,1946,2020
2018-06-09,Sweden,Peru,0,0,0,0.5,0.5,1942,1991
2018-06-09,Hungary,Australia,1,2,1,0.0,1.0,1803,1952
2018-06-09,Estonia,Morocco,1,3,2,0.0,1.0,1728,1886
2018-06-09,Latvia,Azerbaijan,1,3,2,0.0,1.0,1619,1646
2018-06-09,Finland,Belarus,2,0,2,1.0,0.0,1794,1757
2018-06-09,Tunisia,Spain,0,1,1,0.0,1.0,1871,2164
2018-06-09,France,United States,1,1,0,0.5,0.5,2113,1986
2018-06-09,Matabeleland,Tamil Eelam,1,0,1,1.0,0.0,1504,1489
2018-06-09,Tibet,United Koreans in Japan,1,1,0,0.5,0.5,1424,1507
2018-06-09,Kabylia,Abkhazia,0,2,2,0.0,1.0,1489,1562
2018-06-09,Barawa,Western Armenia,0,7,7,0.0,1.0,1471,1501
2018-06-09,Panjab,Cascadia,3,3,0,0.5,0.5,1531,1512
2018-06-09,Padania,Székely Land,0,0,0,0.5,0.5,1640,1498
2018-06-09,Northern Cyprus,Kárpátalja,0,0,0,0.5,0.5,1599,1541
2018-06-10,Austria,Brazil,0,3,3,0.0,1.0,1894,2212
2018-06-10,India,Kenya,2,0,2,1.0,0.0,1623,1664
2018-06-11,South Korea,Senegal,0,2,2,0.0,1.0,1932,1902
2018-06-11,Belgium,Costa Rica,4,1,3,1.0,0.0,2047,1919
2018-06-12,Japan,Paraguay,4,2,2,1.0,0.0,1957,1878
2018-06-12,Poland,Lithuania,4,0,4,1.0,0.0,1967,1624
2018-06-14,Russia,Saudi Arabia,5,0,5,1.0,0.0,1925,1842
2018-06-15,Egypt,Uruguay,0,1,1,0.0,1.0,1889,2014
2018-06-15,Morocco,Iran,0,1,1,0.0,1.0,1881,1994
2018-06-15,Portugal,Spain,3,3,0,0.5,0.5,2061,2162
2018-06-16,France,Australia,2,1,1,1.0,0.0,2118,1948
2018-06-16,Argentina,Iceland,1,1,0,0.5,0.5,2111,1845
2018-06-16,Peru,Denmark,0,1,1,0.0,1.0,1982,1956
2018-06-16,Croatia,Nigeria,2,0,2,1.0,0.0,2011,1870
2018-06-17,Costa Rica,Serbia,0,1,1,0.0,1.0,1911,1906
2018-06-17,Germany,Mexico,0,1,1,0.0,1.0,2117,2031
2018-06-17,Brazil,Switzerland,1,1,0,0.5,0.5,2208,1995
2018-06-18,Sweden,South Korea,1,0,1,1.0,0.0,1950,1925
2018-06-18,Belgium,Panama,3,0,3,1.0,0.0,2052,1853
2018-06-18,Tunisia,England,1,2,1,0.0,1.0,1868,2096
2018-06-19,Colombia,Japan,1,2,1,0.0,1.0,2021,1967
2018-06-19,Poland,Senegal,1,2,1,0.0,1.0,1958,1912
2018-06-19,Russia,Egypt,3,1,2,1.0,0.0,1933,1882
2018-06-20,Portugal,Morocco,1,0,1,1.0,0.0,2066,1877
2018-06-20,Uruguay,Saudi Arabia,1,0,1,1.0,0.0,2019,1838
2018-06-20,Iran,Spain,0,1,1,0.0,1.0,1990,2167
2018-06-21,Denmark,Australia,1,1,0,0.5,0.5,1956,1949
2018-06-21,France,Peru,1,0,1,1.0,0.0,2124,1977
2018-06-21,Argentina,Croatia,0,3,3,0.0,1.0,2101,2022
2018-06-22,Brazil,Costa Rica,2,0,2,1.0,0.0,2211,1909
2018-06-22,Nigeria,Iceland,2,0,2,1.0,0.0,1878,1838
2018-06-22,Serbia,Switzerland,1,2,1,0.0,1.0,1901,2001
2018-06-23,Belgium,Tunisia,5,2,3,1.0,0.0,2057,1864
2018-06-23,South Korea,Mexico,1,2,1,0.0,1.0,1920,2037
2018-06-23,Germany,Sweden,2,1,1,1.0,0.0,2122,1946
2018-06-24,England,Panama,6,1,5,1.0,0.0,2100,1850
2018-06-24,Japan,Senegal,2,2,0,0.5,0.5,1966,1914
2018-06-24,Poland,Colombia,0,3,3,0.0,1.0,1952,2028
2018-06-25,Russia,Uruguay,0,3,3,0.0,1.0,1927,2026
2018-06-25,Saudi Arabia,Egypt,2,1,1,1.0,0.0,1848,1873
2018-06-25,Spain,Morocco,2,2,0,0.5,0.5,2162,1883
2018-06-25,Iran,Portugal,1,1,0,0.5,0.5,1992,2065
2018-06-26,Australia,Peru,0,2,2,0.0,1.0,1942,1985
2018-06-26,Denmark,France,0,0,0,0.5,0.5,1960,2121
2018-06-26,Nigeria,Argentina,1,2,1,0.0,1.0,1875,2105
2018-06-26,Iceland,Croatia,1,2,1,0.0,1.0,1834,2027
2018-06-27,South Korea,Germany,2,0,2,1.0,0.0,1933,2110
2018-06-27,Mexico,Sweden,0,3,3,0.0,1.0,2027,1957
2018-06-27,Serbia,Brazil,0,2,2,0.0,1.0,1899,2214
2018-06-27,Switzerland,Costa Rica,2,2,0,0.5,0.5,1999,1912
2018-06-28,Japan,Poland,0,1,1,0.0,1.0,1958,1961
2018-06-28,Senegal,Colombia,0,1,1,0.0,1.0,1909,2034
2018-06-28,Panama,Tunisia,1,2,1,0.0,1.0,1843,1872
2018-06-28,England,Belgium,0,1,1,0.0,1.0,2092,2066
2018-06-30,France,Argentina,4,3,1,1.0,0.0,2129,2098
2018-06-30,Uruguay,Portugal,2,1,1,1.0,0.0,2035,2057
2018-07-01,Russia,Spain,1,1,0,0.5,0.5,1932,2158
2018-07-01,Croatia,Denmark,1,1,0,0.5,0.5,2026,1962
2018-07-02,Brazil,Mexico,2,0,2,1.0,0.0,2219,2023
2018-07-02,Belgium,Japan,3,2,1,1.0,0.0,2072,1953
2018-07-03,Sweden,Switzerland,1,0,1,1.0,0.0,1966,1991
2018-07-03,Colombia,England,1,1,0,0.5,0.5,2036,2091
2018-07-05,Malaysia,Fiji,1,0,1,1.0,0.0,1559,1651
2018-07-06,Uruguay,France,0,2,2,0.0,1.0,2030,2135
2018-07-06,Brazil,Belgium,1,2,1,0.0,1.0,2208,2084
2018-07-07,Sweden,England,0,2,2,0.0,1.0,1961,2097
2018-07-07,Russia,Croatia,2,2,0,0.5,0.5,1935,2024
2018-07-10,France,Belgium,1,0,1,1.0,0.0,2142,2078
2018-07-11,Croatia,England,2,1,1,1.0,0.0,2034,2088
2018-07-14,Belgium,England,2,0,2,1.0,0.0,2087,2080
2018-07-15,France,Croatia,4,2,2,1.0,0.0,2148,2029
2018-07-22,Liberia,Sierra Leone,0,0,0,0.5,0.5,1608,1622
2018-07-27,Saint Barthélemy,Anguilla,1,2,1,0.0,1.0,1491,1312
2018-07-28,Saint Barthélemy,British Virgin Islands,3,4,1,0.0,1.0,1480,1349
2018-08-04,Belize,Barbados,1,0,1,1.0,0.0,1512,1530
2018-08-04,Palestine,Iraq,0,3,3,0.0,1.0,1674,1831
2018-08-15,Guatemala,Cuba,3,0,3,1.0,0.0,1709,1613
2018-08-18,Andorra,United Arab Emirates,0,0,0,0.5,0.5,1373,1851
2018-08-18,Grenada,Jamaica,1,5,4,0.0,1.0,1505,1774
2018-08-18,Guatemala,Cuba,1,0,1,1.0,0.0,1715,1608
2018-08-20,Barbados,Jamaica,2,2,0,0.5,0.5,1535,1770
2018-08-22,Sint Maarten,Anguilla,1,1,0,0.5,0.5,1474,1316
2018-08-25,Anguilla,Saint Martin,1,2,1,0.0,1.0,1311,1444
2018-08-26,Barbados,Cuba,0,0,0,0.5,0.5,1537,1607
2018-08-29,Bangladesh,Sri Lanka,0,1,1,0.0,1.0,1399,1332
2018-08-29,Barbados,Cuba,0,2,2,0.0,1.0,1531,1614
2018-08-29,Macau,Solomon Islands,1,4,3,0.0,1.0,1316,1626
2018-09-01,Timor-Leste,Brunei,3,1,2,1.0,0.0,1293,1261
2018-09-02,Ethiopia,Burundi,1,1,0,0.5,0.5,1632,1592
2018-09-02,Guam,Northern Mariana Islands,4,0,4,1.0,0.0,1426,1357
2018-09-02,Mongolia,Macau,4,1,3,1.0,0.0,1392,1310
2018-09-04,Macau,Guam,2,0,2,1.0,0.0,1321,1416
2018-09-04,Mongolia,Northern Mariana Islands,9,0,9,1.0,0.0,1400,1350
2018-09-04,Nepal,Pakistan,1,2,1,0.0,1.0,1400,1390
2018-09-04,Bangladesh,Bhutan,2,0,2,1.0,0.0,1404,1253
2018-09-05,Fiji,Solomon Islands,1,1,0,0.5,0.5,1651,1627
2018-09-05,Slovakia,Denmark,3,0,3,1.0,0.0,1908,1953
2018-09-05,India,Sri Lanka,2,0,2,1.0,0.0,1626,1330
2018-09-06,Germany,France,0,0,0,0.5,0.5,2111,2148
2018-09-06,Czech Republic,Ukraine,1,2,1,0.0,1.0,1898,1955
2018-09-06,Wales,Republic of Ireland,4,1,3,1.0,0.0,1865,1915
2018-09-06,Norway,Cyprus,2,0,2,1.0,0.0,1845,1638
2018-09-06,Slovenia,Bulgaria,1,2,1,0.0,1.0,1779,1827
2018-09-06,Kazakhstan,Georgia,0,2,2,0.0,1.0,1621,1715
2018-09-06,Latvia,Andorra,0,0,0,0.5,0.5,1615,1378
2018-09-06,Armenia,Liechtenstein,2,1,1,1.0,0.0,1675,1427
2018-09-06,Gibraltar,North Macedonia,0,2,2,0.0,1.0,1539,1732
2018-09-06,Austria,Sweden,2,0,2,1.0,0.0,1904,1952
2018-09-06,Bahrain,Philippines,1,1,0,0.5,0.5,1767,1605
2018-09-06,Jordan,Lebanon,0,1,1,0.0,1.0,1776,1722
2018-09-06,Kyrgyzstan,Palestine,1,1,0,0.5,0.5,1560,1672
2018-09-06,Netherlands,Peru,2,1,1,1.0,0.0,2048,1979
2018-09-06,Portugal,Croatia,1,1,0,0.5,0.5,2057,2030
2018-09-06,Trinidad and Tobago,United Arab Emirates,2,0,2,1.0,0.0,1721,1840
2018-09-06,Uzbekistan,Syria,1,1,0,0.5,0.5,1846,1805
2018-09-06,Northern Mariana Islands,Macau,1,1,0,0.5,0.5,1350,1322
2018-09-06,Mongolia,Guam,1,1,0,0.5,0.5,1401,1416
2018-09-06,Nepal,Bhutan,4,0,4,1.0,0.0,1405,1249
2018-09-06,Bangladesh,Pakistan,1,0,1,1.0,0.0,1412,1383
2018-09-06,Dominica,Suriname,0,0,0,0.5,0.5,1444,1592
2018-09-06,Guyana,Barbados,3,0,3,1.0,0.0,1593,1525
2018-09-07,Italy,Poland,1,1,0,0.5,0.5,2030,1963
2018-09-07,Turkey,Russia,1,2,1,0.0,1.0,1918,1943
2018-09-07,Albania,Israel,1,0,1,1.0,0.0,1748,1751
2018-09-07,Lithuania,Serbia,0,1,1,0.0,1.0,1622,1902
2018-09-07,Romania,Montenegro,0,0,0,0.5,0.5,1918,1737
2018-09-07,Faroe Islands,Malta,3,1,2,1.0,0.0,1515,1485
2018-09-07,Azerbaijan,Kosovo,0,0,0,0.5,0.5,1645,1586
2018-09-07,Argentina,Guatemala,3,0,3,1.0,0.0,2100,1714
2018-09-07,Taiwan,Malaysia,2,0,2,1.0,0.0,1468,1549
2018-09-07,Ecuador,Jamaica,2,0,2,1.0,0.0,1931,1766
2018-09-07,South Korea,Costa Rica,2,0,2,1.0,0.0,1941,1905
2018-09-07,Mexico,Uruguay,1,4,3,0.0,1.0,2016,2038
2018-09-07,Qatar,China PR,1,0,1,1.0,0.0,1813,1846
2018-09-07,Scotland,Belgium,0,4,4,0.0,1.0,1872,2091
2018-09-07,Singapore,Mauritius,1,1,0,0.5,0.5,1548,1480
2018-09-07,United States,Brazil,0,2,2,0.0,1.0,1983,2212
2018-09-07,Venezuela,Colombia,1,2,1,0.0,1.0,1851,2041
2018-09-07,Maldives,Sri Lanka,0,0,0,0.5,0.5,1447,1333
2018-09-07,Anguilla,French Guiana,0,5,5,0.0,1.0,1309,1609
2018-09-07,Antigua and Barbuda,Saint Lucia,0,3,3,0.0,1.0,1569,1490
2018-09-07,Belize,Bahamas,4,0,4,1.0,0.0,1519,1461
2018-09-08,Switzerland,Iceland,6,0,6,1.0,0.0,1996,1830
2018-09-08,England,Spain,1,2,1,0.0,1.0,2074,2165
2018-09-08,Northern Ireland,Bosnia and Herzegovina,1,2,1,0.0,1.0,1793,1894
2018-09-08,Finland,Hungary,1,0,1,1.0,0.0,1803,1795
2018-09-08,Estonia,Greece,0,1,1,0.0,1.0,1724,1873
2018-09-08,Belarus,San Marino,5,0,5,1.0,0.0,1759,1315
2018-09-08,Luxembourg,Moldova,4,0,4,1.0,0.0,1574,1570
2018-09-08,Brunei,Timor-Leste,1,0,1,1.0,0.0,1270,1285
2018-09-08,Equatorial Guinea,Sudan,1,0,1,1.0,0.0,1572,1581
2018-09-08,Comoros,Cameroon,1,1,0,0.5,0.5,1443,1860
2018-09-08,Gabon,Burundi,1,1,0,0.5,0.5,1697,1595
2018-09-08,Gambia,Algeria,1,1,0,0.5,0.5,1585,1816
2018-09-08,South Africa,Libya,0,0,0,0.5,0.5,1827,1726
2018-09-08,Mauritania,Burkina Faso,2,0,2,1.0,0.0,1573,1746
2018-09-08,Egypt,Niger,6,0,6,1.0,0.0,1876,1594
2018-09-08,Namibia,Zambia,1,1,0,0.5,0.5,1642,1742
2018-09-08,Uganda,Tanzania,0,0,0,0.5,0.5,1719,1630
2018-09-08,Pakistan,Bhutan,3,0,3,1.0,0.0,1389,1244
2018-09-08,Bangladesh,Nepal,0,2,2,0.0,1.0,1404,1414
2018-09-08,Saint Vincent and the Grenadines,Nicaragua,0,2,2,0.0,1.0,1526,1498
2018-09-08,Cuba,Turks and Caicos Islands,11,0,11,1.0,0.0,1619,1423
2018-09-08,Montserrat,El Salvador,1,2,1,0.0,1.0,1389,1725
2018-09-08,Morocco,Malawi,3,0,3,1.0,0.0,1887,1630
2018-09-08,Seychelles,Nigeria,0,3,3,0.0,1.0,1406,1877
2018-09-08,Kenya,Ghana,1,0,1,1.0,0.0,1677,1848
2018-09-08,Mozambique,Guinea-Bissau,2,2,0,0.5,0.5,1651,1548
2018-09-09,France,Netherlands,2,1,1,1.0,0.0,2154,2043
2018-09-09,Ukraine,Slovakia,1,0,1,1.0,0.0,1962,1902
2018-09-09,Denmark,Wales,2,0,2,1.0,0.0,1960,1859
2018-09-09,Bulgaria,Norway,1,0,1,1.0,0.0,1836,1837
2018-09-09,Cyprus,Slovenia,2,1,1,1.0,0.0,1650,1768
2018-09-09,Georgia,Latvia,1,0,1,1.0,0.0,1721,1610
2018-09-09,North Macedonia,Armenia,2,0,2,1.0,0.0,1739,1669
2018-09-09,Liechtenstein,Gibraltar,2,0,2,1.0,0.0,1438,1529
2018-09-09,Germany,Peru,2,1,1,1.0,0.0,2117,1974
2018-09-09,Lebanon,Oman,0,0,0,0.5,0.5,1725,1820
2018-09-09,Congo,Zimbabwe,1,1,0,0.5,0.5,1662,1725
2018-09-09,Rwanda,Ivory Coast,1,2,1,0.0,1.0,1621,1887
2018-09-09,India,Maldives,2,0,2,1.0,0.0,1631,1443
2018-09-09,Bonaire,Dominican Republic,0,5,5,0.0,1.0,1478,1578
2018-09-09,United States Virgin Islands,Canada,0,8,8,0.0,1.0,1377,1763
2018-09-09,Aruba,Bermuda,3,1,2,1.0,0.0,1432,1551
2018-09-09,Jamaica,Cayman Islands,4,0,4,1.0,0.0,1768,1416
2018-09-09,Saint Kitts and Nevis,Puerto Rico,1,0,1,1.0,0.0,1598,1435
2018-09-09,Madagascar,Senegal,2,2,0,0.5,0.5,1603,1904
2018-09-09,South Sudan,Mali,0,3,3,0.0,1.0,1462,1752
2018-09-09,Togo,Benin,0,0,0,0.5,0.5,1672,1653
2018-09-09,Guinea,Central African Republic,1,0,1,1.0,0.0,1758,1539
2018-09-09,Angola,Botswana,1,0,1,1.0,0.0,1669,1646
2018-09-09,Eswatini,Tunisia,0,2,2,0.0,1.0,1549,1875
2018-09-09,Lesotho,Cape Verde,1,1,0,0.5,0.5,1554,1704
2018-09-09,Liberia,DR Congo,1,1,0,0.5,0.5,1612,1769
2018-09-10,Portugal,Italy,1,0,1,1.0,0.0,2065,2023
2018-09-10,Sweden,Turkey,2,3,1,0.0,1.0,1944,1927
2018-09-10,Scotland,Albania,2,0,2,1.0,0.0,1878,1743
2018-09-10,Montenegro,Lithuania,2,0,2,1.0,0.0,1743,1617
2018-09-10,Serbia,Romania,2,2,0,0.5,0.5,1903,1918
2018-09-10,Andorra,Kazakhstan,1,1,0,0.5,0.5,1383,1617
2018-09-10,Kosovo,Faroe Islands,2,0,2,1.0,0.0,1593,1509
2018-09-10,Malta,Azerbaijan,1,1,0,0.5,0.5,1489,1642
2018-09-10,Bahrain,China PR,0,0,0,0.5,0.5,1769,1845
2018-09-10,Cambodia,Malaysia,1,3,2,0.0,1.0,1361,1554
2018-09-10,Kuwait,Iraq,2,2,0,0.5,0.5,1768,1830
2018-09-10,Kyrgyzstan,Syria,2,1,1,1.0,0.0,1573,1793
2018-09-10,Russia,Czech Republic,5,1,4,1.0,0.0,1950,1892
2018-09-10,Saudi Arabia,Bolivia,2,2,0,0.5,0.5,1846,1760
2018-09-10,Haiti,Sint Maarten,13,0,13,1.0,0.0,1725,1471
2018-09-10,Curaçao,Grenada,10,0,10,1.0,0.0,1596,1499
2018-09-11,Iceland,Belgium,0,3,3,0.0,1.0,1828,2094
2018-09-11,Spain,Croatia,6,0,6,1.0,0.0,2171,2025
2018-09-11,Bosnia and Herzegovina,Austria,1,0,1,1.0,0.0,1903,1896
2018-09-11,Hungary,Greece,2,1,1,1.0,0.0,1805,1864
2018-09-11,Finland,Estonia,1,0,1,1.0,0.0,1810,1718
2018-09-11,San Marino,Luxembourg,0,3,3,0.0,1.0,1313,1577
2018-09-11,Moldova,Belarus,0,0,0,0.5,0.5,1574,1756
2018-09-11,Colombia,Argentina,0,0,0,0.5,0.5,2043,2099
2018-09-11,Ecuador,Guatemala,2,0,2,1.0,0.0,1935,1711
2018-09-11,England,Switzerland,1,0,1,1.0,0.0,2081,1990
2018-09-11,Gabon,Zambia,0,1,1,0.0,1.0,1691,1749
2018-09-11,Indonesia,Mauritius,1,0,1,1.0,0.0,1650,1476
2018-09-11,Japan,Costa Rica,3,0,3,1.0,0.0,1960,1899
2018-09-11,Jordan,Oman,0,0,0,0.5,0.5,1778,1819
2018-09-11,Kenya,Malawi,1,0,1,1.0,0.0,1684,1624
2018-09-11,South Korea,Chile,0,0,0,0.5,0.5,1943,2021
2018-09-11,Laos,United Arab Emirates,0,3,3,0.0,1.0,1372,1842
2018-09-11,Liberia,Nigeria,1,2,1,0.0,1.0,1610,1880
2018-09-11,Northern Ireland,Israel,3,0,3,1.0,0.0,1801,1744
2018-09-11,Panama,Venezuela,0,2,2,0.0,1.0,1836,1859
2018-09-11,Poland,Republic of Ireland,1,1,0,0.5,0.5,1962,1917
2018-09-11,Qatar,Palestine,3,0,3,1.0,0.0,1818,1668
2018-09-11,Singapore,Fiji,2,0,2,1.0,0.0,1559,1641
2018-09-11,United States,Mexico,1,0,1,1.0,0.0,1992,2008
2018-09-11,Uzbekistan,Iran,0,1,1,0.0,1.0,1842,1997
2018-09-11,Saint Martin,Guadeloupe,0,3,3,0.0,1.0,1440,1633
2018-09-12,Brazil,El Salvador,5,0,5,1.0,0.0,2213,1725
2018-09-12,India,Pakistan,3,1,2,1.0,0.0,1635,1386
2018-09-12,Nepal,Maldives,0,3,3,0.0,1.0,1407,1451
2018-09-15,Maldives,India,2,1,1,1.0,0.0,1463,1624
2018-09-30,Botswana,Namibia,1,0,1,1.0,0.0,1654,1635
2018-09-30,Saint Vincent and the Grenadines,Barbados,1,1,0,0.5,0.5,1526,1526
2018-10-10,Albania,Jordan,0,0,0,0.5,0.5,1744,1778
2018-10-10,Indonesia,Myanmar,3,0,3,1.0,0.0,1656,1551
2018-10-10,Italy,Ukraine,1,1,0,0.5,0.5,2022,1964
2018-10-10,Ethiopia,Kenya,0,0,0,0.5,0.5,1634,1683
2018-10-10,Zambia,Guinea-Bissau,2,1,1,1.0,0.0,1753,1545
2018-10-11,Poland,Portugal,2,3,1,0.0,1.0,1957,2071
2018-10-11,Russia,Sweden,0,0,0,0.5,0.5,1950,1945
2018-10-11,Israel,Scotland,2,1,1,1.0,0.0,1755,1868
2018-10-11,Montenegro,Serbia,0,2,2,0.0,1.0,1739,1908
2018-10-11,Lithuania,Romania,1,2,1,0.0,1.0,1615,1921
2018-10-11,Faroe Islands,Azerbaijan,0,3,3,0.0,1.0,1504,1648
2018-10-11,Kosovo,Malta,3,1,2,1.0,0.0,1599,1484
2018-10-11,Argentina,Iraq,4,0,4,1.0,0.0,2102,1828
2018-10-11,Bahrain,Syria,0,1,1,0.0,1.0,1762,1801
2018-10-11,France,Iceland,2,2,0,0.5,0.5,2149,1834
2018-10-11,Honduras,United Arab Emirates,1,1,0,0.5,0.5,1825,1842
2018-10-11,Hong Kong,Thailand,0,1,1,0.0,1.0,1607,1770
2018-10-11,Kuwait,Lebanon,1,0,1,1.0,0.0,1776,1718
2018-10-11,Mexico,Costa Rica,3,2,1,1.0,0.0,2014,1894
2018-10-11,Turkey,Bosnia and Herzegovina,0,0,0,0.5,0.5,1927,1904
2018-10-11,United States,Colombia,2,4,2,0.0,1.0,1986,2050
2018-10-11,Wales,Spain,1,4,3,0.0,1.0,1857,2174
2018-10-11,Congo,Liberia,3,1,2,1.0,0.0,1669,1604
2018-10-11,French Guiana,Saint Vincent and the Grenadines,0,1,1,0.0,1.0,1600,1536
2018-10-12,Belgium,Switzerland,2,1,1,1.0,0.0,2100,1985
2018-10-12,Croatia,England,0,0,0,0.5,0.5,2027,2080
2018-10-12,Austria,Northern Ireland,1,0,1,1.0,0.0,1902,1796
2018-10-12,Estonia,Finland,0,1,1,0.0,1.0,1713,1816
2018-10-12,Greece,Hungary,1,0,1,1.0,0.0,1871,1799
2018-10-12,Belarus,Luxembourg,1,0,1,1.0,0.0,1761,1573
2018-10-12,Moldova,San Marino,2,0,2,1.0,0.0,1577,1311
2018-10-12,Cambodia,Timor-Leste,2,2,0,0.5,0.5,1360,1287
2018-10-12,Japan,Panama,3,0,3,1.0,0.0,1966,1831
2018-10-12,South Korea,Uruguay,2,1,1,1.0,0.0,1954,2028
2018-10-12,Peru,Chile,3,0,3,1.0,0.0,1984,2012
2018-10-12,Qatar,Ecuador,4,3,1,1.0,0.0,1829,1925
2018-10-12,Saudi Arabia,Brazil,0,2,2,0.0,1.0,1845,2215
2018-10-12,Singapore,Mongolia,2,0,2,1.0,0.0,1564,1397
2018-10-12,Sri Lanka,Malaysia,1,4,3,0.0,1.0,1330,1558
2018-10-12,Cameroon,Malawi,1,0,1,1.0,0.0,1864,1621
2018-10-12,Gabon,South Sudan,3,0,3,1.0,0.0,1695,1459
2018-10-12,Togo,Gambia,1,1,0,0.5,0.5,1671,1587
2018-10-12,Ivory Coast,Central African Republic,4,0,4,1.0,0.0,1889,1538
2018-10-12,Angola,Mauritania,4,1,3,1.0,0.0,1675,1568
2018-10-12,Egypt,Eswatini,4,1,3,1.0,0.0,1879,1547
2018-10-12,Cape Verde,Tanzania,3,0,3,1.0,0.0,1711,1624
2018-10-12,Basque Country,Venezuela,4,2,2,1.0,0.0,1778,1849
2018-10-12,United States Virgin Islands,Curaçao,0,5,5,0.0,1.0,1374,1600
2018-10-12,Bahamas,Antigua and Barbuda,0,6,6,0.0,1.0,1456,1575
2018-10-12,Dominican Republic,Cayman Islands,3,0,3,1.0,0.0,1583,1412
2018-10-12,Bermuda,Sint Maarten,12,0,12,1.0,0.0,1558,1465
2018-10-12,Grenada,Cuba,0,2,2,0.0,1.0,1494,1625
2018-10-12,Mali,Burundi,0,0,0,0.5,0.5,1749,1599
2018-10-12,Algeria,Benin,2,0,2,1.0,0.0,1821,1649
2018-10-12,Guinea,Rwanda,2,0,2,1.0,0.0,1763,1617
2018-10-13,Netherlands,Germany,3,0,3,1.0,0.0,2053,2108
2018-10-13,Slovakia,Czech Republic,1,2,1,0.0,1.0,1894,1901
2018-10-13,Republic of Ireland,Denmark,0,0,0,0.5,0.5,1918,1960
2018-10-13,Norway,Slovenia,1,0,1,1.0,0.0,1844,1762
2018-10-13,Bulgaria,Cyprus,2,1,1,1.0,0.0,1841,1646
2018-10-13,Latvia,Kazakhstan,1,1,0,0.5,0.5,1611,1617
2018-10-13,Georgia,Andorra,3,0,3,1.0,0.0,1724,1381
2018-10-13,Armenia,Gibraltar,0,1,1,0.0,1.0,1658,1541
2018-10-13,North Macedonia,Liechtenstein,4,1,3,1.0,0.0,1742,1436
2018-10-13,China PR,India,0,0,0,0.5,0.5,1841,1629
2018-10-13,Myanmar,Bolivia,0,3,3,0.0,1.0,1548,1764
2018-10-13,Oman,Philippines,1,1,0,0.5,0.5,1815,1610
2018-10-13,Uzbekistan,North Korea,2,0,2,1.0,0.0,1849,1779
2018-10-13,Equatorial Guinea,Madagascar,0,1,1,0.0,1.0,1565,1611
2018-10-13,Nigeria,Libya,4,0,4,1.0,0.0,1885,1722
2018-10-13,Puerto Rico,Martinique,0,1,1,0.0,1.0,1432,1690
2018-10-13,Turks and Caicos Islands,Guyana,0,8,8,0.0,1.0,1419,1598
2018-10-13,Suriname,British Virgin Islands,5,0,5,1.0,0.0,1596,1346
2018-10-13,El Salvador,Barbados,3,0,3,1.0,0.0,1729,1523
2018-10-13,Senegal,Sudan,3,0,3,1.0,0.0,1907,1579
2018-10-13,Morocco,Comoros,1,0,1,1.0,0.0,1889,1442
2018-10-13,South Africa,Seychelles,6,0,6,1.0,0.0,1829,1405
2018-10-13,DR Congo,Zimbabwe,1,2,1,0.0,1.0,1760,1735
2018-10-13,Burkina Faso,Botswana,3,0,3,1.0,0.0,1752,1649
2018-10-13,Tunisia,Niger,1,0,1,1.0,0.0,1878,1592
2018-10-13,Mozambique,Namibia,1,2,1,0.0,1.0,1643,1644
2018-10-13,Uganda,Lesotho,3,0,3,1.0,0.0,1724,1550
2018-10-14,Poland,Italy,0,1,1,0.0,1.0,1951,2029
2018-10-14,Russia,Turkey,2,0,2,1.0,0.0,1958,1920
2018-10-14,Israel,Albania,2,0,2,1.0,0.0,1763,1737
2018-10-14,Romania,Serbia,0,0,0,0.5,0.5,1921,1909
2018-10-14,Lithuania,Montenegro,1,4,3,0.0,1.0,1610,1745
2018-10-14,Faroe Islands,Kosovo,1,1,0,0.5,0.5,1507,1597
2018-10-14,Azerbaijan,Malta,1,1,0,0.5,0.5,1645,1488
2018-10-14,Scotland,Portugal,1,3,2,0.0,1.0,1865,2075
2018-10-14,Thailand,Trinidad and Tobago,1,0,1,1.0,0.0,1777,1715
2018-10-14,Guinea-Bissau,Zambia,2,1,1,1.0,0.0,1558,1741
2018-10-14,Saint Martin,Saint Kitts and Nevis,0,10,10,0.0,1.0,1436,1603
2018-10-14,Bonaire,Jamaica,0,6,6,0.0,1.0,1476,1771
2018-10-14,Montserrat,Belize,1,0,1,1.0,0.0,1400,1509
2018-10-14,Nicaragua,Anguilla,6,0,6,1.0,0.0,1503,1305
2018-10-14,Kenya,Ethiopia,3,0,3,1.0,0.0,1690,1628
2018-10-15,Iceland,Switzerland,1,2,1,0.0,1.0,1830,1990
2018-10-15,Spain,England,2,3,1,0.0,1.0,2164,2091
2018-10-15,Bosnia and Herzegovina,Northern Ireland,2,0,2,1.0,0.0,1910,1791
2018-10-15,Estonia,Hungary,3,3,0,0.5,0.5,1715,1798
2018-10-15,Finland,Greece,2,0,2,1.0,0.0,1826,1862
2018-10-15,Luxembourg,San Marino,3,0,3,1.0,0.0,1576,1309
2018-10-15,Belarus,Moldova,0,0,0,0.5,0.5,1758,1581
2018-10-15,Croatia,Jordan,2,1,1,1.0,0.0,2031,1775
2018-10-15,Kuwait,Australia,0,4,4,0.0,1.0,1772,1947
2018-10-15,Saudi Arabia,Iraq,1,1,0,0.5,0.5,1845,1829
2018-10-16,France,Germany,2,1,1,1.0,0.0,2157,2101
2018-10-16,Ukraine,Czech Republic,1,0,1,1.0,0.0,1971,1895
2018-10-16,Republic of Ireland,Wales,0,1,1,0.0,1.0,1909,1867
2018-10-16,Norway,Bulgaria,1,0,1,1.0,0.0,1852,1834
2018-10-16,Slovenia,Cyprus,1,1,0,0.5,0.5,1760,1649
2018-10-16,Kazakhstan,Andorra,4,0,4,1.0,0.0,1621,1378
2018-10-16,Latvia,Georgia,0,3,3,0.0,1.0,1606,1730
2018-10-16,Armenia,North Macedonia,4,0,4,1.0,0.0,1668,1733
2018-10-16,Gibraltar,Liechtenstein,2,1,1,1.0,0.0,1547,1431
2018-10-16,Bahrain,Myanmar,4,1,3,1.0,0.0,1766,1545
2018-10-16,Belgium,Netherlands,1,1,0,0.5,0.5,2099,2055
2018-10-16,Cambodia,Singapore,1,2,1,0.0,1.0,1357,1568
2018-10-16,China PR,Syria,2,0,2,1.0,0.0,1849,1794
2018-10-16,Colombia,Costa Rica,3,1,2,1.0,0.0,2055,1890
2018-10-16,Denmark,Austria,2,0,2,1.0,0.0,1967,1896
2018-10-16,Indonesia,Hong Kong,1,1,0,0.5,0.5,1655,1609
2018-10-16,Iran,Bolivia,2,1,1,1.0,0.0,2001,1761
2018-10-16,Japan,Uruguay,4,3,1,1.0,0.0,1976,2019
2018-10-16,South Korea,Panama,2,2,0,0.5,0.5,1952,1834
2018-10-16,Laos,Mongolia,1,4,3,0.0,1.0,1365,1405
2018-10-16,Malaysia,Kyrgyzstan,0,1,1,0.0,1.0,1551,1581
2018-10-16,Mexico,Chile,0,1,1,0.0,1.0,2006,2021
2018-10-16,Oman,Ecuador,0,0,0,0.5,0.5,1818,1923
2018-10-16,Sweden,Slovakia,1,1,0,0.5,0.5,1944,1896
2018-10-16,United Arab Emirates,Venezuela,0,2,2,0.0,1.0,1835,1857
2018-10-16,United States,Peru,1,1,0,0.5,0.5,1986,1985
2018-10-16,Uzbekistan,Qatar,2,0,2,1.0,0.0,1857,1822
2018-10-16,Madagascar,Equatorial Guinea,1,0,1,1.0,0.0,1618,1559
2018-10-16,Malawi,Cameroon,0,0,0,0.5,0.5,1626,1860
2018-10-16,Burundi,Mali,1,1,0,0.5,0.5,1603,1746
2018-10-16,Benin,Algeria,1,0,1,1.0,0.0,1661,1810
2018-10-16,Seychelles,South Africa,0,0,0,0.5,0.5,1412,1823
2018-10-16,Liberia,Congo,2,1,1,1.0,0.0,1614,1660
2018-10-16,Central African Republic,Ivory Coast,0,0,0,0.5,0.5,1545,1883
2018-10-16,Mauritania,Angola,1,0,1,1.0,0.0,1579,1665
2018-10-16,Eswatini,Egypt,0,2,2,0.0,1.0,1545,1882
2018-10-16,Tanzania,Cape Verde,2,0,2,1.0,0.0,1634,1702
2018-10-16,Argentina,Brazil,0,1,1,0.0,1.0,2097,2221
2018-10-16,Martinique,British Virgin Islands,4,0,4,1.0,0.0,1692,1345
2018-10-16,Canada,Dominica,5,0,5,1.0,0.0,1766,1442
2018-10-16,Guadeloupe,Aruba,0,0,0,0.5,0.5,1629,1437
2018-10-16,Saint Lucia,Haiti,1,2,1,0.0,1.0,1487,1729
2018-10-16,Sudan,Senegal,0,1,1,0.0,1.0,1577,1910
2018-10-16,Comoros,Morocco,2,2,0,0.5,0.5,1449,1883
2018-10-16,South Sudan,Gabon,0,1,1,0.0,1.0,1456,1699
2018-10-16,Gambia,Togo,0,1,1,0.0,1.0,1581,1678
2018-10-16,Libya,Nigeria,2,3,1,0.0,1.0,1718,1890
2018-10-16,Rwanda,Guinea,1,1,0,0.5,0.5,1621,1760
2018-10-16,Zimbabwe,DR Congo,1,1,0,0.5,0.5,1736,1760
2018-10-16,Botswana,Burkina Faso,0,0,0,0.5,0.5,1652,1750
2018-10-16,Niger,Tunisia,1,2,1,0.0,1.0,1590,1881
2018-10-16,Namibia,Mozambique,1,0,1,1.0,0.0,1652,1636
2018-10-16,Lesotho,Uganda,0,2,2,0.0,1.0,1546,1729
2018-10-21,Parishes of Jersey,Yorkshire,2,1,1,1.0,0.0,1509,1509
2018-11-03,Malaysia,Maldives,3,0,3,1.0,0.0,1558,1457
2018-11-08,Cambodia,Malaysia,0,1,1,0.0,1.0,1354,1562
2018-11-08,Laos,Vietnam,0,3,3,0.0,1.0,1363,1694
2018-11-09,Singapore,Indonesia,1,0,1,1.0,0.0,1578,1646
2018-11-09,Thailand,Timor-Leste,7,0,7,1.0,0.0,1778,1287
2018-11-11,North Korea,Mongolia,4,1,3,1.0,0.0,1781,1404
2018-11-11,Taiwan,Hong Kong,1,2,1,0.0,1.0,1464,1614
2018-11-12,Myanmar,Cambodia,4,1,3,1.0,0.0,1549,1351
2018-11-12,Malaysia,Laos,3,1,2,1.0,0.0,1566,1360
2018-11-13,Indonesia,Timor-Leste,3,1,2,1.0,0.0,1648,1286
2018-11-13,Philippines,Singapore,1,0,1,1.0,0.0,1618,1571
2018-11-13,Taiwan,Mongolia,2,1,1,1.0,0.0,1471,1398
2018-11-13,Hong Kong,North Korea,0,0,0,0.5,0.5,1618,1778
2018-11-14,Switzerland,Qatar,0,1,1,0.0,1.0,1979,1834
2018-11-14,Vanuatu,New Caledonia,0,1,1,0.0,1.0,1628,1654
2018-11-15,Belgium,Iceland,2,0,2,1.0,0.0,2102,1828
2018-11-15,Croatia,Spain,3,2,1,1.0,0.0,2042,2154
2018-11-15,Austria,Bosnia and Herzegovina,0,0,0,0.5,0.5,1897,1910
2018-11-15,Hungary,Estonia,2,0,2,1.0,0.0,1805,1709
2018-11-15,Greece,Finland,1,0,1,1.0,0.0,1870,1819
2018-11-15,Andorra,Georgia,1,1,0,0.5,0.5,1385,1724
2018-11-15,Kazakhstan,Latvia,1,1,0,0.5,0.5,1621,1607
2018-11-15,Luxembourg,Belarus,0,2,2,0.0,1.0,1572,1763
2018-11-15,San Marino,Moldova,0,1,1,0.0,1.0,1307,1584
2018-11-15,England,United States,3,0,3,1.0,0.0,2097,1981
2018-11-15,Germany,Russia,3,0,3,1.0,0.0,2106,1954
2018-11-15,Iran,Trinidad and Tobago,1,0,1,1.0,0.0,2004,1713
2018-11-15,Israel,Guatemala,7,0,7,1.0,0.0,1770,1705
2018-11-15,Peru,Ecuador,0,2,2,0.0,1.0,1976,1933
2018-11-15,Poland,Czech Republic,0,1,1,0.0,1.0,1942,1905
2018-11-15,Republic of Ireland,Northern Ireland,0,0,0,0.5,0.5,1907,1794
2018-11-15,Uzbekistan,Lebanon,0,0,0,0.5,0.5,1854,1722
2018-11-16,Netherlands,France,2,0,2,1.0,0.0,2066,2147
2018-11-16,Slovakia,Ukraine,4,1,3,1.0,0.0,1906,1962
2018-11-16,Wales,Denmark,1,2,1,0.0,1.0,1862,1973
2018-11-16,Slovenia,Norway,1,1,0,0.5,0.5,1763,1850
2018-11-16,Cyprus,Bulgaria,1,1,0,0.5,0.5,1653,1831
2018-11-16,Gibraltar,Armenia,2,6,4,0.0,1.0,1542,1674
2018-11-16,Liechtenstein,North Macedonia,0,2,2,0.0,1.0,1429,1736
2018-11-16,Argentina,Mexico,2,0,2,1.0,0.0,2103,2001
2018-11-16,Brazil,Uruguay,1,0,1,1.0,0.0,2225,2016
2018-11-16,Chile,Costa Rica,2,3,1,0.0,1.0,2011,1901
2018-11-16,Honduras,Panama,1,0,1,1.0,0.0,1834,1826
2018-11-16,Japan,Venezuela,1,1,0,0.5,0.5,1974,1860
2018-11-16,Oman,Syria,1,1,0,0.5,0.5,1818,1795
2018-11-16,Palestine,Pakistan,2,1,1,1.0,0.0,1671,1384
2018-11-16,Saudi Arabia,Yemen,1,0,1,1.0,0.0,1848,1559
2018-11-16,United Arab Emirates,Bolivia,0,0,0,0.5,0.5,1834,1763
2018-11-16,Laos,Myanmar,1,3,2,0.0,1.0,1356,1554
2018-11-16,Vietnam,Malaysia,2,0,2,1.0,0.0,1700,1561
2018-11-16,Morocco,Cameroon,2,0,2,1.0,0.0,1891,1853
2018-11-16,South Sudan,Burundi,2,5,3,0.0,1.0,1452,1608
2018-11-16,Egypt,Tunisia,3,2,1,1.0,0.0,1890,1874
2018-11-16,Taiwan,North Korea,0,2,2,0.0,1.0,1469,1781
2018-11-16,Mongolia,Hong Kong,1,5,4,0.0,1.0,1395,1622
2018-11-16,Grenada,Saint Martin,5,2,3,1.0,0.0,1501,1430
2018-11-16,Bermuda,El Salvador,1,0,1,1.0,0.0,1570,1718
2018-11-16,Aruba,Montserrat,0,2,2,0.0,1.0,1429,1409
2018-11-16,Belize,Puerto Rico,1,0,1,1.0,0.0,1516,1426
2018-11-17,Italy,Portugal,0,0,0,0.5,0.5,2031,2074
2018-11-17,Turkey,Sweden,0,1,1,0.0,1.0,1913,1952
2018-11-17,Albania,Scotland,0,4,4,0.0,1.0,1732,1871
2018-11-17,Serbia,Montenegro,2,1,1,1.0,0.0,1914,1741
2018-11-17,Romania,Lithuania,3,0,3,1.0,0.0,1924,1608
2018-11-17,Malta,Kosovo,0,5,5,0.0,1.0,1483,1603
2018-11-17,Azerbaijan,Faroe Islands,2,0,2,1.0,0.0,1650,1503
2018-11-17,Australia,South Korea,1,1,0,0.5,0.5,1948,1952
2018-11-17,Jordan,India,2,1,1,1.0,0.0,1780,1625
2018-11-17,Vanuatu,New Caledonia,2,2,0,0.5,0.5,1629,1654
2018-11-17,Thailand,Indonesia,4,2,2,1.0,0.0,1784,1643
2018-11-17,Timor-Leste,Philippines,2,3,1,0.0,1.0,1284,1621
2018-11-17,Equatorial Guinea,Senegal,0,1,1,0.0,1.0,1558,1912
2018-11-17,Gambia,Benin,3,1,2,1.0,0.0,1591,1652
2018-11-17,Seychelles,Libya,1,8,7,0.0,1.0,1410,1721
2018-11-17,Namibia,Guinea-Bissau,0,0,0,0.5,0.5,1650,1561
2018-11-17,Uganda,Cape Verde,1,0,1,1.0,0.0,1737,1695
2018-11-17,Cuba,Dominican Republic,1,0,1,1.0,0.0,1633,1576
2018-11-17,Jamaica,Suriname,2,1,1,1.0,0.0,1776,1592
2018-11-17,Cayman Islands,Saint Lucia,0,0,0,0.5,0.5,1414,1486
2018-11-17,Nicaragua,Haiti,0,2,2,0.0,1.0,1500,1733
2018-11-17,Comoros,Malawi,2,1,1,1.0,0.0,1461,1615
2018-11-17,Gabon,Mali,0,1,1,0.0,1.0,1693,1753
2018-11-17,South Africa,Nigeria,1,1,0,0.5,0.5,1825,1889
2018-11-18,Switzerland,Belgium,5,2,3,1.0,0.0,1990,2092
2018-11-18,England,Croatia,2,1,1,1.0,0.0,2104,2036
2018-11-18,Northern Ireland,Austria,1,2,1,0.0,1.0,1789,1903
2018-11-18,Greece,Estonia,0,1,1,0.0,1.0,1859,1721
2018-11-18,Hungary,Finland,2,0,2,1.0,0.0,1814,1811
2018-11-18,San Marino,Belarus,0,2,2,0.0,1.0,1306,1765
2018-11-18,Moldova,Luxembourg,1,1,0,0.5,0.5,1584,1573
2018-11-18,Spain,Bosnia and Herzegovina,1,0,1,1.0,0.0,2158,1907
2018-11-18,Ethiopia,Ghana,0,2,2,0.0,1.0,1625,1852
2018-11-18,Congo,DR Congo,1,1,0,0.5,0.5,1663,1758
2018-11-18,Guinea,Ivory Coast,1,1,0,0.5,0.5,1763,1881
2018-11-18,Angola,Burkina Faso,2,1,1,1.0,0.0,1675,1741
2018-11-18,Yorkshire,Panjab,5,4,1,1.0,0.0,1518,1523
2018-11-18,Turks and Caicos Islands,Saint Vincent and the Grenadines,3,2,1,1.0,0.0,1430,1526
2018-11-18,Bahamas,Anguilla,1,1,0,0.5,0.5,1453,1309
2018-11-18,Barbados,United States Virgin Islands,3,0,3,1.0,0.0,1528,1370
2018-11-18,Saint Kitts and Nevis,Canada,0,1,1,0.0,1.0,1599,1771
2018-11-18,Madagascar,Sudan,1,3,2,0.0,1.0,1610,1586
2018-11-18,Togo,Algeria,1,4,3,0.0,1.0,1673,1816
2018-11-18,Liberia,Zimbabwe,1,0,1,1.0,0.0,1625,1726
2018-11-18,Rwanda,Central African Republic,2,2,0,0.5,0.5,1620,1547
2018-11-18,Mauritania,Botswana,2,1,1,1.0,0.0,1589,1643
2018-11-18,Eswatini,Niger,1,2,1,0.0,1.0,1539,1597
2018-11-18,Mozambique,Zambia,1,0,1,1.0,0.0,1647,1731
2018-11-18,Lesotho,Tanzania,1,0,1,1.0,0.0,1556,1625
2018-11-19,Germany,Netherlands,2,2,0,0.5,0.5,2106,2067
2018-11-19,Czech Republic,Slovakia,1,0,1,1.0,0.0,1914,1898
2018-11-19,Denmark,Republic of Ireland,0,0,0,0.5,0.5,1972,1909
2018-11-19,Bulgaria,Slovenia,1,1,0,0.5,0.5,1830,1765
2018-11-19,Cyprus,Norway,0,2,2,0.0,1.0,1650,1854
2018-11-19,Andorra,Latvia,0,0,0,0.5,0.5,1390,1603
2018-11-19,Georgia,Kazakhstan,2,1,1,1.0,0.0,1730,1616
2018-11-19,North Macedonia,Gibraltar,4,0,4,1.0,0.0,1740,1539
2018-11-19,Liechtenstein,Armenia,2,2,0,0.5,0.5,1434,1670
2018-11-19,Iceland,Qatar,2,2,0,0.5,0.5,1829,1834
2018-11-19,Oman,Bahrain,2,1,1,1.0,0.0,1825,1760
2018-11-19,Curaçao,Guadeloupe,6,0,6,1.0,0.0,1609,1621
2018-11-19,Martinique,Antigua and Barbuda,4,2,2,1.0,0.0,1698,1570
2018-11-20,Portugal,Poland,1,1,0,0.5,0.5,2072,1945
2018-11-20,Sweden,Russia,2,0,2,1.0,0.0,1961,1946
2018-11-20,Scotland,Israel,3,2,1,1.0,0.0,1877,1765
2018-11-20,Montenegro,Romania,0,1,1,0.0,1.0,1737,1929
2018-11-20,Serbia,Lithuania,4,1,3,1.0,0.0,1917,1606
2018-11-20,Kosovo,Azerbaijan,4,0,4,1.0,0.0,1613,1641
2018-11-20,Malta,Faroe Islands,1,1,0,0.5,0.5,1484,1503
2018-11-20,Albania,Wales,1,0,1,1.0,0.0,1743,1852
2018-11-20,Argentina,Mexico,2,0,2,1.0,0.0,2109,1996
2018-11-20,Australia,Lebanon,3,0,3,1.0,0.0,1952,1719
2018-11-20,Brazil,Cameroon,1,0,1,1.0,0.0,2227,1852
2018-11-20,Chile,Honduras,4,1,3,1.0,0.0,2016,1830
2018-11-20,China PR,Palestine,1,1,0,0.5,0.5,1846,1675
2018-11-20,El Salvador,Haiti,1,0,1,1.0,0.0,1727,1725
2018-11-20,France,Uruguay,1,0,1,1.0,0.0,2153,2011
2018-11-20,Iran,Venezuela,1,1,0,0.5,0.5,2001,1864
2018-11-20,Iraq,Bolivia,0,0,0,0.5,0.5,1828,1765
2018-11-20,Italy,United States,1,0,1,1.0,0.0,2038,1975
2018-11-20,Japan,Kyrgyzstan,4,0,4,1.0,0.0,1976,1580
2018-11-20,Jordan,Saudi Arabia,1,1,0,0.5,0.5,1782,1847
2018-11-20,South Korea,Uzbekistan,4,0,4,1.0,0.0,1958,1849
2018-11-20,Kuwait,Syria,1,2,1,0.0,1.0,1765,1803
2018-11-20,Nigeria,Uganda,0,0,0,0.5,0.5,1886,1741
2018-11-20,Panama,Ecuador,1,2,1,0.0,1.0,1821,1939
2018-11-20,Peru,Costa Rica,2,3,1,0.0,1.0,1967,1911
2018-11-20,South Africa,Paraguay,1,1,0,0.5,0.5,1827,1877
2018-11-20,Tunisia,Morocco,0,1,1,0.0,1.0,1867,1899
2018-11-20,Turkey,Ukraine,0,0,0,0.5,0.5,1915,1961
2018-11-20,United Arab Emirates,Yemen,2,0,2,1.0,0.0,1837,1557
2018-11-20,Myanmar,Vietnam,0,0,0,0.5,0.5,1558,1697
2018-11-20,Cambodia,Laos,3,1,2,1.0,0.0,1360,1348
2018-11-20,Sint Maarten,Dominica,0,2,2,0.0,1.0,1457,1451
2018-11-20,French Guiana,Guyana,2,1,1,1.0,0.0,1608,1591
2018-11-21,Philippines,Thailand,1,1,0,0.5,0.5,1625,1781
2018-11-21,Singapore,Timor-Leste,6,1,5,1.0,0.0,1574,1282
2018-11-24,Vietnam,Cambodia,3,0,3,1.0,0.0,1700,1358
2018-11-24,Malaysia,Myanmar,3,0,3,1.0,0.0,1569,1551
2018-11-25,Indonesia,Philippines,0,0,0,0.5,0.5,1643,1626
2018-11-25,Thailand,Singapore,3,0,3,1.0,0.0,1785,1571
2018-12-01,Malaysia,Thailand,0,0,0,0.5,0.5,1574,1781
2018-12-02,Philippines,Vietnam,1,2,1,0.0,1.0,1620,1707
2018-12-05,Thailand,Malaysia,2,2,0,0.5,0.5,1777,1579
2018-12-06,Vietnam,Philippines,2,1,1,1.0,0.0,1714,1614
2018-12-11,Malaysia,Vietnam,2,2,0,0.5,0.5,1582,1712
2018-12-13,Oman,Tajikistan,2,1,1,1.0,0.0,1829,1597
2018-12-15,Vietnam,Malaysia,1,0,1,1.0,0.0,1718,1577
2018-12-16,Oman,Tajikistan,1,0,1,1.0,0.0,1833,1594
2018-12-16,Palestine,Pakistan,2,0,2,1.0,0.0,1678,1382
2018-12-20,Bahrain,Tajikistan,5,0,5,1.0,0.0,1765,1590
2018-12-20,Jordan,Kyrgyzstan,0,1,1,0.0,1.0,1770,1593
2018-12-23,Qatar,Jordan,2,0,2,1.0,0.0,1841,1764
2018-12-24,Iraq,China PR,2,1,1,1.0,0.0,1837,1838
2018-12-24,Palestine,Iran,1,1,0,0.5,0.5,1684,1996
2018-12-25,Afghanistan,Turkmenistan,0,2,2,0.0,1.0,1504,1603
2018-12-25,Qatar,Kyrgyzstan,1,0,1,1.0,0.0,1845,1590
2018-12-25,Vietnam,North Korea,1,1,0,0.5,0.5,1720,1780
2018-12-27,Bahrain,Lebanon,1,0,1,1.0,0.0,1772,1713
2018-12-27,India,Oman,0,0,0,0.5,0.5,1630,1829
2018-12-27,Qatar,Algeria,0,1,1,0.0,1.0,1837,1825
2018-12-28,China PR,Jordan,1,1,0,0.5,0.5,1837,1766
2018-12-28,Iraq,Palestine,1,0,1,1.0,0.0,1842,1680
2018-12-28,United Arab Emirates,Kuwait,0,2,2,0.0,1.0,1828,1775
2018-12-29,Bahrain,North Korea,4,0,4,1.0,0.0,1781,1772
2018-12-30,Australia,Oman,5,0,5,1.0,0.0,1958,1824
2018-12-30,Yemen,Syria,0,1,1,0.0,1.0,1554,1807
2018-12-31,South Korea,Saudi Arabia,0,0,0,0.5,0.5,1956,1850
2018-12-31,Kyrgyzstan,Palestine,2,1,1,1.0,0.0,1601,1670
2018-12-31,Philippines,Vietnam,2,4,2,0.0,1.0,1609,1726
2018-12-31,Qatar,Iran,1,2,1,0.0,1.0,1833,2001
2019-01-02,Oman,Thailand,2,0,2,1.0,0.0,1831,1771
2019-01-05,United Arab Emirates,Bahrain,1,1,0,0.5,0.5,1827,1783
2019-01-06,Thailand,India,1,4,3,0.0,1.0,1760,1642
2019-01-06,Australia,Jordan,0,1,1,0.0,1.0,1946,1779
2019-01-06,Syria,Palestine,0,0,0,0.5,0.5,1804,1674
2019-01-07,China PR,Kyrgyzstan,2,1,1,1.0,0.0,1841,1598
2019-01-07,South Korea,Philippines,1,0,1,1.0,0.0,1958,1608
2019-01-07,Iran,Yemen,5,0,5,1.0,0.0,2003,1553
2019-01-08,Finland,Sweden,1,0,1,1.0,0.0,1823,1950
2019-01-08,Iraq,Vietnam,3,2,1,1.0,0.0,1848,1721
2019-01-08,Saudi Arabia,North Korea,4,0,4,1.0,0.0,1857,1766
2019-01-09,Qatar,Lebanon,2,0,2,1.0,0.0,1839,1708
2019-01-09,Japan,Turkmenistan,3,2,1,1.0,0.0,1978,1602
2019-01-09,Uzbekistan,Oman,2,1,1,1.0,0.0,1857,1824
2019-01-10,Bahrain,Thailand,0,1,1,0.0,1.0,1775,1769
2019-01-10,Jordan,Syria,2,0,2,1.0,0.0,1788,1796
2019-01-10,United Arab Emirates,India,2,0,2,1.0,0.0,1832,1638
2019-01-11,Estonia,Finland,2,1,1,1.0,0.0,1732,1813
2019-01-11,Iceland,Sweden,2,2,0,0.5,0.5,1832,1948
2019-01-11,Palestine,Australia,0,3,3,0.0,1.0,1672,1949
2019-01-11,Philippines,China PR,0,3,3,0.0,1.0,1605,1845
2019-01-11,Kyrgyzstan,South Korea,0,1,1,0.0,1.0,1597,1960
2019-01-12,Vietnam,Iran,0,2,2,0.0,1.0,1719,2006
2019-01-12,Yemen,Iraq,0,3,3,0.0,1.0,1551,1851
2019-01-12,Lebanon,Saudi Arabia,0,2,2,0.0,1.0,1704,1862
2019-01-13,North Korea,Qatar,0,6,6,0.0,1.0,1760,1846
2019-01-13,Oman,Japan,0,1,1,0.0,1.0,1820,1983
2019-01-13,Turkmenistan,Uzbekistan,0,4,4,0.0,1.0,1600,1860
2019-01-14,India,Bahrain,0,1,1,0.0,1.0,1634,1780
2019-01-14,United Arab Emirates,Thailand,1,1,0,0.5,0.5,1831,1771
2019-01-15,Estonia,Iceland,0,0,0,0.5,0.5,1735,1830
2019-01-15,Australia,Syria,3,2,1,1.0,0.0,1954,1792
2019-01-15,Palestine,Jordan,0,0,0,0.5,0.5,1675,1786
2019-01-16,South Korea,China PR,2,0,2,1.0,0.0,1966,1840
2019-01-16,Kyrgyzstan,Philippines,3,1,2,1.0,0.0,1606,1597
2019-01-16,Iran,Iraq,0,0,0,0.5,0.5,2003,1855
2019-01-16,Vietnam,Yemen,2,0,2,1.0,0.0,1724,1547
2019-01-17,Lebanon,North Korea,4,1,3,1.0,0.0,1714,1751
2019-01-17,Saudi Arabia,Qatar,0,2,2,0.0,1.0,1854,1855
2019-01-17,Japan,Uzbekistan,2,1,1,1.0,0.0,1989,1855
2019-01-17,Oman,Turkmenistan,3,1,2,1.0,0.0,1824,1597
2019-01-20,Iran,Oman,2,0,2,1.0,0.0,2008,1820
2019-01-20,Jordan,Vietnam,1,1,0,0.5,0.5,1785,1726
2019-01-20,Thailand,China PR,1,2,1,0.0,1.0,1765,1847
2019-01-21,Australia,Uzbekistan,0,0,0,0.5,0.5,1952,1858
2019-01-21,Japan,Saudi Arabia,1,0,1,1.0,0.0,1995,1849
2019-01-21,United Arab Emirates,Kyrgyzstan,3,2,1,1.0,0.0,1835,1603
2019-01-22,South Korea,Bahrain,2,1,1,1.0,0.0,1971,1776
2019-01-22,Qatar,Iraq,1,0,1,1.0,0.0,1863,1847
2019-01-24,China PR,Iran,0,3,3,0.0,1.0,1843,2013
2019-01-24,Vietnam,Japan,0,1,1,0.0,1.0,1724,1998
2019-01-25,South Korea,Qatar,0,1,1,0.0,1.0,1961,1874
2019-01-25,United Arab Emirates,Australia,1,0,1,1.0,0.0,1846,1942
2019-01-27,United States,Panama,3,0,3,1.0,0.0,1980,1817
2019-01-28,Iran,Japan,0,3,3,0.0,1.0,2005,2007
2019-01-29,United Arab Emirates,Qatar,0,4,4,0.0,1.0,1839,1882
2019-02-01,Japan,Qatar,1,3,2,0.0,1.0,1997,1893
2019-02-02,United States,Costa Rica,2,0,2,1.0,0.0,1987,1905
2019-02-21,Kazakhstan,Moldova,1,0,1,1.0,0.0,1624,1577
2019-02-23,Sint Maarten,Saint Barthélemy,1,1,0,0.5,0.5,1458,1480
2019-02-27,Cuba,Bermuda,5,0,5,1.0,0.0,1640,1564
2019-03-03,Bolivia,Nicaragua,2,2,0,0.5,0.5,1760,1506
2019-03-04,Barbados,Grenada,3,0,3,1.0,0.0,1536,1494
2019-03-06,El Salvador,Guatemala,3,1,2,1.0,0.0,1735,1698
2019-03-09,Cambodia,Bangladesh,0,1,1,0.0,1.0,1352,1411
2019-03-16,Bahamas,Turks and Caicos Islands,6,1,5,1.0,0.0,1461,1423
2019-03-17,Saint Barthélemy,Saint Martin,4,3,1,1.0,0.0,1487,1424
2019-03-18,Fiji,New Caledonia,3,0,3,1.0,0.0,1650,1646
2019-03-18,Solomon Islands,Vanuatu,3,1,2,1.0,0.0,1636,1621
2019-03-19,Myanmar,Taiwan,0,0,0,0.5,0.5,1550,1471
2019-03-20,Germany,Serbia,1,1,0,0.5,0.5,2103,1921
2019-03-20,Wales,Trinidad and Tobago,1,0,1,1.0,0.0,1857,1709
2019-03-21,Kosovo,Denmark,2,2,0,0.5,0.5,1620,1966
2019-03-21,Kuwait,Nepal,0,0,0,0.5,0.5,1769,1414
2019-03-21,Mauritius,New Caledonia,3,1,2,1.0,0.0,1488,1635
2019-03-21,United Arab Emirates,Saudi Arabia,2,1,1,1.0,0.0,1848,1841
2019-03-21,United States,Ecuador,1,0,1,1.0,0.0,1994,1933
2019-03-21,Northern Ireland,Estonia,2,0,2,1.0,0.0,1796,1729
2019-03-21,Netherlands,Belarus,4,0,4,1.0,0.0,2070,1763
2019-03-21,Croatia,Azerbaijan,2,1,1,1.0,0.0,2038,1640
2019-03-21,Slovakia,Hungary,2,0,2,1.0,0.0,1905,1808
2019-03-21,Austria,Poland,0,1,1,0.0,1.0,1896,1953
2019-03-21,North Macedonia,Latvia,3,1,2,1.0,0.0,1745,1599
2019-03-21,Israel,Slovenia,1,1,0,0.5,0.5,1765,1765
2019-03-21,Cyprus,San Marino,5,0,5,1.0,0.0,1652,1305
2019-03-21,Belgium,Russia,3,1,2,1.0,0.0,2097,1942
2019-03-21,Kazakhstan,Scotland,3,0,3,1.0,0.0,1637,1865
2019-03-21,British Virgin Islands,Turks and Caicos Islands,2,2,0,0.5,0.5,1347,1422
2019-03-22,Argentina,Venezuela,1,3,2,0.0,1.0,2097,1877
2019-03-22,Guatemala,Costa Rica,1,0,1,1.0,0.0,1711,1893
2019-03-22,Japan,Colombia,0,1,1,0.0,1.0,1991,2062
2019-03-22,South Korea,Bolivia,1,0,1,1.0,0.0,1965,1757
2019-03-22,Mexico,Chile,3,1,2,1.0,0.0,2005,2008
2019-03-22,Peru,Paraguay,1,0,1,1.0,0.0,1973,1872
2019-03-22,Bulgaria,Montenegro,1,1,0,0.5,0.5,1828,1740
2019-03-22,England,Czech Republic,5,0,5,1.0,0.0,2109,1910
2019-03-22,Portugal,Ukraine,0,0,0,0.5,0.5,2070,1964
2019-03-22,Luxembourg,Lithuania,2,1,1,1.0,0.0,1582,1598
2019-03-22,Albania,Turkey,0,2,2,0.0,1.0,1739,1920
2019-03-22,Andorra,Iceland,0,2,2,0.0,1.0,1389,1832
2019-03-22,Moldova,France,1,4,3,0.0,1.0,1577,2154
2019-03-22,Botswana,Angola,0,1,1,0.0,1.0,1636,1683
2019-03-22,Anguilla,United States Virgin Islands,0,3,3,0.0,1.0,1303,1377
2019-03-22,Saint Vincent and the Grenadines,Bonaire,2,1,1,1.0,0.0,1533,1470
2019-03-22,Cayman Islands,Montserrat,1,2,1,0.0,1.0,1406,1418
2019-03-22,Saint Lucia,Aruba,3,2,1,1.0,0.0,1493,1423
2019-03-22,Sudan,Equatorial Guinea,1,4,3,0.0,1.0,1578,1567
2019-03-22,Malawi,Morocco,0,0,0,0.5,0.5,1621,1894
2019-03-22,Algeria,Gambia,1,1,0,0.5,0.5,1821,1596
2019-03-22,Nigeria,Seychelles,3,1,2,1.0,0.0,1887,1410
2019-03-22,Burkina Faso,Mauritania,1,0,1,1.0,0.0,1746,1585
2019-03-22,Tunisia,Eswatini,4,0,4,1.0,0.0,1870,1537
2019-03-23,Brazil,Panama,1,1,0,0.5,0.5,2221,1824
2019-03-23,Malaysia,Afghanistan,2,1,1,1.0,0.0,1584,1498
2019-03-23,Oman,Singapore,1,1,0,0.5,0.5,1816,1576
2019-03-23,Georgia,Switzerland,0,2,2,0.0,1.0,1728,1993
2019-03-23,Gibraltar,Republic of Ireland,0,1,1,0.0,1.0,1538,1911
2019-03-23,Malta,Faroe Islands,2,1,1,1.0,0.0,1493,1495
2019-03-23,Sweden,Romania,2,1,1,1.0,0.0,1956,1922
2019-03-23,Spain,Norway,2,1,1,1.0,0.0,2161,1852
2019-03-23,Bosnia and Herzegovina,Armenia,2,1,1,1.0,0.0,1911,1667
2019-03-23,Italy,Finland,2,0,2,1.0,0.0,2042,1810
2019-03-23,Liechtenstein,Greece,0,2,2,0.0,1.0,1433,1861
2019-03-23,Senegal,Madagascar,2,0,2,1.0,0.0,1915,1608
2019-03-23,Cameroon,Comoros,3,0,3,1.0,0.0,1854,1460
2019-03-23,Mali,South Sudan,3,0,3,1.0,0.0,1756,1450
2019-03-23,Ghana,Kenya,1,0,1,1.0,0.0,1857,1686
2019-03-23,Niger,Egypt,1,1,0,0.5,0.5,1603,1885
2019-03-23,Zambia,Namibia,4,1,3,1.0,0.0,1738,1644
2019-03-23,Dominica,Bahamas,4,0,4,1.0,0.0,1460,1453
2019-03-23,Sint Maarten,Saint Martin,4,3,1,1.0,0.0,1466,1417
2019-03-23,Antigua and Barbuda,Curaçao,2,1,1,1.0,0.0,1579,1601
2019-03-23,Guyana,Belize,2,1,1,1.0,0.0,1598,1510
2019-03-23,Suriname,Saint Kitts and Nevis,2,0,2,1.0,0.0,1601,1591
2019-03-23,Guadeloupe,Martinique,0,1,1,0.0,1.0,1615,1705
2019-03-23,Burundi,Gabon,1,1,0,0.5,0.5,1610,1692
2019-03-23,Ivory Coast,Rwanda,3,0,3,1.0,0.0,1884,1618
2019-03-23,Guinea-Bissau,Mozambique,2,2,0,0.5,0.5,1563,1646
2019-03-23,Vatican City,Raetia,2,2,0,0.5,0.5,1472,1447
2019-03-23,Alderney,Jersey,0,2,2,0.0,1.0,1260,1748
2019-03-24,Taiwan,Solomon Islands,0,1,1,0.0,1.0,1467,1641
2019-03-24,Fiji,Mauritius,1,0,1,1.0,0.0,1655,1484
2019-03-24,Northern Ireland,Belarus,2,1,1,1.0,0.0,1804,1756
2019-03-24,Netherlands,Germany,2,3,1,0.0,1.0,2063,2111
2019-03-24,Wales,Slovakia,1,0,1,1.0,0.0,1867,1896
2019-03-24,Hungary,Croatia,2,1,1,1.0,0.0,1821,2026
2019-03-24,Israel,Austria,4,2,2,1.0,0.0,1776,1886
2019-03-24,Poland,Latvia,2,0,2,1.0,0.0,1955,1598
2019-03-24,Slovenia,North Macedonia,1,1,0,0.5,0.5,1765,1746
2019-03-24,San Marino,Scotland,0,2,2,0.0,1.0,1305,1866
2019-03-24,Kazakhstan,Russia,0,4,4,0.0,1.0,1635,1945
2019-03-24,Cyprus,Belgium,0,2,2,0.0,1.0,1651,2099
2019-03-24,Benin,Togo,2,1,1,1.0,0.0,1661,1665
2019-03-24,Libya,South Africa,1,2,1,0.0,1.0,1716,1833
2019-03-24,Zimbabwe,Congo,2,0,2,1.0,0.0,1733,1657
2019-03-24,Central African Republic,Guinea,0,0,0,0.5,0.5,1552,1759
2019-03-24,Tanzania,Uganda,3,0,3,1.0,0.0,1636,1731
2019-03-24,British Virgin Islands,Bonaire,1,2,1,0.0,1.0,1342,1476
2019-03-24,Puerto Rico,Grenada,0,2,2,0.0,1.0,1420,1501
2019-03-24,Canada,French Guiana,4,1,3,1.0,0.0,1776,1604
2019-03-24,Dominican Republic,Bermuda,1,3,2,0.0,1.0,1568,1573
2019-03-24,Haiti,Cuba,2,1,1,1.0,0.0,1732,1634
2019-03-24,Barbados,Nicaragua,0,1,1,0.0,1.0,1528,1515
2019-03-24,El Salvador,Jamaica,2,0,2,1.0,0.0,1744,1768
2019-03-24,DR Congo,Liberia,1,0,1,1.0,0.0,1764,1620
2019-03-24,Cape Verde,Lesotho,0,0,0,0.5,0.5,1692,1560
2019-03-25,Catalonia,Venezuela,2,1,1,1.0,0.0,1681,1865
2019-03-25,Azerbaijan,Lithuania,0,0,0,0.5,0.5,1640,1599
2019-03-25,Kuwait,Nepal,1,0,1,1.0,0.0,1771,1413
2019-03-25,Myanmar,Indonesia,0,2,2,0.0,1.0,1545,1649
2019-03-25,Saudi Arabia,Equatorial Guinea,3,2,1,1.0,0.0,1844,1565
2019-03-25,Kosovo,Bulgaria,1,1,0,0.5,0.5,1625,1824
2019-03-25,Montenegro,England,1,5,4,0.0,1.0,1739,2111
2019-03-25,Portugal,Serbia,1,1,0,0.5,0.5,2067,1925
2019-03-25,Luxembourg,Ukraine,1,2,1,0.0,1.0,1581,1966
2019-03-25,Turkey,Moldova,4,0,4,1.0,0.0,1922,1576
2019-03-25,Andorra,Albania,0,3,3,0.0,1.0,1388,1741
2019-03-25,France,Iceland,4,0,4,1.0,0.0,2157,1830
2019-03-26,Algeria,Tunisia,1,0,1,1.0,0.0,1831,1861
2019-03-26,Costa Rica,Jamaica,1,0,1,1.0,0.0,1899,1763
2019-03-26,Czech Republic,Brazil,1,3,2,0.0,1.0,1908,2224
2019-03-26,Ghana,Mauritania,3,1,2,1.0,0.0,1860,1583
2019-03-26,Gibraltar,Estonia,0,1,1,0.0,1.0,1535,1733
2019-03-26,Honduras,Ecuador,0,0,0,0.5,0.5,1833,1931
2019-03-26,Ivory Coast,Liberia,1,0,1,1.0,0.0,1887,1618
2019-03-26,Japan,Bolivia,1,0,1,1.0,0.0,1995,1754
2019-03-26,South Korea,Colombia,2,1,1,1.0,0.0,1976,2052
2019-03-26,Morocco,Argentina,0,1,1,0.0,1.0,1891,2101
2019-03-26,Nicaragua,Guatemala,0,1,1,0.0,1.0,1512,1715
2019-03-26,Nigeria,Egypt,1,0,1,1.0,0.0,1895,1878
2019-03-26,Paraguay,Mexico,2,4,2,0.0,1.0,1867,2011
2019-03-26,Peru,El Salvador,0,2,2,0.0,1.0,1961,1757
2019-03-26,Senegal,Mali,2,1,1,1.0,0.0,1920,1752
2019-03-26,United Arab Emirates,Syria,0,0,0,0.5,0.5,1847,1794
2019-03-26,United States,Chile,1,1,0,0.5,0.5,1995,2008
2019-03-26,Republic of Ireland,Georgia,1,0,1,1.0,0.0,1916,1724
2019-03-26,Switzerland,Denmark,3,3,0,0.5,0.5,1993,1967
2019-03-26,Malta,Spain,0,2,2,0.0,1.0,1493,2162
2019-03-26,Norway,Sweden,3,3,0,0.5,0.5,1855,1954
2019-03-26,Romania,Faroe Islands,4,1,3,1.0,0.0,1924,1494
2019-03-26,Bosnia and Herzegovina,Greece,2,2,0,0.5,0.5,1910,1863
2019-03-26,Italy,Liechtenstein,6,0,6,1.0,0.0,2043,1433
2019-03-26,Armenia,Finland,0,2,2,0.0,1.0,1663,1815
2019-05-04,Yorkshire,Somaliland,6,2,4,1.0,0.0,1526,1495
2019-05-11,Guernsey,Jersey,0,0,0,0.5,0.5,1732,1748
2019-05-25,Eswatini,Mauritius,2,2,0,0.5,0.5,1536,1486
2019-05-25,Kernow,Barawa,5,0,5,1.0,0.0,1561,1465
2019-05-25,Cascadia,Chagos Islands,6,3,3,1.0,0.0,1519,1460
2019-05-26,Mozambique,Namibia,1,2,1,0.0,1.0,1638,1653
2019-05-26,Malawi,Seychelles,3,0,3,1.0,0.0,1625,1407
2019-05-27,Eswatini,Comoros,2,2,0,0.5,0.5,1535,1462
2019-05-28,Seychelles,Mozambique,0,0,0,0.5,0.5,1412,1634
2019-05-28,Namibia,Malawi,1,2,1,0.0,1.0,1645,1634
2019-05-28,Laos,Sri Lanka,2,1,1,1.0,0.0,1356,1323
2019-05-29,Comoros,Mauritius,2,1,1,1.0,0.0,1471,1478
2019-05-29,Panama,Basque Country,0,0,0,0.5,0.5,1823,1780
2019-05-30,Mozambique,Malawi,1,1,0,0.5,0.5,1634,1634
2019-05-30,Namibia,Seychelles,3,0,3,1.0,0.0,1649,1409
2019-05-30,Turkey,Greece,2,1,1,1.0,0.0,1929,1857
2019-05-31,Laos,Sri Lanka,2,2,0,0.5,0.5,1356,1324
2019-06-01,Lesotho,Uganda,0,0,0,0.5,0.5,1564,1728
2019-06-01,Zimbabwe,Comoros,2,0,2,1.0,0.0,1736,1469
2019-06-01,Venezuela,Ecuador,1,1,0,0.5,0.5,1867,1930
2019-06-01,Yorkshire,Parishes of Jersey,1,0,1,1.0,0.0,1534,1502
2019-06-02,South Africa,Botswana,2,2,0,0.5,0.5,1829,1641
2019-06-02,Zambia,Malawi,2,2,0,0.5,0.5,1736,1637
2019-06-02,El Salvador,Haiti,1,0,1,1.0,0.0,1765,1725
2019-06-02,France,Bolivia,2,0,2,1.0,0.0,2159,1753
2019-06-02,Luxembourg,Madagascar,3,3,0,0.5,0.5,1582,1608
2019-06-02,Malaysia,Nepal,2,0,2,1.0,0.0,1589,1409
2019-06-02,Turkey,Uzbekistan,2,0,2,1.0,0.0,1936,1852
2019-06-02,Abkhazia,Chameria,3,1,2,1.0,0.0,1569,1494
2019-06-02,Artsakh,Sápmi,3,2,1,1.0,0.0,1518,1504
2019-06-02,Padania,Székely Land,4,0,4,1.0,0.0,1645,1494
2019-06-02,Western Armenia,South Ossetia,1,2,1,0.0,1.0,1493,1472
2019-06-02,Parishes of Jersey,Chagos Islands,9,2,7,1.0,0.0,1510,1453
2019-06-03,Colombia,Panama,3,0,3,1.0,0.0,2056,1820
2019-06-03,Vanuatu,Tahiti,2,0,2,1.0,0.0,1630,1646
2019-06-03,Artsakh,Chameria,1,4,3,0.0,1.0,1510,1503
2019-06-03,Sápmi,Abkhazia,0,1,1,0.0,1.0,1498,1576
2019-06-03,Székely Land,Western Armenia,0,5,5,0.0,1.0,1486,1502
2019-06-03,South Ossetia,Padania,2,1,1,1.0,0.0,1484,1634
2019-06-04,Comoros,Malawi,1,2,1,0.0,1.0,1465,1642
2019-06-04,Artsakh,Abkhazia,1,1,0,0.5,0.5,1512,1575
2019-06-04,Chameria,Sápmi,4,0,4,1.0,0.0,1511,1491
2019-06-04,South Ossetia,Székely Land,2,2,0,0.5,0.5,1485,1486
2019-06-04,Padania,Western Armenia,1,1,0,0.5,0.5,1632,1505
2019-06-04,South Africa,Uganda,1,1,0,0.5,0.5,1827,1731
2019-06-05,Lesotho,Botswana,1,2,1,0.0,1.0,1558,1648
2019-06-05,Zimbabwe,Zambia,0,0,0,0.5,0.5,1736,1736
2019-06-05,Brazil,Qatar,2,0,2,1.0,0.0,2227,1891
2019-06-05,Japan,Trinidad and Tobago,0,0,0,0.5,0.5,1990,1715
2019-06-05,Mexico,Venezuela,3,1,2,1.0,0.0,2016,1863
2019-06-05,Paraguay,Honduras,1,1,0,0.5,0.5,1867,1834
2019-06-05,Peru,Costa Rica,1,0,1,1.0,0.0,1968,1893
2019-06-05,United States,Jamaica,0,1,1,0.0,1.0,1983,1776
2019-06-05,Portugal,Switzerland,3,1,2,1.0,0.0,2074,1987
2019-06-06,Bermuda,Guyana,1,0,1,1.0,0.0,1582,1590
2019-06-06,Chile,Haiti,2,1,1,1.0,0.0,2011,1723
2019-06-06,Taiwan,Nepal,1,1,0,0.5,0.5,1466,1411
2019-06-06,Iran,Syria,5,0,5,1.0,0.0,2009,1791
2019-06-06,Slovakia,Jordan,5,1,4,1.0,0.0,1902,1780
2019-06-06,Tajikistan,Afghanistan,1,1,0,0.5,0.5,1588,1501
2019-06-06,England,Netherlands,1,3,2,0.0,1.0,2102,2073
2019-06-06,Abkhazia,Western Armenia,1,1,0,0.5,0.5,1574,1507
2019-06-06,South Ossetia,Chameria,0,0,0,0.5,0.5,1486,1511
2019-06-06,Padania,Sápmi,4,0,4,1.0,0.0,1637,1487
2019-06-06,Artsakh,Székely Land,2,1,1,1.0,0.0,1520,1479
2019-06-06,Bhutan,Guam,1,0,1,1.0,0.0,1256,1405
2019-06-06,Cambodia,Pakistan,2,0,2,1.0,0.0,1361,1374
2019-06-06,Laos,Bangladesh,0,1,1,0.0,1.0,1350,1418
2019-06-06,Macau,Sri Lanka,1,0,1,1.0,0.0,1331,1316
2019-06-06,Mongolia,Brunei,2,0,2,1.0,0.0,1401,1265
2019-06-07,Czech Republic,Bulgaria,2,1,1,1.0,0.0,1915,1818
2019-06-07,Montenegro,Kosovo,1,1,0,0.5,0.5,1737,1628
2019-06-07,Lithuania,Luxembourg,1,1,0,0.5,0.5,1599,1583
2019-06-07,Ukraine,Serbia,5,0,5,1.0,0.0,1974,1918
2019-06-07,Georgia,Gibraltar,3,0,3,1.0,0.0,1729,1531
2019-06-07,Denmark,Republic of Ireland,1,1,0,0.5,0.5,1966,1918
2019-06-07,Faroe Islands,Spain,1,4,3,0.0,1.0,1494,2163
2019-06-07,Norway,Romania,2,2,0,0.5,0.5,1857,1923
2019-06-07,Sweden,Malta,3,0,3,1.0,0.0,1956,1492
2019-06-07,Austria,Slovenia,1,0,1,1.0,0.0,1892,1760
2019-06-07,North Macedonia,Poland,0,1,1,0.0,1.0,1743,1959
2019-06-07,Latvia,Israel,0,3,3,0.0,1.0,1594,1781
2019-06-07,Lesotho,Zimbabwe,2,2,0,0.5,0.5,1562,1733
2019-06-07,South Africa,Malawi,0,0,0,0.5,0.5,1824,1646
2019-06-07,Argentina,Nicaragua,5,1,4,1.0,0.0,2102,1512
2019-06-07,China PR,Philippines,2,0,2,1.0,0.0,1847,1594
2019-06-07,Fiji,Tahiti,1,1,0,0.5,0.5,1655,1647
2019-06-07,Ivory Coast,Comoros,3,1,2,1.0,0.0,1889,1464
2019-06-07,Kenya,Madagascar,1,0,1,1.0,0.0,1693,1602
2019-06-07,South Korea,Australia,1,0,1,1.0,0.0,1984,1935
2019-06-07,Tunisia,Iraq,2,0,2,1.0,0.0,1869,1840
2019-06-07,Uruguay,Panama,3,0,3,1.0,0.0,2015,1817
2019-06-07,Uzbekistan,North Korea,4,0,4,1.0,0.0,1858,1746
2019-06-07,Malaysia,Timor-Leste,7,1,6,1.0,0.0,1592,1280
2019-06-08,Estonia,Northern Ireland,1,2,1,0.0,1.0,1727,1811
2019-06-08,Belarus,Germany,0,2,2,0.0,1.0,1755,2113
2019-06-08,Croatia,Wales,2,1,1,1.0,0.0,2031,1863
2019-06-08,Azerbaijan,Hungary,1,3,2,0.0,1.0,1636,1826
2019-06-08,Iceland,Albania,1,0,1,1.0,0.0,1836,1736
2019-06-08,Moldova,Andorra,1,0,1,1.0,0.0,1581,1384
2019-06-08,Turkey,France,2,0,2,1.0,0.0,1949,2147
2019-06-08,Russia,San Marino,9,0,9,1.0,0.0,1946,1305
2019-06-08,Scotland,Cyprus,2,1,1,1.0,0.0,1870,1648
2019-06-08,Belgium,Kazakhstan,3,0,3,1.0,0.0,2101,1634
2019-06-08,Finland,Bosnia and Herzegovina,2,0,2,1.0,0.0,1826,1900
2019-06-08,Armenia,Liechtenstein,3,0,3,1.0,0.0,1667,1430
2019-06-08,Greece,Italy,0,3,3,0.0,1.0,1853,2048
2019-06-08,Botswana,Zambia,0,1,1,0.0,1.0,1642,1743
2019-06-08,Angola,Guinea-Bissau,2,0,2,1.0,0.0,1689,1558
2019-06-08,Nigeria,Zimbabwe,0,0,0,0.5,0.5,1892,1737
2019-06-08,Singapore,Solomon Islands,4,3,1,1.0,0.0,1586,1632
2019-06-08,Abkhazia,Chameria,0,0,0,0.5,0.5,1573,1513
2019-06-08,Sápmi,Székely Land,3,2,1,1.0,0.0,1495,1472
2019-06-08,Artsakh,Padania,2,0,2,1.0,0.0,1531,1627
2019-06-09,Brazil,Honduras,7,0,7,1.0,0.0,2229,1833
2019-06-09,Cameroon,Zambia,2,1,1,1.0,0.0,1860,1738
2019-06-09,DR Congo,Burkina Faso,0,0,0,0.5,0.5,1764,1747
2019-06-09,Japan,El Salvador,2,0,2,1.0,0.0,1994,1762
2019-06-09,Mexico,Ecuador,3,2,1,1.0,0.0,2023,1924
2019-06-09,Paraguay,Guatemala,2,0,2,1.0,0.0,1872,1711
2019-06-09,Peru,Colombia,0,3,3,0.0,1.0,1962,2063
2019-06-09,Turkmenistan,Uganda,0,0,0,0.5,0.5,1600,1729
2019-06-09,United States,Venezuela,0,3,3,0.0,1.0,1973,1874
2019-06-09,Switzerland,England,0,0,0,0.5,0.5,1990,2100
2019-06-09,Portugal,Netherlands,1,0,1,1.0,0.0,2082,2066
2019-06-09,Western Armenia,South Ossetia,0,1,1,0.0,1.0,1499,1495
2019-06-10,Czech Republic,Montenegro,3,0,3,1.0,0.0,1920,1733
2019-06-10,Bulgaria,Kosovo,2,3,1,0.0,1.0,1807,1640
2019-06-10,Serbia,Lithuania,4,1,3,1.0,0.0,1921,1597
2019-06-10,Ukraine,Luxembourg,1,0,1,1.0,0.0,1976,1582
2019-06-10,Republic of Ireland,Gibraltar,2,0,2,1.0,0.0,1920,1530
2019-06-10,Denmark,Georgia,5,1,4,1.0,0.0,1970,1726
2019-06-10,Faroe Islands,Norway,0,2,2,0.0,1.0,1493,1859
2019-06-10,Malta,Romania,0,4,4,0.0,1.0,1491,1925
2019-06-10,Spain,Sweden,3,0,3,1.0,0.0,2167,1953
2019-06-10,North Macedonia,Austria,1,4,3,0.0,1.0,1739,1897
2019-06-10,Poland,Israel,4,0,4,1.0,0.0,1964,1777
2019-06-10,Latvia,Slovenia,0,5,5,0.0,1.0,1590,1765
2019-06-10,Vanuatu,Fiji,0,0,0,0.5,0.5,1631,1655
2019-06-11,Germany,Estonia,8,0,8,1.0,0.0,2115,1726
2019-06-11,Belarus,Northern Ireland,0,1,1,0.0,1.0,1749,1818
2019-06-11,Azerbaijan,Slovakia,1,5,4,0.0,1.0,1634,1905
2019-06-11,Hungary,Wales,1,0,1,1.0,0.0,1835,1855
2019-06-11,Iceland,Turkey,2,1,1,1.0,0.0,1847,1939
2019-06-11,Albania,Moldova,2,0,2,1.0,0.0,1741,1577
2019-06-11,Andorra,France,0,4,4,0.0,1.0,1384,2148
2019-06-11,Kazakhstan,San Marino,4,0,4,1.0,0.0,1637,1303
2019-06-11,Belgium,Scotland,3,0,3,1.0,0.0,2105,1867
2019-06-11,Russia,Cyprus,1,0,1,1.0,0.0,1949,1646
2019-06-11,Italy,Bosnia and Herzegovina,2,1,1,1.0,0.0,2053,1896
2019-06-11,Liechtenstein,Finland,0,2,2,0.0,1.0,1429,1828
2019-06-11,Greece,Armenia,2,3,1,0.0,1.0,1842,1679
2019-06-11,Algeria,Burundi,1,1,0,0.5,0.5,1827,1615
2019-06-11,Benin,Guinea,1,0,1,1.0,0.0,1672,1749
2019-06-11,China PR,Tajikistan,1,0,1,1.0,0.0,1850,1586
2019-06-11,Croatia,Tunisia,1,2,1,0.0,1.0,2020,1881
2019-06-11,Hong Kong,Taiwan,0,2,2,0.0,1.0,1611,1478
2019-06-11,Jordan,Indonesia,4,1,3,1.0,0.0,1786,1644
2019-06-11,South Korea,Iran,1,1,0,0.5,0.5,1985,2009
2019-06-11,Kyrgyzstan,Palestine,2,2,0,0.5,0.5,1605,1674
2019-06-11,Singapore,Myanmar,1,2,1,0.0,1.0,1578,1554
2019-06-11,Uzbekistan,Syria,2,0,2,1.0,0.0,1865,1785
2019-06-11,Bangladesh,Laos,0,0,0,0.5,0.5,1417,1352
2019-06-11,Brunei,Mongolia,2,1,1,1.0,0.0,1276,1391
2019-06-11,Guam,Bhutan,5,0,5,1.0,0.0,1410,1252
2019-06-11,Pakistan,Cambodia,1,2,1,0.0,1.0,1366,1370
2019-06-11,Sri Lanka,Macau,3,0,3,1.0,0.0,1325,1323
2019-06-11,Malaysia,Timor-Leste,5,1,4,1.0,0.0,1595,1278
2019-06-12,Morocco,Gambia,0,1,1,0.0,1.0,1878,1610
2019-06-12,Ynys Môn,Saint Helena,7,2,5,1.0,0.0,1573,1494
2019-06-13,Egypt,Tanzania,1,0,1,1.0,0.0,1882,1633
2019-06-14,Cameroon,Mali,1,1,0,0.5,0.5,1858,1755
2019-06-14,Madagascar,Mauritania,1,3,2,0.0,1.0,1594,1592
2019-06-14,Brazil,Bolivia,3,0,3,1.0,0.0,2230,1753
2019-06-15,Venezuela,Peru,0,0,0,0.5,0.5,1876,1961
2019-06-15,Argentina,Colombia,0,2,2,0.0,1.0,2094,2072
2019-06-15,Canada,Martinique,4,0,4,1.0,0.0,1783,1699
2019-06-15,Mexico,Cuba,7,0,7,1.0,0.0,2025,1633
2019-06-15,Ghana,South Africa,0,0,0,0.5,0.5,1860,1825
2019-06-15,Indonesia,Vanuatu,6,0,6,1.0,0.0,1652,1624
2019-06-15,Ivory Coast,Uganda,0,1,1,0.0,1.0,1878,1741
2019-06-15,Kenya,DR Congo,1,1,0,0.5,0.5,1695,1763
2019-06-15,Tanzania,Zimbabwe,1,1,0,0.5,0.5,1636,1735
2019-06-16,Jersey,Orkney,5,0,5,1.0,0.0,1751,1455
2019-06-16,Ynys Môn,Western Isles,2,1,1,1.0,0.0,1580,1494
2019-06-16,Alderney,Hitra,2,4,2,0.0,1.0,1256,1452
2019-06-16,Saint Helena,Shetland,1,6,5,0.0,1.0,1487,1506
2019-06-16,Paraguay,Qatar,2,2,0,0.5,0.5,1873,1891
2019-06-16,Uruguay,Ecuador,4,0,4,1.0,0.0,2021,1919
2019-06-16,Haiti,Bermuda,2,1,1,1.0,0.0,1728,1578
2019-06-16,Costa Rica,Nicaragua,4,0,4,1.0,0.0,1895,1511
2019-06-16,Algeria,Mali,3,2,1,1.0,0.0,1834,1749
2019-06-16,Egypt,Guinea,3,1,2,1.0,0.0,1888,1744
2019-06-16,Morocco,Zambia,2,3,1,0.0,1.0,1867,1750
2019-06-16,Senegal,Nigeria,1,0,1,1.0,0.0,1928,1885
2019-06-17,Ynys Môn,Orkney,3,1,2,1.0,0.0,1586,1450
2019-06-17,Jersey,Western Isles,7,0,7,1.0,0.0,1754,1492
2019-06-17,Isle of Man,Hitra,7,1,6,1.0,0.0,1625,1448
2019-06-17,Guernsey,Shetland,2,1,1,1.0,0.0,1736,1503
2019-06-17,Japan,Chile,0,4,4,0.0,1.0,1987,2019
2019-06-17,Curaçao,El Salvador,0,1,1,0.0,1.0,1597,1767
2019-06-17,Jamaica,Honduras,3,2,1,1.0,0.0,1786,1824
2019-06-17,Tunisia,Burundi,2,1,1,1.0,0.0,1884,1613
2019-06-18,Ynys Môn,Jersey,1,0,1,1.0,0.0,1598,1743
2019-06-18,Western Isles,Orkney,1,2,1,0.0,1.0,1484,1459
2019-06-18,Isle of Man,Alderney,6,1,5,1.0,0.0,1627,1255
2019-06-18,Guernsey,Saint Helena,9,0,9,1.0,0.0,1740,1484
2019-06-18,Bolivia,Peru,1,3,2,0.0,1.0,1750,1965
2019-06-18,Brazil,Venezuela,0,0,0,0.5,0.5,2224,1883
2019-06-18,Panama,Trinidad and Tobago,2,0,2,1.0,0.0,1823,1710
2019-06-18,United States,Guyana,4,0,4,1.0,0.0,1975,1589
2019-06-18,Benin,Mauritania,3,1,2,1.0,0.0,1679,1586
2019-06-19,Colombia,Qatar,1,0,1,1.0,0.0,2077,1887
2019-06-19,Argentina,Paraguay,1,1,0,0.5,0.5,2090,1878
2019-06-19,Cuba,Martinique,0,3,3,0.0,1.0,1627,1706
2019-06-19,Mexico,Canada,3,1,2,1.0,0.0,2029,1780
2019-06-19,Ivory Coast,Zambia,4,1,3,1.0,0.0,1884,1745
2019-06-20,Western Isles,Saint Helena,2,1,1,1.0,0.0,1492,1476
2019-06-20,Orkney,Alderney,1,2,1,0.0,1.0,1447,1268
2019-06-20,Jersey,Hitra,3,1,2,1.0,0.0,1746,1446
2019-06-20,Ynys Môn,Shetland,2,1,1,1.0,0.0,1604,1498
2019-06-20,Isle of Man,Guernsey,2,3,1,0.0,1.0,1622,1746
2019-06-20,Uruguay,Japan,2,2,0,0.5,0.5,2021,1988
2019-06-20,Nicaragua,Haiti,0,2,2,0.0,1.0,1508,1732
2019-06-20,Costa Rica,Bermuda,2,1,1,1.0,0.0,1898,1576
2019-06-21,Shetland,Isle of Man,0,5,5,0.0,1.0,1493,1628
2019-06-21,Ynys Môn,Guernsey,2,1,1,1.0,0.0,1616,1735
2019-06-21,Egypt,Zimbabwe,1,0,1,1.0,0.0,1893,1731
2019-06-21,Ecuador,Chile,1,2,1,0.0,1.0,1914,2025
2019-06-21,El Salvador,Jamaica,0,0,0,0.5,0.5,1768,1786
2019-06-21,Honduras,Curaçao,0,1,1,0.0,1.0,1812,1610
2019-06-22,DR Congo,Uganda,0,2,2,0.0,1.0,1755,1750
2019-06-22,Nigeria,Burundi,1,0,1,1.0,0.0,1888,1611
2019-06-22,Guinea,Madagascar,2,2,0,0.5,0.5,1741,1598
2019-06-22,Bolivia,Venezuela,1,3,2,0.0,1.0,1745,1889
2019-06-22,Guyana,Panama,2,4,2,0.0,1.0,1586,1827
2019-06-22,United States,Trinidad and Tobago,6,0,6,1.0,0.0,1978,1708
2019-06-22,Brazil,Peru,5,0,5,1.0,0.0,2227,1963
2019-06-23,Senegal,Tanzania,2,0,2,1.0,0.0,1931,1634
2019-06-23,Algeria,Kenya,2,0,2,1.0,0.0,1839,1691
2019-06-23,Morocco,Namibia,1,0,1,1.0,0.0,1871,1646
2019-06-23,Colombia,Paraguay,1,0,1,1.0,0.0,2081,1875
2019-06-23,Qatar,Argentina,0,2,2,0.0,1.0,1884,2094
2019-06-23,Canada,Cuba,7,0,7,1.0,0.0,1785,1623
2019-06-23,Martinique,Mexico,2,3,1,0.0,1.0,1704,2032
2019-06-24,Ivory Coast,South Africa,1,0,1,1.0,0.0,1891,1819
2019-06-24,Tunisia,Angola,1,1,0,0.5,0.5,1880,1694
2019-06-24,Mali,Mauritania,4,1,3,1.0,0.0,1754,1582
2019-06-24,Chile,Uruguay,0,1,1,0.0,1.0,2017,2030
2019-06-24,Ecuador,Japan,1,1,0,0.5,0.5,1916,1987
2019-06-24,Bermuda,Nicaragua,2,0,2,1.0,0.0,1583,1502
2019-06-24,Haiti,Costa Rica,2,1,1,1.0,0.0,1744,1887
2019-06-25,Cameroon,Guinea-Bissau,2,0,2,1.0,0.0,1861,1556
2019-06-25,Ghana,Benin,2,2,0,0.5,0.5,1857,1683
2019-06-25,Jamaica,Curaçao,1,1,0,0.5,0.5,1783,1614
2019-06-25,Honduras,El Salvador,4,0,4,1.0,0.0,1819,1762
2019-06-25,Raetia,Franconia,3,4,1,0.0,1.0,1441,1506
2019-06-26,Uganda,Zimbabwe,1,1,0,0.5,0.5,1750,1732
2019-06-26,Egypt,DR Congo,2,0,2,1.0,0.0,1898,1751
2019-06-26,Nigeria,Guinea,1,0,1,1.0,0.0,1893,1737
2019-06-26,Trinidad and Tobago,Guyana,1,1,0,0.5,0.5,1706,1589
2019-06-26,United States,Panama,1,0,1,1.0,0.0,1983,1823
2019-06-27,Madagascar,Burundi,1,0,1,1.0,0.0,1607,1603
2019-06-27,Senegal,Algeria,0,1,1,0.0,1.0,1921,1850
2019-06-27,Kenya,Tanzania,3,2,1,1.0,0.0,1698,1628
2019-06-27,Brazil,Paraguay,0,0,0,0.5,0.5,2221,1882
2019-06-28,Morocco,Ivory Coast,1,0,1,1.0,0.0,1880,1883
2019-06-28,South Africa,Namibia,1,0,1,1.0,0.0,1824,1642
2019-06-28,Tunisia,Mali,1,1,0,0.5,0.5,1878,1757
2019-06-28,Colombia,Chile,0,0,0,0.5,0.5,2080,2019
2019-06-28,Venezuela,Argentina,0,2,2,0.0,1.0,1886,2098
2019-06-29,Mauritania,Angola,0,0,0,0.5,0.5,1585,1692
2019-06-29,Cameroon,Ghana,0,0,0,0.5,0.5,1861,1858
2019-06-29,Benin,Guinea-Bissau,0,0,0,0.5,0.5,1681,1559
2019-06-29,Uruguay,Peru,0,0,0,0.5,0.5,2029,1965
2019-06-29,Haiti,Canada,3,2,1,1.0,0.0,1753,1777
2019-06-29,Mexico,Costa Rica,1,1,0,0.5,0.5,2029,1891
2019-06-30,Egypt,Uganda,2,0,2,1.0,0.0,1903,1746
2019-06-30,Zimbabwe,DR Congo,0,4,4,0.0,1.0,1725,1759
2019-06-30,Burundi,Guinea,0,2,2,0.0,1.0,1598,1743
2019-06-30,Madagascar,Nigeria,2,0,2,1.0,0.0,1621,1880
2019-06-30,Jamaica,Panama,1,0,1,1.0,0.0,1792,1815
2019-06-30,United States,Curaçao,1,0,1,1.0,0.0,1985,1613
2019-07-01,Kenya,Senegal,0,3,3,0.0,1.0,1695,1925
2019-07-01,Tanzania,Algeria,0,3,3,0.0,1.0,1625,1854
2019-07-01,Namibia,Ivory Coast,1,4,3,0.0,1.0,1639,1887
2019-07-01,South Africa,Morocco,0,1,1,0.0,1.0,1818,1887
2019-07-02,Angola,Mali,0,1,1,0.0,1.0,1686,1764
2019-07-02,Mauritania,Tunisia,0,0,0,0.5,0.5,1591,1873
2019-07-02,Benin,Cameroon,0,0,0,0.5,0.5,1685,1858
2019-07-02,Guinea-Bissau,Ghana,0,2,2,0.0,1.0,1557,1861
2019-07-02,Brazil,Argentina,2,0,2,1.0,0.0,2227,2093
2019-07-02,Haiti,Mexico,0,1,1,0.0,1.0,1751,2032
2019-07-03,Chile,Peru,0,3,3,0.0,1.0,2010,1975
2019-07-03,United States,Jamaica,3,1,2,1.0,0.0,1989,1789
2019-07-05,Morocco,Benin,1,1,0,0.5,0.5,1883,1690
2019-07-05,Uganda,Senegal,0,1,1,0.0,1.0,1742,1930
2019-07-06,Egypt,South Africa,0,1,1,0.0,1.0,1894,1828
2019-07-06,Nigeria,Cameroon,3,2,1,1.0,0.0,1888,1851
2019-07-06,Argentina,Chile,2,1,1,1.0,0.0,2100,2004
2019-07-07,Algeria,Guinea,3,0,3,1.0,0.0,1860,1738
2019-07-07,Madagascar,DR Congo,2,2,0,0.5,0.5,1625,1756
2019-07-07,Brazil,Peru,3,1,2,1.0,0.0,2231,1972
2019-07-07,United States,Mexico,0,1,1,0.0,1.0,1982,2040
2019-07-07,India,Tajikistan,2,4,2,0.0,1.0,1625,1596
2019-07-08,Ghana,Tunisia,1,1,0,0.5,0.5,1862,1873
2019-07-08,Mali,Ivory Coast,0,1,1,0.0,1.0,1759,1893
2019-07-08,Samoa,Papua New Guinea,0,6,6,0.0,1.0,1449,1526
2019-07-08,American Samoa,New Caledonia,0,5,5,0.0,1.0,1358,1638
2019-07-08,Tuvalu,Solomon Islands,0,13,13,0.0,1.0,1439,1637
2019-07-08,Tahiti,Fiji,1,2,1,0.0,1.0,1640,1663
2019-07-08,Syria,North Korea,5,2,3,1.0,0.0,1793,1739
2019-07-10,Nigeria,South Africa,2,1,1,1.0,0.0,1895,1822
2019-07-10,Senegal,Benin,1,0,1,1.0,0.0,1934,1687
2019-07-10,Papua New Guinea,Vanuatu,2,0,2,1.0,0.0,1537,1614
2019-07-10,Tuvalu,Tahiti,0,7,7,0.0,1.0,1436,1644
2019-07-10,American Samoa,Fiji,0,9,9,0.0,1.0,1356,1666
2019-07-10,Solomon Islands,New Caledonia,0,2,2,0.0,1.0,1630,1646
2019-07-10,Tajikistan,Syria,2,0,2,1.0,0.0,1609,1781
2019-07-11,Ivory Coast,Algeria,1,1,0,0.5,0.5,1893,1861
2019-07-11,Madagascar,Tunisia,0,3,3,0.0,1.0,1622,1877
2019-07-12,Samoa,Tonga,2,0,2,1.0,0.0,1457,1399
2019-07-12,American Samoa,Tuvalu,1,1,0,0.5,0.5,1358,1435
2019-07-12,Solomon Islands,Tahiti,0,3,3,0.0,1.0,1623,1652
2019-07-12,New Caledonia,Fiji,1,0,1,1.0,0.0,1655,1658
2019-07-13,India,North Korea,2,5,3,0.0,1.0,1620,1745
2019-07-14,Algeria,Nigeria,2,1,1,1.0,0.0,1870,1887
2019-07-14,Senegal,Tunisia,1,0,1,1.0,0.0,1941,1871
2019-07-15,Tonga,Vanuatu,0,14,14,0.0,1.0,1396,1618
2019-07-15,Fiji,Tuvalu,10,1,9,1.0,0.0,1662,1432
2019-07-15,Solomon Islands,American Samoa,13,0,13,1.0,0.0,1626,1356
2019-07-15,Tahiti,New Caledonia,0,3,3,0.0,1.0,1645,1663
2019-07-15,North Korea,Tajikistan,1,0,1,1.0,0.0,1751,1604
2019-07-16,India,Syria,1,1,0,0.5,0.5,1624,1778
2019-07-17,Tunisia,Nigeria,0,1,1,0.0,1.0,1864,1895
2019-07-18,Papua New Guinea,Tonga,8,0,8,1.0,0.0,1542,1392
2019-07-18,Samoa,Vanuatu,0,11,11,0.0,1.0,1453,1623
2019-07-18,New Caledonia,Tuvalu,11,0,11,1.0,0.0,1667,1429
2019-07-18,Tahiti,American Samoa,8,1,7,1.0,0.0,1648,1354
2019-07-18,Fiji,Solomon Islands,4,4,0,0.5,0.5,1662,1627
2019-07-18,Mauritius,Seychelles,1,1,0,0.5,0.5,1477,1411
2019-07-18,Réunion,Maldives,4,0,4,1.0,0.0,1656,1454
2019-07-18,Comoros,Mayotte,0,2,2,0.0,1.0,1458,1526
2019-07-19,Senegal,Algeria,0,1,1,0.0,1.0,1932,1880
2019-07-19,Tajikistan,North Korea,0,1,1,0.0,1.0,1600,1756
2019-07-20,Papua New Guinea,Fiji,1,1,0,0.5,0.5,1545,1660
2019-07-20,Seychelles,Madagascar,0,0,0,0.5,0.5,1416,1618
2019-07-20,Réunion,Mayotte,1,0,1,1.0,0.0,1662,1521
2019-07-20,Comoros,Maldives,3,0,3,1.0,0.0,1466,1447
2019-07-21,Equatorial Guinea,Liberia,1,1,0,0.5,0.5,1567,1617
2019-07-22,Mauritius,Madagascar,1,1,0,0.5,0.5,1481,1615
2019-07-22,Mayotte,Maldives,3,1,2,1.0,0.0,1528,1441
2019-07-22,Réunion,Comoros,0,1,1,0.0,1.0,1650,1479
2019-07-24,Mauritius,Mayotte,1,0,1,1.0,0.0,1491,1519
2019-07-24,Réunion,Seychelles,4,0,4,1.0,0.0,1654,1413
2019-07-26,Seychelles,Mayotte,1,3,2,0.0,1.0,1408,1525
2019-07-28,Mauritius,Réunion,1,1,0,0.5,0.5,1495,1651
2019-07-30,Iraq,Lebanon,1,0,1,1.0,0.0,1846,1709
2019-07-30,Yemen,Palestine,0,1,1,0.0,1.0,1542,1680
2019-08-02,Iraq,Palestine,2,1,1,1.0,0.0,1851,1676
2019-08-02,Lebanon,Syria,2,1,1,1.0,0.0,1719,1769
2019-08-04,Jordan,Bahrain,0,1,1,0.0,1.0,1778,1785
2019-08-04,Saudi Arabia,Kuwait,1,2,1,0.0,1.0,1835,1781
2019-08-05,Syria,Yemen,1,1,0,0.5,0.5,1765,1547
2019-08-05,Lebanon,Palestine,0,0,0,0.5,0.5,1719,1677
2019-08-07,Bahrain,Saudi Arabia,0,0,0,0.5,0.5,1787,1834
2019-08-07,Kuwait,Jordan,1,1,0,0.5,0.5,1781,1779
2019-08-08,Yemen,Lebanon,2,1,1,1.0,0.0,1559,1708
2019-08-08,Iraq,Syria,0,0,0,0.5,0.5,1850,1767
2019-08-09,South Ossetia,Luhansk PR,2,0,2,1.0,0.0,1503,1487
2019-08-10,Jordan,Saudi Arabia,3,0,3,1.0,0.0,1789,1825
2019-08-10,Kuwait,Bahrain,0,1,1,0.0,1.0,1774,1795
2019-08-11,Saint Vincent and the Grenadines,Trinidad and Tobago,1,0,1,1.0,0.0,1545,1695
2019-08-11,Palestine,Syria,4,3,1,1.0,0.0,1688,1757
2019-08-11,Iraq,Yemen,2,1,1,1.0,0.0,1853,1557
2019-08-14,Dominican Republic,Guatemala,0,0,0,0.5,0.5,1572,1708
2019-08-14,Iraq,Bahrain,0,1,1,0.0,1.0,1844,1805
2019-08-27,Saint Kitts and Nevis,Antigua and Barbuda,4,3,1,1.0,0.0,1599,1572
2019-08-28,Belize,Saint Vincent and the Grenadines,1,1,0,0.5,0.5,1511,1545
2019-08-28,Taiwan,Guam,3,0,3,1.0,0.0,1485,1404
2019-08-29,United Arab Emirates,Dominican Republic,4,0,4,1.0,0.0,1850,1570
2019-08-30,Belize,Saint Vincent and the Grenadines,1,0,1,1.0,0.0,1520,1537
2019-08-30,China PR,Myanmar,4,1,3,1.0,0.0,1853,1552
2019-08-30,Malaysia,Jordan,0,1,1,0.0,1.0,1592,1793
2019-08-31,United Arab Emirates,Sri Lanka,5,1,4,1.0,0.0,1851,1325
2019-09-04,Libya,Burkina Faso,0,1,1,0.0,1.0,1709,1755
2019-09-04,Burundi,Tanzania,1,1,0,0.5,0.5,1599,1625
2019-09-04,Djibouti,Eswatini,2,1,1,1.0,0.0,1309,1523
2019-09-04,Eritrea,Namibia,1,2,1,0.0,1.0,1453,1644
2019-09-04,Ethiopia,Lesotho,0,0,0,0.5,0.5,1624,1564
2019-09-04,Liberia,Sierra Leone,3,1,2,1.0,0.0,1626,1614
2019-09-04,Mauritius,Mozambique,0,1,1,0.0,1.0,1491,1639
2019-09-04,São Tomé and Príncipe,Guinea-Bissau,0,1,1,0.0,1.0,1446,1563
2019-09-04,South Sudan,Equatorial Guinea,1,1,0,0.5,0.5,1453,1565
2019-09-05,Argentina,Chile,0,0,0,0.5,0.5,2098,2007
2019-09-05,Honduras,Puerto Rico,4,0,4,1.0,0.0,1821,1419
2019-09-05,South Korea,Georgia,2,2,0,0.5,0.5,1980,1732
2019-09-05,Montenegro,Hungary,2,1,1,1.0,0.0,1744,1825
2019-09-05,Northern Ireland,Luxembourg,1,0,1,1.0,0.0,1822,1579
2019-09-05,Peru,Ecuador,0,1,1,0.0,1.0,1963,1926
2019-09-05,Saudi Arabia,Mali,1,1,0,0.5,0.5,1824,1761
2019-09-05,Republic of Ireland,Switzerland,1,1,0,0.5,0.5,1922,1989
2019-09-05,Gibraltar,Denmark,0,6,6,0.0,1.0,1529,1972
2019-09-05,Faroe Islands,Sweden,0,4,4,0.0,1.0,1492,1955
2019-09-05,Norway,Malta,2,0,2,1.0,0.0,1861,1490
2019-09-05,Romania,Spain,1,2,1,0.0,1.0,1922,2171
2019-09-05,Israel,North Macedonia,1,1,0,0.5,0.5,1777,1740
2019-09-05,Armenia,Italy,1,3,2,0.0,1.0,1678,2055
2019-09-05,Bosnia and Herzegovina,Liechtenstein,5,0,5,1.0,0.0,1898,1428
2019-09-05,Finland,Greece,1,0,1,1.0,0.0,1837,1834
2019-09-05,Japan,Paraguay,2,0,2,1.0,0.0,1993,1877
2019-09-05,Bermuda,Panama,1,4,3,0.0,1.0,1580,1819
2019-09-05,Grenada,Saint Kitts and Nevis,2,1,1,1.0,0.0,1512,1589
2019-09-05,French Guiana,Belize,3,0,3,1.0,0.0,1611,1514
2019-09-05,Dominica,Suriname,1,2,1,0.0,1.0,1456,1606
2019-09-05,United States Virgin Islands,Cayman Islands,0,2,2,0.0,1.0,1370,1414
2019-09-05,Barbados,Saint Martin,4,0,4,1.0,0.0,1534,1412
2019-09-05,Guatemala,Anguilla,10,0,10,1.0,0.0,1710,1302
2019-09-05,Guam,Maldives,0,1,1,0.0,1.0,1397,1449
2019-09-05,Philippines,Syria,2,5,3,0.0,1.0,1590,1762
2019-09-05,Taiwan,Jordan,1,2,1,0.0,1.0,1483,1796
2019-09-05,Kuwait,Nepal,7,0,7,1.0,0.0,1776,1410
2019-09-05,Cambodia,Hong Kong,1,1,0,0.5,0.5,1375,1607
2019-09-05,Bahrain,Iraq,1,1,0,0.5,0.5,1806,1844
2019-09-05,Palestine,Uzbekistan,2,0,2,1.0,0.0,1700,1854
2019-09-05,Singapore,Yemen,2,2,0,0.5,0.5,1578,1558
2019-09-05,India,Oman,1,2,1,0.0,1.0,1621,1820
2019-09-05,Qatar,Afghanistan,6,0,6,1.0,0.0,1886,1500
2019-09-05,Mongolia,Myanmar,1,0,1,1.0,0.0,1403,1541
2019-09-05,Tajikistan,Kyrgyzstan,1,0,1,1.0,0.0,1609,1597
2019-09-05,Thailand,Vietnam,0,0,0,0.5,0.5,1765,1725
2019-09-05,Indonesia,Malaysia,2,3,1,0.0,1.0,1643,1602
2019-09-05,North Korea,Lebanon,2,0,2,1.0,0.0,1763,1702
2019-09-05,Sri Lanka,Turkmenistan,0,2,2,0.0,1.0,1323,1603
2019-09-05,Chad,Sudan,1,3,2,0.0,1.0,1533,1586
2019-09-05,Seychelles,Rwanda,0,3,3,0.0,1.0,1405,1622
2019-09-05,Somalia,Zimbabwe,1,0,1,1.0,0.0,1334,1711
2019-09-06,Brazil,Colombia,2,2,0,0.5,0.5,2228,2084
2019-09-06,Costa Rica,Uruguay,1,2,1,0.0,1.0,1887,2034
2019-09-06,Ivory Coast,Benin,1,2,1,0.0,1.0,1881,1700
2019-09-06,Morocco,Burkina Faso,1,1,0,0.5,0.5,1881,1758
2019-09-06,Tunisia,Mauritania,1,0,1,1.0,0.0,1867,1589
2019-09-06,United States,Mexico,0,3,3,0.0,1.0,1976,2047
2019-09-06,Estonia,Belarus,1,2,1,0.0,1.0,1719,1757
2019-09-06,Germany,Netherlands,2,4,2,0.0,1.0,2106,2076
2019-09-06,Wales,Azerbaijan,2,1,1,1.0,0.0,1859,1631
2019-09-06,Slovakia,Croatia,0,4,4,0.0,1.0,1900,2026
2019-09-06,Austria,Latvia,6,0,6,1.0,0.0,1900,1588
2019-09-06,Slovenia,Poland,2,0,2,1.0,0.0,1778,1952
2019-09-06,Cyprus,Kazakhstan,1,1,0,0.5,0.5,1646,1638
2019-09-06,Scotland,Russia,1,2,1,0.0,1.0,1861,1956
2019-09-06,San Marino,Belgium,0,4,4,0.0,1.0,1303,2106
2019-09-06,Martinique,Trinidad and Tobago,1,1,0,0.5,0.5,1704,1696
2019-09-06,Aruba,Guyana,0,1,1,0.0,1.0,1419,1594
2019-09-06,Jamaica,Antigua and Barbuda,6,0,6,1.0,0.0,1793,1569
2019-09-06,Nicaragua,Saint Vincent and the Grenadines,1,1,0,0.5,0.5,1503,1537
2019-09-06,Bonaire,British Virgin Islands,4,2,2,1.0,0.0,1482,1337
2019-09-06,Comoros,Togo,1,1,0,0.5,0.5,1483,1662
2019-09-06,Gambia,Angola,0,1,1,0.0,1.0,1604,1693
2019-09-07,Libya,Niger,2,0,2,1.0,0.0,1715,1598
2019-09-07,Kosovo,Czech Republic,2,1,1,1.0,0.0,1654,1907
2019-09-07,England,Bulgaria,4,0,4,1.0,0.0,2103,1805
2019-09-07,Lithuania,Ukraine,0,3,3,0.0,1.0,1596,1978
2019-09-07,Serbia,Portugal,2,4,2,0.0,1.0,1917,2087
2019-09-07,Iceland,Moldova,3,0,3,1.0,0.0,1850,1575
2019-09-07,France,Albania,4,1,3,1.0,0.0,2150,1740
2019-09-07,Turkey,Andorra,1,0,1,1.0,0.0,1940,1384
2019-09-07,Canada,Cuba,6,0,6,1.0,0.0,1782,1619
2019-09-07,Curaçao,Haiti,1,0,1,1.0,0.0,1625,1740
2019-09-07,Montserrat,Dominican Republic,2,1,1,1.0,0.0,1430,1559
2019-09-07,El Salvador,Saint Lucia,3,0,3,1.0,0.0,1765,1491
2019-09-07,Guadeloupe,Sint Maarten,5,1,4,1.0,0.0,1620,1462
2019-09-07,Botswana,Malawi,0,0,0,0.5,0.5,1643,1646
2019-09-08,Kenya,Uganda,1,1,0,0.5,0.5,1697,1741
2019-09-08,Switzerland,Gibraltar,4,0,4,1.0,0.0,1991,1528
2019-09-08,Georgia,Denmark,0,0,0,0.5,0.5,1737,1968
2019-09-08,Romania,Malta,1,0,1,1.0,0.0,1924,1489
2019-09-08,Spain,Faroe Islands,4,0,4,1.0,0.0,2172,1492
2019-09-08,Sweden,Norway,1,1,0,0.5,0.5,1953,1864
2019-09-08,Armenia,Bosnia and Herzegovina,4,2,2,1.0,0.0,1691,1886
2019-09-08,Finland,Italy,1,2,1,0.0,1.0,1834,2059
2019-09-08,Greece,Liechtenstein,1,1,0,0.5,0.5,1828,1435
2019-09-08,Panama,Bermuda,0,2,2,0.0,1.0,1807,1593
2019-09-08,Belize,Grenada,1,2,1,0.0,1.0,1506,1521
2019-09-08,Saint Kitts and Nevis,French Guiana,2,2,0,0.5,0.5,1590,1611
2019-09-08,Saint Vincent and the Grenadines,Dominica,1,0,1,1.0,0.0,1544,1450
2019-09-08,Suriname,Nicaragua,6,0,6,1.0,0.0,1612,1498
2019-09-08,Saint Martin,United States Virgin Islands,1,2,1,0.0,1.0,1404,1379
2019-09-08,Cayman Islands,Barbados,3,2,1,1.0,0.0,1425,1524
2019-09-08,Equatorial Guinea,South Sudan,1,0,1,1.0,0.0,1571,1448
2019-09-08,Lesotho,Ethiopia,1,1,0,0.5,0.5,1566,1623
2019-09-08,Sierra Leone,Liberia,1,0,1,1.0,0.0,1623,1618
2019-09-08,Tanzania,Burundi,1,1,0,0.5,0.5,1625,1600
2019-09-09,Algeria,Benin,1,0,1,1.0,0.0,1885,1696
2019-09-09,Iraq,Uzbekistan,0,0,0,0.5,0.5,1845,1854
2019-09-09,Wales,Belarus,1,0,1,1.0,0.0,1865,1752
2019-09-09,Northern Ireland,Germany,0,2,2,0.0,1.0,1820,2109
2019-09-09,Estonia,Netherlands,0,4,4,0.0,1.0,1718,2078
2019-09-09,Azerbaijan,Croatia,1,1,0,0.5,0.5,1638,2020
2019-09-09,Hungary,Slovakia,1,2,1,0.0,1.0,1819,1907
2019-09-09,Poland,Austria,0,0,0,0.5,0.5,1951,1902
2019-09-09,Slovenia,Israel,3,2,1,1.0,0.0,1786,1770
2019-09-09,Latvia,North Macedonia,0,2,2,0.0,1.0,1584,1745
2019-09-09,Scotland,Belgium,0,4,4,0.0,1.0,1858,2110
2019-09-09,Russia,Kazakhstan,1,0,1,1.0,0.0,1959,1636
2019-09-09,San Marino,Cyprus,0,4,4,0.0,1.0,1302,1648
2019-09-09,Trinidad and Tobago,Martinique,2,2,0,0.5,0.5,1697,1704
2019-09-09,Antigua and Barbuda,Aruba,2,1,1,1.0,0.0,1574,1415
2019-09-09,Guyana,Jamaica,0,4,4,0.0,1.0,1591,1797
2019-09-09,Bahamas,Bonaire,2,1,1,1.0,0.0,1462,1474
2019-09-10,Argentina,Mexico,4,0,4,1.0,0.0,2105,2041
2019-09-10,Brazil,Peru,0,1,1,0.0,1.0,2215,1977
2019-09-10,Colombia,Venezuela,0,0,0,0.5,0.5,2080,1891
2019-09-10,Ecuador,Bolivia,3,0,3,1.0,0.0,1931,1741
2019-09-10,Honduras,Chile,2,1,1,1.0,0.0,1833,1996
2019-09-10,Ivory Coast,Tunisia,2,1,1,1.0,0.0,1889,1860
2019-09-10,Jordan,Paraguay,2,4,2,0.0,1.0,1790,1884
2019-09-10,Morocco,Niger,1,0,1,1.0,0.0,1884,1596
2019-09-10,Oman,Lebanon,1,0,1,1.0,0.0,1826,1697
2019-09-10,Republic of Ireland,Bulgaria,3,1,2,1.0,0.0,1928,1800
2019-09-10,Ukraine,Nigeria,2,2,0,0.5,0.5,1977,1897
2019-09-10,United States,Uruguay,1,1,0,0.5,0.5,1978,2033
2019-09-10,England,Kosovo,5,3,2,1.0,0.0,2105,1653
2019-09-10,Montenegro,Czech Republic,0,3,3,0.0,1.0,1740,1912
2019-09-10,Luxembourg,Serbia,1,3,2,0.0,1.0,1577,1920
2019-09-10,Lithuania,Portugal,1,5,4,0.0,1.0,1596,2088
2019-09-10,Albania,Iceland,4,2,2,1.0,0.0,1751,1840
2019-09-10,France,Andorra,3,0,3,1.0,0.0,2151,1384
2019-09-10,Moldova,Turkey,0,4,4,0.0,1.0,1574,1942
2019-09-10,Cuba,Canada,0,1,1,0.0,1.0,1615,1787
2019-09-10,Haiti,Curaçao,1,1,0,0.5,0.5,1738,1628
2019-09-10,Montserrat,Saint Lucia,1,1,0,0.5,0.5,1432,1490
2019-09-10,Dominican Republic,El Salvador,1,0,1,1.0,0.0,1572,1753
2019-09-10,Puerto Rico,Guatemala,0,5,5,0.0,1.0,1417,1713
2019-09-10,Turks and Caicos Islands,Guadeloupe,0,3,3,0.0,1.0,1419,1624
2019-09-10,Guam,Philippines,1,4,3,0.0,1.0,1394,1594
2019-09-10,Maldives,China PR,0,5,5,0.0,1.0,1448,1855
2019-09-10,Kuwait,Australia,0,3,3,0.0,1.0,1772,1940
2019-09-10,Taiwan,Nepal,0,2,2,0.0,1.0,1474,1420
2019-09-10,Cambodia,Bahrain,0,1,1,0.0,1.0,1374,1808
2019-09-10,Hong Kong,Iran,0,2,2,0.0,1.0,1606,2011
2019-09-10,Yemen,Saudi Arabia,2,2,0,0.5,0.5,1564,1819
2019-09-10,Singapore,Palestine,2,1,1,1.0,0.0,1589,1690
2019-09-10,Afghanistan,Bangladesh,1,0,1,1.0,0.0,1507,1411
2019-09-10,Qatar,India,0,0,0,0.5,0.5,1881,1627
2019-09-10,Mongolia,Tajikistan,0,1,1,0.0,1.0,1400,1613
2019-09-10,Myanmar,Japan,0,2,2,0.0,1.0,1540,1995
2019-09-10,Indonesia,Thailand,0,3,3,0.0,1.0,1638,1771
2019-09-10,Malaysia,United Arab Emirates,1,2,1,0.0,1.0,1599,1855
2019-09-10,Turkmenistan,South Korea,0,2,2,0.0,1.0,1602,1982
2019-09-10,Sri Lanka,North Korea,0,1,1,0.0,1.0,1322,1765
2019-09-10,Angola,Gambia,2,1,1,1.0,0.0,1699,1599
2019-09-10,Guinea-Bissau,São Tomé and Príncipe,2,1,1,1.0,0.0,1569,1441
2019-09-10,Malawi,Botswana,1,0,1,1.0,0.0,1654,1636
2019-09-10,Mozambique,Mauritius,2,0,2,1.0,0.0,1644,1487
2019-09-10,Namibia,Eritrea,2,0,2,1.0,0.0,1648,1450
2019-09-10,Rwanda,Seychelles,7,0,7,1.0,0.0,1626,1402
2019-09-10,Sudan,Chad,0,0,0,0.5,0.5,1585,1535
2019-09-10,Eswatini,Djibouti,0,0,0,0.5,0.5,1519,1314
2019-09-10,Togo,Comoros,2,0,2,1.0,0.0,1667,1479
2019-09-10,Zimbabwe,Somalia,3,1,2,1.0,0.0,1713,1333
2019-09-18,DR Congo,Rwanda,2,3,1,0.0,1.0,1746,1637
2019-09-29,Bangladesh,Bhutan,4,1,3,1.0,0.0,1416,1248
2019-09-30,Botswana,Liberia,0,0,0,0.5,0.5,1636,1619
2019-10-02,Mexico,Trinidad and Tobago,2,0,2,1.0,0.0,2043,1696
2019-10-03,Bangladesh,Bhutan,2,0,2,1.0,0.0,1421,1244
2019-10-05,Jordan,Singapore,0,0,0,0.5,0.5,1786,1594
2019-10-05,Malaysia,Sri Lanka,6,0,6,1.0,0.0,1602,1320
2019-10-09,Djibouti,Gambia,1,1,0,0.5,0.5,1320,1594
2019-10-09,Liberia,Chad,1,0,1,1.0,0.0,1626,1529
2019-10-09,Mauritius,São Tomé and Príncipe,1,3,2,0.0,1.0,1478,1451
2019-10-09,South Sudan,Seychelles,2,1,1,1.0,0.0,1455,1396
2019-10-09,Bahrain,Azerbaijan,2,3,1,0.0,1.0,1797,1650
2019-10-09,Germany,Argentina,2,2,0,0.5,0.5,2109,2106
2019-10-10,Belarus,Estonia,0,0,0,0.5,0.5,1752,1719
2019-10-10,Netherlands,Northern Ireland,3,1,2,1.0,0.0,2081,1818
2019-10-10,Croatia,Hungary,3,0,3,1.0,0.0,2024,1816
2019-10-10,Slovakia,Wales,1,1,0,0.5,0.5,1907,1866
2019-10-10,Austria,Israel,3,1,2,1.0,0.0,1908,1765
2019-10-10,North Macedonia,Slovenia,2,1,1,1.0,0.0,1754,1778
2019-10-10,Latvia,Poland,0,3,3,0.0,1.0,1583,1953
2019-10-10,Kazakhstan,Cyprus,1,2,1,0.0,1.0,1629,1656
2019-10-10,Belgium,San Marino,9,0,9,1.0,0.0,2111,1302
2019-10-10,Russia,Scotland,4,0,4,1.0,0.0,1965,1853
2019-10-10,Algeria,DR Congo,1,1,0,0.5,0.5,1882,1750
2019-10-10,Brazil,Senegal,1,1,0,0.5,0.5,2210,1938
2019-10-10,Cape Verde,Togo,2,1,1,1.0,0.0,1700,1660
2019-10-10,Gabon,Burkina Faso,1,0,1,1.0,0.0,1702,1749
2019-10-10,Kosovo,Gibraltar,1,0,1,1.0,0.0,1659,1523
2019-10-10,Niger,Zambia,1,1,0,0.5,0.5,1600,1742
2019-10-10,Serbia,Paraguay,1,0,1,1.0,0.0,1928,1877
2019-10-10,Thailand,Congo,1,1,0,0.5,0.5,1769,1660
2019-10-10,Venezuela,Bolivia,4,1,3,1.0,0.0,1896,1737
2019-10-10,Trinidad and Tobago,Honduras,0,2,2,0.0,1.0,1692,1838
2019-10-10,Haiti,Costa Rica,1,1,0,0.5,0.5,1742,1884
2019-10-10,Belize,Saint Kitts and Nevis,0,4,4,0.0,1.0,1500,1597
2019-10-10,French Guiana,Grenada,0,0,0,0.5,0.5,1609,1524
2019-10-10,British Virgin Islands,Bahamas,0,4,4,0.0,1.0,1332,1468
2019-10-10,Sint Maarten,Turks and Caicos Islands,2,5,3,0.0,1.0,1454,1428
2019-10-10,Syria,Maldives,2,1,1,1.0,0.0,1765,1446
2019-10-10,China PR,Guam,7,0,7,1.0,0.0,1857,1393
2019-10-10,Jordan,Kuwait,0,0,0,0.5,0.5,1786,1773
2019-10-10,Australia,Nepal,5,0,5,1.0,0.0,1941,1420
2019-10-10,Iran,Cambodia,14,0,14,1.0,0.0,2012,1374
2019-10-10,Iraq,Hong Kong,2,0,2,1.0,0.0,1849,1603
2019-10-10,Uzbekistan,Yemen,5,0,5,1.0,0.0,1857,1562
2019-10-10,Saudi Arabia,Singapore,3,0,3,1.0,0.0,1823,1591
2019-10-10,Bangladesh,Qatar,0,2,2,0.0,1.0,1420,1883
2019-10-10,Oman,Afghanistan,3,0,3,1.0,0.0,1829,1505
2019-10-10,Japan,Mongolia,6,0,6,1.0,0.0,1996,1400
2019-10-10,Kyrgyzstan,Myanmar,7,0,7,1.0,0.0,1604,1534
2019-10-10,United Arab Emirates,Indonesia,5,0,5,1.0,0.0,1859,1635
2019-10-10,Vietnam,Malaysia,1,0,1,1.0,0.0,1731,1597
2019-10-10,Lebanon,Turkmenistan,2,1,1,1.0,0.0,1703,1597
2019-10-10,South Korea,Sri Lanka,8,0,8,1.0,0.0,1983,1320
2019-10-11,Czech Republic,England,2,1,1,1.0,0.0,1925,2093
2019-10-11,Montenegro,Bulgaria,0,0,0,0.5,0.5,1742,1799
2019-10-11,Portugal,Luxembourg,3,0,3,1.0,0.0,2089,1577
2019-10-11,Ukraine,Lithuania,2,0,2,1.0,0.0,1979,1595
2019-10-11,Iceland,France,0,1,1,0.0,1.0,1838,2154
2019-10-11,Andorra,Moldova,1,0,1,1.0,0.0,1396,1563
2019-10-11,Turkey,Albania,1,0,1,1.0,0.0,1946,1748
2019-10-11,Morocco,Libya,1,1,0,0.5,0.5,1881,1719
2019-10-11,Uruguay,Peru,1,0,1,1.0,0.0,2040,1971
2019-10-11,United States,Cuba,7,0,7,1.0,0.0,1980,1614
2019-10-11,Bermuda,Mexico,1,5,4,0.0,1.0,1592,2045
2019-10-11,Antigua and Barbuda,Guyana,2,1,1,1.0,0.0,1583,1583
2019-10-11,Saint Vincent and the Grenadines,Suriname,2,2,0,0.5,0.5,1546,1611
2019-10-11,Nicaragua,Dominica,3,1,2,1.0,0.0,1505,1444
2019-10-12,Georgia,Republic of Ireland,0,0,0,0.5,0.5,1742,1924
2019-10-12,Denmark,Switzerland,1,0,1,1.0,0.0,1977,1983
2019-10-12,Faroe Islands,Romania,0,3,3,0.0,1.0,1491,1926
2019-10-12,Malta,Sweden,0,4,4,0.0,1.0,1488,1955
2019-10-12,Norway,Spain,1,1,0,0.5,0.5,1870,2167
2019-10-12,Bosnia and Herzegovina,Finland,4,1,3,1.0,0.0,1893,1828
2019-10-12,Italy,Greece,2,0,2,1.0,0.0,2063,1825
2019-10-12,Liechtenstein,Armenia,1,1,0,0.5,0.5,1441,1686
2019-10-12,Colombia,Chile,0,0,0,0.5,0.5,2079,1998
2019-10-12,Guinea,Comoros,0,1,1,0.0,1.0,1725,1493
2019-10-12,Ivory Coast,DR Congo,3,1,2,1.0,0.0,1894,1746
2019-10-12,Tunisia,Cameroon,0,0,0,0.5,0.5,1860,1852
2019-10-12,Dominican Republic,Saint Lucia,3,0,3,1.0,0.0,1579,1484
2019-10-12,Montserrat,El Salvador,0,2,2,0.0,1.0,1430,1756
2019-10-12,Jamaica,Aruba,2,0,2,1.0,0.0,1799,1414
2019-10-12,Barbados,United States Virgin Islands,1,0,1,1.0,0.0,1529,1375
2019-10-12,Saint Martin,Cayman Islands,3,0,3,1.0,0.0,1413,1417
2019-10-12,Anguilla,Guatemala,0,5,5,0.0,1.0,1301,1715
2019-10-13,Belarus,Netherlands,1,2,1,0.0,1.0,1750,2084
2019-10-13,Estonia,Germany,0,3,3,0.0,1.0,1718,2111
2019-10-13,Hungary,Azerbaijan,1,0,1,1.0,0.0,1821,1646
2019-10-13,Wales,Croatia,1,1,0,0.5,0.5,1870,2021
2019-10-13,Poland,North Macedonia,2,0,2,1.0,0.0,1957,1751
2019-10-13,Slovenia,Austria,0,1,1,0.0,1.0,1773,1914
2019-10-13,Scotland,San Marino,6,0,6,1.0,0.0,1854,1302
2019-10-13,Cyprus,Russia,0,5,5,0.0,1.0,1654,1968
2019-10-13,Kazakhstan,Belgium,0,2,2,0.0,1.0,1629,2112
2019-10-13,Gambia,Djibouti,1,1,0,0.5,0.5,1589,1326
2019-10-13,Chad,Liberia,1,0,1,1.0,0.0,1540,1616
2019-10-13,São Tomé and Príncipe,Mauritius,2,1,1,1.0,0.0,1460,1470
2019-10-13,Seychelles,South Sudan,0,1,1,0.0,1.0,1390,1462
2019-10-13,Benin,Zambia,2,2,0,0.5,0.5,1698,1741
2019-10-13,Brazil,Nigeria,1,1,0,0.5,0.5,2205,1903
2019-10-13,Ecuador,Argentina,1,6,5,0.0,1.0,1927,2111
2019-10-13,Equatorial Guinea,Togo,1,1,0,0.5,0.5,1574,1658
2019-10-13,Ethiopia,Uganda,0,1,1,0.0,1.0,1618,1747
2019-10-13,Kenya,Mozambique,0,1,1,0.0,1.0,1688,1654
2019-10-13,Lesotho,Malawi,1,1,0,0.5,0.5,1568,1653
2019-10-13,Niger,Central African Republic,0,2,2,0.0,1.0,1591,1562
2019-10-13,Slovakia,Paraguay,1,1,0,0.5,0.5,1907,1878
2019-10-13,South Africa,Mali,2,1,1,1.0,0.0,1829,1755
2019-10-13,Honduras,Martinique,1,0,1,1.0,0.0,1844,1699
2019-10-13,Costa Rica,Curaçao,0,0,0,0.5,0.5,1879,1634
2019-10-13,Saint Kitts and Nevis,Belize,0,1,1,0.0,1.0,1587,1511
2019-10-13,Grenada,French Guiana,1,0,1,1.0,0.0,1534,1600
2019-10-13,British Virgin Islands,Bonaire,3,4,1,0.0,1.0,1328,1479
2019-10-14,Kosovo,Montenegro,2,0,2,1.0,0.0,1669,1733
2019-10-14,Bulgaria,England,0,6,6,0.0,1.0,1797,2096
2019-10-14,Lithuania,Serbia,1,2,1,0.0,1.0,1593,1931
2019-10-14,Ukraine,Portugal,2,1,1,1.0,0.0,1990,2079
2019-10-14,Iceland,Andorra,2,0,2,1.0,0.0,1840,1395
2019-10-14,France,Turkey,1,1,0,0.5,0.5,2150,1951
2019-10-14,Moldova,Albania,0,4,4,0.0,1.0,1559,1753
2019-10-14,Czech Republic,Northern Ireland,2,3,1,0.0,1.0,1915,1829
2019-10-14,Egypt,Botswana,1,0,1,1.0,0.0,1897,1634
2019-10-14,Rwanda,Tanzania,0,0,0,0.5,0.5,1637,1626
2019-10-14,Venezuela,Trinidad and Tobago,2,0,2,1.0,0.0,1900,1689
2019-10-14,Guyana,Antigua and Barbuda,5,1,4,1.0,0.0,1591,1575
2019-10-14,Dominica,Nicaragua,0,4,4,0.0,1.0,1438,1512
2019-10-14,Suriname,Saint Vincent and the Grenadines,0,1,1,0.0,1.0,1602,1556
2019-10-14,Sint Maarten,Guadeloupe,1,2,1,0.0,1.0,1450,1629
2019-10-15,Gibraltar,Georgia,2,3,1,0.0,1.0,1520,1746
2019-10-15,Switzerland,Republic of Ireland,2,0,2,1.0,0.0,1990,1918
2019-10-15,Faroe Islands,Malta,1,0,1,1.0,0.0,1499,1481
2019-10-15,Sweden,Spain,1,1,0,0.5,0.5,1960,2163
2019-10-15,Romania,Norway,1,1,0,0.5,0.5,1925,1872
2019-10-15,Israel,Latvia,3,1,2,1.0,0.0,1770,1579
2019-10-15,Finland,Armenia,3,0,3,1.0,0.0,1833,1682
2019-10-15,Liechtenstein,Italy,0,5,5,0.0,1.0,1441,2064
2019-10-15,Greece,Bosnia and Herzegovina,2,1,1,1.0,0.0,1835,1884
2019-10-15,Algeria,Colombia,3,0,3,1.0,0.0,1895,2067
2019-10-15,Bermuda,Guatemala,0,0,0,0.5,0.5,1595,1713
2019-10-15,Bolivia,Haiti,3,1,2,1.0,0.0,1746,1734
2019-10-15,Chile,Guinea,3,2,1,1.0,0.0,2001,1723
2019-10-15,Denmark,Luxembourg,4,0,4,1.0,0.0,1979,1576
2019-10-15,Kuwait,Turkmenistan,1,1,0,0.5,0.5,1770,1601
2019-10-15,Mauritania,Libya,0,0,0,0.5,0.5,1592,1717
2019-10-15,Morocco,Gabon,2,3,1,0.0,1.0,1870,1714
2019-10-15,Peru,Uruguay,1,1,0,0.5,0.5,1973,2039
2019-10-15,Canada,United States,2,0,2,1.0,0.0,1800,1968
2019-10-15,Mexico,Panama,3,1,2,1.0,0.0,2049,1804
2019-10-15,Dominican Republic,Montserrat,0,0,0,0.5,0.5,1576,1434
2019-10-15,Saint Lucia,El Salvador,0,2,2,0.0,1.0,1482,1759
2019-10-15,Aruba,Jamaica,0,6,6,0.0,1.0,1413,1801
2019-10-15,Cayman Islands,Saint Martin,1,0,1,1.0,0.0,1425,1406
2019-10-15,United States Virgin Islands,Barbados,0,4,4,0.0,1.0,1371,1534
2019-10-15,Anguilla,Puerto Rico,2,3,1,0.0,1.0,1296,1423
2019-10-15,Syria,Guam,4,0,4,1.0,0.0,1767,1392
2019-10-15,Philippines,China PR,0,0,0,0.5,0.5,1600,1852
2019-10-15,Jordan,Nepal,3,0,3,1.0,0.0,1788,1419
2019-10-15,Taiwan,Australia,1,7,6,0.0,1.0,1473,1943
2019-10-15,Cambodia,Iraq,0,4,4,0.0,1.0,1374,1850
2019-10-15,Bahrain,Iran,1,0,1,1.0,0.0,1810,2000
2019-10-15,Palestine,Saudi Arabia,0,0,0,0.5,0.5,1693,1821
2019-10-15,Singapore,Uzbekistan,1,3,2,0.0,1.0,1589,1860
2019-10-15,India,Bangladesh,1,1,0,0.5,0.5,1623,1425
2019-10-15,Qatar,Oman,2,1,1,1.0,0.0,1890,1823
2019-10-15,Mongolia,Kyrgyzstan,1,2,1,0.0,1.0,1397,1608
2019-10-15,Tajikistan,Japan,0,3,3,0.0,1.0,1612,1998
2019-10-15,Thailand,United Arab Emirates,2,1,1,1.0,0.0,1780,1849
2019-10-15,Indonesia,Vietnam,1,3,2,0.0,1.0,1630,1737
2019-10-15,North Korea,South Korea,0,0,0,0.5,0.5,1770,1979
2019-10-15,Sri Lanka,Lebanon,0,3,3,0.0,1.0,1319,1705
2019-11-07,Egypt,Liberia,1,0,1,1.0,0.0,1900,1614
2019-11-07,Nicaragua,Cuba,0,0,0,0.5,0.5,1515,1612
2019-11-09,Malaysia,Tajikistan,1,0,1,1.0,0.0,1606,1604
2019-11-09,Namibia,Zambia,0,2,2,0.0,1.0,1643,1747
2019-11-09,Uzbekistan,Kyrgyzstan,3,1,2,1.0,0.0,1864,1605
2019-11-10,Nicaragua,Cuba,0,1,1,0.0,1.0,1510,1618
2019-11-10,Trinidad and Tobago,Anguilla,15,0,15,1.0,0.0,1691,1295
2019-11-13,Namibia,Chad,2,1,1,1.0,0.0,1649,1535
2019-11-13,Malawi,South Sudan,1,0,1,1.0,0.0,1657,1459
2019-11-13,Burkina Faso,Uganda,0,0,0,0.5,0.5,1749,1748
2019-11-13,Sudan,São Tomé and Príncipe,4,0,4,1.0,0.0,1591,1455
2019-11-13,Angola,Gambia,1,3,2,0.0,1.0,1689,1600
2019-11-13,Central African Republic,Burundi,2,0,2,1.0,0.0,1571,1592
2019-11-13,Cameroon,Cape Verde,0,0,0,0.5,0.5,1849,1704
2019-11-13,Guinea-Bissau,Eswatini,3,0,3,1.0,0.0,1576,1513
2019-11-13,Senegal,Congo,2,0,2,1.0,0.0,1941,1658
2019-11-13,Nigeria,Benin,2,1,1,1.0,0.0,1907,1695
2019-11-13,Sierra Leone,Lesotho,1,1,0,0.5,0.5,1622,1570
2019-11-14,Mali,Guinea,2,2,0,0.5,0.5,1755,1724
2019-11-14,Ghana,South Africa,2,0,2,1.0,0.0,1870,1822
2019-11-14,DR Congo,Gabon,0,0,0,0.5,0.5,1746,1715
2019-11-14,Mozambique,Rwanda,2,0,2,1.0,0.0,1662,1630
2019-11-14,Egypt,Kenya,1,1,0,0.5,0.5,1896,1693
2019-11-14,Togo,Comoros,0,1,1,0.0,1.0,1647,1505
2019-11-14,Algeria,Zambia,5,0,5,1.0,0.0,1900,1743
2019-11-14,England,Montenegro,7,0,7,1.0,0.0,2098,1732
2019-11-14,Czech Republic,Kosovo,2,1,1,1.0,0.0,1919,1666
2019-11-14,Portugal,Lithuania,6,0,6,1.0,0.0,2080,1593
2019-11-14,Serbia,Luxembourg,3,2,1,1.0,0.0,1933,1575
2019-11-14,Turkey,Iceland,0,0,0,0.5,0.5,1949,1843
2019-11-14,Albania,Andorra,2,2,0,0.5,0.5,1747,1402
2019-11-14,France,Moldova,2,1,1,1.0,0.0,2151,1559
2019-11-14,Martinique,Honduras,1,1,0,0.5,0.5,1703,1841
2019-11-14,Curaçao,Costa Rica,1,2,1,0.0,1.0,1631,1883
2019-11-14,Saint Kitts and Nevis,Grenada,0,0,0,0.5,0.5,1586,1536
2019-11-14,Belize,French Guiana,2,0,2,1.0,0.0,1522,1590
2019-11-14,Bahamas,British Virgin Islands,3,0,3,1.0,0.0,1473,1324
2019-11-14,Turks and Caicos Islands,Sint Maarten,3,2,1,1.0,0.0,1437,1442
2019-11-14,Bulgaria,Paraguay,0,1,1,0.0,1.0,1791,1885
2019-11-14,Cambodia,Mongolia,1,1,0,0.5,0.5,1375,1397
2019-11-14,Ecuador,Trinidad and Tobago,3,0,3,1.0,0.0,1931,1688
2019-11-14,Qatar,Singapore,2,0,2,1.0,0.0,1893,1587
2019-11-14,Republic of Ireland,New Zealand,3,1,2,1.0,0.0,1923,1753
2019-11-14,Ukraine,Estonia,1,0,1,1.0,0.0,1993,1716
2019-11-14,Maldives,Philippines,1,2,1,0.0,1.0,1442,1605
2019-11-14,Syria,China PR,2,1,1,1.0,0.0,1777,1843
2019-11-14,Jordan,Australia,0,1,1,0.0,1.0,1784,1948
2019-11-14,Kuwait,Taiwan,9,0,9,1.0,0.0,1773,1471
2019-11-14,Iraq,Iran,2,1,1,1.0,0.0,1862,1989
2019-11-14,Hong Kong,Bahrain,0,0,0,0.5,0.5,1608,1806
2019-11-14,Uzbekistan,Saudi Arabia,2,3,1,0.0,1.0,1856,1830
2019-11-14,Yemen,Palestine,1,0,1,1.0,0.0,1573,1683
2019-11-14,Afghanistan,India,1,1,0,0.5,0.5,1508,1621
2019-11-14,Oman,Bangladesh,4,1,3,1.0,0.0,1825,1424
2019-11-14,Myanmar,Tajikistan,4,3,1,1.0,0.0,1544,1595
2019-11-14,Kyrgyzstan,Japan,0,2,2,0.0,1.0,1604,2000
2019-11-14,Vietnam,United Arab Emirates,1,0,1,1.0,0.0,1748,1839
2019-11-14,Malaysia,Thailand,2,1,1,1.0,0.0,1618,1769
2019-11-14,Lebanon,South Korea,0,0,0,0.5,0.5,1711,1974
2019-11-14,Turkmenistan,North Korea,3,1,2,1.0,0.0,1613,1759
2019-11-15,Morocco,Mauritania,0,0,0,0.5,0.5,1865,1598
2019-11-15,Zimbabwe,Botswana,0,0,0,0.5,0.5,1712,1636
2019-11-15,Tanzania,Equatorial Guinea,2,1,1,1.0,0.0,1633,1568
2019-11-15,Tunisia,Libya,4,1,3,1.0,0.0,1865,1713
2019-11-15,Denmark,Gibraltar,6,0,6,1.0,0.0,1981,1519
2019-11-15,Switzerland,Georgia,1,0,1,1.0,0.0,1994,1743
2019-11-15,Norway,Faroe Islands,4,0,4,1.0,0.0,1874,1498
2019-11-15,Spain,Malta,7,0,7,1.0,0.0,2164,1481
2019-11-15,Romania,Sweden,0,2,2,0.0,1.0,1918,1968
2019-11-15,Finland,Liechtenstein,3,0,3,1.0,0.0,1835,1440
2019-11-15,Brazil,Argentina,0,1,1,0.0,1.0,2195,2122
2019-11-15,Bosnia and Herzegovina,Italy,0,3,3,0.0,1.0,1880,2069
2019-11-15,Armenia,Greece,0,1,1,0.0,1.0,1678,1840
2019-11-15,United States,Canada,4,1,3,1.0,0.0,1973,1796
2019-11-15,Panama,Mexico,0,3,3,0.0,1.0,1801,2053
2019-11-15,Antigua and Barbuda,Jamaica,0,2,2,0.0,1.0,1572,1805
2019-11-15,Guyana,Aruba,4,2,2,1.0,0.0,1596,1409
2019-11-15,Saint Vincent and the Grenadines,Nicaragua,1,0,1,1.0,0.0,1563,1504
2019-11-15,Suriname,Dominica,4,0,4,1.0,0.0,1607,1434
2019-11-15,Colombia,Peru,1,0,1,1.0,0.0,2073,1968
2019-11-15,Hungary,Uruguay,1,2,1,0.0,1.0,1818,2043
2019-11-16,Ivory Coast,Niger,1,0,1,1.0,0.0,1897,1589
2019-11-16,Madagascar,Ethiopia,1,0,1,1.0,0.0,1624,1610
2019-11-16,Northern Ireland,Netherlands,0,0,0,0.5,0.5,1835,2079
2019-11-16,Germany,Belarus,4,0,4,1.0,0.0,2113,1749
2019-11-16,Croatia,Slovakia,3,1,2,1.0,0.0,2027,1902
2019-11-16,Azerbaijan,Wales,0,2,2,0.0,1.0,1643,1874
2019-11-16,Slovenia,Latvia,1,0,1,1.0,0.0,1777,1576
2019-11-16,Austria,North Macedonia,2,1,1,1.0,0.0,1919,1747
2019-11-16,Israel,Poland,1,2,1,0.0,1.0,1766,1962
2019-11-16,Cyprus,Scotland,1,2,1,0.0,1.0,1651,1858
2019-11-16,San Marino,Kazakhstan,1,3,2,0.0,1.0,1300,1632
2019-11-16,Russia,Belgium,1,4,3,0.0,1.0,1964,2117
2019-11-16,Saint Lucia,Dominican Republic,1,0,1,1.0,0.0,1493,1566
2019-11-16,El Salvador,Montserrat,1,0,1,1.0,0.0,1762,1432
2019-11-16,Saint Martin,Barbados,1,0,1,1.0,0.0,1417,1524
2019-11-16,Cayman Islands,United States Virgin Islands,1,0,1,1.0,0.0,1432,1365
2019-11-16,Guatemala,Puerto Rico,5,0,5,1.0,0.0,1716,1421
2019-11-17,Chad,Mali,0,2,2,0.0,1.0,1532,1759
2019-11-17,Guinea,Namibia,2,0,2,1.0,0.0,1731,1643
2019-11-17,South Sudan,Burkina Faso,1,2,1,0.0,1.0,1457,1752
2019-11-17,Uganda,Malawi,2,0,2,1.0,0.0,1754,1652
2019-11-17,South Africa,Sudan,1,0,1,1.0,0.0,1826,1588
2019-11-17,Gabon,Angola,2,1,1,1.0,0.0,1723,1682
2019-11-17,Rwanda,Cameroon,0,1,1,0.0,1.0,1627,1853
2019-11-17,Congo,Guinea-Bissau,3,0,3,1.0,0.0,1665,1570
2019-11-17,Eswatini,Senegal,1,4,3,0.0,1.0,1512,1943
2019-11-17,Benin,Sierra Leone,1,0,1,1.0,0.0,1702,1616
2019-11-17,Lesotho,Nigeria,2,4,2,0.0,1.0,1568,1910
2019-11-17,Kosovo,England,0,4,4,0.0,1.0,1665,2100
2019-11-17,Bulgaria,Czech Republic,1,0,1,1.0,0.0,1802,1909
2019-11-17,Luxembourg,Portugal,0,2,2,0.0,1.0,1575,2081
2019-11-17,Serbia,Ukraine,2,2,0,0.5,0.5,1935,1992
2019-11-17,Albania,France,0,2,2,0.0,1.0,1746,2153
2019-11-17,Andorra,Turkey,0,2,2,0.0,1.0,1402,1950
2019-11-17,Moldova,Iceland,1,2,1,0.0,1.0,1557,1846
2019-11-17,Honduras,Trinidad and Tobago,4,0,4,1.0,0.0,1846,1684
2019-11-17,Costa Rica,Haiti,1,1,0,0.5,0.5,1880,1738
2019-11-17,Grenada,Belize,3,2,1,1.0,0.0,1544,1515
2019-11-17,French Guiana,Saint Kitts and Nevis,3,1,2,1.0,0.0,1598,1579
2019-11-17,Bonaire,Bahamas,1,1,0,0.5,0.5,1479,1474
2019-11-17,Guadeloupe,Turks and Caicos Islands,10,0,10,1.0,0.0,1633,1434
2019-11-17,Lithuania,New Zealand,1,0,1,1.0,0.0,1605,1742
2019-11-18,São Tomé and Príncipe,Ghana,0,1,1,0.0,1.0,1454,1872
2019-11-18,Gambia,DR Congo,2,2,0,0.5,0.5,1604,1743
2019-11-18,Cape Verde,Mozambique,2,2,0,0.5,0.5,1704,1663
2019-11-18,Comoros,Egypt,0,0,0,0.5,0.5,1512,1890
2019-11-18,Kenya,Togo,1,1,0,0.5,0.5,1692,1649
2019-11-18,Botswana,Algeria,0,1,1,0.0,1.0,1634,1903
2019-11-18,Niger,Madagascar,2,6,4,0.0,1.0,1582,1632
2019-11-18,Republic of Ireland,Denmark,1,1,0,0.5,0.5,1925,1980
2019-11-18,Gibraltar,Switzerland,1,6,5,0.0,1.0,1519,1995
2019-11-18,Malta,Norway,1,2,1,0.0,1.0,1480,1876
2019-11-18,Spain,Romania,5,0,5,1.0,0.0,2168,1915
2019-11-18,Sweden,Faroe Islands,3,0,3,1.0,0.0,1970,1497
2019-11-18,Italy,Armenia,9,1,8,1.0,0.0,2071,1677
2019-11-18,Liechtenstein,Bosnia and Herzegovina,0,3,3,0.0,1.0,1439,1882
2019-11-18,Greece,Finland,2,1,1,1.0,0.0,1848,1828
2019-11-18,Jamaica,Guyana,1,1,0,0.5,0.5,1801,1601
2019-11-18,Aruba,Antigua and Barbuda,2,3,1,0.0,1.0,1405,1577
2019-11-18,Nicaragua,Suriname,1,2,1,0.0,1.0,1499,1613
2019-11-18,Dominica,Saint Vincent and the Grenadines,1,0,1,1.0,0.0,1445,1553
2019-11-18,Argentina,Uruguay,2,2,0,0.5,0.5,2121,2045
2019-11-19,Burundi,Morocco,0,3,3,0.0,1.0,1590,1868
2019-11-19,Mauritania,Central African Republic,2,0,2,1.0,0.0,1606,1564
2019-11-19,Zambia,Zimbabwe,1,2,1,0.0,1.0,1735,1721
2019-11-19,Equatorial Guinea,Tunisia,0,1,1,0.0,1.0,1566,1868
2019-11-19,Libya,Tanzania,2,1,1,1.0,0.0,1720,1627
2019-11-19,Ethiopia,Ivory Coast,2,1,1,1.0,0.0,1624,1884
2019-11-19,Germany,Northern Ireland,6,1,5,1.0,0.0,2116,1833
2019-11-19,Netherlands,Estonia,5,0,5,1.0,0.0,2081,1715
2019-11-19,Wales,Hungary,2,0,2,1.0,0.0,1881,1812
2019-11-19,Slovakia,Azerbaijan,2,0,2,1.0,0.0,1905,1641
2019-11-19,North Macedonia,Israel,1,0,1,1.0,0.0,1756,1758
2019-11-19,Japan,Venezuela,1,4,3,0.0,1.0,1990,1911
2019-11-19,Poland,Slovenia,3,2,1,1.0,0.0,1967,1773
2019-11-19,Latvia,Austria,1,0,1,1.0,0.0,1591,1905
2019-11-19,Scotland,Kazakhstan,3,1,2,1.0,0.0,1862,1629
2019-11-19,Belgium,Cyprus,6,1,5,1.0,0.0,2119,1650
2019-11-19,San Marino,Russia,0,5,5,0.0,1.0,1300,1965
2019-11-19,Cuba,United States,0,4,4,0.0,1.0,1617,1975
2019-11-19,Mexico,Bermuda,2,1,1,1.0,0.0,2055,1594
2019-11-19,El Salvador,Dominican Republic,2,0,2,1.0,0.0,1766,1563
2019-11-19,Saint Lucia,Montserrat,0,1,1,0.0,1.0,1484,1442
2019-11-19,Barbados,Cayman Islands,3,0,3,1.0,0.0,1530,1427
2019-11-19,United States Virgin Islands,Saint Martin,1,2,1,0.0,1.0,1359,1424
2019-11-19,Puerto Rico,Anguilla,3,0,3,1.0,0.0,1427,1290
2019-11-19,Brazil,South Korea,3,0,3,1.0,0.0,2199,1971
2019-11-19,Croatia,Georgia,2,1,1,1.0,0.0,2030,1741
2019-11-19,Ecuador,Colombia,0,1,1,0.0,1.0,1927,2078
2019-11-19,Montenegro,Belarus,2,0,2,1.0,0.0,1741,1741
2019-11-19,Saudi Arabia,Paraguay,0,0,0,0.5,0.5,1832,1884
2019-11-19,Maldives,Guam,3,1,2,1.0,0.0,1449,1386
2019-11-19,Syria,Philippines,1,0,1,1.0,0.0,1782,1601
2019-11-19,Nepal,Kuwait,0,1,1,0.0,1.0,1418,1775
2019-11-19,Jordan,Taiwan,5,0,5,1.0,0.0,1787,1469
2019-11-19,Iraq,Bahrain,0,0,0,0.5,0.5,1861,1808
2019-11-19,Hong Kong,Cambodia,2,0,2,1.0,0.0,1612,1372
2019-11-19,Uzbekistan,Palestine,2,0,2,1.0,0.0,1861,1679
2019-11-19,Yemen,Singapore,1,2,1,0.0,1.0,1566,1595
2019-11-19,Afghanistan,Qatar,0,1,1,0.0,1.0,1507,1895
2019-11-19,Oman,India,1,0,1,1.0,0.0,1829,1618
2019-11-19,Myanmar,Mongolia,1,0,1,1.0,0.0,1549,1393
2019-11-19,Kyrgyzstan,Tajikistan,1,1,0,0.5,0.5,1604,1596
2019-11-19,Vietnam,Thailand,0,0,0,0.5,0.5,1749,1769
2019-11-19,Malaysia,Indonesia,2,0,2,1.0,0.0,1627,1622
2019-11-19,Turkmenistan,Sri Lanka,2,0,2,1.0,0.0,1616,1317
2019-11-19,Lebanon,North Korea,0,0,0,0.5,0.5,1713,1758
2019-11-21,Guatemala,Antigua and Barbuda,8,0,8,1.0,0.0,1721,1573
2019-11-26,Qatar,Iraq,1,2,1,0.0,1.0,1887,1870
2019-11-26,United Arab Emirates,Yemen,3,0,3,1.0,0.0,1842,1564
2019-11-27,Oman,Bahrain,0,0,0,0.5,0.5,1829,1809
2019-11-27,Saudi Arabia,Kuwait,1,3,2,0.0,1.0,1823,1785
2019-11-29,United Arab Emirates,Iraq,0,2,2,0.0,1.0,1835,1878
2019-11-29,Qatar,Yemen,6,0,6,1.0,0.0,1890,1562
2019-11-30,Kuwait,Oman,1,2,1,0.0,1.0,1779,1836
2019-11-30,Bahrain,Saudi Arabia,0,2,2,0.0,1.0,1802,1831
2019-12-02,Qatar,United Arab Emirates,4,2,2,1.0,0.0,1897,1829
2019-12-02,Yemen,Iraq,0,0,0,0.5,0.5,1568,1873
2019-12-02,Kuwait,Bahrain,2,4,2,0.0,1.0,1772,1810
2019-12-02,Oman,Saudi Arabia,1,3,2,0.0,1.0,1828,1840
2019-12-05,Iraq,Bahrain,2,2,0,0.5,0.5,1872,1812
2019-12-05,Qatar,Saudi Arabia,0,1,1,0.0,1.0,1888,1850
2019-12-08,Bahrain,Saudi Arabia,1,0,1,1.0,0.0,1821,1842
2019-12-08,Luhansk PR,South Ossetia,4,3,1,1.0,0.0,1496,1495
2019-12-10,China PR,Japan,1,2,1,0.0,1.0,1839,1995
2019-12-11,South Korea,Hong Kong,2,0,2,1.0,0.0,1973,1611
2019-12-14,Japan,Hong Kong,5,0,5,1.0,0.0,1997,1610
2019-12-15,South Korea,China PR,1,0,1,1.0,0.0,1979,1834
2019-12-18,Hong Kong,China PR,0,2,2,0.0,1.0,1607,1838
2019-12-18,South Korea,Japan,1,0,1,1.0,0.0,1988,1989
2019-12-29,Chagos Islands,Panjab,0,6,6,0.0,1.0,1447,1530
2020-01-07,Barbados,Canada,1,4,3,0.0,1.0,1528,1799
2020-01-09,Moldova,Sweden,0,1,1,0.0,1.0,1556,1972
2020-01-10,Barbados,Canada,1,4,3,0.0,1.0,1526,1802
2020-01-12,Kosovo,Sweden,0,1,1,0.0,1.0,1663,1975
2020-01-15,Canada,Iceland,0,1,1,0.0,1.0,1796,1853
2020-01-19,El Salvador,Iceland,0,1,1,0.0,1.0,1760,1860
2020-02-01,United States,Costa Rica,1,0,1,1.0,0.0,1981,1875
2020-09-03,Germany,Spain,1,1,0,0.5,0.5,2118,2167
2020-09-03,Ukraine,Switzerland,2,1,1,1.0,0.0,2001,1987
2020-09-03,Russia,Serbia,3,1,2,1.0,0.0,1973,1928
2020-09-03,Turkey,Hungary,0,1,1,0.0,1.0,1939,1824
2020-09-03,Bulgaria,Republic of Ireland,1,1,0,0.5,0.5,1805,1923
2020-09-03,Finland,Wales,0,1,1,0.0,1.0,1822,1888
2020-09-03,Moldova,Kosovo,1,1,0,0.5,0.5,1559,1661
2020-09-03,Slovenia,Greece,0,0,0,0.5,0.5,1775,1847
2020-09-03,Latvia,Andorra,0,0,0,0.5,0.5,1588,1406
2020-09-03,Faroe Islands,Malta,3,2,1,1.0,0.0,1505,1473
2020-09-04,Italy,Bosnia and Herzegovina,1,1,0,0.5,0.5,2068,1886
2020-09-04,Netherlands,Poland,1,0,1,1.0,0.0,2087,1962
2020-09-04,Norway,Austria,1,2,1,0.0,1.0,1869,1913
2020-09-04,Romania,Northern Ireland,1,1,0,0.5,0.5,1914,1835
2020-09-04,Scotland,Israel,1,1,0,0.5,0.5,1860,1761
2020-09-04,Slovakia,Czech Republic,1,3,2,0.0,1.0,1898,1917
2020-09-04,Lithuania,Kazakhstan,0,2,2,0.0,1.0,1598,1637
2020-09-04,Belarus,Albania,0,2,2,0.0,1.0,1734,1754
2020-09-05,Iceland,England,0,1,1,0.0,1.0,1857,2104
2020-09-05,Denmark,Belgium,0,2,2,0.0,1.0,1976,2124
2020-09-05,Portugal,Croatia,4,1,3,1.0,0.0,2088,2024
2020-09-05,Sweden,France,0,1,1,0.0,1.0,1971,2158
2020-09-05,Cyprus,Montenegro,0,2,2,0.0,1.0,1645,1747
2020-09-05,Azerbaijan,Luxembourg,1,2,1,0.0,1.0,1632,1585
2020-09-05,North Macedonia,Armenia,2,1,1,1.0,0.0,1763,1671
2020-09-05,Estonia,Georgia,0,1,1,0.0,1.0,1708,1749
2020-09-05,Gibraltar,San Marino,1,0,1,1.0,0.0,1523,1297
2020-09-06,Spain,Ukraine,4,0,4,1.0,0.0,2172,1997
2020-09-06,Switzerland,Germany,1,1,0,0.5,0.5,1990,2116
2020-09-06,Hungary,Russia,2,3,1,0.0,1.0,1820,1978
2020-09-06,Serbia,Turkey,0,0,0,0.5,0.5,1929,1939
2020-09-06,Wales,Bulgaria,1,0,1,1.0,0.0,1895,1799
2020-09-06,Republic of Ireland,Finland,0,1,1,0.0,1.0,1913,1833
2020-09-06,Slovenia,Moldova,1,0,1,1.0,0.0,1779,1556
2020-09-06,Kosovo,Greece,1,2,1,0.0,1.0,1657,1852
2020-09-06,Andorra,Faroe Islands,0,1,1,0.0,1.0,1401,1511
2020-09-06,Malta,Latvia,1,1,0,0.5,0.5,1476,1586
2020-09-07,Bosnia and Herzegovina,Poland,1,2,1,0.0,1.0,1880,1969
2020-09-07,Netherlands,Italy,0,1,1,0.0,1.0,2079,2077
2020-09-07,Northern Ireland,Norway,1,5,4,0.0,1.0,1828,1877
2020-09-07,Austria,Romania,2,3,1,0.0,1.0,1906,1922
2020-09-07,Czech Republic,Scotland,1,2,1,0.0,1.0,1908,1870
2020-09-07,Israel,Slovakia,1,1,0,0.5,0.5,1765,1895
2020-09-07,Kazakhstan,Belarus,1,2,1,0.0,1.0,1632,1740
2020-09-07,Albania,Lithuania,0,1,1,0.0,1.0,1743,1610
2020-09-08,Belgium,Iceland,5,1,4,1.0,0.0,2127,1855
2020-09-08,Denmark,England,0,0,0,0.5,0.5,1979,2102
2020-09-08,France,Croatia,4,2,2,1.0,0.0,2164,2019
2020-09-08,Sweden,Portugal,0,2,2,0.0,1.0,1966,2094
2020-09-08,Luxembourg,Montenegro,0,1,1,0.0,1.0,1581,1752
2020-09-08,Cyprus,Azerbaijan,0,1,1,0.0,1.0,1637,1641
2020-09-08,Armenia,Estonia,2,0,2,1.0,0.0,1680,1700
2020-09-08,Georgia,North Macedonia,1,1,0,0.5,0.5,1750,1763
2020-09-08,San Marino,Liechtenstein,0,2,2,0.0,1.0,1293,1444
2020-10-06,Nicaragua,Guatemala,0,0,0,0.5,0.5,1504,1717
2020-10-07,Andorra,Cape Verde,1,2,1,0.0,1.0,1399,1707
2020-10-07,Austria,Greece,2,1,1,1.0,0.0,1913,1846
2020-10-07,Cyprus,Czech Republic,1,2,1,0.0,1.0,1635,1911
2020-10-07,Denmark,Faroe Islands,4,0,4,1.0,0.0,1981,1510
2020-10-07,Estonia,Lithuania,1,3,2,0.0,1.0,1690,1621
2020-10-07,France,Ukraine,7,1,6,1.0,0.0,2169,1993
2020-10-07,Germany,Turkey,3,3,0,0.5,0.5,2113,1943
2020-10-07,Italy,Moldova,6,0,6,1.0,0.0,2078,1556
2020-10-07,Luxembourg,Liechtenstein,1,2,1,0.0,1.0,1570,1456
2020-10-07,Malta,Gibraltar,2,0,2,1.0,0.0,1486,1514
2020-10-07,Montenegro,Latvia,1,1,0,0.5,0.5,1749,1590
2020-10-07,Netherlands,Mexico,0,1,1,0.0,1.0,2071,2064
2020-10-07,Poland,Finland,5,1,4,1.0,0.0,1975,1828
2020-10-07,Portugal,Spain,0,0,0,0.5,0.5,2096,2171
2020-10-07,Slovenia,San Marino,4,0,4,1.0,0.0,1780,1293
2020-10-07,Switzerland,Croatia,1,2,1,0.0,1.0,1983,2027
2020-10-07,Zambia,Malawi,1,0,1,1.0,0.0,1742,1646
2020-10-08,Belgium,Ivory Coast,1,1,0,0.5,0.5,2123,1889
2020-10-08,England,Wales,3,0,3,1.0,0.0,2106,1892
2020-10-08,Russia,Sweden,1,2,1,0.0,1.0,1970,1975
2020-10-08,South Africa,Namibia,1,1,0,0.5,0.5,1823,1647
2020-10-08,Uzbekistan,Iran,1,2,1,0.0,1.0,1856,1995
2020-10-08,Paraguay,Peru,2,2,0,0.5,0.5,1886,1967
2020-10-08,Uruguay,Chile,2,1,1,1.0,0.0,2052,1995
2020-10-08,Argentina,Ecuador,1,0,1,1.0,0.0,2125,1924
2020-10-08,Iceland,Romania,2,1,1,1.0,0.0,1865,1913
2020-10-08,Bulgaria,Hungary,1,3,2,0.0,1.0,1792,1828
2020-10-08,Bosnia and Herzegovina,Northern Ireland,1,1,0,0.5,0.5,1879,1830
2020-10-08,Slovakia,Republic of Ireland,0,0,0,0.5,0.5,1896,1913
2020-10-08,Scotland,Israel,0,0,0,0.5,0.5,1868,1768
2020-10-08,Norway,Serbia,1,2,1,0.0,1.0,1871,1936
2020-10-08,Georgia,Belarus,1,0,1,1.0,0.0,1758,1733
2020-10-08,North Macedonia,Kosovo,2,1,1,1.0,0.0,1769,1652
2020-10-09,Burkina Faso,DR Congo,3,0,3,1.0,0.0,1760,1736
2020-10-09,Congo,Gambia,0,1,1,0.0,1.0,1656,1614
2020-10-09,Japan,Cameroon,0,0,0,0.5,0.5,1987,1856
2020-10-09,Kenya,Zambia,2,1,1,1.0,0.0,1702,1733
2020-10-09,Mali,Ghana,3,0,3,1.0,0.0,1770,1862
2020-10-09,Mauritania,Sierra Leone,2,1,1,1.0,0.0,1615,1608
2020-10-09,Morocco,Senegal,3,1,2,1.0,0.0,1878,1934
2020-10-09,Nigeria,Algeria,0,1,1,0.0,1.0,1902,1912
2020-10-09,Tunisia,Sudan,3,0,3,1.0,0.0,1871,1586
2020-10-09,Colombia,Venezuela,3,0,3,1.0,0.0,2083,1907
2020-10-09,Brazil,Bolivia,5,0,5,1.0,0.0,2201,1745
2020-10-10,Spain,Switzerland,1,0,1,1.0,0.0,2176,1979
2020-10-10,Ukraine,Germany,1,2,1,0.0,1.0,1988,2119
2020-10-10,Luxembourg,Cyprus,2,0,2,1.0,0.0,1580,1626
2020-10-10,Montenegro,Azerbaijan,2,0,2,1.0,0.0,1755,1636
2020-10-10,Faroe Islands,Latvia,1,1,0,0.5,0.5,1512,1589
2020-10-10,Andorra,Malta,0,0,0,0.5,0.5,1401,1485
2020-10-10,Liechtenstein,Gibraltar,0,1,1,0.0,1.0,1450,1521
2020-10-10,Cape Verde,Guinea,1,2,1,0.0,1.0,1700,1739
2020-10-10,Costa Rica,Panama,0,1,1,0.0,1.0,1866,1811
2020-10-10,Honduras,Nicaragua,1,1,0,0.5,0.5,1840,1511
2020-10-10,Niger,Chad,2,0,2,1.0,0.0,1589,1526
2020-10-11,Bosnia and Herzegovina,Netherlands,0,0,0,0.5,0.5,1884,2067
2020-10-11,Poland,Italy,0,0,0,0.5,0.5,1978,2076
2020-10-11,England,Belgium,2,1,1,1.0,0.0,2115,2115
2020-10-11,Iceland,Denmark,0,3,3,0.0,1.0,1860,1987
2020-10-11,Croatia,Sweden,2,1,1,1.0,0.0,2034,1969
2020-10-11,France,Portugal,0,0,0,0.5,0.5,2168,2098
2020-10-11,Norway,Romania,4,0,4,1.0,0.0,1880,1905
2020-10-11,Northern Ireland,Austria,0,1,1,0.0,1.0,1824,1920
2020-10-11,Scotland,Slovakia,1,0,1,1.0,0.0,1877,1888
2020-10-11,Israel,Czech Republic,1,2,1,0.0,1.0,1764,1916
2020-10-11,Serbia,Hungary,0,1,1,0.0,1.0,1926,1839
2020-10-11,Russia,Turkey,1,1,0,0.5,0.5,1970,1944
2020-10-11,Republic of Ireland,Wales,0,0,0,0.5,0.5,1913,1893
2020-10-11,Finland,Bulgaria,2,0,2,1.0,0.0,1836,1785
2020-10-11,Armenia,Georgia,2,2,0,0.5,0.5,1682,1757
2020-10-11,Estonia,North Macedonia,3,3,0,0.5,0.5,1692,1768
2020-10-11,Kosovo,Slovenia,0,1,1,0.0,1.0,1647,1786
2020-10-11,Greece,Moldova,2,0,2,1.0,0.0,1849,1554
2020-10-11,Kazakhstan,Albania,0,0,0,0.5,0.5,1635,1741
2020-10-11,Lithuania,Belarus,2,2,0,0.5,0.5,1624,1731
2020-10-11,Gabon,Benin,0,2,2,0.0,1.0,1715,1711
2020-10-11,Malawi,Zimbabwe,0,0,0,0.5,0.5,1648,1720
2020-10-11,South Africa,Zambia,1,2,1,0.0,1.0,1813,1744
2020-10-11,Tanzania,Burundi,0,1,1,0.0,1.0,1619,1599
2020-10-12,Burkina Faso,Madagascar,2,1,1,1.0,0.0,1766,1627
2020-10-12,Ghana,Qatar,5,1,4,1.0,0.0,1871,1880
2020-10-12,Togo,Sudan,1,1,0,0.5,0.5,1648,1588
2020-10-12,United Arab Emirates,Uzbekistan,1,2,1,0.0,1.0,1822,1864
2020-10-13,Cameroon,South Sudan,0,0,0,0.5,0.5,1850,1464
2020-10-13,Germany,Switzerland,3,3,0,0.5,0.5,2116,1983
2020-10-13,Ukraine,Spain,1,0,1,1.0,0.0,2000,2165
2020-10-13,Azerbaijan,Cyprus,0,0,0,0.5,0.5,1636,1627
2020-10-13,Montenegro,Luxembourg,1,2,1,0.0,1.0,1744,1592
2020-10-13,Latvia,Malta,0,1,1,0.0,1.0,1579,1496
2020-10-13,Faroe Islands,Andorra,2,0,2,1.0,0.0,1518,1396
2020-10-13,Liechtenstein,San Marino,0,0,0,0.5,0.5,1447,1297
2020-10-13,Costa Rica,Panama,0,1,1,0.0,1.0,1857,1821
2020-10-13,Japan,Ivory Coast,1,0,1,1.0,0.0,1993,1884
2020-10-13,Mexico,Algeria,2,2,0,0.5,0.5,2061,1916
2020-10-13,Morocco,DR Congo,1,1,0,0.5,0.5,1875,1740
2020-10-13,Mozambique,Angola,0,3,3,0.0,1.0,1656,1690
2020-10-13,Niger,Sierra Leone,1,0,1,1.0,0.0,1598,1600
2020-10-13,Nigeria,Tunisia,1,1,0,0.5,0.5,1902,1872
2020-10-13,Bolivia,Argentina,1,2,1,0.0,1.0,1744,2127
2020-10-13,Ecuador,Uruguay,4,2,2,1.0,0.0,1935,2042
2020-10-13,Venezuela,Paraguay,0,1,1,0.0,1.0,1899,1895
2020-10-13,Peru,Brazil,2,4,2,0.0,1.0,1964,2205
2020-10-13,Chile,Colombia,2,2,0,0.5,0.5,1997,2082
2020-10-14,Italy,Netherlands,1,1,0,0.5,0.5,2076,2068
2020-10-14,Poland,Bosnia and Herzegovina,3,0,3,1.0,0.0,1984,1879
2020-10-14,Iceland,Belgium,1,2,1,0.0,1.0,1858,2118
2020-10-14,England,Denmark,0,1,1,0.0,1.0,2105,1998
2020-10-14,Portugal,Sweden,3,0,3,1.0,0.0,2104,1964
2020-10-14,Croatia,France,1,2,1,0.0,1.0,2029,2174
2020-10-14,Norway,Northern Ireland,1,0,1,1.0,0.0,1887,1818
2020-10-14,Romania,Austria,0,1,1,0.0,1.0,1898,1928
2020-10-14,Scotland,Czech Republic,1,0,1,1.0,0.0,1886,1908
2020-10-14,Slovakia,Israel,2,3,1,0.0,1.0,1878,1775
2020-10-14,Russia,Hungary,0,0,0,0.5,0.5,1968,1842
2020-10-14,Turkey,Serbia,2,2,0,0.5,0.5,1944,1927
2020-10-14,Finland,Republic of Ireland,1,0,1,1.0,0.0,1846,1904
2020-10-14,Bulgaria,Wales,0,1,1,0.0,1.0,1780,1899
2020-10-14,North Macedonia,Georgia,1,1,0,0.5,0.5,1768,1758
2020-10-14,Estonia,Armenia,1,1,0,0.5,0.5,1692,1683
2020-10-14,Greece,Kosovo,0,0,0,0.5,0.5,1845,1652
2020-10-14,Moldova,Slovenia,0,4,4,0.0,1.0,1551,1790
2020-10-14,Lithuania,Albania,0,0,0,0.5,0.5,1627,1739
2020-10-14,Belarus,Kazakhstan,2,0,2,1.0,0.0,1737,1630
2020-11-06,Ethiopia,Sudan,2,2,0,0.5,0.5,1624,1589
2020-11-07,Bahrain,Tajikistan,1,0,1,1.0,0.0,1825,1593
2020-11-11,Albania,Kosovo,2,1,1,1.0,0.0,1746,1646
2020-11-11,Belgium,Switzerland,2,1,1,1.0,0.0,2124,1978
2020-11-11,Bulgaria,Gibraltar,3,0,3,1.0,0.0,1783,1519
2020-11-11,Denmark,Sweden,2,0,2,1.0,0.0,2006,1957
2020-11-11,France,Finland,0,2,2,0.0,1.0,2161,1860
2020-11-11,Germany,Czech Republic,1,0,1,1.0,0.0,2120,1905
2020-11-11,Greece,Cyprus,2,1,1,1.0,0.0,1849,1624
2020-11-11,Italy,Estonia,4,0,4,1.0,0.0,2078,1691
2020-11-11,Lithuania,Faroe Islands,2,1,1,1.0,0.0,1633,1513
2020-11-11,Luxembourg,Austria,0,3,3,0.0,1.0,1590,1931
2020-11-11,Malta,Liechtenstein,3,0,3,1.0,0.0,1503,1441
2020-11-11,Montenegro,Kazakhstan,0,0,0,0.5,0.5,1742,1633
2020-11-11,Netherlands,Spain,1,1,0,0.5,0.5,2071,2163
2020-11-11,Poland,Ukraine,2,0,2,1.0,0.0,1993,1992
2020-11-11,Portugal,Andorra,7,0,7,1.0,0.0,2105,1396
2020-11-11,Romania,Belarus,5,3,2,1.0,0.0,1903,1733
2020-11-11,San Marino,Latvia,0,3,3,0.0,1.0,1295,1582
2020-11-11,Slovenia,Azerbaijan,0,0,0,0.5,0.5,1787,1640
2020-11-11,Turkey,Croatia,3,3,0,0.5,0.5,1946,2028
2020-11-11,Guinea,Chad,1,0,1,1.0,0.0,1743,1523
2020-11-11,Mauritania,Burundi,1,1,0,0.5,0.5,1615,1600
2020-11-11,Kenya,Comoros,1,1,0,0.5,0.5,1699,1516
2020-11-11,Senegal,Guinea-Bissau,2,0,2,1.0,0.0,1936,1569
2020-11-11,Libya,Equatorial Guinea,2,3,1,0.0,1.0,1709,1578
2020-11-12,Hungary,Iceland,2,1,1,1.0,0.0,1851,1850
2020-11-12,Northern Ireland,Slovakia,1,2,1,0.0,1.0,1812,1885
2020-11-12,Serbia,Scotland,1,1,0,0.5,0.5,1927,1887
2020-11-12,Georgia,North Macedonia,0,1,1,0.0,1.0,1751,1776
2020-11-12,Bosnia and Herzegovina,Iran,0,2,2,0.0,1.0,1874,2001
2020-11-12,England,Republic of Ireland,3,0,3,1.0,0.0,2109,1901
2020-11-12,Jordan,Iraq,0,0,0,0.5,0.5,1789,1871
2020-11-12,Lebanon,Bahrain,1,3,2,0.0,1.0,1708,1831
2020-11-12,Moldova,Russia,0,0,0,0.5,0.5,1558,1962
2020-11-12,United Arab Emirates,Tajikistan,3,2,1,1.0,0.0,1826,1590
2020-11-12,Uzbekistan,Syria,0,1,1,0.0,1.0,1855,1792
2020-11-12,Wales,United States,0,0,0,0.5,0.5,1901,1980
2020-11-12,Bolivia,Ecuador,2,3,1,0.0,1.0,1741,1939
2020-11-12,Argentina,Paraguay,1,1,0,0.5,0.5,2123,1900
2020-11-12,Burkina Faso,Malawi,3,1,2,1.0,0.0,1772,1643
2020-11-12,Uganda,South Sudan,1,0,1,1.0,0.0,1757,1462
2020-11-12,Ghana,Sudan,2,0,2,1.0,0.0,1874,1587
2020-11-12,Gabon,Gambia,2,1,1,1.0,0.0,1721,1609
2020-11-12,Cape Verde,Rwanda,0,0,0,0.5,0.5,1699,1629
2020-11-12,Cameroon,Mozambique,4,1,3,1.0,0.0,1854,1653
2020-11-12,Zambia,Botswana,2,1,1,1.0,0.0,1750,1629
2020-11-12,Algeria,Zimbabwe,3,1,2,1.0,0.0,1920,1717
2020-11-12,Congo,Eswatini,2,0,2,1.0,0.0,1661,1508
2020-11-12,Ivory Coast,Madagascar,2,1,1,1.0,0.0,1887,1625
2020-11-13,Bangladesh,Nepal,2,0,2,1.0,0.0,1432,1411
2020-11-13,Costa Rica,Qatar,1,1,0,0.5,0.5,1858,1880
2020-11-13,Japan,Panama,1,0,1,1.0,0.0,1998,1817
2020-11-13,Colombia,Uruguay,0,3,3,0.0,1.0,2074,2051
2020-11-13,Chile,Peru,2,0,2,1.0,0.0,2005,1957
2020-11-13,Brazil,Venezuela,1,0,1,1.0,0.0,2208,1897
2020-11-13,Mali,Namibia,1,0,1,1.0,0.0,1776,1642
2020-11-13,South Africa,São Tomé and Príncipe,2,0,2,1.0,0.0,1815,1453
2020-11-13,Morocco,Central African Republic,4,1,3,1.0,0.0,1878,1562
2020-11-13,Tunisia,Tanzania,1,0,1,1.0,0.0,1876,1616
2020-11-13,Niger,Ethiopia,1,0,1,1.0,0.0,1607,1616
2020-11-13,Nigeria,Sierra Leone,4,4,0,0.5,0.5,1897,1606
2020-11-14,Portugal,France,0,1,1,0.0,1.0,2099,2168
2020-11-14,Sweden,Croatia,2,1,1,1.0,0.0,1967,2019
2020-11-14,Germany,Ukraine,3,1,2,1.0,0.0,2126,1987
2020-11-14,Switzerland,Spain,1,1,0,0.5,0.5,1982,2160
2020-11-14,Azerbaijan,Montenegro,0,0,0,0.5,0.5,1643,1740
2020-11-14,Cyprus,Luxembourg,2,1,1,1.0,0.0,1632,1583
2020-11-14,Malta,Andorra,3,1,2,1.0,0.0,1509,1391
2020-11-14,Latvia,Faroe Islands,1,1,0,0.5,0.5,1581,1515
2020-11-14,San Marino,Gibraltar,0,0,0,0.5,0.5,1300,1515
2020-11-14,Mexico,South Korea,3,2,1,1.0,0.0,2068,1982
2020-11-14,Saudi Arabia,Jamaica,3,0,3,1.0,0.0,1850,1794
2020-11-14,DR Congo,Angola,0,0,0,0.5,0.5,1739,1692
2020-11-14,Egypt,Togo,1,0,1,1.0,0.0,1894,1645
2020-11-14,Benin,Lesotho,1,0,1,1.0,0.0,1716,1564
2020-11-15,Netherlands,Bosnia and Herzegovina,3,1,2,1.0,0.0,2075,1871
2020-11-15,Italy,Poland,2,0,2,1.0,0.0,2085,1987
2020-11-15,Belgium,England,2,0,2,1.0,0.0,2132,2102
2020-11-15,Denmark,Iceland,2,1,1,1.0,0.0,2011,1846
2020-11-15,Austria,Northern Ireland,2,1,1,1.0,0.0,1937,1807
2020-11-15,Romania,Norway,3,0,3,1.0,0.0,1911,1880
2020-11-15,Slovakia,Scotland,1,0,1,1.0,0.0,1894,1879
2020-11-15,Czech Republic,Israel,1,0,1,1.0,0.0,1911,1770
2020-11-15,Turkey,Russia,3,2,1,1.0,0.0,1955,1954
2020-11-15,Hungary,Serbia,1,1,0,0.5,0.5,1853,1926
2020-11-15,Wales,Republic of Ireland,1,0,1,1.0,0.0,1909,1893
2020-11-15,Bulgaria,Finland,1,2,1,0.0,1.0,1777,1867
2020-11-15,North Macedonia,Estonia,2,1,1,1.0,0.0,1783,1685
2020-11-15,Georgia,Armenia,1,2,1,0.0,1.0,1742,1693
2020-11-15,Slovenia,Kosovo,2,1,1,1.0,0.0,1792,1642
2020-11-15,Moldova,Greece,0,2,2,0.0,1.0,1556,1852
2020-11-15,Albania,Kazakhstan,3,1,2,1.0,0.0,1752,1628
2020-11-15,Belarus,Lithuania,2,0,2,1.0,0.0,1739,1628
2020-11-15,Guatemala,Honduras,2,1,1,1.0,0.0,1728,1830
2020-11-15,Chad,Guinea,1,1,0,0.5,0.5,1528,1739
2020-11-15,Burundi,Mauritania,3,1,2,1.0,0.0,1609,1607
2020-11-15,Comoros,Kenya,2,1,1,1.0,0.0,1528,1688
2020-11-15,Guinea-Bissau,Senegal,0,1,1,0.0,1.0,1568,1938
2020-11-15,Equatorial Guinea,Libya,1,0,1,1.0,0.0,1589,1699
2020-11-16,Jordan,Syria,1,0,1,1.0,0.0,1798,1784
2020-11-16,United Arab Emirates,Bahrain,1,3,2,0.0,1.0,1819,1839
2020-11-16,United States,Panama,6,2,4,1.0,0.0,1985,1813
2020-11-16,Basque Country,Costa Rica,2,1,1,1.0,0.0,1790,1849
2020-11-16,Malawi,Burkina Faso,0,0,0,0.5,0.5,1646,1770
2020-11-16,South Sudan,Uganda,1,0,1,1.0,0.0,1476,1744
2020-11-16,South Africa,São Tomé and Príncipe,4,2,2,1.0,0.0,1817,1452
2020-11-16,Gambia,Gabon,2,1,1,1.0,0.0,1620,1711
2020-11-16,Mozambique,Cameroon,0,2,2,0.0,1.0,1650,1858
2020-11-16,Zimbabwe,Algeria,2,2,0,0.5,0.5,1722,1916
2020-11-16,Botswana,Zambia,1,0,1,1.0,0.0,1640,1740
2020-11-16,Eswatini,Congo,0,0,0,0.5,0.5,1512,1658
2020-11-17,Croatia,Portugal,2,3,1,0.0,1.0,2013,2106
2020-11-17,France,Sweden,4,2,2,1.0,0.0,2172,1964
2020-11-17,Spain,Germany,6,0,6,1.0,0.0,2168,2119
2020-11-17,Switzerland,Ukraine,3,0,3,1.0,0.0,1991,1979
2020-11-17,Luxembourg,Azerbaijan,0,0,0,0.5,0.5,1585,1642
2020-11-17,Montenegro,Cyprus,4,0,4,1.0,0.0,1746,1627
2020-11-17,Andorra,Latvia,0,5,5,0.0,1.0,1387,1586
2020-11-17,Malta,Faroe Islands,1,1,0,0.5,0.5,1510,1515
2020-11-17,Gibraltar,Liechtenstein,1,1,0,0.5,0.5,1514,1443
2020-11-17,Bangladesh,Nepal,0,0,0,0.5,0.5,1432,1412
2020-11-17,Japan,Mexico,0,2,2,0.0,1.0,1992,2075
2020-11-17,South Korea,Qatar,2,1,1,1.0,0.0,1988,1875
2020-11-17,Saudi Arabia,Jamaica,1,2,1,0.0,1.0,1841,1804
2020-11-17,Uzbekistan,Iraq,1,2,1,0.0,1.0,1848,1879
2020-11-17,Ecuador,Colombia,6,1,5,1.0,0.0,1950,2064
2020-11-17,Venezuela,Chile,2,1,1,1.0,0.0,1908,1995
2020-11-17,Peru,Argentina,0,2,2,0.0,1.0,1953,2128
2020-11-17,Paraguay,Bolivia,2,2,0,0.5,0.5,1897,1745
2020-11-17,Uruguay,Brazil,0,2,2,0.0,1.0,2047,2213
2020-11-17,Namibia,Mali,1,2,1,0.0,1.0,1637,1782
2020-11-17,Sudan,Ghana,1,0,1,1.0,0.0,1601,1861
2020-11-17,Angola,DR Congo,0,1,1,0.0,1.0,1686,1746
2020-11-17,Central African Republic,Morocco,0,2,2,0.0,1.0,1560,1881
2020-11-17,Rwanda,Cape Verde,0,0,0,0.5,0.5,1631,1698
2020-11-17,Togo,Egypt,1,3,2,0.0,1.0,1642,1898
2020-11-17,Tanzania,Tunisia,1,1,0,0.5,0.5,1622,1871
2020-11-17,Ethiopia,Niger,3,0,3,1.0,0.0,1624,1600
2020-11-17,Madagascar,Ivory Coast,1,1,0,0.5,0.5,1631,1882
2020-11-17,Sierra Leone,Nigeria,0,0,0,0.5,0.5,1612,1892
2020-11-17,Lesotho,Benin,0,0,0,0.5,0.5,1568,1713
2020-11-18,Bosnia and Herzegovina,Italy,0,2,2,0.0,1.0,1868,2089
2020-11-18,Poland,Netherlands,1,2,1,0.0,1.0,1981,2082
2020-11-18,England,Iceland,4,0,4,1.0,0.0,2105,1844
2020-11-18,Belgium,Denmark,4,2,2,1.0,0.0,2138,2006
2020-11-18,Northern Ireland,Romania,1,1,0,0.5,0.5,1810,1909
2020-11-18,Austria,Norway,1,1,0,0.5,0.5,1936,1882
2020-11-18,Czech Republic,Slovakia,2,0,2,1.0,0.0,1919,1887
2020-11-18,Israel,Scotland,1,0,1,1.0,0.0,1781,1869
2020-11-18,Hungary,Turkey,2,0,2,1.0,0.0,1864,1945
2020-11-18,Serbia,Russia,5,0,5,1.0,0.0,1935,1946
2020-11-18,Republic of Ireland,Bulgaria,0,0,0,0.5,0.5,1891,1780
2020-11-18,Wales,Finland,3,1,2,1.0,0.0,1917,1860
2020-11-18,Armenia,North Macedonia,1,0,1,1.0,0.0,1704,1773
2020-11-18,Georgia,Estonia,0,0,0,0.5,0.5,1741,1687
2020-11-18,Kosovo,Moldova,1,0,1,1.0,0.0,1649,1550
2020-11-18,Greece,Slovenia,0,0,0,0.5,0.5,1851,1794
2020-11-18,Albania,Belarus,3,2,1,1.0,0.0,1760,1732
2020-11-18,Kazakhstan,Lithuania,1,2,1,0.0,1.0,1620,1636
2020-12-04,Qatar,Bangladesh,5,0,5,1.0,0.0,1877,1431
2020-12-09,United States,El Salvador,6,0,6,1.0,0.0,1989,1757
2021-01-12,United Arab Emirates,Iraq,0,0,0,0.5,0.5,1821,1878
2021-01-18,Kuwait,Palestine,0,1,1,0.0,1.0,1762,1690
2021-01-19,Dominican Republic,Puerto Rico,0,1,1,0.0,1.0,1553,1438
2021-01-22,Guatemala,Puerto Rico,1,0,1,1.0,0.0,1731,1436
2021-01-25,Dominican Republic,Serbia,0,0,0,0.5,0.5,1560,1929
2021-01-27,Iraq,Kuwait,2,1,1,1.0,0.0,1884,1757
2021-01-28,Panama,Serbia,0,0,0,0.5,0.5,1816,1927
2021-01-31,United States,Trinidad and Tobago,7,0,7,1.0,0.0,1992,1682
2021-02-01,Jordan,Tajikistan,2,0,2,1.0,0.0,1802,1587
2021-02-05,Jordan,Tajikistan,0,1,1,0.0,1.0,1790,1600
2021-02-15,Jordan,Uzbekistan,0,2,2,0.0,1.0,1784,1855
2021-02-24,Guatemala,Nicaragua,1,0,1,1.0,0.0,1735,1508
2021-03-13,Kenya,South Sudan,1,0,1,1.0,0.0,1692,1473
2021-03-15,Kenya,Tanzania,2,1,1,1.0,0.0,1699,1616
2021-03-17,Ethiopia,Malawi,4,0,4,1.0,0.0,1633,1638
2021-03-20,Oman,Jordan,0,0,0,0.5,0.5,1827,1786
2021-03-24,Belarus,Honduras,1,1,0,0.5,0.5,1735,1828
2021-03-24,Jordan,Lebanon,1,0,1,1.0,0.0,1793,1702
2021-03-24,Kosovo,Lithuania,4,0,4,1.0,0.0,1657,1629
2021-03-24,Qatar,Luxembourg,1,0,1,1.0,0.0,1880,1583
2021-03-24,Antigua and Barbuda,Montserrat,2,2,0,0.5,0.5,1571,1445
2021-03-24,Suriname,Cayman Islands,3,0,3,1.0,0.0,1618,1423
2021-03-24,Guatemala,Cuba,1,0,1,1.0,0.0,1741,1612
2021-03-24,Dominican Republic,Dominica,1,0,1,1.0,0.0,1566,1440
2021-03-24,Saint Kitts and Nevis,Puerto Rico,1,0,1,1.0,0.0,1584,1432
2021-03-24,Portugal,Azerbaijan,1,0,1,1.0,0.0,2108,1641
2021-03-24,Serbia,Republic of Ireland,3,2,1,1.0,0.0,1935,1884
2021-03-24,France,Ukraine,1,1,0,0.5,0.5,2168,1984
2021-03-24,Finland,Bosnia and Herzegovina,2,2,0,0.5,0.5,1861,1868
2021-03-24,Belgium,Wales,3,1,2,1.0,0.0,2142,1914
2021-03-24,Estonia,Czech Republic,2,6,4,0.0,1.0,1684,1923
2021-03-24,Turkey,Netherlands,4,2,2,1.0,0.0,1957,2071
2021-03-24,Gibraltar,Norway,0,3,3,0.0,1.0,1513,1884
2021-03-24,Latvia,Montenegro,1,2,1,0.0,1.0,1582,1751
2021-03-24,Malta,Russia,1,3,2,0.0,1.0,1509,1948
2021-03-24,Slovenia,Croatia,1,0,1,1.0,0.0,1807,2001
2021-03-24,Cyprus,Slovakia,0,0,0,0.5,0.5,1633,1882
2021-03-24,Chad,Namibia,0,3,3,0.0,1.0,1523,1643
2021-03-24,Guinea,Mali,1,0,1,1.0,0.0,1748,1774
2021-03-24,South Sudan,Malawi,0,1,1,0.0,1.0,1469,1643
2021-03-24,Uganda,Burkina Faso,0,0,0,0.5,0.5,1745,1770
2021-03-24,São Tomé and Príncipe,Sudan,0,2,2,0.0,1.0,1448,1606
2021-03-24,Rwanda,Mozambique,1,0,1,1.0,0.0,1640,1642
2021-03-24,Ethiopia,Madagascar,4,0,4,1.0,0.0,1641,1624
2021-03-25,Bahrain,Syria,3,1,2,1.0,0.0,1846,1778
2021-03-25,India,Oman,1,1,0,0.5,0.5,1623,1823
2021-03-25,Japan,South Korea,3,0,3,1.0,0.0,2000,1981
2021-03-25,Saudi Arabia,Kuwait,1,0,1,1.0,0.0,1848,1751
2021-03-25,United States,Jamaica,4,1,3,1.0,0.0,1997,1800
2021-03-25,El Salvador,Grenada,2,0,2,1.0,0.0,1761,1541
2021-03-25,Canada,Bermuda,5,1,4,1.0,0.0,1800,1591
2021-03-25,Curaçao,Saint Vincent and the Grenadines,5,0,5,1.0,0.0,1638,1547
2021-03-25,Panama,Barbados,1,0,1,1.0,0.0,1819,1524
2021-03-25,Haiti,Belize,2,0,2,1.0,0.0,1742,1512
2021-03-25,Trinidad and Tobago,Guyana,3,0,3,1.0,0.0,1689,1595
2021-03-25,Spain,Greece,1,1,0,0.5,0.5,2163,1857
2021-03-25,Sweden,Georgia,1,0,1,1.0,0.0,1968,1738
2021-03-25,Bulgaria,Switzerland,1,3,2,0.0,1.0,1777,1995
2021-03-25,Italy,Northern Ireland,2,0,2,1.0,0.0,2092,1808
2021-03-25,Israel,Denmark,0,2,2,0.0,1.0,1778,2010
2021-03-25,Scotland,Austria,2,2,0,0.5,0.5,1871,1935
2021-03-25,Moldova,Faroe Islands,1,1,0,0.5,0.5,1550,1516
2021-03-25,England,San Marino,5,0,5,1.0,0.0,2106,1300
2021-03-25,Andorra,Albania,0,1,1,0.0,1.0,1386,1762
2021-03-25,Hungary,Poland,3,3,0,0.5,0.5,1867,1979
2021-03-25,Germany,Iceland,3,0,3,1.0,0.0,2122,1842
2021-03-25,Liechtenstein,Armenia,0,1,1,0.0,1.0,1441,1707
2021-03-25,Romania,North Macedonia,3,2,1,1.0,0.0,1915,1768
2021-03-25,South Africa,Ghana,1,1,0,0.5,0.5,1819,1860
2021-03-25,Gambia,Angola,1,0,1,1.0,0.0,1630,1677
2021-03-25,Gabon,DR Congo,3,0,3,1.0,0.0,1720,1738
2021-03-25,Comoros,Togo,0,0,0,0.5,0.5,1531,1640
2021-03-25,Kenya,Egypt,1,1,0,0.5,0.5,1704,1894
2021-03-25,Botswana,Zimbabwe,0,1,1,0.0,1.0,1634,1729
2021-03-25,Zambia,Algeria,3,3,0,0.5,0.5,1744,1913
2021-03-25,Equatorial Guinea,Tanzania,1,0,1,1.0,0.0,1598,1608
2021-03-25,Libya,Tunisia,2,5,3,0.0,1.0,1695,1876
2021-03-25,Tajikistan,Mongolia,3,0,3,1.0,0.0,1604,1390
2021-03-26,Chile,Bolivia,2,1,1,1.0,0.0,1999,1742
2021-03-26,Burundi,Central African Republic,2,2,0,0.5,0.5,1608,1562
2021-03-26,Mauritania,Morocco,0,0,0,0.5,0.5,1613,1876
2021-03-26,Cape Verde,Cameroon,3,1,2,1.0,0.0,1710,1847
2021-03-26,Eswatini,Guinea-Bissau,1,3,2,0.0,1.0,1506,1575
2021-03-26,Congo,Senegal,0,0,0,0.5,0.5,1664,1933
2021-03-26,Niger,Ivory Coast,0,3,3,0.0,1.0,1598,1885
2021-03-27,Bosnia and Herzegovina,Costa Rica,0,0,0,0.5,0.5,1868,1850
2021-03-27,Nepal,Bangladesh,0,0,0,0.5,0.5,1413,1431
2021-03-27,Qatar,Azerbaijan,2,1,1,1.0,0.0,1884,1638
2021-03-27,Wales,Mexico,1,0,1,1.0,0.0,1926,2064
2021-03-27,United States Virgin Islands,Antigua and Barbuda,0,3,3,0.0,1.0,1356,1575
2021-03-27,Aruba,Suriname,0,6,6,0.0,1.0,1402,1622
2021-03-27,British Virgin Islands,Guatemala,0,3,3,0.0,1.0,1323,1743
2021-03-27,Anguilla,Dominican Republic,0,6,6,0.0,1.0,1288,1569
2021-03-27,Turks and Caicos Islands,Nicaragua,0,7,7,0.0,1.0,1428,1515
2021-03-27,Bahamas,Saint Kitts and Nevis,0,4,4,0.0,1.0,1469,1590
2021-03-27,Republic of Ireland,Luxembourg,0,1,1,0.0,1.0,1871,1597
2021-03-27,Serbia,Portugal,2,2,0,0.5,0.5,1939,2105
2021-03-27,Belarus,Estonia,4,2,2,1.0,0.0,1742,1678
2021-03-27,Czech Republic,Belgium,1,1,0,0.5,0.5,1928,2138
2021-03-27,Montenegro,Gibraltar,4,1,3,1.0,0.0,1755,1510
2021-03-27,Netherlands,Latvia,2,0,2,1.0,0.0,2072,1582
2021-03-27,Norway,Turkey,0,3,3,0.0,1.0,1878,1964
2021-03-27,Russia,Slovenia,2,1,1,1.0,0.0,1953,1803
2021-03-27,Croatia,Cyprus,1,0,1,1.0,0.0,2003,1632
2021-03-27,Slovakia,Malta,2,2,0,0.5,0.5,1876,1516
2021-03-27,Lesotho,Sierra Leone,0,0,0,0.5,0.5,1570,1611
2021-03-27,Benin,Nigeria,0,1,1,0.0,1.0,1709,1897
2021-03-28,Greece,Honduras,2,1,1,1.0,0.0,1865,1821
2021-03-28,Northern Ireland,United States,1,2,1,0.0,1.0,1804,2002
2021-03-28,Montserrat,El Salvador,1,1,0,0.5,0.5,1451,1756
2021-03-28,Cuba,Curaçao,1,2,1,0.0,1.0,1605,1646
2021-03-28,Dominica,Panama,1,2,1,0.0,1.0,1439,1821
2021-03-28,Puerto Rico,Trinidad and Tobago,1,1,0,0.5,0.5,1438,1684
2021-03-28,Georgia,Spain,1,2,1,0.0,1.0,1737,2165
2021-03-28,Kosovo,Sweden,0,3,3,0.0,1.0,1655,1971
2021-03-28,Switzerland,Lithuania,1,0,1,1.0,0.0,1997,1628
2021-03-28,Bulgaria,Italy,0,2,2,0.0,1.0,1775,2095
2021-03-28,Kazakhstan,France,0,2,2,0.0,1.0,1620,2169
2021-03-28,Ukraine,Finland,1,1,0,0.5,0.5,1982,1864
2021-03-28,Denmark,Moldova,8,0,8,1.0,0.0,2012,1549
2021-03-28,Austria,Faroe Islands,3,1,2,1.0,0.0,1937,1515
2021-03-28,Israel,Scotland,1,1,0,0.5,0.5,1781,1869
2021-03-28,Albania,England,0,2,2,0.0,1.0,1761,2108
2021-03-28,Poland,Andorra,3,0,3,1.0,0.0,1980,1386
2021-03-28,San Marino,Hungary,0,3,3,0.0,1.0,1300,1868
2021-03-28,Armenia,Iceland,2,0,2,1.0,0.0,1718,1832
2021-03-28,North Macedonia,Liechtenstein,5,0,5,1.0,0.0,1771,1439
2021-03-28,Romania,Germany,0,1,1,0.0,1.0,1912,2126
2021-03-28,Namibia,Guinea,2,1,1,1.0,0.0,1654,1738
2021-03-28,Mali,Chad,3,0,3,1.0,0.0,1778,1520
2021-03-28,Ghana,São Tomé and Príncipe,3,1,2,1.0,0.0,1862,1447
2021-03-28,Sudan,South Africa,2,0,2,1.0,0.0,1619,1807
2021-03-28,Tunisia,Equatorial Guinea,2,1,1,1.0,0.0,1879,1596
2021-03-28,Tanzania,Libya,1,0,1,1.0,0.0,1618,1686
2021-03-29,Ecuador,Bolivia,2,1,1,1.0,0.0,1954,1739
2021-03-29,Kuwait,Lebanon,1,1,0,0.5,0.5,1750,1704
2021-03-29,Nepal,Bangladesh,2,1,1,1.0,0.0,1422,1423
2021-03-29,Uzbekistan,Iraq,0,1,1,0.0,1.0,1848,1892
2021-03-29,Cayman Islands,Canada,0,11,11,0.0,1.0,1422,1802
2021-03-29,Burkina Faso,South Sudan,1,0,1,1.0,0.0,1773,1467
2021-03-29,Malawi,Uganda,1,0,1,1.0,0.0,1654,1735
2021-03-29,Angola,Gabon,2,0,2,1.0,0.0,1686,1712
2021-03-29,DR Congo,Gambia,1,0,1,1.0,0.0,1744,1625
2021-03-29,Togo,Kenya,1,2,1,0.0,1.0,1634,1711
2021-03-29,Egypt,Comoros,4,0,4,1.0,0.0,1896,1530
2021-03-29,Algeria,Botswana,5,0,5,1.0,0.0,1916,1632
2021-03-29,Zimbabwe,Zambia,0,2,2,0.0,1.0,1722,1752
2021-03-29,United Arab Emirates,India,6,0,6,1.0,0.0,1825,1620
2021-03-30,Bahrain,Jordan,1,2,1,0.0,1.0,1837,1803
2021-03-30,Costa Rica,Mexico,0,1,1,0.0,1.0,1847,2068
2021-03-30,Iran,Syria,3,0,3,1.0,0.0,2005,1775
2021-03-30,Republic of Ireland,Qatar,1,1,0,0.5,0.5,1872,1884
2021-03-30,Grenada,United States Virgin Islands,1,0,1,1.0,0.0,1546,1352
2021-03-30,Bermuda,Aruba,5,0,5,1.0,0.0,1596,1398
2021-03-30,Saint Vincent and the Grenadines,British Virgin Islands,3,0,3,1.0,0.0,1551,1320
2021-03-30,Barbados,Anguilla,1,0,1,1.0,0.0,1528,1285
2021-03-30,Belize,Turks and Caicos Islands,5,0,5,1.0,0.0,1519,1422
2021-03-30,Guyana,Bahamas,4,0,4,1.0,0.0,1601,1464
2021-03-30,Azerbaijan,Serbia,1,2,1,0.0,1.0,1636,1942
2021-03-30,Luxembourg,Portugal,1,3,2,0.0,1.0,1597,2106
2021-03-30,Wales,Czech Republic,1,0,1,1.0,0.0,1935,1920
2021-03-30,Belgium,Belarus,8,0,8,1.0,0.0,2140,1741
2021-03-30,Gibraltar,Netherlands,0,7,7,0.0,1.0,1510,2073
2021-03-30,Montenegro,Norway,0,1,1,0.0,1.0,1750,1884
2021-03-30,Turkey,Latvia,3,3,0,0.5,0.5,1958,1589
2021-03-30,Cyprus,Slovenia,1,0,1,1.0,0.0,1644,1792
2021-03-30,Croatia,Malta,3,0,3,1.0,0.0,2004,1516
2021-03-30,Slovakia,Russia,2,1,1,1.0,0.0,1886,1944
2021-03-30,Saudi Arabia,Palestine,5,0,5,1.0,0.0,1853,1686
2021-03-30,Japan,Mongolia,14,0,14,1.0,0.0,2001,1390
2021-03-30,Central African Republic,Mauritania,0,1,1,0.0,1.0,1556,1620
2021-03-30,Morocco,Burundi,1,0,1,1.0,0.0,1879,1606
2021-03-30,Cameroon,Rwanda,0,0,0,0.5,0.5,1843,1645
2021-03-30,Mozambique,Cape Verde,0,1,1,0.0,1.0,1636,1717
2021-03-30,Guinea-Bissau,Congo,3,0,3,1.0,0.0,1586,1654
2021-03-30,Senegal,Eswatini,1,1,0,0.5,0.5,1927,1513
2021-03-30,Ivory Coast,Ethiopia,3,1,2,1.0,0.0,1889,1638
2021-03-30,Madagascar,Niger,0,0,0,0.5,0.5,1624,1599
2021-03-30,Nigeria,Lesotho,3,0,3,1.0,0.0,1900,1568
2021-03-31,Sweden,Estonia,1,0,1,1.0,0.0,1974,1676
2021-03-31,Switzerland,Finland,3,2,1,1.0,0.0,2003,1859
2021-03-31,Spain,Kosovo,3,1,2,1.0,0.0,2166,1655
2021-03-31,Greece,Georgia,1,1,0,0.5,0.5,1863,1740
2021-03-31,Northern Ireland,Bulgaria,0,0,0,0.5,0.5,1804,1776
2021-03-31,Lithuania,Italy,0,2,2,0.0,1.0,1627,2097
2021-03-31,Bosnia and Herzegovina,France,0,1,1,0.0,1.0,1866,2172
2021-03-31,Ukraine,Kazakhstan,1,1,0,0.5,0.5,1976,1627
2021-03-31,Scotland,Faroe Islands,4,0,4,1.0,0.0,1871,1514
2021-03-31,Austria,Denmark,0,4,4,0.0,1.0,1931,2019
2021-03-31,Moldova,Israel,1,4,3,0.0,1.0,1546,1785
2021-03-31,England,Poland,2,1,1,1.0,0.0,2114,1975
2021-03-31,Andorra,Hungary,1,4,3,0.0,1.0,1386,1869
2021-03-31,San Marino,Albania,0,2,2,0.0,1.0,1299,1763
2021-03-31,Armenia,Romania,3,2,1,1.0,0.0,1731,1900
2021-03-31,Germany,North Macedonia,1,2,1,0.0,1.0,2112,1786
2021-03-31,Liechtenstein,Iceland,1,4,3,0.0,1.0,1438,1834
2021-05-23,Ukraine,Bahrain,1,1,0,0.5,0.5,1973,1841
2021-05-24,Iraq,Tajikistan,0,0,0,0.5,0.5,1887,1610
2021-05-24,United Arab Emirates,Jordan,5,1,4,1.0,0.0,1833,1796
2021-05-25,Indonesia,Afghanistan,2,3,1,0.0,1.0,1612,1518
2021-05-25,Oman,Thailand,1,0,1,1.0,0.0,1830,1763
2021-05-27,Turkey,Azerbaijan,2,1,1,1.0,0.0,1961,1634
2021-05-28,Bahrain,Malaysia,2,0,2,1.0,0.0,1845,1624
2021-05-28,Italy,San Marino,7,0,7,1.0,0.0,2098,1299
2021-05-28,Japan,Myanmar,10,0,10,1.0,0.0,2003,1548
2021-05-29,Indonesia,Oman,1,3,2,0.0,1.0,1609,1834
2021-05-29,Iraq,Nepal,6,2,4,1.0,0.0,1889,1421
2021-05-29,Mexico,Iceland,2,1,1,1.0,0.0,2072,1831
2021-05-29,Singapore,Afghanistan,1,1,0,0.5,0.5,1594,1520
2021-05-29,Sweden,Finland,2,0,2,1.0,0.0,1980,1854
2021-05-29,Thailand,Tajikistan,2,2,0,0.5,0.5,1760,1614
2021-05-30,Malta,Northern Ireland,0,3,3,0.0,1.0,1514,1807
2021-05-30,Switzerland,United States,2,1,1,1.0,0.0,2011,1995
2021-05-30,China PR,Guam,7,0,7,1.0,0.0,1840,1385
2021-05-31,Jordan,Vietnam,1,1,0,0.5,0.5,1795,1751
2021-05-31,Turkey,Guinea,0,0,0,0.5,0.5,1957,1743
2021-06-01,Croatia,Armenia,1,1,0,0.5,0.5,1999,1737
2021-06-01,Kosovo,San Marino,4,1,3,1.0,0.0,1657,1298
2021-06-01,North Macedonia,Slovenia,1,1,0,0.5,0.5,1787,1792
2021-06-01,Poland,Russia,1,1,0,0.5,0.5,1975,1945
2021-06-01,Slovakia,Bulgaria,1,1,0,0.5,0.5,1884,1779
2021-06-01,Lithuania,Estonia,0,1,1,0.0,1.0,1621,1683
2021-06-02,Belarus,Azerbaijan,1,2,1,0.0,1.0,1731,1645
2021-06-02,Bosnia and Herzegovina,Montenegro,0,0,0,0.5,0.5,1864,1753
2021-06-02,England,Austria,1,0,1,1.0,0.0,2119,1927
2021-06-02,France,Wales,3,0,3,1.0,0.0,2176,1932
2021-06-02,Germany,Denmark,1,1,0,0.5,0.5,2110,2022
2021-06-02,Mozambique,Lesotho,5,0,5,1.0,0.0,1643,1562
2021-06-02,Netherlands,Scotland,2,2,0,0.5,0.5,2069,1876
2021-06-02,Norway,Luxembourg,1,0,1,1.0,0.0,1887,1595
2021-06-02,Romania,Georgia,1,2,1,0.0,1.0,1889,1752
2021-06-02,Montserrat,United States Virgin Islands,4,0,4,1.0,0.0,1457,1347
2021-06-02,Cayman Islands,Aruba,1,3,2,0.0,1.0,1414,1407
2021-06-02,Cuba,British Virgin Islands,5,0,5,1.0,0.0,1608,1318
2021-06-02,Dominica,Anguilla,3,0,3,1.0,0.0,1444,1281
2021-06-02,Puerto Rico,Bahamas,7,0,7,1.0,0.0,1447,1456
2021-06-03,Algeria,Mauritania,4,1,3,1.0,0.0,1919,1618
2021-06-03,Andorra,Republic of Ireland,1,4,3,0.0,1.0,1386,1873
2021-06-03,Belgium,Greece,1,1,0,0.5,0.5,2135,1869
2021-06-03,Switzerland,Liechtenstein,7,0,7,1.0,0.0,2012,1438
2021-06-03,Turkey,Moldova,2,0,2,1.0,0.0,1959,1545
2021-06-03,Ukraine,Northern Ireland,1,0,1,1.0,0.0,1978,1803
2021-06-03,Mexico,Costa Rica,0,0,0,0.5,0.5,2068,1852
2021-06-03,United States,Honduras,1,0,1,1.0,0.0,2000,1817
2021-06-03,Nepal,Taiwan,2,0,2,1.0,0.0,1431,1460
2021-06-03,Iran,Hong Kong,3,1,2,1.0,0.0,2007,1606
2021-06-03,Bahrain,Cambodia,8,0,8,1.0,0.0,1846,1372
2021-06-03,Palestine,Singapore,4,0,4,1.0,0.0,1692,1589
2021-06-03,Bangladesh,Afghanistan,1,1,0,0.5,0.5,1426,1518
2021-06-03,United Arab Emirates,Malaysia,4,0,4,1.0,0.0,1837,1621
2021-06-03,Thailand,Indonesia,2,2,0,0.5,0.5,1757,1613
2021-06-03,Bolivia,Venezuela,3,1,2,1.0,0.0,1751,1897
2021-06-03,Uruguay,Paraguay,0,0,0,0.5,0.5,2044,1901
2021-06-03,Argentina,Chile,1,1,0,0.5,0.5,2126,2002
2021-06-03,Peru,Colombia,0,3,3,0.0,1.0,1948,2070
2021-06-03,Kuwait,Australia,0,3,3,0.0,1.0,1747,1952
2021-06-03,Qatar,India,1,0,1,1.0,0.0,1887,1618
2021-06-04,Faroe Islands,Iceland,0,1,1,0.0,1.0,1512,1834
2021-06-04,Finland,Estonia,0,1,1,0.0,1.0,1843,1695
2021-06-04,Hungary,Cyprus,1,0,1,1.0,0.0,1873,1641
2021-06-04,Italy,Czech Republic,4,0,4,1.0,0.0,2103,1916
2021-06-04,Kosovo,Malta,2,1,1,1.0,0.0,1662,1510
2021-06-04,Nigeria,Cameroon,0,1,1,0.0,1.0,1891,1853
2021-06-04,North Macedonia,Kazakhstan,4,0,4,1.0,0.0,1792,1623
2021-06-04,Rwanda,Central African Republic,2,0,2,1.0,0.0,1651,1551
2021-06-04,Slovenia,Gibraltar,6,0,6,1.0,0.0,1795,1508
2021-06-04,Spain,Portugal,0,0,0,0.5,0.5,2165,2108
2021-06-04,Latvia,Lithuania,3,1,2,1.0,0.0,1598,1613
2021-06-04,Maldives,Syria,0,4,4,0.0,1.0,1447,1778
2021-06-04,Antigua and Barbuda,Grenada,1,0,1,1.0,0.0,1583,1539
2021-06-04,Suriname,Bermuda,6,0,6,1.0,0.0,1630,1589
2021-06-04,Guatemala,Saint Vincent and the Grenadines,10,0,10,1.0,0.0,1747,1548
2021-06-04,Dominican Republic,Barbados,1,1,0,0.5,0.5,1569,1529
2021-06-04,Nicaragua,Belize,3,0,3,1.0,0.0,1524,1511
2021-06-04,Saint Kitts and Nevis,Guyana,3,0,3,1.0,0.0,1599,1593
2021-06-04,Brazil,Ecuador,2,0,2,1.0,0.0,2216,1952
2021-06-05,Guinea,Togo,0,2,2,0.0,1.0,1733,1645
2021-06-05,Ivory Coast,Burkina Faso,2,1,1,1.0,0.0,1895,1768
2021-06-05,Montenegro,Israel,1,3,2,0.0,1.0,1746,1793
2021-06-05,Niger,Gambia,0,2,2,0.0,1.0,1592,1633
2021-06-05,Russia,Bulgaria,1,0,1,1.0,0.0,1950,1775
2021-06-05,Senegal,Zambia,3,1,2,1.0,0.0,1932,1748
2021-06-05,Sweden,Armenia,3,1,2,1.0,0.0,1984,1734
2021-06-05,Tunisia,DR Congo,1,0,1,1.0,0.0,1885,1739
2021-06-05,Wales,Albania,0,0,0,0.5,0.5,1929,1767
2021-06-05,Saudi Arabia,Yemen,3,0,3,1.0,0.0,1856,1566
2021-06-05,Lebanon,Sri Lanka,3,2,1,1.0,0.0,1706,1316
2021-06-05,South Korea,Turkmenistan,5,0,5,1.0,0.0,1983,1615
2021-06-05,United States Virgin Islands,El Salvador,0,7,7,0.0,1.0,1346,1758
2021-06-05,Aruba,Canada,0,7,7,0.0,1.0,1406,1804
2021-06-05,British Virgin Islands,Curaçao,0,8,8,0.0,1.0,1316,1649
2021-06-05,Panama,Anguilla,13,0,13,1.0,0.0,1822,1281
2021-06-05,Turks and Caicos Islands,Haiti,0,10,10,0.0,1.0,1420,1745
2021-06-05,Bahamas,Trinidad and Tobago,0,0,0,0.5,0.5,1461,1680
2021-06-06,Algeria,Mali,1,0,1,1.0,0.0,1924,1774
2021-06-06,Austria,Slovakia,0,0,0,0.5,0.5,1927,1885
2021-06-06,Belgium,Croatia,1,0,1,1.0,0.0,2141,1994
2021-06-06,Denmark,Bosnia and Herzegovina,2,0,2,1.0,0.0,2027,1860
2021-06-06,England,Romania,1,0,1,1.0,0.0,2123,1886
2021-06-06,Luxembourg,Scotland,0,1,1,0.0,1.0,1593,1879
2021-06-06,Moldova,Azerbaijan,1,0,1,1.0,0.0,1556,1635
2021-06-06,Netherlands,Georgia,3,0,3,1.0,0.0,2072,1750
2021-06-06,Norway,Greece,1,2,1,0.0,1.0,1879,1878
2021-06-06,Honduras,Costa Rica,2,2,0,0.5,0.5,1818,1852
2021-06-06,United States,Mexico,3,2,1,1.0,0.0,2010,2059
2021-06-07,Andorra,Gibraltar,0,0,0,0.5,0.5,1389,1506
2021-06-07,Faroe Islands,Liechtenstein,5,1,4,1.0,0.0,1519,1432
2021-06-07,Germany,Latvia,7,1,6,1.0,0.0,2111,1598
2021-06-07,Rwanda,Central African Republic,5,0,5,1.0,0.0,1657,1546
2021-06-07,Serbia,Jamaica,1,1,0,0.5,0.5,1939,1804
2021-06-07,Ukraine,Cyprus,4,0,4,1.0,0.0,1981,1639
2021-06-07,Guam,Syria,0,3,3,0.0,1.0,1384,1780
2021-06-07,China PR,Philippines,2,0,2,1.0,0.0,1844,1598
2021-06-07,Nepal,Jordan,0,3,3,0.0,1.0,1430,1797
2021-06-07,Australia,Taiwan,5,1,4,1.0,0.0,1953,1460
2021-06-07,Iraq,Cambodia,4,1,3,1.0,0.0,1890,1372
2021-06-07,Uzbekistan,Singapore,5,0,5,1.0,0.0,1851,1587
2021-06-07,Bangladesh,India,0,2,2,0.0,1.0,1423,1622
2021-06-07,Kyrgyzstan,Mongolia,0,1,1,0.0,1.0,1592,1403
2021-06-07,Japan,Tajikistan,4,1,3,1.0,0.0,2005,1613
2021-06-07,United Arab Emirates,Thailand,3,1,2,1.0,0.0,1844,1751
2021-06-07,Vietnam,Indonesia,4,0,4,1.0,0.0,1756,1609
2021-06-07,Bahrain,Iran,0,3,3,0.0,1.0,1842,2012
2021-06-07,Qatar,Oman,1,0,1,1.0,0.0,1894,1828
2021-06-08,Benin,Zambia,2,2,0,0.5,0.5,1710,1748
2021-06-08,Cameroon,Nigeria,0,0,0,0.5,0.5,1854,1891
2021-06-08,Czech Republic,Albania,3,1,2,1.0,0.0,1921,1763
2021-06-08,France,Bulgaria,3,0,3,1.0,0.0,2178,1774
2021-06-08,Gambia,Togo,1,0,1,1.0,0.0,1642,1637
2021-06-08,Hungary,Republic of Ireland,0,0,0,0.5,0.5,1873,1873
2021-06-08,Kosovo,Guinea,1,2,1,0.0,1.0,1656,1740
2021-06-08,Morocco,Ghana,1,0,1,1.0,0.0,1887,1855
2021-06-08,Mozambique,Eswatini,1,1,0,0.5,0.5,1641,1516
2021-06-08,Poland,Iceland,2,2,0,0.5,0.5,1972,1838
2021-06-08,Senegal,Cape Verde,2,0,2,1.0,0.0,1936,1714
2021-06-08,Spain,Lithuania,4,0,4,1.0,0.0,2166,1613
2021-06-08,Grenada,Montserrat,1,2,1,0.0,1.0,1530,1467
2021-06-08,El Salvador,Antigua and Barbuda,3,0,3,1.0,0.0,1763,1579
2021-06-08,Canada,Suriname,4,0,4,1.0,0.0,1809,1626
2021-06-08,Bermuda,Cayman Islands,1,1,0,0.5,0.5,1586,1418
2021-06-08,Saint Vincent and the Grenadines,Cuba,0,1,1,0.0,1.0,1542,1615
2021-06-08,Curaçao,Guatemala,0,0,0,0.5,0.5,1652,1745
2021-06-08,Barbados,Dominica,1,1,0,0.5,0.5,1528,1446
2021-06-08,Panama,Dominican Republic,3,0,3,1.0,0.0,1826,1566
2021-06-08,Haiti,Nicaragua,1,0,1,1.0,0.0,1749,1521
2021-06-08,Guyana,Puerto Rico,0,2,2,0.0,1.0,1582,1459
2021-06-08,Trinidad and Tobago,Saint Kitts and Nevis,2,0,2,1.0,0.0,1687,1593
2021-06-08,Ecuador,Peru,1,2,1,0.0,1.0,1944,1957
2021-06-08,Colombia,Argentina,2,2,0,0.5,0.5,2072,2125
2021-06-08,Venezuela,Uruguay,0,0,0,0.5,0.5,1901,2041
2021-06-08,Paraguay,Brazil,0,2,2,0.0,1.0,1899,2219
2021-06-08,Chile,Bolivia,1,1,0,0.5,0.5,1998,1756
2021-06-09,Turkmenistan,Lebanon,3,2,1,1.0,0.0,1626,1696
2021-06-09,Niger,Congo,0,1,1,0.0,1.0,1586,1661
2021-06-09,Portugal,Israel,4,0,4,1.0,0.0,2111,1791
2021-06-09,United States,Costa Rica,4,0,4,1.0,0.0,2015,1848
2021-06-09,South Korea,Sri Lanka,5,0,5,1.0,0.0,1984,1316
2021-06-10,Estonia,Latvia,2,1,1,1.0,0.0,1701,1593
2021-06-10,South Africa,Uganda,3,2,1,1.0,0.0,1814,1729
2021-06-11,Philippines,Guam,3,0,3,1.0,0.0,1602,1381
2021-06-11,China PR,Maldives,5,0,5,1.0,0.0,1846,1446
2021-06-11,Nepal,Australia,0,3,3,0.0,1.0,1430,1954
2021-06-11,Kuwait,Jordan,0,0,0,0.5,0.5,1749,1796
2021-06-11,Cambodia,Iran,0,10,10,0.0,1.0,1372,2013
2021-06-11,Hong Kong,Iraq,0,1,1,0.0,1.0,1604,1893
2021-06-11,Yemen,Uzbekistan,0,1,1,0.0,1.0,1564,1854
2021-06-11,Afghanistan,Oman,1,2,1,0.0,1.0,1516,1831
2021-06-11,Myanmar,Kyrgyzstan,1,8,7,0.0,1.0,1542,1599
2021-06-11,Malaysia,Vietnam,1,2,1,0.0,1.0,1616,1762
2021-06-11,Japan,Serbia,1,0,1,1.0,0.0,2012,1933
2021-06-11,DR Congo,Mali,1,1,0,0.5,0.5,1740,1774
2021-06-11,Guinea,Niger,2,1,1,1.0,0.0,1745,1582
2021-06-11,Kosovo,Gambia,1,0,1,1.0,0.0,1664,1635
2021-06-11,Mauritania,Liberia,1,0,1,1.0,0.0,1626,1607
2021-06-11,Tunisia,Algeria,0,2,2,0.0,1.0,1878,1932
2021-06-11,Italy,Turkey,3,0,3,1.0,0.0,2108,1955
2021-06-11,Saudi Arabia,Singapore,3,0,3,1.0,0.0,1859,1585
2021-06-11,United Arab Emirates,Indonesia,5,0,5,1.0,0.0,1848,1606
2021-06-12,Haiti,Canada,0,1,1,0.0,1.0,1743,1816
2021-06-12,Panama,Curaçao,2,1,1,1.0,0.0,1831,1648
2021-06-12,Saint Kitts and Nevis,El Salvador,0,4,4,0.0,1.0,1589,1768
2021-06-12,Ghana,Ivory Coast,0,0,0,0.5,0.5,1856,1895
2021-06-12,Mexico,Honduras,0,0,0,0.5,0.5,2055,1823
2021-06-12,Morocco,Burkina Faso,1,0,1,1.0,0.0,1893,1763
2021-06-12,Wales,Switzerland,1,1,0,0.5,0.5,1931,2011
2021-06-12,Denmark,Finland,0,1,1,0.0,1.0,2016,1855
2021-06-12,Russia,Belgium,0,3,3,0.0,1.0,1947,2145
2021-06-13,South Korea,Lebanon,2,1,1,1.0,0.0,1987,1694
2021-06-13,Sudan,Zambia,0,1,1,0.0,1.0,1614,1754
2021-06-13,Tanzania,Malawi,2,0,2,1.0,0.0,1627,1646
2021-06-13,Austria,North Macedonia,3,1,2,1.0,0.0,1933,1787
2021-06-13,Netherlands,Ukraine,3,2,1,1.0,0.0,2078,1976
2021-06-13,England,Croatia,1,0,1,1.0,0.0,2129,1989
2021-06-13,Brazil,Venezuela,3,0,3,1.0,0.0,2222,1899
2021-06-13,Colombia,Ecuador,1,0,1,1.0,0.0,2078,1939
2021-06-14,Libya,Liberia,0,1,1,0.0,1.0,1677,1617
2021-06-14,Scotland,Czech Republic,0,2,2,0.0,1.0,1872,1929
2021-06-14,Poland,Slovakia,1,2,1,0.0,1.0,1963,1895
2021-06-14,Spain,Sweden,0,0,0,0.5,0.5,2163,1988
2021-06-14,Argentina,Chile,1,1,0,0.5,0.5,2123,2001
2021-06-14,Paraguay,Bolivia,3,1,2,1.0,0.0,1904,1752
2021-06-15,Philippines,Maldives,1,1,0,0.5,0.5,1599,1450
2021-06-15,China PR,Syria,3,1,2,1.0,0.0,1853,1774
2021-06-15,Australia,Jordan,1,0,1,1.0,0.0,1959,1792
2021-06-15,Bahrain,Hong Kong,4,0,4,1.0,0.0,1846,1601
2021-06-15,Iran,Iraq,1,0,1,1.0,0.0,2019,1888
2021-06-15,Palestine,Yemen,3,0,3,1.0,0.0,1698,1559
2021-06-15,Saudi Arabia,Uzbekistan,3,0,3,1.0,0.0,1867,1847
2021-06-15,Bangladesh,Oman,0,3,3,0.0,1.0,1422,1833
2021-06-15,India,Afghanistan,1,1,0,0.5,0.5,1620,1519
2021-06-15,Tajikistan,Myanmar,4,0,4,1.0,0.0,1620,1536
2021-06-15,Japan,Kyrgyzstan,5,1,4,1.0,0.0,2014,1598
2021-06-15,Thailand,Malaysia,0,1,1,0.0,1.0,1741,1627
2021-06-15,United Arab Emirates,Vietnam,3,2,1,1.0,0.0,1855,1756
2021-06-15,Canada,Haiti,3,0,3,1.0,0.0,1823,1737
2021-06-15,Curaçao,Panama,0,0,0,0.5,0.5,1652,1828
2021-06-15,El Salvador,Saint Kitts and Nevis,2,0,2,1.0,0.0,1773,1585
2021-06-15,Tunisia,Mali,1,0,1,1.0,0.0,1884,1769
2021-06-15,Djibouti,Somalia,1,0,1,1.0,0.0,1335,1325
2021-06-15,Hungary,Portugal,0,3,3,0.0,1.0,1870,2115
2021-06-15,Germany,France,0,1,1,0.0,1.0,2105,2185
2021-06-15,Kuwait,Taiwan,2,1,1,1.0,0.0,1752,1458
2021-06-15,Sierra Leone,Benin,1,0,1,1.0,0.0,1622,1700
2021-06-16,Turkey,Wales,0,2,2,0.0,1.0,1947,1940
2021-06-16,Italy,Switzerland,3,0,3,1.0,0.0,2114,2006
2021-06-16,Russia,Finland,1,0,1,1.0,0.0,1953,1850
2021-06-17,Denmark,Belgium,1,2,1,0.0,1.0,2011,2151
2021-06-17,Ukraine,North Macedonia,2,1,1,1.0,0.0,1981,1783
2021-06-17,Netherlands,Austria,2,0,2,1.0,0.0,2083,1929
2021-06-17,Colombia,Venezuela,0,0,0,0.5,0.5,2075,1903
2021-06-17,Brazil,Peru,4,0,4,1.0,0.0,2225,1955
2021-06-17,Algeria,Liberia,5,1,4,1.0,0.0,1935,1615
2021-06-18,Croatia,Czech Republic,1,1,0,0.5,0.5,1988,1931
2021-06-18,England,Scotland,0,0,0,0.5,0.5,2124,1878
2021-06-18,Sweden,Slovakia,1,0,1,1.0,0.0,1994,1890
2021-06-18,Chile,Bolivia,1,0,1,1.0,0.0,2005,1749
2021-06-18,Argentina,Uruguay,1,0,1,1.0,0.0,2130,2035
2021-06-19,Spain,Poland,1,1,0,0.5,0.5,2159,1968
2021-06-19,Hungary,France,1,1,0,0.5,0.5,1876,2180
2021-06-19,Germany,Portugal,4,2,2,1.0,0.0,2114,2107
2021-06-19,Libya,Sudan,0,1,1,0.0,1.0,1668,1624
2021-06-20,Italy,Wales,1,0,1,1.0,0.0,2119,1936
2021-06-20,Switzerland,Turkey,3,1,2,1.0,0.0,2013,1941
2021-06-20,Venezuela,Ecuador,2,2,0,0.5,0.5,1904,1939
2021-06-20,Colombia,Peru,1,2,1,0.0,1.0,2065,1966
2021-06-20,Oman,Somalia,2,1,1,1.0,0.0,1834,1325
2021-06-21,Denmark,Russia,4,1,3,1.0,0.0,2018,1947
2021-06-21,Finland,Belgium,0,2,2,0.0,1.0,1848,2154
2021-06-21,Netherlands,North Macedonia,3,0,3,1.0,0.0,2086,1781
2021-06-21,Ukraine,Austria,0,1,1,0.0,1.0,1972,1939
2021-06-21,Uruguay,Chile,1,1,0,0.5,0.5,2035,2006
2021-06-21,Argentina,Paraguay,1,0,1,1.0,0.0,2134,1901
2021-06-22,Scotland,Croatia,1,3,2,0.0,1.0,1873,1994
2021-06-22,England,Czech Republic,1,0,1,1.0,0.0,2128,1928
2021-06-22,Mauritania,Yemen,2,0,2,1.0,0.0,1633,1553
2021-06-23,Spain,Slovakia,5,0,5,1.0,0.0,2162,1888
2021-06-23,Sweden,Poland,3,2,1,1.0,0.0,2002,1961
2021-06-23,Germany,Hungary,2,2,0,0.5,0.5,2110,1881
2021-06-23,Portugal,France,2,2,0,0.5,0.5,2109,2179
2021-06-23,Ecuador,Peru,2,2,0,0.5,0.5,1940,1966
2021-06-23,Brazil,Colombia,2,1,1,1.0,0.0,2230,2061
2021-06-23,Lebanon,Djibouti,1,0,1,1.0,0.0,1696,1334
2021-06-24,Bolivia,Uruguay,0,2,2,0.0,1.0,1747,2038
2021-06-24,Chile,Paraguay,0,2,2,0.0,1.0,1996,1912
2021-06-24,Palestine,Comoros,5,1,4,1.0,0.0,1703,1526
2021-06-25,Bahrain,Kuwait,2,0,2,1.0,0.0,1852,1747
2021-06-26,Italy,Austria,2,1,1,1.0,0.0,2124,1935
2021-06-26,Wales,Denmark,0,4,4,0.0,1.0,1930,2025
2021-06-27,Netherlands,Czech Republic,0,2,2,0.0,1.0,2075,1940
2021-06-27,Belgium,Portugal,1,0,1,1.0,0.0,2161,2103
2021-06-27,Brazil,Ecuador,1,1,0,0.5,0.5,2225,1946
2021-06-27,Venezuela,Peru,0,1,1,0.0,1.0,1898,1973
2021-06-27,El Salvador,Guatemala,0,0,0,0.5,0.5,1773,1746
2021-06-28,Croatia,Spain,3,5,2,0.0,1.0,1990,2167
2021-06-28,France,Switzerland,3,3,0,0.5,0.5,2176,2017
2021-06-28,Argentina,Bolivia,4,1,3,1.0,0.0,2136,1746
2021-06-28,Uruguay,Paraguay,1,0,1,1.0,0.0,2044,1907
2021-06-29,England,Germany,2,0,2,1.0,0.0,2136,2103
2021-06-29,Sweden,Ukraine,1,2,1,0.0,1.0,1994,1981
2021-06-30,Mexico,Panama,3,0,3,1.0,0.0,2059,1825
2021-07-02,Switzerland,Spain,1,1,0,0.5,0.5,2021,2164
2021-07-02,Belgium,Italy,1,2,1,0.0,1.0,2153,2133
2021-07-02,Peru,Paraguay,3,3,0,0.5,0.5,1972,1909
2021-07-02,Brazil,Chile,1,0,1,1.0,0.0,2229,1993
2021-07-02,Haiti,Saint Vincent and the Grenadines,6,1,5,1.0,0.0,1741,1539
2021-07-02,Trinidad and Tobago,Montserrat,6,1,5,1.0,0.0,1691,1464
2021-07-02,Bermuda,Barbados,8,1,7,1.0,0.0,1593,1522
2021-07-03,Czech Republic,Denmark,1,2,1,0.0,1.0,1934,2032
2021-07-03,Ukraine,England,0,4,4,0.0,1.0,1977,2141
2021-07-03,Mexico,Nigeria,4,0,4,1.0,0.0,2064,1887
2021-07-03,Uruguay,Colombia,0,0,0,0.5,0.5,2045,2061
2021-07-03,Argentina,Ecuador,3,0,3,1.0,0.0,2141,1942
2021-07-03,Guatemala,Guyana,4,0,4,1.0,0.0,1751,1578
2021-07-03,Cuba,French Guiana,0,3,3,0.0,1.0,1607,1607
2021-07-03,Guadeloupe,Bahamas,2,0,2,1.0,0.0,1638,1457
2021-07-04,Qatar,El Salvador,1,0,1,1.0,0.0,1900,1768
2021-07-05,Brazil,Peru,1,0,1,1.0,0.0,2232,1970
2021-07-06,Argentina,Colombia,1,1,0,0.5,0.5,2140,2063
2021-07-06,Italy,Spain,1,1,0,0.5,0.5,2134,2164
2021-07-06,Haiti,Bermuda,4,1,3,1.0,0.0,1746,1589
2021-07-06,Guatemala,Guadeloupe,1,1,0,0.5,0.5,1749,1641
2021-07-06,Trinidad and Tobago,French Guiana,1,1,0,0.5,0.5,1690,1609
2021-07-06,Eswatini,Lesotho,3,1,2,1.0,0.0,1526,1553
2021-07-06,South Africa,Botswana,1,0,1,1.0,0.0,1819,1628
2021-07-07,England,Denmark,2,1,1,1.0,0.0,2147,2027
2021-07-07,Mozambique,Zimbabwe,0,0,0,0.5,0.5,1643,1721
2021-07-07,Senegal,Namibia,1,2,1,0.0,1.0,1923,1668
2021-07-08,Zambia,Lesotho,1,2,1,0.0,1.0,1742,1566
2021-07-08,South Africa,Eswatini,1,0,1,1.0,0.0,1822,1524
2021-07-09,Peru,Colombia,2,3,1,0.0,1.0,1965,2069
2021-07-09,Malawi,Zimbabwe,2,2,0,0.5,0.5,1648,1720
2021-07-09,Senegal,Mozambique,1,0,1,1.0,0.0,1926,1641
2021-07-10,Brazil,Argentina,0,1,1,0.0,1.0,2222,2151
2021-07-10,Lesotho,Botswana,0,4,4,0.0,1.0,1560,1635
2021-07-10,Zambia,Eswatini,0,1,1,0.0,1.0,1730,1537
2021-07-10,Mexico,Trinidad and Tobago,0,0,0,0.5,0.5,2058,1697
2021-07-11,England,Italy,1,1,0,0.5,0.5,2147,2135
2021-07-11,Namibia,Zimbabwe,2,0,2,1.0,0.0,1678,1711
2021-07-11,Mozambique,Malawi,2,0,2,1.0,0.0,1650,1640
2021-07-11,El Salvador,Guatemala,2,0,2,1.0,0.0,1776,1742
2021-07-11,Canada,Martinique,4,1,3,1.0,0.0,1829,1698
2021-07-11,United States,Haiti,1,0,1,1.0,0.0,2018,1744
2021-07-12,Jamaica,Suriname,2,0,2,1.0,0.0,1809,1622
2021-07-12,Costa Rica,Guadeloupe,3,1,2,1.0,0.0,1852,1638
2021-07-13,Botswana,Zambia,1,2,1,0.0,1.0,1630,1736
2021-07-13,South Africa,Lesotho,4,0,4,1.0,0.0,1825,1558
2021-07-13,Senegal,Zimbabwe,2,1,1,1.0,0.0,1930,1708
2021-07-13,Malawi,Namibia,1,1,0,0.5,0.5,1641,1678
2021-07-13,Qatar,Panama,3,3,0,0.5,0.5,1899,1827
2021-07-13,Honduras,Grenada,4,0,4,1.0,0.0,1826,1528
2021-07-14,South Africa,Zambia,0,0,0,0.5,0.5,1823,1739
2021-07-14,Eswatini,Botswana,1,1,0,0.5,0.5,1540,1628
2021-07-14,Mozambique,Namibia,1,0,1,1.0,0.0,1659,1670
2021-07-14,Senegal,Malawi,2,1,1,1.0,0.0,1933,1639
2021-07-14,Trinidad and Tobago,El Salvador,0,2,2,0.0,1.0,1691,1783
2021-07-14,Guatemala,Mexico,0,3,3,0.0,1.0,1740,2061
2021-07-15,Haiti,Canada,1,4,3,0.0,1.0,1738,1836
2021-07-15,United States,Martinique,6,1,5,1.0,0.0,2021,1696
2021-07-16,Senegal,Eswatini,2,2,0,0.5,0.5,1927,1547
2021-07-16,South Africa,Mozambique,3,0,3,1.0,0.0,1828,1655
2021-07-16,Guadeloupe,Jamaica,1,2,1,0.0,1.0,1634,1814
2021-07-16,Suriname,Costa Rica,1,2,1,0.0,1.0,1619,1856
2021-07-17,Grenada,Qatar,0,4,4,0.0,1.0,1527,1901
2021-07-17,Panama,Honduras,2,3,1,0.0,1.0,1819,1835
2021-07-18,Eswatini,Mozambique,1,1,0,0.5,0.5,1550,1653
2021-07-18,South Africa,Senegal,0,0,0,0.5,0.5,1831,1925
2021-07-18,Guatemala,Trinidad and Tobago,1,1,0,0.5,0.5,1739,1693
2021-07-18,Mexico,El Salvador,1,0,1,1.0,0.0,2064,1781
2021-07-18,Martinique,Haiti,1,2,1,0.0,1.0,1689,1746
2021-07-18,United States,Canada,1,0,1,1.0,0.0,2026,1832
2021-07-20,Suriname,Guadeloupe,2,1,1,1.0,0.0,1628,1626
2021-07-20,Costa Rica,Jamaica,1,0,1,1.0,0.0,1864,1807
2021-07-20,Panama,Grenada,3,1,2,1.0,0.0,1822,1525
2021-07-20,Honduras,Qatar,0,2,2,0.0,1.0,1829,1908
2021-07-24,Mexico,Honduras,3,0,3,1.0,0.0,2068,1826
2021-07-24,Qatar,El Salvador,3,2,1,1.0,0.0,1914,1776
2021-07-25,Costa Rica,Canada,0,2,2,0.0,1.0,1856,1841
2021-07-25,United States,Jamaica,1,0,1,1.0,0.0,2030,1804
2021-07-29,Mexico,Canada,2,1,1,1.0,0.0,2072,1838
2021-07-29,United States,Qatar,1,0,1,1.0,0.0,2036,1909
2021-08-01,United States,Mexico,1,0,1,1.0,0.0,2045,2064
2021-08-21,El Salvador,Costa Rica,0,0,0,0.5,0.5,1778,1855
2021-08-22,Niger,Sudan,2,1,1,1.0,0.0,1591,1616
2021-08-26,Sudan,Niger,3,0,3,1.0,0.0,1624,1584
2021-08-26,Ethiopia,Sierra Leone,0,0,0,0.5,0.5,1638,1623
2021-08-29,Ethiopia,Uganda,2,1,1,1.0,0.0,1649,1719
2021-09-01,Bahrain,Haiti,6,1,5,1.0,0.0,1858,1741
2021-09-01,Comoros,Seychelles,7,1,6,1.0,0.0,1532,1385
2021-09-01,Finland,Wales,0,0,0,0.5,0.5,1850,1929
2021-09-01,Qatar,Serbia,0,4,4,0.0,1.0,1902,1941
2021-09-01,Switzerland,Greece,2,1,1,1.0,0.0,2026,1874
2021-09-01,Central African Republic,Cape Verde,1,1,0,0.5,0.5,1550,1711
2021-09-01,Mali,Rwanda,1,0,1,1.0,0.0,1775,1652
2021-09-01,Egypt,Angola,1,0,1,1.0,0.0,1900,1683
2021-09-01,Libya,Gabon,2,1,1,1.0,0.0,1678,1703
2021-09-01,Senegal,Togo,2,0,2,1.0,0.0,1928,1635
2021-09-01,Guinea-Bissau,Guinea,1,1,0,0.5,0.5,1590,1742
2021-09-01,Portugal,Republic of Ireland,2,1,1,1.0,0.0,2107,1870
2021-09-01,Luxembourg,Azerbaijan,2,1,1,1.0,0.0,1602,1627
2021-09-01,Kazakhstan,Ukraine,2,2,0,0.5,0.5,1630,1971
2021-09-01,France,Bosnia and Herzegovina,1,1,0,0.5,0.5,2171,1866
2021-09-01,Faroe Islands,Israel,0,4,4,0.0,1.0,1517,1794
2021-09-01,Denmark,Scotland,2,0,2,1.0,0.0,2032,1869
2021-09-01,Moldova,Austria,0,2,2,0.0,1.0,1555,1937
2021-09-01,Norway,Netherlands,1,1,0,0.5,0.5,1884,2071
2021-09-01,Latvia,Gibraltar,3,1,2,1.0,0.0,1600,1500
2021-09-01,Turkey,Montenegro,2,2,0,0.5,0.5,1937,1751
2021-09-01,Malta,Cyprus,3,0,3,1.0,0.0,1521,1629
2021-09-01,Slovenia,Slovakia,1,1,0,0.5,0.5,1798,1886
2021-09-01,Russia,Croatia,0,0,0,0.5,0.5,1948,1990
2021-09-02,Kyrgyzstan,Palestine,1,0,1,1.0,0.0,1609,1693
2021-09-02,Nepal,India,1,1,0,0.5,0.5,1434,1617
2021-09-02,Niger,Burkina Faso,0,2,2,0.0,1.0,1580,1768
2021-09-02,Algeria,Djibouti,8,0,8,1.0,0.0,1936,1334
2021-09-02,Kenya,Uganda,0,0,0,0.5,0.5,1712,1719
2021-09-02,Namibia,Congo,1,1,0,0.5,0.5,1670,1662
2021-09-02,Morocco,Sudan,2,0,2,1.0,0.0,1896,1622
2021-09-02,DR Congo,Tanzania,1,1,0,0.5,0.5,1738,1630
2021-09-02,Madagascar,Benin,0,1,1,0.0,1.0,1618,1707
2021-09-02,South Korea,Iraq,0,0,0,0.5,0.5,1985,1891
2021-09-02,Iran,Syria,1,0,1,1.0,0.0,2023,1771
2021-09-02,United Arab Emirates,Lebanon,0,0,0,0.5,0.5,1852,1700
2021-09-02,Japan,Oman,0,1,1,0.0,1.0,2003,1846
2021-09-02,Australia,China PR,3,0,3,1.0,0.0,1965,1848
2021-09-02,Saudi Arabia,Vietnam,3,1,2,1.0,0.0,1873,1751
2021-09-02,Georgia,Kosovo,0,1,1,0.0,1.0,1741,1674
2021-09-02,Sweden,Spain,2,1,1,1.0,0.0,2006,2153
2021-09-02,Italy,Bulgaria,1,1,0,0.5,0.5,2129,1781
2021-09-02,Lithuania,Northern Ireland,1,4,3,0.0,1.0,1609,1808
2021-09-02,Czech Republic,Belarus,1,0,1,1.0,0.0,1938,1728
2021-09-02,Estonia,Belgium,2,5,3,0.0,1.0,1700,2155
2021-09-02,Andorra,San Marino,2,0,2,1.0,0.0,1395,1293
2021-09-02,Hungary,England,0,4,4,0.0,1.0,1879,2150
2021-09-02,Poland,Albania,4,1,3,1.0,0.0,1965,1760
2021-09-02,Iceland,Romania,0,2,2,0.0,1.0,1832,1893
2021-09-02,Liechtenstein,Germany,0,2,2,0.0,1.0,1432,2104
2021-09-02,North Macedonia,Armenia,0,0,0,0.5,0.5,1780,1736
2021-09-02,Bolivia,Colombia,1,1,0,0.5,0.5,1752,2064
2021-09-02,Ecuador,Paraguay,2,0,2,1.0,0.0,1950,1902
2021-09-02,Peru,Uruguay,1,1,0,0.5,0.5,1967,2044
2021-09-02,Venezuela,Argentina,1,3,2,0.0,1.0,1895,2155
2021-09-02,Chile,Brazil,0,1,1,0.0,1.0,1990,2226
2021-09-02,Canada,Honduras,1,1,0,0.5,0.5,1838,1827
2021-09-02,El Salvador,United States,0,0,0,0.5,0.5,1784,2040
2021-09-02,Panama,Costa Rica,0,0,0,0.5,0.5,1823,1855
2021-09-02,Mexico,Jamaica,2,1,1,1.0,0.0,2067,1802
2021-09-03,Mauritania,Zambia,1,2,1,0.0,1.0,1628,1745
2021-09-03,Tunisia,Equatorial Guinea,3,0,3,1.0,0.0,1887,1594
2021-09-03,Nigeria,Liberia,2,0,2,1.0,0.0,1890,1613
2021-09-03,Mozambique,Ivory Coast,0,0,0,0.5,0.5,1658,1891
2021-09-03,Cameroon,Malawi,2,0,2,1.0,0.0,1858,1636
2021-09-03,Zimbabwe,South Africa,0,0,0,0.5,0.5,1711,1829
2021-09-03,Ghana,Ethiopia,1,0,1,1.0,0.0,1860,1646
2021-09-04,Bosnia and Herzegovina,Kuwait,1,0,1,1.0,0.0,1872,1742
2021-09-04,Burundi,Seychelles,8,1,7,1.0,0.0,1610,1382
2021-09-04,Haiti,Jordan,2,0,2,1.0,0.0,1751,1783
2021-09-04,Qatar,Portugal,1,3,2,0.0,1.0,1899,2111
2021-09-04,Republic of Ireland,Azerbaijan,1,1,0,0.5,0.5,1866,1632
2021-09-04,Serbia,Luxembourg,4,1,3,1.0,0.0,1943,1601
2021-09-04,Finland,Kazakhstan,1,0,1,1.0,0.0,1854,1627
2021-09-04,Ukraine,France,1,1,0,0.5,0.5,1976,2167
2021-09-04,Faroe Islands,Denmark,0,1,1,0.0,1.0,1517,2033
2021-09-04,Scotland,Moldova,1,0,1,1.0,0.0,1872,1553
2021-09-04,Israel,Austria,5,2,3,1.0,0.0,1806,1926
2021-09-04,Latvia,Norway,0,2,2,0.0,1.0,1598,1887
2021-09-04,Gibraltar,Turkey,0,3,3,0.0,1.0,1499,1939
2021-09-04,Netherlands,Montenegro,4,0,4,1.0,0.0,2074,1749
2021-09-04,Slovenia,Malta,1,0,1,1.0,0.0,1801,1519
2021-09-04,Cyprus,Russia,0,2,2,0.0,1.0,1627,1951
2021-09-04,Slovakia,Croatia,0,1,1,0.0,1.0,1881,1996
2021-09-05,Bangladesh,Palestine,0,2,2,0.0,1.0,1420,1696
2021-09-05,Estonia,Northern Ireland,0,1,1,0.0,1.0,1695,1814
2021-09-05,Nepal,India,1,2,1,0.0,1.0,1430,1622
2021-09-05,Sweden,Uzbekistan,2,1,1,1.0,0.0,2011,1843
2021-09-05,Rwanda,Kenya,1,1,0,0.5,0.5,1654,1711
2021-09-05,Gabon,Egypt,1,1,0,0.5,0.5,1708,1896
2021-09-05,Togo,Namibia,0,1,1,0.0,1.0,1628,1678
2021-09-05,Kosovo,Greece,1,1,0,0.5,0.5,1679,1870
2021-09-05,Spain,Georgia,4,0,4,1.0,0.0,2155,1740
2021-09-05,Bulgaria,Lithuania,1,0,1,1.0,0.0,1786,1605
2021-09-05,Switzerland,Italy,0,0,0,0.5,0.5,2029,2127
2021-09-05,Belarus,Wales,2,3,1,0.0,1.0,1725,1933
2021-09-05,Belgium,Czech Republic,3,0,3,1.0,0.0,2159,1935
2021-09-05,England,Andorra,4,0,4,1.0,0.0,2151,1395
2021-09-05,Albania,Hungary,1,0,1,1.0,0.0,1771,1869
2021-09-05,San Marino,Poland,1,7,6,0.0,1.0,1293,1966
2021-09-05,Iceland,North Macedonia,2,2,0,0.5,0.5,1831,1782
2021-09-05,Germany,Armenia,6,0,6,1.0,0.0,2106,1735
2021-09-05,Romania,Liechtenstein,2,0,2,1.0,0.0,1895,1431
2021-09-05,Ecuador,Chile,0,0,0,0.5,0.5,1951,1990
2021-09-05,Paraguay,Colombia,1,1,0,0.5,0.5,1906,2061
2021-09-05,Uruguay,Bolivia,4,2,2,1.0,0.0,2047,1750
2021-09-05,Peru,Venezuela,1,0,1,1.0,0.0,1974,1889
2021-09-05,Costa Rica,Mexico,0,1,1,0.0,1.0,1852,2071
2021-09-05,El Salvador,Honduras,0,0,0,0.5,0.5,1785,1827
2021-09-05,Jamaica,Panama,0,3,3,0.0,1.0,1795,1831
2021-09-05,United States,Canada,1,1,0,0.5,0.5,2036,1843
2021-09-06,Djibouti,Niger,2,4,2,0.0,1.0,1331,1584
2021-09-06,Liberia,Central African Republic,1,0,1,1.0,0.0,1620,1544
2021-09-06,Ivory Coast,Cameroon,2,1,1,1.0,0.0,1899,1851
2021-09-06,Uganda,Mali,0,0,0,0.5,0.5,1721,1774
2021-09-06,South Africa,Ghana,1,0,1,1.0,0.0,1838,1852
2021-09-06,Benin,DR Congo,1,1,0,0.5,0.5,1708,1738
2021-09-07,Kyrgyzstan,Bangladesh,4,1,3,1.0,0.0,1614,1416
2021-09-07,Bahrain,Jordan,1,2,1,0.0,1.0,1849,1793
2021-09-07,Comoros,Burundi,1,0,1,1.0,0.0,1542,1601
2021-09-07,Luxembourg,Qatar,1,1,0,0.5,0.5,1607,1894
2021-09-07,Burkina Faso,Algeria,1,1,0,0.5,0.5,1772,1933
2021-09-07,Zambia,Tunisia,0,2,2,0.0,1.0,1741,1892
2021-09-07,Equatorial Guinea,Mauritania,1,0,1,1.0,0.0,1603,1620
2021-09-07,Cape Verde,Nigeria,1,2,1,0.0,1.0,1707,1895
2021-09-07,Malawi,Mozambique,1,0,1,1.0,0.0,1645,1650
2021-09-07,Angola,Libya,0,1,1,0.0,1.0,1675,1687
2021-09-07,Ethiopia,Zimbabwe,1,0,1,1.0,0.0,1656,1702
2021-09-07,Congo,Senegal,1,3,2,0.0,1.0,1660,1931
2021-09-07,Sudan,Guinea-Bissau,2,4,2,0.0,1.0,1614,1599
2021-09-07,Tanzania,Madagascar,3,2,1,1.0,0.0,1638,1611
2021-09-07,Syria,United Arab Emirates,1,1,0,0.5,0.5,1773,1851
2021-09-07,South Korea,Lebanon,1,0,1,1.0,0.0,1988,1698
2021-09-07,Iraq,Iran,0,3,3,0.0,1.0,1886,2029
2021-09-07,China PR,Japan,0,1,1,0.0,1.0,1844,2008
2021-09-07,Vietnam,Australia,0,1,1,0.0,1.0,1748,1969
2021-09-07,Oman,Saudi Arabia,0,1,1,0.0,1.0,1839,1881
2021-09-07,Republic of Ireland,Serbia,1,1,0,0.5,0.5,1868,1942
2021-09-07,Azerbaijan,Portugal,0,3,3,0.0,1.0,1632,2112
2021-09-07,Bosnia and Herzegovina,Kazakhstan,2,2,0,0.5,0.5,1868,1632
2021-09-07,France,Finland,2,0,2,1.0,0.0,2170,1852
2021-09-07,Faroe Islands,Moldova,2,1,1,1.0,0.0,1526,1545
2021-09-07,Austria,Scotland,0,1,1,0.0,1.0,1917,1882
2021-09-07,Denmark,Israel,5,0,5,1.0,0.0,2037,1803
2021-09-07,Montenegro,Latvia,0,0,0,0.5,0.5,1746,1602
2021-09-07,Netherlands,Turkey,6,1,5,1.0,0.0,2080,1934
2021-09-07,Norway,Gibraltar,5,1,4,1.0,0.0,1889,1498
2021-09-07,Croatia,Slovenia,3,0,3,1.0,0.0,2000,1798
2021-09-07,Slovakia,Cyprus,2,0,2,1.0,0.0,1885,1624
2021-09-07,Russia,Malta,2,0,2,1.0,0.0,1953,1518
2021-09-08,Bulgaria,Georgia,4,1,3,1.0,0.0,1793,1734
2021-09-08,Czech Republic,Ukraine,1,1,0,0.5,0.5,1936,1976
2021-09-08,Guatemala,Nicaragua,2,2,0,0.5,0.5,1735,1526
2021-09-08,Kosovo,Spain,0,2,2,0.0,1.0,1679,2156
2021-09-08,Greece,Sweden,2,1,1,1.0,0.0,1882,2000
2021-09-08,Northern Ireland,Switzerland,0,0,0,0.5,0.5,1819,2025
2021-09-08,Italy,Lithuania,5,0,5,1.0,0.0,2128,1605
2021-09-08,Wales,Estonia,0,0,0,0.5,0.5,1929,1700
2021-09-08,Belarus,Belgium,0,1,1,0.0,1.0,1724,2161
2021-09-08,Albania,San Marino,5,0,5,1.0,0.0,1772,1293
2021-09-08,Hungary,Andorra,2,1,1,1.0,0.0,1870,1395
2021-09-08,Poland,England,1,1,0,0.5,0.5,1970,2148
2021-09-08,Iceland,Germany,0,4,4,0.0,1.0,1829,2109
2021-09-08,Armenia,Liechtenstein,1,1,0,0.5,0.5,1730,1437
2021-09-08,North Macedonia,Romania,0,0,0,0.5,0.5,1785,1893
2021-09-08,Costa Rica,Jamaica,1,1,0,0.5,0.5,1851,1797
2021-09-08,Panama,Mexico,1,1,0,0.5,0.5,1836,2067
2021-09-08,Canada,El Salvador,3,0,3,1.0,0.0,1850,1779
2021-09-08,Honduras,United States,1,4,3,0.0,1.0,1824,2040
2021-09-09,Colombia,Chile,3,1,2,1.0,0.0,2068,1984
2021-09-09,Paraguay,Venezuela,2,1,1,1.0,0.0,1914,1882
2021-09-09,Uruguay,Ecuador,1,0,1,1.0,0.0,2053,1946
2021-09-09,Argentina,Bolivia,3,0,3,1.0,0.0,2157,1749
2021-09-09,Brazil,Peru,2,0,2,1.0,0.0,2230,1971
2021-09-24,El Salvador,Guatemala,0,2,2,0.0,1.0,1770,1745
2021-09-30,Egypt,Liberia,2,0,2,1.0,0.0,1899,1618
2021-10-01,Sri Lanka,Bangladesh,0,1,1,0.0,1.0,1311,1422
2021-10-01,Maldives,Nepal,0,1,1,0.0,1.0,1442,1439
2021-10-04,Bangladesh,India,1,1,0,0.5,0.5,1427,1618
2021-10-04,Sri Lanka,Nepal,2,3,1,0.0,1.0,1306,1445
2021-10-06,Sudan,Guinea,1,1,0,0.5,0.5,1617,1740
2021-10-06,Morocco,Guinea-Bissau,5,0,5,1.0,0.0,1899,1597
2021-10-06,Bahrain,Curaçao,4,0,4,1.0,0.0,1853,1649
2021-10-06,Jordan,Malaysia,4,0,4,1.0,0.0,1798,1623
2021-10-06,Sierra Leone,South Sudan,1,1,0,0.5,0.5,1620,1471
2021-10-06,Italy,Spain,1,2,1,0.0,1.0,2121,2164
2021-10-07,Iraq,Lebanon,0,0,0,0.5,0.5,1883,1702
2021-10-07,South Korea,Syria,2,1,1,1.0,0.0,1992,1770
2021-10-07,United Arab Emirates,Iran,0,1,1,0.0,1.0,1847,2034
2021-10-07,Saudi Arabia,Japan,1,0,1,1.0,0.0,1892,1998
2021-10-07,China PR,Vietnam,3,2,1,1.0,0.0,1850,1743
2021-10-07,Australia,Oman,3,1,2,1.0,0.0,1975,1834
2021-10-07,Honduras,Costa Rica,0,0,0,0.5,0.5,1825,1851
2021-10-07,United States,Jamaica,2,0,2,1.0,0.0,2044,1794
2021-10-07,El Salvador,Panama,1,0,1,1.0,0.0,1780,1827
2021-10-07,Mexico,Canada,1,1,0,0.5,0.5,2063,1855
2021-10-07,Equatorial Guinea,Zambia,2,0,2,1.0,0.0,1615,1730
2021-10-07,Tunisia,Mauritania,3,0,3,1.0,0.0,1895,1618
2021-10-07,Liberia,Cape Verde,1,2,1,0.0,1.0,1613,1713
2021-10-07,Nigeria,Central African Republic,0,1,1,0.0,1.0,1881,1559
2021-10-07,Rwanda,Uganda,0,1,1,0.0,1.0,1648,1728
2021-10-07,Mali,Kenya,5,0,5,1.0,0.0,1781,1705
2021-10-07,DR Congo,Madagascar,2,0,2,1.0,0.0,1744,1606
2021-10-07,Tanzania,Benin,0,1,1,0.0,1.0,1632,1715
2021-10-07,Ecuador,Bolivia,3,0,3,1.0,0.0,1950,1746
2021-10-07,Venezuela,Brazil,1,3,2,0.0,1.0,1881,2232
2021-10-07,Paraguay,Argentina,0,0,0,0.5,0.5,1919,2153
2021-10-07,Peru,Chile,2,0,2,1.0,0.0,1980,1976
2021-10-07,Uruguay,Colombia,0,0,0,0.5,0.5,2054,2068
2021-10-07,Indonesia,Taiwan,2,1,1,1.0,0.0,1611,1454
2021-10-07,India,Sri Lanka,0,0,0,0.5,0.5,1613,1312
2021-10-07,Maldives,Bangladesh,2,0,2,1.0,0.0,1450,1420
2021-10-07,Belgium,France,2,3,1,0.0,1.0,2154,2178
2021-10-08,Czech Republic,Wales,2,2,0,0.5,0.5,1936,1930
2021-10-08,Estonia,Belarus,2,0,2,1.0,0.0,1709,1716
2021-10-08,Gibraltar,Montenegro,0,3,3,0.0,1.0,1495,1750
2021-10-08,Latvia,Netherlands,0,1,1,0.0,1.0,1602,2081
2021-10-08,Turkey,Norway,1,1,0,0.5,0.5,1933,1891
2021-10-08,Malta,Slovenia,0,4,4,0.0,1.0,1516,1801
2021-10-08,Cyprus,Croatia,0,3,3,0.0,1.0,1623,2002
2021-10-08,Russia,Slovakia,1,0,1,1.0,0.0,1960,1879
2021-10-08,Iceland,Armenia,1,1,0,0.5,0.5,1827,1733
2021-10-08,Germany,Romania,2,1,1,1.0,0.0,2113,1890
2021-10-08,Liechtenstein,North Macedonia,0,4,4,0.0,1.0,1436,1787
2021-10-08,Algeria,Niger,6,1,5,1.0,0.0,1935,1583
2021-10-08,Djibouti,Burkina Faso,0,4,4,0.0,1.0,1330,1774
2021-10-08,Malawi,Ivory Coast,0,3,3,0.0,1.0,1642,1903
2021-10-08,Cameroon,Mozambique,3,1,2,1.0,0.0,1855,1647
2021-10-08,Angola,Gabon,3,1,2,1.0,0.0,1684,1700
2021-10-08,Egypt,Libya,1,0,1,1.0,0.0,1903,1684
2021-10-09,Azerbaijan,Republic of Ireland,0,3,3,0.0,1.0,1629,1872
2021-10-09,Luxembourg,Serbia,0,1,1,0.0,1.0,1605,1945
2021-10-09,Sweden,Kosovo,3,0,3,1.0,0.0,2003,1677
2021-10-09,Georgia,Greece,0,2,2,0.0,1.0,1730,1887
2021-10-09,Lithuania,Bulgaria,3,1,2,1.0,0.0,1617,1782
2021-10-09,Switzerland,Northern Ireland,2,0,2,1.0,0.0,2029,1816
2021-10-09,Finland,Ukraine,1,2,1,0.0,1.0,1847,1982
2021-10-09,Kazakhstan,Bosnia and Herzegovina,0,2,2,0.0,1.0,1629,1872
2021-10-09,Scotland,Israel,3,2,1,1.0,0.0,1889,1797
2021-10-09,Faroe Islands,Austria,0,2,2,0.0,1.0,1525,1919
2021-10-09,Moldova,Denmark,0,4,4,0.0,1.0,1545,2038
2021-10-09,Andorra,England,0,5,5,0.0,1.0,1395,2149
2021-10-09,Hungary,Albania,0,1,1,0.0,1.0,1860,1783
2021-10-09,Poland,San Marino,5,0,5,1.0,0.0,1971,1293
2021-10-09,Ethiopia,South Africa,1,3,2,0.0,1.0,1652,1843
2021-10-09,Ghana,Zimbabwe,3,1,2,1.0,0.0,1857,1698
2021-10-09,Togo,Congo,1,1,0,0.5,0.5,1629,1660
2021-10-09,Senegal,Namibia,4,1,3,1.0,0.0,1935,1675
2021-10-09,Guinea,Sudan,2,2,0,0.5,0.5,1738,1620
2021-10-09,Curaçao,New Zealand,1,2,1,0.0,1.0,1644,1748
2021-10-09,Gambia,Sierra Leone,1,2,1,0.0,1.0,1627,1629
2021-10-09,Portugal,Qatar,3,0,3,1.0,0.0,2116,1891
2021-10-09,Uzbekistan,Malaysia,5,1,4,1.0,0.0,1847,1620
2021-10-09,Guam,Cambodia,0,1,1,0.0,1.0,1373,1381
2021-10-09,Morocco,Guinea-Bissau,3,0,3,1.0,0.0,1902,1595
2021-10-10,Costa Rica,El Salvador,2,1,1,1.0,0.0,1858,1774
2021-10-10,Jamaica,Canada,0,0,0,0.5,0.5,1796,1854
2021-10-10,Panama,United States,1,0,1,1.0,0.0,1840,2032
2021-10-10,Mexico,Honduras,3,0,3,1.0,0.0,2067,1822
2021-10-10,Zambia,Equatorial Guinea,1,1,0,0.5,0.5,1728,1618
2021-10-10,Mauritania,Tunisia,0,0,0,0.5,0.5,1624,1890
2021-10-10,Central African Republic,Nigeria,0,2,2,0.0,1.0,1557,1884
2021-10-10,Cape Verde,Liberia,1,0,1,1.0,0.0,1719,1608
2021-10-10,Kenya,Mali,0,1,1,0.0,1.0,1699,1788
2021-10-10,Uganda,Rwanda,1,0,1,1.0,0.0,1735,1642
2021-10-10,Benin,Tanzania,0,1,1,0.0,1.0,1706,1642
2021-10-10,Madagascar,DR Congo,1,0,1,1.0,0.0,1618,1733
2021-10-10,Bolivia,Peru,1,0,1,1.0,0.0,1759,1968
2021-10-10,Colombia,Brazil,0,0,0,0.5,0.5,2072,2229
2021-10-10,Venezuela,Ecuador,2,1,1,1.0,0.0,1891,1941
2021-10-10,Argentina,Uruguay,3,0,3,1.0,0.0,2159,2049
2021-10-10,Chile,Paraguay,2,0,2,1.0,0.0,1983,1913
2021-10-10,Maldives,Sri Lanka,1,0,1,1.0,0.0,1455,1308
2021-10-10,Nepal,India,0,1,1,0.0,1.0,1441,1618
2021-10-10,Italy,Belgium,2,1,1,1.0,0.0,2130,2146
2021-10-10,Spain,France,1,2,1,0.0,1.0,2157,2186
2021-10-11,Belarus,Czech Republic,0,2,2,0.0,1.0,1713,1940
2021-10-11,Estonia,Wales,0,1,1,0.0,1.0,1706,1934
2021-10-11,Netherlands,Gibraltar,6,0,6,1.0,0.0,2082,1495
2021-10-11,Norway,Montenegro,2,0,2,1.0,0.0,1896,1746
2021-10-11,Latvia,Turkey,1,2,1,0.0,1.0,1600,1936
2021-10-11,Cyprus,Malta,2,2,0,0.5,0.5,1621,1519
2021-10-11,Croatia,Slovakia,2,2,0,0.5,0.5,2000,1882
2021-10-11,Slovenia,Russia,1,2,1,0.0,1.0,1797,1965
2021-10-11,Iceland,Liechtenstein,4,0,4,1.0,0.0,1829,1435
2021-10-11,North Macedonia,Germany,0,4,4,0.0,1.0,1785,2116
2021-10-11,Romania,Armenia,1,0,1,1.0,0.0,1895,1729
2021-10-11,Burkina Faso,Djibouti,2,0,2,1.0,0.0,1776,1329
2021-10-11,Mozambique,Cameroon,0,1,1,0.0,1.0,1644,1859
2021-10-11,Ivory Coast,Malawi,2,1,1,1.0,0.0,1906,1640
2021-10-11,Gabon,Angola,2,0,2,1.0,0.0,1708,1677
2021-10-11,Libya,Egypt,0,3,3,0.0,1.0,1681,1907
2021-10-11,Taiwan,Indonesia,0,3,3,0.0,1.0,1450,1616
2021-10-12,Iran,South Korea,1,1,0,0.5,0.5,2034,1993
2021-10-12,Syria,Lebanon,2,3,1,0.0,1.0,1761,1712
2021-10-12,United Arab Emirates,Iraq,2,2,0,0.5,0.5,1848,1883
2021-10-12,Japan,Australia,2,1,1,1.0,0.0,2006,1968
2021-10-12,Oman,Vietnam,3,1,2,1.0,0.0,1840,1738
2021-10-12,Saudi Arabia,China PR,3,2,1,1.0,0.0,1900,1843
2021-10-12,Portugal,Luxembourg,5,0,5,1.0,0.0,2117,1605
2021-10-12,Serbia,Azerbaijan,3,1,2,1.0,0.0,1948,1627
2021-10-12,Kosovo,Georgia,1,2,1,0.0,1.0,1671,1737
2021-10-12,Sweden,Greece,2,0,2,1.0,0.0,2009,1882
2021-10-12,Bulgaria,Northern Ireland,2,1,1,1.0,0.0,1791,1808
2021-10-12,Lithuania,Switzerland,0,4,4,0.0,1.0,1616,2031
2021-10-12,Kazakhstan,Finland,0,2,2,0.0,1.0,1626,1851
2021-10-12,Ukraine,Bosnia and Herzegovina,1,1,0,0.5,0.5,1980,1875
2021-10-12,Faroe Islands,Scotland,0,1,1,0.0,1.0,1524,1891
2021-10-12,Denmark,Austria,1,0,1,1.0,0.0,2044,1914
2021-10-12,Israel,Moldova,2,1,1,1.0,0.0,1801,1542
2021-10-12,England,Hungary,1,1,0,0.5,0.5,2144,1866
2021-10-12,Albania,Poland,0,1,1,0.0,1.0,1779,1976
2021-10-12,San Marino,Andorra,0,3,3,0.0,1.0,1288,1401
2021-10-12,Niger,Algeria,0,4,4,0.0,1.0,1582,1937
2021-10-12,Zimbabwe,Ghana,0,1,1,0.0,1.0,1694,1862
2021-10-12,South Africa,Ethiopia,1,0,1,1.0,0.0,1847,1649
2021-10-12,Namibia,Senegal,1,3,2,0.0,1.0,1673,1938
2021-10-12,Congo,Togo,1,2,1,0.0,1.0,1652,1638
2021-10-12,Bahrain,New Zealand,0,1,1,0.0,1.0,1843,1759
2021-10-12,Jordan,Uzbekistan,3,0,3,1.0,0.0,1808,1838
2021-10-12,Republic of Ireland,Qatar,4,0,4,1.0,0.0,1881,1883
2021-10-12,South Sudan,Gambia,1,2,1,0.0,1.0,1467,1632
2021-10-12,Cambodia,Guam,2,1,1,1.0,0.0,1389,1366
2021-10-12,Morocco,Guinea,4,1,3,1.0,0.0,1907,1734
2021-10-13,Honduras,Jamaica,0,2,2,0.0,1.0,1814,1805
2021-10-13,United States,Costa Rica,2,1,1,1.0,0.0,2037,1854
2021-10-13,Canada,Panama,4,1,3,1.0,0.0,1862,1833
2021-10-13,El Salvador,Mexico,0,2,2,0.0,1.0,1772,2070
2021-10-13,Bangladesh,Nepal,1,1,0,0.5,0.5,1421,1441
2021-10-13,Maldives,India,1,3,2,0.0,1.0,1451,1623
2021-10-14,Bolivia,Paraguay,4,0,4,1.0,0.0,1771,1902
2021-10-14,Colombia,Ecuador,0,0,0,0.5,0.5,2070,1944
2021-10-14,Argentina,Peru,1,0,1,1.0,0.0,2163,1965
2021-10-14,Brazil,Uruguay,4,1,3,1.0,0.0,2234,2045
2021-10-14,Chile,Venezuela,3,0,3,1.0,0.0,1989,1886
2021-10-16,India,Nepal,3,0,3,1.0,0.0,1628,1437
2021-10-27,Mexico,Ecuador,2,3,1,0.0,1.0,2060,1955
2021-11-05,El Salvador,Bolivia,0,1,1,0.0,1.0,1764,1780
2021-11-09,Sri Lanka,Maldives,4,4,0,0.5,0.5,1312,1448
2021-11-10,Kosovo,Jordan,0,2,2,0.0,1.0,1667,1813
2021-11-10,Nicaragua,Cuba,0,3,3,0.0,1.0,1520,1614
2021-11-10,Bangladesh,Seychelles,1,1,0,0.5,0.5,1421,1383
2021-11-11,Czech Republic,Kuwait,7,0,7,1.0,0.0,1944,1739
2021-11-11,Kyrgyzstan,Singapore,2,1,1,1.0,0.0,1622,1578
2021-11-11,Serbia,Qatar,4,0,4,1.0,0.0,1955,1877
2021-11-11,Ukraine,Bulgaria,1,1,0,0.5,0.5,1977,1795
2021-11-11,Uganda,Kenya,1,1,0,0.5,0.5,1735,1700
2021-11-11,Rwanda,Mali,0,3,3,0.0,1.0,1638,1793
2021-11-11,Ethiopia,Ghana,1,1,0,0.5,0.5,1654,1858
2021-11-11,South Africa,Zimbabwe,1,0,1,1.0,0.0,1852,1690
2021-11-11,Congo,Namibia,1,1,0,0.5,0.5,1653,1673
2021-11-11,Togo,Senegal,1,1,0,0.5,0.5,1644,1933
2021-11-11,Tanzania,DR Congo,0,3,3,0.0,1.0,1637,1739
2021-11-11,Benin,Madagascar,2,0,2,1.0,0.0,1713,1612
2021-11-11,Lebanon,Iran,1,2,1,0.0,1.0,1710,2037
2021-11-11,Iraq,Syria,1,1,0,0.5,0.5,1881,1764
2021-11-11,South Korea,United Arab Emirates,1,0,1,1.0,0.0,1998,1844
2021-11-11,China PR,Oman,1,1,0,0.5,0.5,1843,1841
2021-11-11,Vietnam,Japan,0,1,1,0.0,1.0,1736,2009
2021-11-11,Australia,Saudi Arabia,0,0,0,0.5,0.5,1967,1902
2021-11-11,Republic of Ireland,Portugal,0,0,0,0.5,0.5,1886,2113
2021-11-11,Azerbaijan,Luxembourg,1,3,2,0.0,1.0,1619,1614
2021-11-11,Georgia,Sweden,2,0,2,1.0,0.0,1751,1996
2021-11-11,Greece,Spain,0,1,1,0.0,1.0,1880,2160
2021-11-11,Russia,Cyprus,6,0,6,1.0,0.0,1967,1620
2021-11-11,Malta,Croatia,1,7,6,0.0,1.0,1519,2001
2021-11-11,Slovakia,Slovenia,2,2,0,0.5,0.5,1881,1799
2021-11-11,Germany,Liechtenstein,9,0,9,1.0,0.0,2117,1435
2021-11-11,Armenia,North Macedonia,0,5,5,0.0,1.0,1723,1792
2021-11-11,Romania,Iceland,0,0,0,0.5,0.5,1894,1831
2021-11-11,Ecuador,Venezuela,1,0,1,1.0,0.0,1962,1880
2021-11-11,Paraguay,Chile,0,1,1,0.0,1.0,1896,1996
2021-11-11,Peru,Bolivia,3,0,3,1.0,0.0,1970,1776
2021-11-11,Brazil,Colombia,1,0,1,1.0,0.0,2239,2066
2021-11-12,Burkina Faso,Niger,1,1,0,0.5,0.5,1772,1587
2021-11-12,Djibouti,Algeria,0,4,4,0.0,1.0,1329,1938
2021-11-12,Gabon,Libya,1,0,1,1.0,0.0,1716,1674
2021-11-12,Angola,Egypt,2,2,0,0.5,0.5,1682,1903
2021-11-12,Guinea,Guinea-Bissau,0,0,0,0.5,0.5,1731,1599
2021-11-12,Morocco,Sudan,3,0,3,1.0,0.0,1910,1618
2021-11-12,Canada,Costa Rica,1,0,1,1.0,0.0,1870,1847
2021-11-12,Honduras,Panama,2,3,1,0.0,1.0,1807,1841
2021-11-12,El Salvador,Jamaica,1,1,0,0.5,0.5,1765,1805
2021-11-12,United States,Mexico,2,0,2,1.0,0.0,2046,2052
2021-11-12,Northern Ireland,Lithuania,1,0,1,1.0,0.0,1812,1613
2021-11-12,Italy,Switzerland,1,1,0,0.5,0.5,2128,2034
2021-11-12,Moldova,Scotland,0,2,2,0.0,1.0,1541,1893
2021-11-12,Denmark,Faroe Islands,3,1,2,1.0,0.0,2045,1524
2021-11-12,Austria,Israel,4,2,2,1.0,0.0,1920,1796
2021-11-12,England,Albania,5,0,5,1.0,0.0,2146,1778
2021-11-12,Andorra,Poland,1,4,3,0.0,1.0,1401,1977
2021-11-12,Hungary,San Marino,4,0,4,1.0,0.0,1867,1288
2021-11-12,Uruguay,Argentina,0,1,1,0.0,1.0,2040,2169
2021-11-13,Burundi,Myanmar,2,1,1,1.0,0.0,1608,1530
2021-11-13,Nicaragua,Cuba,2,0,2,1.0,0.0,1531,1604
2021-11-13,Sierra Leone,Comoros,0,2,2,0.0,1.0,1620,1552
2021-11-13,Bangladesh,Maldives,2,1,1,1.0,0.0,1430,1440
2021-11-13,Sri Lanka,Seychelles,0,1,1,0.0,1.0,1306,1390
2021-11-13,Zambia,Mauritania,4,0,4,1.0,0.0,1734,1619
2021-11-13,Equatorial Guinea,Tunisia,1,0,1,1.0,0.0,1632,1877
2021-11-13,Cape Verde,Central African Republic,2,1,1,1.0,0.0,1724,1553
2021-11-13,Liberia,Nigeria,0,2,2,0.0,1.0,1606,1887
2021-11-13,Malawi,Cameroon,0,4,4,0.0,1.0,1637,1863
2021-11-13,Ivory Coast,Mozambique,3,0,3,1.0,0.0,1909,1642
2021-11-13,Bosnia and Herzegovina,Finland,1,3,2,0.0,1.0,1867,1860
2021-11-13,France,Kazakhstan,8,0,8,1.0,0.0,2187,1626
2021-11-13,Wales,Belarus,5,1,4,1.0,0.0,1938,1710
2021-11-13,Belgium,Estonia,3,1,2,1.0,0.0,2148,1705
2021-11-13,Norway,Latvia,0,0,0,0.5,0.5,1891,1606
2021-11-13,Turkey,Gibraltar,6,0,6,1.0,0.0,1938,1494
2021-11-13,Montenegro,Netherlands,2,2,0,0.5,0.5,1752,2077
2021-11-14,Azerbaijan,Qatar,2,2,0,0.5,0.5,1625,1872
2021-11-14,Nicaragua,Cuba,2,0,2,1.0,0.0,1541,1595
2021-11-14,Mali,Uganda,1,0,1,1.0,0.0,1800,1729
2021-11-14,Zimbabwe,Ethiopia,1,1,0,0.5,0.5,1690,1655
2021-11-14,Ghana,South Africa,1,0,1,1.0,0.0,1866,1845
2021-11-14,Senegal,Congo,2,0,2,1.0,0.0,1936,1651
2021-11-14,DR Congo,Benin,2,0,2,1.0,0.0,1747,1706
2021-11-14,Madagascar,Tanzania,1,1,0,0.5,0.5,1613,1637
2021-11-14,Portugal,Serbia,1,2,1,0.0,1.0,2102,1967
2021-11-14,Luxembourg,Republic of Ireland,0,3,3,0.0,1.0,1612,1889
2021-11-14,Spain,Sweden,1,0,1,1.0,0.0,2165,1992
2021-11-14,Greece,Kosovo,1,1,0,0.5,0.5,1876,1672
2021-11-14,Croatia,Russia,1,0,1,1.0,0.0,2009,1960
2021-11-14,Malta,Slovakia,0,6,6,0.0,1.0,1518,1883
2021-11-14,Slovenia,Cyprus,2,1,1,1.0,0.0,1804,1616
2021-11-14,Liechtenstein,Romania,0,2,2,0.0,1.0,1434,1896
2021-11-14,North Macedonia,Iceland,3,1,2,1.0,0.0,1801,1823
2021-11-14,Armenia,Germany,1,4,3,0.0,1.0,1722,2119
2021-11-15,Georgia,Uzbekistan,1,0,1,1.0,0.0,1761,1829
2021-11-15,Lithuania,Kuwait,1,1,0,0.5,0.5,1616,1737
2021-11-15,Niger,Djibouti,7,2,5,1.0,0.0,1590,1327
2021-11-15,Kenya,Rwanda,2,1,1,1.0,0.0,1707,1632
2021-11-15,Namibia,Togo,0,1,1,0.0,1.0,1665,1653
2021-11-15,Guinea-Bissau,Sudan,0,0,0,0.5,0.5,1600,1618
2021-11-15,Northern Ireland,Italy,0,0,0,0.5,0.5,1818,2123
2021-11-15,Switzerland,Bulgaria,4,0,4,1.0,0.0,2038,1792
2021-11-15,Scotland,Denmark,2,0,2,1.0,0.0,1905,2034
2021-11-15,Austria,Moldova,4,1,3,1.0,0.0,1922,1540
2021-11-15,Israel,Faroe Islands,3,2,1,1.0,0.0,1799,1522
2021-11-15,Albania,Andorra,1,0,1,1.0,0.0,1780,1400
2021-11-15,Poland,Hungary,1,2,1,0.0,1.0,1967,1878
2021-11-15,San Marino,England,0,10,10,0.0,1.0,1288,2147
2021-11-16,Bahrain,Kyrgyzstan,4,2,2,1.0,0.0,1847,1619
2021-11-16,Belarus,Jordan,1,0,1,1.0,0.0,1721,1803
2021-11-16,Kazakhstan,Tajikistan,1,0,1,1.0,0.0,1634,1613
2021-11-16,New Zealand,Gambia,2,0,2,1.0,0.0,1765,1627
2021-11-16,Indonesia,Afghanistan,0,1,1,0.0,1.0,1606,1530
2021-11-16,Maldives,Seychelles,0,0,0,0.5,0.5,1439,1392
2021-11-16,Sri Lanka,Bangladesh,2,1,1,1.0,0.0,1317,1420
2021-11-16,Algeria,Burkina Faso,2,2,0,0.5,0.5,1935,1776
2021-11-16,Mauritania,Equatorial Guinea,1,1,0,0.5,0.5,1620,1632
2021-11-16,Tunisia,Zambia,3,1,2,1.0,0.0,1882,1730
2021-11-16,Liberia,Central African Republic,3,1,2,1.0,0.0,1613,1547
2021-11-16,Nigeria,Cape Verde,1,1,0,0.5,0.5,1884,1728
2021-11-16,Mozambique,Malawi,1,0,1,1.0,0.0,1650,1630
2021-11-16,Cameroon,Ivory Coast,1,0,1,1.0,0.0,1873,1900
2021-11-16,Egypt,Gabon,2,1,1,1.0,0.0,1908,1712
2021-11-16,Libya,Angola,1,1,0,0.5,0.5,1675,1682
2021-11-16,Morocco,Guinea,3,0,3,1.0,0.0,1915,1727
2021-11-16,Lebanon,United Arab Emirates,0,1,1,0.0,1.0,1705,1850
2021-11-16,Iraq,South Korea,0,3,3,0.0,1.0,1876,2004
2021-11-16,Syria,Iran,0,3,3,0.0,1.0,1762,2040
2021-11-16,China PR,Australia,1,1,0,0.5,0.5,1846,1965
2021-11-16,Vietnam,Saudi Arabia,0,1,1,0.0,1.0,1732,1907
2021-11-16,Oman,Japan,0,1,1,0.0,1.0,1837,2014
2021-11-16,Jamaica,United States,1,1,0,0.5,0.5,1810,2042
2021-11-16,Canada,Mexico,2,1,1,1.0,0.0,1882,2041
2021-11-16,Costa Rica,Honduras,2,1,1,1.0,0.0,1855,1800
2021-11-16,Panama,El Salvador,2,1,1,1.0,0.0,1848,1759
2021-11-16,Bosnia and Herzegovina,Ukraine,0,2,2,0.0,1.0,1862,1983
2021-11-16,Finland,France,0,2,2,0.0,1.0,1858,2190
2021-11-16,Wales,Belgium,1,1,0,0.5,0.5,1943,2144
2021-11-16,Czech Republic,Estonia,2,0,2,1.0,0.0,1948,1702
2021-11-16,Gibraltar,Latvia,1,3,2,0.0,1.0,1489,1612
2021-11-16,Montenegro,Turkey,1,2,1,0.0,1.0,1748,1943
2021-11-16,Netherlands,Norway,2,0,2,1.0,0.0,2082,1887
2021-11-16,Bolivia,Uruguay,3,0,3,1.0,0.0,1790,2027
2021-11-16,Venezuela,Peru,1,2,1,0.0,1.0,1875,1976
2021-11-16,Colombia,Paraguay,0,0,0,0.5,0.5,2063,1900
2021-11-16,Argentina,Brazil,0,0,0,0.5,0.5,2171,2238
2021-11-16,Chile,Ecuador,0,2,2,0.0,1.0,1988,1971
2021-11-19,Sri Lanka,Seychelles,3,3,0,0.5,0.5,1319,1391
2021-11-25,Indonesia,Myanmar,4,1,3,1.0,0.0,1613,1524
2021-11-30,Iraq,Oman,1,1,0,0.5,0.5,1876,1838
2021-11-30,Qatar,Bahrain,1,0,1,1.0,0.0,1880,1840
2021-11-30,Tunisia,Mauritania,5,1,4,1.0,0.0,1885,1618
2021-11-30,United Arab Emirates,Syria,2,1,1,1.0,0.0,1857,1756
2021-12-01,Morocco,Palestine,4,0,4,1.0,0.0,1919,1693
2021-12-01,Saudi Arabia,Jordan,0,1,1,0.0,1.0,1897,1814
2021-12-01,Algeria,Sudan,4,0,4,1.0,0.0,1938,1616
2021-12-01,Egypt,Lebanon,1,0,1,1.0,0.0,1912,1702
2021-12-03,Bahrain,Iraq,0,0,0,0.5,0.5,1841,1876
2021-12-03,Qatar,Oman,2,1,1,1.0,0.0,1888,1831
2021-12-03,Mauritania,United Arab Emirates,0,1,1,0.0,1.0,1615,1861
2021-12-03,Syria,Tunisia,2,0,2,1.0,0.0,1767,1875
2021-12-04,El Salvador,Ecuador,1,1,0,0.5,0.5,1764,1967
2021-12-04,Jordan,Morocco,0,4,4,0.0,1.0,1809,1925
2021-12-04,Palestine,Saudi Arabia,1,1,0,0.5,0.5,1698,1893
2021-12-04,Lebanon,Algeria,0,2,2,0.0,1.0,1699,1942
2021-12-04,Sudan,Egypt,0,5,5,0.0,1.0,1614,1915
2021-12-05,East Timor,Thailand,0,2,2,0.0,1.0,1497,1745
2021-12-05,Singapore,Myanmar,3,0,3,1.0,0.0,1585,1518
2021-12-06,Oman,Bahrain,3,0,3,1.0,0.0,1840,1833
2021-12-06,Qatar,Iraq,3,0,3,1.0,0.0,1896,1869
2021-12-06,Syria,Mauritania,1,2,1,0.0,1.0,1756,1627
2021-12-06,Tunisia,United Arab Emirates,1,0,1,1.0,0.0,1883,1854
2021-12-06,Cambodia,Malaysia,1,3,2,0.0,1.0,1386,1624
2021-12-06,Laos,Vietnam,0,2,2,0.0,1.0,1351,1734
2021-12-07,Jordan,Palestine,5,1,4,1.0,0.0,1815,1693
2021-12-07,Morocco,Saudi Arabia,1,0,1,1.0,0.0,1933,1886
2021-12-07,Algeria,Egypt,1,1,0,0.5,0.5,1942,1916
2021-12-07,Lebanon,Sudan,1,0,1,1.0,0.0,1706,1608
2021-12-08,Mexico,Chile,2,2,0,0.5,0.5,2040,1990
2021-12-08,Myanmar,East Timor,2,0,2,1.0,0.0,1526,1490
2021-12-08,Singapore,Philippines,2,1,1,1.0,0.0,1594,1591
2021-12-09,Tanzania,Uganda,0,2,2,0.0,1.0,1632,1735
2021-12-09,Malaysia,Laos,4,0,4,1.0,0.0,1627,1349
2021-12-09,Indonesia,Cambodia,4,2,2,1.0,0.0,1617,1383
2021-12-10,Tunisia,Oman,2,1,1,1.0,0.0,1891,1833
2021-12-10,Qatar,United Arab Emirates,5,0,5,1.0,0.0,1904,1847
2021-12-11,Egypt,Jordan,3,1,2,1.0,0.0,1922,1810
2021-12-11,Morocco,Algeria,2,2,0,0.5,0.5,1934,1942
2021-12-11,El Salvador,Chile,0,1,1,0.0,1.0,1761,1994
2021-12-11,East Timor,Philippines,0,7,7,0.0,1.0,1485,1597
2021-12-11,Thailand,Myanmar,4,0,4,1.0,0.0,1749,1523
2021-12-12,Laos,Indonesia,1,5,4,0.0,1.0,1347,1620
2021-12-12,Vietnam,Malaysia,3,0,3,1.0,0.0,1740,1622
2021-12-14,Philippines,Thailand,1,2,1,0.0,1.0,1593,1754
2021-12-14,Singapore,East Timor,2,0,2,1.0,0.0,1600,1480
2021-12-15,Tunisia,Egypt,1,0,1,1.0,0.0,1900,1914
2021-12-15,Qatar,Algeria,1,2,1,0.0,1.0,1897,1950
2021-12-15,Cambodia,Laos,3,0,3,1.0,0.0,1391,1340
2021-12-15,Indonesia,Vietnam,0,0,0,0.5,0.5,1623,1738
2021-12-18,Qatar,Egypt,0,0,0,0.5,0.5,1898,1914
2021-12-18,Tunisia,Algeria,0,2,2,0.0,1.0,1894,1957
2021-12-18,United States,Bosnia and Herzegovina,1,0,1,1.0,0.0,2047,1858
2021-12-18,Singapore,Thailand,0,2,2,0.0,1.0,1596,1759
2021-12-18,Myanmar,Philippines,2,3,1,0.0,1.0,1517,1600
2021-12-19,Vietnam,Cambodia,4,0,4,1.0,0.0,1740,1390
2021-12-19,Malaysia,Indonesia,1,4,3,0.0,1.0,1615,1631
2021-12-22,Singapore,Indonesia,1,1,0,0.5,0.5,1597,1631
2021-12-23,Vietnam,Thailand,0,2,2,0.0,1.0,1733,1767
2021-12-25,Singapore,Indonesia,2,4,2,0.0,1.0,1590,1639
2021-12-26,Thailand,Vietnam,0,0,0,0.5,0.5,1767,1734
2021-12-29,Indonesia,Thailand,0,4,4,0.0,1.0,1634,1773
2021-12-30,Mauritania,Burkina Faso,0,0,0,0.5,0.5,1631,1773
2021-12-30,Sudan,Ethiopia,2,3,1,0.0,1.0,1602,1662
2021-12-31,Malawi,Comoros,2,1,1,1.0,0.0,1637,1546
2022-01-01,Thailand,Indonesia,2,2,0,0.5,0.5,1770,1638
2022-01-02,Gabon,Burkina Faso,0,3,3,0.0,1.0,1706,1780
2022-01-02,Sudan,Zimbabwe,0,0,0,0.5,0.5,1604,1689
2022-01-03,Rwanda,Guinea,3,0,3,1.0,0.0,1643,1717
2022-01-04,Mauritania,Gabon,1,1,0,0.5,0.5,1633,1705
2022-01-05,Algeria,Ghana,3,0,3,1.0,0.0,1963,1861
2022-01-06,Rwanda,Guinea,0,2,2,0.0,1.0,1637,1724
2022-01-09,Cameroon,Burkina Faso,2,1,1,1.0,0.0,1879,1775
2022-01-09,Ethiopia,Cape Verde,0,1,1,0.0,1.0,1656,1735
2022-01-10,Senegal,Zimbabwe,1,0,1,1.0,0.0,1940,1686
2022-01-10,Guinea,Malawi,1,0,1,1.0,0.0,1731,1631
2022-01-10,Morocco,Ghana,1,0,1,1.0,0.0,1941,1855
2022-01-10,Comoros,Gabon,0,1,1,0.0,1.0,1542,1710
2022-01-11,Nigeria,Egypt,1,0,1,1.0,0.0,1893,1906
2022-01-11,Sudan,Guinea-Bissau,0,0,0,0.5,0.5,1604,1601
2022-01-11,Algeria,Sierra Leone,0,0,0,0.5,0.5,1957,1627
2022-01-12,Iceland,Uganda,1,1,0,0.5,0.5,1822,1737
2022-01-12,Equatorial Guinea,Ivory Coast,0,1,1,0.0,1.0,1630,1903
2022-01-12,Tunisia,Mali,0,1,1,0.0,1.0,1884,1811
2022-01-12,Mauritania,Gambia,0,1,1,0.0,1.0,1625,1636
2022-01-13,Cameroon,Ethiopia,4,1,3,1.0,0.0,1883,1653
2022-01-13,Cape Verde,Burkina Faso,0,1,1,0.0,1.0,1728,1783
2022-01-14,Senegal,Guinea,0,0,0,0.5,0.5,1936,1736
2022-01-14,Malawi,Zimbabwe,2,1,1,1.0,0.0,1641,1677
2022-01-14,Morocco,Comoros,2,0,2,1.0,0.0,1943,1541
2022-01-14,Gabon,Ghana,1,1,0,0.5,0.5,1714,1852
2022-01-15,South Korea,Iceland,5,1,4,1.0,0.0,2009,1818
2022-01-15,Nigeria,Sudan,3,1,2,1.0,0.0,1896,1602
2022-01-15,Guinea-Bissau,Egypt,0,1,1,0.0,1.0,1599,1909
2022-01-16,Colombia,Honduras,2,1,1,1.0,0.0,2066,1798
2022-01-16,Peru,Panama,1,1,0,0.5,0.5,1974,1851
2022-01-16,Ivory Coast,Sierra Leone,2,2,0,0.5,0.5,1898,1633
2022-01-16,Algeria,Equatorial Guinea,0,1,1,0.0,1.0,1944,1644
2022-01-16,Gambia,Mali,1,1,0,0.5,0.5,1640,1808
2022-01-16,Tunisia,Mauritania,4,0,4,1.0,0.0,1887,1623
2022-01-17,Burkina Faso,Ethiopia,1,1,0,0.5,0.5,1781,1656
2022-01-17,Cameroon,Cape Verde,1,1,0,0.5,0.5,1880,1732
2022-01-18,Moldova,Uganda,2,3,1,0.0,1.0,1537,1741
2022-01-18,Malawi,Senegal,0,0,0,0.5,0.5,1647,1931
2022-01-18,Zimbabwe,Guinea,2,1,1,1.0,0.0,1687,1727
2022-01-18,Gabon,Morocco,2,2,0,0.5,0.5,1719,1939
2022-01-18,Ghana,Comoros,2,3,1,0.0,1.0,1839,1555
2022-01-19,Egypt,Sudan,1,0,1,1.0,0.0,1912,1600
2022-01-19,Guinea-Bissau,Nigeria,0,2,2,0.0,1.0,1597,1899
2022-01-20,South Korea,Moldova,4,0,4,1.0,0.0,2010,1537
2022-01-20,Peru,Jamaica,3,0,3,1.0,0.0,1979,1806
2022-01-20,Ivory Coast,Algeria,3,1,2,1.0,0.0,1908,1935
2022-01-20,Sierra Leone,Equatorial Guinea,0,1,1,0.0,1.0,1626,1652
2022-01-20,Gambia,Tunisia,1,0,1,1.0,0.0,1653,1875
2022-01-20,Mali,Mauritania,2,0,2,1.0,0.0,1813,1619
2022-01-21,Bolivia,Trinidad and Tobago,5,0,5,1.0,0.0,1796,1688
2022-01-21,Iraq,Uganda,1,0,1,1.0,0.0,1875,1736
2022-01-23,Burkina Faso,Gabon,1,1,0,0.5,0.5,1780,1721
2022-01-23,Nigeria,Tunisia,0,1,1,0.0,1.0,1891,1884
2022-01-24,Cameroon,Comoros,2,1,1,1.0,0.0,1883,1553
2022-01-24,Guinea,Gambia,0,1,1,0.0,1.0,1718,1663
2022-01-25,Morocco,Malawi,2,1,1,1.0,0.0,1942,1645
2022-01-25,Senegal,Cape Verde,2,0,2,1.0,0.0,1935,1729
2022-01-26,Ivory Coast,Egypt,0,0,0,0.5,0.5,1909,1912
2022-01-26,Mali,Equatorial Guinea,0,0,0,0.5,0.5,1810,1656
2022-01-27,Bahrain,Uganda,3,1,2,1.0,0.0,1839,1731
2022-01-27,Indonesia,Timor-Leste,4,1,3,1.0,0.0,1640,1277
2022-01-27,Uzbekistan,South Sudan,3,0,3,1.0,0.0,1831,1466
2022-01-27,Jamaica,Mexico,1,2,1,0.0,1.0,1803,2044
2022-01-27,United States,El Salvador,1,0,1,1.0,0.0,2050,1759
2022-01-27,Honduras,Canada,0,2,2,0.0,1.0,1792,1889
2022-01-27,Costa Rica,Panama,1,0,1,1.0,0.0,1863,1844
2022-01-27,Lebanon,South Korea,0,1,1,0.0,1.0,1704,2013
2022-01-27,Iran,Iraq,1,0,1,1.0,0.0,2045,1871
2022-01-27,United Arab Emirates,Syria,2,0,2,1.0,0.0,1853,1751
2022-01-27,Japan,China PR,2,0,2,1.0,0.0,2019,1842
2022-01-27,Australia,Vietnam,4,0,4,1.0,0.0,1969,1731
2022-01-27,Saudi Arabia,Oman,1,0,1,1.0,0.0,1893,1827
2022-01-27,Ecuador,Brazil,1,1,0,0.5,0.5,1973,2233
2022-01-27,Paraguay,Uruguay,0,1,1,0.0,1.0,1895,2033
2022-01-27,Chile,Argentina,1,2,1,0.0,1.0,1990,2176
2022-01-28,Jordan,New Zealand,3,1,2,1.0,0.0,1817,1759
2022-01-28,Suriname,Barbados,1,0,1,1.0,0.0,1634,1517
2022-01-28,Colombia,Peru,0,1,1,0.0,1.0,2057,1989
2022-01-28,Venezuela,Bolivia,4,1,3,1.0,0.0,1882,1790
2022-01-29,Kuwait,Libya,2,0,2,1.0,0.0,1744,1669
2022-01-29,Nepal,Mauritius,1,0,1,1.0,0.0,1446,1462
2022-01-29,Nicaragua,Belize,4,0,4,1.0,0.0,1549,1504
2022-01-29,Burkina Faso,Tunisia,1,0,1,1.0,0.0,1791,1874
2022-01-29,Cameroon,Gambia,2,0,2,1.0,0.0,1887,1660
2022-01-30,Indonesia,Timor-Leste,3,0,3,1.0,0.0,1642,1276
2022-01-30,Egypt,Morocco,2,1,1,1.0,0.0,1921,1934
2022-01-30,Senegal,Equatorial Guinea,3,1,2,1.0,0.0,1938,1654
2022-01-30,Canada,United States,2,0,2,1.0,0.0,1901,2039
2022-01-30,Mexico,Costa Rica,0,0,0,0.5,0.5,2041,1867
2022-01-30,Panama,Jamaica,3,2,1,1.0,0.0,1852,1796
2022-01-30,Honduras,El Salvador,0,2,2,0.0,1.0,1784,1768
2022-02-01,Bahrain,DR Congo,1,0,1,1.0,0.0,1845,1742
2022-02-01,Kuwait,Libya,0,2,2,0.0,1.0,1735,1679
2022-02-01,Nepal,Mauritius,1,0,1,1.0,0.0,1455,1454
2022-02-01,Nicaragua,Belize,1,1,0,0.5,0.5,1548,1506
2022-02-01,Suriname,Guyana,2,1,1,1.0,0.0,1641,1572
2022-02-01,Lebanon,Iraq,1,1,0,0.5,0.5,1708,1868
2022-02-01,Iran,United Arab Emirates,1,0,1,1.0,0.0,2049,1850
2022-02-01,Syria,South Korea,0,2,2,0.0,1.0,1749,2016
2022-02-01,Vietnam,China PR,3,1,2,1.0,0.0,1742,1832
2022-02-01,Japan,Saudi Arabia,2,0,2,1.0,0.0,2025,1888
2022-02-01,Oman,Australia,2,2,0,0.5,0.5,1831,1966
2022-02-01,Bolivia,Chile,2,3,1,0.0,1.0,1787,1994
2022-02-01,Uruguay,Venezuela,4,1,3,1.0,0.0,2038,1878
2022-02-01,Argentina,Colombia,1,0,1,1.0,0.0,2182,2052
2022-02-01,Peru,Ecuador,1,1,0,0.5,0.5,1989,1974
2022-02-01,Brazil,Paraguay,4,0,4,1.0,0.0,2236,1893
2022-02-02,Burkina Faso,Senegal,1,3,2,0.0,1.0,1787,1943
2022-02-02,United States,Honduras,3,0,3,1.0,0.0,2042,1782
2022-02-02,Jamaica,Costa Rica,0,1,1,0.0,1.0,1790,1874
2022-02-02,El Salvador,Canada,0,2,2,0.0,1.0,1763,1907
2022-02-02,Mexico,Panama,1,0,1,1.0,0.0,2046,1848
2022-02-03,Cameroon,Egypt,0,0,0,0.5,0.5,1888,1921
2022-02-05,Cameroon,Burkina Faso,3,3,0,0.5,0.5,1886,1790
2022-02-06,Senegal,Egypt,0,0,0,0.5,0.5,1943,1922
2022-03-17,Cook Islands,Solomon Islands,0,2,2,0.0,1.0,1434,1632
2022-03-18,Papua New Guinea,New Zealand,0,1,1,0.0,1.0,1542,1763
2022-03-18,New Caledonia,Fiji,1,2,1,0.0,1.0,1659,1669
2022-03-18,Iraq,Zambia,3,1,2,1.0,0.0,1873,1726
2022-03-19,Mauritius,Seychelles,0,0,0,0.5,0.5,1453,1393
2022-03-21,Papua New Guinea,New Caledonia,1,0,1,1.0,0.0,1553,1649
2022-03-21,New Zealand,Fiji,4,0,4,1.0,0.0,1769,1664
2022-03-23,Bahrain,India,2,1,1,1.0,0.0,1849,1625
2022-03-23,Gibraltar,Grenada,0,0,0,0.5,0.5,1490,1525
2022-03-23,Guinea-Bissau,Equatorial Guinea,3,0,3,1.0,0.0,1607,1645
2022-03-23,Guadeloupe,Cape Verde,0,2,2,0.0,1.0,1621,1735
2022-03-23,Laos,Mongolia,1,0,1,1.0,0.0,1350,1394
2022-03-23,Malaysia,Philippines,2,0,2,1.0,0.0,1623,1593
2022-03-23,Mozambique,Niger,1,1,0,0.5,0.5,1649,1592
2022-03-23,Tanzania,Central African Republic,3,1,2,1.0,0.0,1639,1541
2022-03-23,Chad,Gambia,0,1,1,0.0,1.0,1516,1665
2022-03-23,Djibouti,South Sudan,2,4,2,0.0,1.0,1323,1471
2022-03-23,Seychelles,Lesotho,0,0,0,0.5,0.5,1397,1555
2022-03-23,Somalia,Eswatini,0,3,3,0.0,1.0,1322,1554
2022-03-24,Jamaica,El Salvador,1,1,0,0.5,0.5,1790,1764
2022-03-24,Mexico,United States,0,0,0,0.5,0.5,2046,2043
2022-03-24,Panama,Honduras,1,1,0,0.5,0.5,1847,1784
2022-03-24,Costa Rica,Canada,1,0,1,1.0,0.0,1883,1899
2022-03-24,Lebanon,Syria,0,3,3,0.0,1.0,1701,1757
2022-03-24,Iraq,United Arab Emirates,1,0,1,1.0,0.0,1881,1843
2022-03-24,South Korea,Iran,2,0,2,1.0,0.0,2025,2041
2022-03-24,China PR,Saudi Arabia,1,1,0,0.5,0.5,1834,1887
2022-03-24,Vietnam,Oman,0,1,1,0.0,1.0,1737,1837
2022-03-24,Australia,Japan,0,2,2,0.0,1.0,1960,2032
2022-03-24,Solomon Islands,Tahiti,3,1,2,1.0,0.0,1641,1640
2022-03-24,Fiji,Papua New Guinea,1,2,1,0.0,1.0,1654,1564
2022-03-24,New Zealand,New Caledonia,7,1,6,1.0,0.0,1775,1644
2022-03-24,Colombia,Bolivia,3,0,3,1.0,0.0,2055,1785
2022-03-24,Brazil,Chile,4,0,4,1.0,0.0,2240,1991
2022-03-24,Paraguay,Ecuador,3,1,2,1.0,0.0,1903,1965
2022-03-24,Uruguay,Peru,1,0,1,1.0,0.0,2045,1983
2022-03-24,Italy,North Macedonia,0,1,1,0.0,1.0,2110,1815
2022-03-24,Portugal,Turkey,3,1,2,1.0,0.0,2107,1939
2022-03-24,Sweden,Czech Republic,1,0,1,1.0,0.0,1999,1942
2022-03-24,Wales,Austria,2,1,1,1.0,0.0,1951,1915
2022-03-24,Armenia,Montenegro,1,0,1,1.0,0.0,1731,1740
2022-03-24,Guatemala,Cuba,1,0,1,1.0,0.0,1750,1591
2022-03-24,Hungary,Serbia,0,1,1,0.0,1.0,1873,1973
2022-03-24,Kosovo,Burkina Faso,5,0,5,1.0,0.0,1683,1780
2022-03-24,Liberia,Benin,0,4,4,0.0,1.0,1608,1712
2022-03-24,Maldives,Bangladesh,2,0,2,1.0,0.0,1447,1413
2022-03-24,Scotland,Poland,1,1,0,0.5,0.5,1907,1966
2022-03-24,Thailand,Nepal,2,0,2,1.0,0.0,1773,1453
2022-03-24,Togo,Sierra Leone,3,0,3,1.0,0.0,1661,1619
2022-03-24,Estonia,Cyprus,0,0,0,0.5,0.5,1701,1618
2022-03-24,Moldova,Kazakhstan,1,2,1,0.0,1.0,1532,1640
2022-03-24,Mauritius,São Tomé and Príncipe,3,0,3,1.0,0.0,1461,1440
2022-03-25,Cameroon,Algeria,0,1,1,0.0,1.0,1880,1942
2022-03-25,DR Congo,Morocco,1,1,0,0.5,0.5,1747,1930
2022-03-25,Egypt,Senegal,1,0,1,1.0,0.0,1931,1935
2022-03-25,Ghana,Nigeria,0,0,0,0.5,0.5,1841,1890
2022-03-25,Mali,Tunisia,0,1,1,0.0,1.0,1804,1881
2022-03-25,Argentina,Venezuela,3,0,3,1.0,0.0,2185,1876
2022-03-25,Andorra,Saint Kitts and Nevis,1,0,1,1.0,0.0,1412,1574
2022-03-25,Bosnia and Herzegovina,Georgia,0,1,1,0.0,1.0,1848,1772
2022-03-25,Cape Verde,Liechtenstein,6,0,6,1.0,0.0,1738,1432
2022-03-25,Comoros,Ethiopia,2,1,1,1.0,0.0,1564,1646
2022-03-25,Congo,Zambia,1,3,2,0.0,1.0,1645,1733
2022-03-25,France,Ivory Coast,2,1,1,1.0,0.0,2193,1907
2022-03-25,Latvia,Kuwait,1,1,0,0.5,0.5,1615,1733
2022-03-25,Luxembourg,Northern Ireland,1,3,2,0.0,1.0,1609,1822
2022-03-25,Malta,Azerbaijan,1,0,1,1.0,0.0,1529,1615
2022-03-25,Norway,Slovakia,2,0,2,1.0,0.0,1895,1876
2022-03-25,Romania,Greece,0,1,1,0.0,1.0,1888,1885
2022-03-25,San Marino,Lithuania,1,2,1,0.0,1.0,1286,1619
2022-03-25,South Africa,Guinea,0,0,0,0.5,0.5,1843,1721
2022-03-25,Tajikistan,Uganda,1,1,0,0.5,0.5,1616,1729
2022-03-25,Trinidad and Tobago,Barbados,9,0,9,1.0,0.0,1693,1513
2022-03-25,Uzbekistan,Kyrgyzstan,3,1,2,1.0,0.0,1835,1616
2022-03-25,Alderney,Jersey,1,6,5,0.0,1.0,1268,1747
2022-03-26,Angola,Guinea-Bissau,3,2,1,1.0,0.0,1689,1601
2022-03-26,Bahrain,Burundi,1,0,1,1.0,0.0,1853,1605
2022-03-26,Belarus,India,3,0,3,1.0,0.0,1727,1620
2022-03-26,Central African Republic,Sudan,0,0,0,0.5,0.5,1543,1599
2022-03-26,Croatia,Slovenia,1,1,0,0.5,0.5,2005,1809
2022-03-26,England,Switzerland,2,1,1,1.0,0.0,2153,2033
2022-03-26,Finland,Iceland,1,1,0,0.5,0.5,1858,1819
2022-03-26,Germany,Israel,2,0,2,1.0,0.0,2122,1797
2022-03-26,Gibraltar,Faroe Islands,0,0,0,0.5,0.5,1491,1522
2022-03-26,Libya,Niger,2,1,1,1.0,0.0,1686,1586
2022-03-26,Mauritania,Mozambique,2,1,1,1.0,0.0,1628,1641
2022-03-26,Netherlands,Denmark,4,2,2,1.0,0.0,2089,2028
2022-03-26,Qatar,Bulgaria,2,1,1,1.0,0.0,1904,1787
2022-03-26,Republic of Ireland,Belgium,2,2,0,0.5,0.5,1895,2139
2022-03-26,Singapore,Malaysia,2,1,1,1.0,0.0,1599,1615
2022-03-26,Spain,Albania,2,1,1,1.0,0.0,2167,1779
2022-03-27,El Salvador,Costa Rica,1,2,1,0.0,1.0,1759,1889
2022-03-27,Canada,Jamaica,4,0,4,1.0,0.0,1905,1785
2022-03-27,Honduras,Mexico,0,1,1,0.0,1.0,1782,2049
2022-03-27,United States,Panama,5,1,4,1.0,0.0,2047,1844
2022-03-27,New Zealand,Tahiti,1,0,1,1.0,0.0,1781,1635
2022-03-27,Solomon Islands,Papua New Guinea,3,2,1,1.0,0.0,1648,1558
2022-03-27,Barbados,Guyana,0,5,5,0.0,1.0,1507,1579
2022-03-27,Belize,Cuba,0,3,3,0.0,1.0,1500,1598
2022-03-27,Benin,Zambia,2,1,1,1.0,0.0,1721,1725
2022-03-27,Guatemala,Haiti,2,1,1,1.0,0.0,1759,1743
2022-03-27,Laos,Brunei,3,2,1,1.0,0.0,1357,1270
2022-03-27,Liberia,Sierra Leone,0,1,1,0.0,1.0,1601,1627
2022-03-27,Thailand,Suriname,1,0,1,1.0,0.0,1779,1636
2022-03-27,South Sudan,Djibouti,1,0,1,1.0,0.0,1476,1319
2022-03-27,Lesotho,Seychelles,3,1,2,1.0,0.0,1560,1393
2022-03-27,Eswatini,Somalia,2,1,1,1.0,0.0,1558,1319
2022-03-27,Mauritius,São Tomé and Príncipe,3,3,0,0.5,0.5,1461,1441
2022-03-28,Andorra,Grenada,1,0,1,1.0,0.0,1423,1515
2022-03-28,Cape Verde,San Marino,2,0,2,1.0,0.0,1740,1285
2022-03-28,Montenegro,Greece,1,0,1,1.0,0.0,1752,1874
2022-03-28,Vanuatu,Fiji,1,2,1,0.0,1.0,1616,1662
2022-03-29,Algeria,Cameroon,1,2,1,0.0,1.0,1933,1890
2022-03-29,Morocco,DR Congo,4,1,3,1.0,0.0,1935,1743
2022-03-29,Nigeria,Ghana,1,1,0,0.5,0.5,1889,1843
2022-03-29,Senegal,Egypt,1,0,1,1.0,0.0,1943,1924
2022-03-29,Tunisia,Mali,0,0,0,0.5,0.5,1880,1806
2022-03-29,Iran,Lebanon,2,0,2,1.0,0.0,2043,1700
2022-03-29,Syria,Iraq,1,1,0,0.5,0.5,1760,1879
2022-03-29,United Arab Emirates,South Korea,1,0,1,1.0,0.0,1855,2014
2022-03-29,Japan,Vietnam,1,1,0,0.5,0.5,2027,1743
2022-03-29,Oman,China PR,2,0,2,1.0,0.0,1845,1827
2022-03-29,Saudi Arabia,Australia,1,0,1,1.0,0.0,1897,1951
2022-03-29,Ecuador,Argentina,1,1,0,0.5,0.5,1970,2181
2022-03-29,Peru,Paraguay,2,0,2,1.0,0.0,1990,1897
2022-03-29,Bolivia,Brazil,0,4,4,0.0,1.0,1784,2242
2022-03-29,Venezuela,Colombia,0,1,1,0.0,1.0,1872,2060
2022-03-29,Chile,Uruguay,0,2,2,0.0,1.0,1985,2052
2022-03-29,Poland,Sweden,2,0,2,1.0,0.0,1975,1991
2022-03-29,Portugal,North Macedonia,2,0,2,1.0,0.0,2110,1813
2022-03-29,Albania,Georgia,0,0,0,0.5,0.5,1779,1773
2022-03-29,Angola,Equatorial Guinea,0,0,0,0.5,0.5,1688,1647
2022-03-29,Austria,Scotland,2,2,0,0.5,0.5,1915,1908
2022-03-29,Azerbaijan,Latvia,0,1,1,0.0,1.0,1607,1623
2022-03-29,Bahrain,Belarus,0,1,1,0.0,1.0,1843,1738
2022-03-29,Bangladesh,Mongolia,0,0,0,0.5,0.5,1413,1395
2022-03-29,Belgium,Burkina Faso,3,0,3,1.0,0.0,2141,1779
2022-03-29,Bosnia and Herzegovina,Luxembourg,1,0,1,1.0,0.0,1852,1606
2022-03-29,Congo,Sierra Leone,1,2,1,0.0,1.0,1637,1636
2022-03-29,Croatia,Bulgaria,2,1,1,1.0,0.0,2009,1784
2022-03-29,Denmark,Serbia,3,0,3,1.0,0.0,2035,1967
2022-03-29,England,Ivory Coast,3,0,3,1.0,0.0,2157,1904
2022-03-29,Faroe Islands,Liechtenstein,1,0,1,1.0,0.0,1528,1427
2022-03-29,Finland,Slovakia,0,2,2,0.0,1.0,1851,1884
2022-03-29,France,South Africa,5,0,5,1.0,0.0,2195,1842
2022-03-29,Israel,Romania,2,2,0,0.5,0.5,1800,1886
2022-03-29,Liberia,Burundi,1,2,1,0.0,1.0,1594,1613
2022-03-29,Malta,Kuwait,2,0,2,1.0,0.0,1542,1721
2022-03-29,Mauritania,Libya,2,0,2,1.0,0.0,1638,1677
2022-03-29,Netherlands,Germany,1,1,0,0.5,0.5,2090,2122
2022-03-29,Northern Ireland,Hungary,0,1,1,0.0,1.0,1816,1880
2022-03-29,Norway,Armenia,9,0,9,1.0,0.0,1900,1727
2022-03-29,Qatar,Slovenia,0,0,0,0.5,0.5,1902,1812
2022-03-29,Republic of Ireland,Lithuania,1,0,1,1.0,0.0,1898,1617
2022-03-29,Singapore,Philippines,2,0,2,1.0,0.0,1607,1586
2022-03-29,Spain,Iceland,5,0,5,1.0,0.0,2169,1818
2022-03-29,Switzerland,Kosovo,1,1,0,0.5,0.5,2027,1690
2022-03-29,Tanzania,Sudan,1,1,0,0.5,0.5,1639,1600
2022-03-29,Togo,Benin,1,1,0,0.5,0.5,1663,1720
2022-03-29,Trinidad and Tobago,Guyana,1,1,0,0.5,0.5,1691,1582
2022-03-29,Turkey,Italy,2,3,1,0.0,1.0,1935,2115
2022-03-29,Wales,Czech Republic,1,1,0,0.5,0.5,1951,1943
2022-03-29,Tajikistan,Kyrgyzstan,1,0,1,1.0,0.0,1624,1608
2022-03-29,Uzbekistan,Uganda,4,2,2,1.0,0.0,1841,1724
2022-03-29,Cyprus,Estonia,2,0,2,1.0,0.0,1628,1692
2022-03-29,Kazakhstan,Moldova,0,1,1,0.0,1.0,1630,1543
2022-03-29,Gambia,Chad,2,2,0,0.5,0.5,1662,1520
2022-03-30,Mexico,El Salvador,2,0,2,1.0,0.0,2052,1757
2022-03-30,Costa Rica,United States,2,0,2,1.0,0.0,1901,2036
2022-03-30,Panama,Canada,1,0,1,1.0,0.0,1854,1896
2022-03-30,Jamaica,Honduras,2,1,1,1.0,0.0,1793,1775
2022-03-30,Solomon Islands,New Zealand,0,5,5,0.0,1.0,1643,1787
2022-04-23,Alderney,Guernsey,0,2,2,0.0,1.0,1267,1737
2022-04-24,El Salvador,Guatemala,0,4,4,0.0,1.0,1750,1767
2022-04-27,Mexico,Guatemala,0,0,0,0.5,0.5,2047,1773
2022-05-12,Bahamas,Turks and Caicos Islands,4,2,2,1.0,0.0,1465,1413
2022-05-12,Dominica,Saint Vincent and the Grenadines,2,1,1,1.0,0.0,1457,1529
2022-05-13,Guernsey,Jersey,1,2,1,0.0,1.0,1730,1755
2022-05-14,Bahamas,Turks and Caicos Islands,1,2,1,0.0,1.0,1456,1423
2022-05-15,Dominica,Saint Vincent and the Grenadines,3,1,2,1.0,0.0,1467,1520
2022-05-21,Yoruba Nation,Matabeleland,1,1,0,0.5,0.5,1501,1504
2022-05-21,Jersey,Guernsey,1,0,1,1.0,0.0,1763,1723
2022-05-22,Biafra,Matabeleland,0,1,1,0.0,1.0,1493,1512
2022-05-23,Yoruba Nation,Biafra,0,1,1,0.0,1.0,1493,1502
2022-05-24,Mozambique,Eswatini,0,1,1,0.0,1.0,1632,1568
2022-05-24,Thailand,Bahrain,3,1,2,1.0,0.0,1789,1834
2022-05-25,Biafra,Matabeleland,1,0,1,1.0,0.0,1511,1504
2022-05-27,Bahrain,Myanmar,2,0,2,1.0,0.0,1837,1515
2022-05-27,Malaysia,Brunei,4,0,4,1.0,0.0,1617,1269
2022-05-27,Thailand,Turkmenistan,1,0,1,1.0,0.0,1794,1622
2022-05-28,Ethiopia,Lesotho,1,1,0,0.5,0.5,1645,1562
2022-05-28,India,Jordan,0,2,2,0.0,1.0,1617,1821
2022-05-28,Mexico,Nigeria,2,1,1,1.0,0.0,2052,1885
2022-05-29,United Arab Emirates,Gambia,1,1,0,0.5,0.5,1851,1667
2022-05-30,Ethiopia,Lesotho,1,1,0,0.5,0.5,1644,1564
2022-05-30,Trinidad and Tobago,Saint Lucia,1,0,1,1.0,0.0,1695,1481
2022-05-31,Thailand,Bahrain,1,2,1,0.0,1.0,1787,1845
2022-06-01,Italy,Argentina,0,3,3,0.0,1.0,2109,2188
2022-06-01,Scotland,Ukraine,1,3,2,0.0,1.0,1902,1990
2022-06-01,Angola,Central African Republic,2,1,1,1.0,0.0,1693,1539
2022-06-01,Ghana,Madagascar,3,0,3,1.0,0.0,1847,1610
2022-06-01,Libya,Botswana,1,0,1,1.0,0.0,1684,1622
2022-06-01,Poland,Wales,2,1,1,1.0,0.0,1983,1944
2022-06-01,Australia,Jordan,2,1,1,1.0,0.0,1957,1816
2022-06-01,Indonesia,Bangladesh,0,0,0,0.5,0.5,1638,1418
2022-06-01,Malta,Venezuela,0,1,1,0.0,1.0,1540,1875
2022-06-01,Kuwait,Singapore,2,0,2,1.0,0.0,1727,1602
2022-06-01,Malaysia,Hong Kong,2,0,2,1.0,0.0,1625,1594
2022-06-01,Syria,Tajikistan,1,0,1,1.0,0.0,1766,1619
2022-06-01,United States,Morocco,3,0,3,1.0,0.0,2042,1930
2022-06-01,Vietnam,Afghanistan,2,0,2,1.0,0.0,1747,1527
2022-06-02,Tunisia,Equatorial Guinea,4,0,4,1.0,0.0,1884,1644
2022-06-02,Mozambique,Rwanda,1,1,0,0.5,0.5,1633,1637
2022-06-02,Panama,Costa Rica,2,0,2,1.0,0.0,1864,1892
2022-06-02,Barbados,Antigua and Barbuda,0,1,1,0.0,1.0,1501,1586
2022-06-02,Guadeloupe,Cuba,2,1,1,1.0,0.0,1629,1591
2022-06-02,Belize,Dominican Republic,0,2,2,0.0,1.0,1494,1573
2022-06-02,French Guiana,Guatemala,2,0,2,1.0,0.0,1621,1762
2022-06-02,Anguilla,Dominica,0,0,0,0.5,0.5,1285,1464
2022-06-02,Czech Republic,Switzerland,2,1,1,1.0,0.0,1953,2018
2022-06-02,Spain,Portugal,1,1,0,0.5,0.5,2168,2112
2022-06-02,Israel,Iceland,2,2,0,0.5,0.5,1801,1818
2022-06-02,Serbia,Norway,0,1,1,0.0,1.0,1958,1910
2022-06-02,Slovenia,Sweden,0,2,2,0.0,1.0,1808,1996
2022-06-02,Northern Ireland,Greece,0,1,1,0.0,1.0,1810,1881
2022-06-02,Cyprus,Kosovo,0,2,2,0.0,1.0,1622,1697
2022-06-02,Georgia,Gibraltar,4,0,4,1.0,0.0,1776,1489
2022-06-02,Bulgaria,North Macedonia,1,1,0,0.5,0.5,1785,1813
2022-06-02,Estonia,San Marino,2,0,2,1.0,0.0,1694,1284
2022-06-02,Cambodia,Timor-Leste,2,1,1,1.0,0.0,1396,1271
2022-06-02,Ecuador,Nigeria,1,0,1,1.0,0.0,1977,1879
2022-06-02,Japan,Paraguay,4,1,3,1.0,0.0,2033,1892
2022-06-02,South Korea,Brazil,1,5,4,0.0,1.0,2011,2246
2022-06-02,Mexico,Uruguay,0,3,3,0.0,1.0,2044,2060
2022-06-03,Togo,Eswatini,2,2,0,0.5,0.5,1661,1571
2022-06-03,Burkina Faso,Cape Verde,2,0,2,1.0,0.0,1787,1733
2022-06-03,Comoros,Lesotho,2,0,2,1.0,0.0,1572,1556
2022-06-03,Ivory Coast,Zambia,3,1,2,1.0,0.0,1909,1721
2022-06-03,Curaçao,Honduras,0,1,1,0.0,1.0,1639,1781
2022-06-03,Bahamas,Saint Vincent and the Grenadines,1,0,1,1.0,0.0,1466,1511
2022-06-03,Nicaragua,Trinidad and Tobago,2,1,1,1.0,0.0,1560,1684
2022-06-03,Sint Maarten,United States Virgin Islands,1,1,0,0.5,0.5,1440,1349
2022-06-03,Turks and Caicos Islands,Bonaire,1,4,3,0.0,1.0,1417,1486
2022-06-03,Saint Martin,Aruba,0,0,0,0.5,0.5,1424,1407
2022-06-03,British Virgin Islands,Cayman Islands,1,1,0,0.5,0.5,1319,1416
2022-06-03,Croatia,Austria,0,3,3,0.0,1.0,1999,1926
2022-06-03,France,Denmark,1,2,1,0.0,1.0,2184,2047
2022-06-03,Belgium,Netherlands,1,4,3,0.0,1.0,2132,2100
2022-06-03,Kazakhstan,Azerbaijan,2,0,2,1.0,0.0,1638,1600
2022-06-03,Belarus,Slovakia,0,1,1,0.0,1.0,1734,1889
2022-06-03,Liechtenstein,Moldova,0,2,2,0.0,1.0,1422,1549
2022-06-03,Latvia,Andorra,3,0,3,1.0,0.0,1627,1420
2022-06-03,Nepal,Oman,0,2,2,0.0,1.0,1452,1847
2022-06-04,Namibia,Burundi,1,1,0,0.5,0.5,1664,1615
2022-06-04,Niger,Tanzania,1,1,0,0.5,0.5,1588,1638
2022-06-04,Algeria,Uganda,2,0,2,1.0,0.0,1937,1721
2022-06-04,Gambia,South Sudan,1,0,1,1.0,0.0,1671,1473
2022-06-04,Mali,Congo,4,0,4,1.0,0.0,1811,1633
2022-06-04,Mauritania,Sudan,3,0,3,1.0,0.0,1646,1593
2022-06-04,DR Congo,Gabon,0,1,1,0.0,1.0,1735,1730
2022-06-04,Senegal,Benin,3,1,2,1.0,0.0,1947,1717
2022-06-04,Suriname,Jamaica,1,1,0,0.5,0.5,1640,1790
2022-06-04,El Salvador,Grenada,3,1,2,1.0,0.0,1754,1512
2022-06-04,Bermuda,Haiti,0,0,0,0.5,0.5,1593,1740
2022-06-04,Montserrat,Guyana,1,2,1,0.0,1.0,1459,1588
2022-06-04,Hungary,England,1,0,1,1.0,0.0,1894,2144
2022-06-04,Italy,Germany,1,1,0,0.5,0.5,2110,2122
2022-06-04,Armenia,Republic of Ireland,1,0,1,1.0,0.0,1739,1887
2022-06-04,Finland,Bosnia and Herzegovina,1,1,0,0.5,0.5,1852,1852
2022-06-04,Montenegro,Romania,2,0,2,1.0,0.0,1763,1876
2022-06-04,Lithuania,Luxembourg,0,2,2,0.0,1.0,1609,1615
2022-06-04,Turkey,Faroe Islands,4,0,4,1.0,0.0,1937,1527
2022-06-05,Wales,Ukraine,1,0,1,1.0,0.0,1954,1981
2022-06-05,Malawi,Ethiopia,2,1,1,1.0,0.0,1653,1637
2022-06-05,Egypt,Guinea,1,0,1,1.0,0.0,1928,1718
2022-06-05,Central African Republic,Ghana,1,1,0,0.5,0.5,1545,1842
2022-06-05,Madagascar,Angola,1,1,0,0.5,0.5,1612,1692
2022-06-05,Botswana,Tunisia,0,0,0,0.5,0.5,1628,1879
2022-06-05,Costa Rica,Martinique,2,0,2,1.0,0.0,1896,1686
2022-06-05,Cuba,Barbados,3,0,3,1.0,0.0,1597,1496
2022-06-05,Antigua and Barbuda,Guadeloupe,1,0,1,1.0,0.0,1595,1621
2022-06-05,Guatemala,Belize,2,0,2,1.0,0.0,1765,1492
2022-06-05,Dominican Republic,French Guiana,2,3,1,0.0,1.0,1567,1628
2022-06-05,Dominica,Anguilla,1,1,0,0.5,0.5,1461,1289
2022-06-05,Portugal,Switzerland,4,0,4,1.0,0.0,2118,2013
2022-06-05,Czech Republic,Spain,2,2,0,0.5,0.5,1958,2164
2022-06-05,Serbia,Slovenia,4,1,3,1.0,0.0,1963,1804
2022-06-05,Sweden,Norway,1,2,1,0.0,1.0,1987,1920
2022-06-05,Cyprus,Northern Ireland,0,0,0,0.5,0.5,1626,1807
2022-06-05,Kosovo,Greece,0,1,1,0.0,1.0,1693,1886
2022-06-05,Gibraltar,North Macedonia,0,2,2,0.0,1.0,1487,1816
2022-06-05,Bulgaria,Georgia,2,5,3,0.0,1.0,1777,1785
2022-06-05,San Marino,Malta,0,2,2,0.0,1.0,1282,1543
2022-06-05,Argentina,Estonia,5,0,5,1.0,0.0,2189,1694
2022-06-05,Mexico,Ecuador,0,0,0,0.5,0.5,2043,1979
2022-06-05,Peru,New Zealand,1,0,1,1.0,0.0,1994,1784
2022-06-05,Saudi Arabia,Colombia,0,1,1,0.0,1.0,1893,2065
2022-06-05,United States,Uruguay,0,0,0,0.5,0.5,2043,2060
2022-06-06,Equatorial Guinea,Libya,2,0,2,1.0,0.0,1653,1676
2022-06-06,Honduras,Curaçao,1,2,1,0.0,1.0,1770,1651
2022-06-06,Saint Vincent and the Grenadines,Nicaragua,2,2,0,0.5,0.5,1513,1559
2022-06-06,Trinidad and Tobago,Bahamas,1,0,1,1.0,0.0,1688,1463
2022-06-06,Bonaire,Sint Maarten,2,2,0,0.5,0.5,1485,1442
2022-06-06,United States Virgin Islands,Turks and Caicos Islands,3,2,1,1.0,0.0,1359,1408
2022-06-06,Aruba,Saint Martin,3,0,3,1.0,0.0,1416,1416
2022-06-06,Cayman Islands,British Virgin Islands,1,1,0,0.5,0.5,1414,1322
2022-06-06,Austria,Denmark,1,2,1,0.0,1.0,1921,2053
2022-06-06,Croatia,France,1,1,0,0.5,0.5,2003,2181
2022-06-06,Iceland,Albania,1,1,0,0.5,0.5,1818,1780
2022-06-06,Belarus,Azerbaijan,0,0,0,0.5,0.5,1732,1603
2022-06-06,Slovakia,Kazakhstan,0,1,1,0.0,1.0,1877,1651
2022-06-06,Latvia,Liechtenstein,1,0,1,1.0,0.0,1631,1419
2022-06-06,Andorra,Moldova,0,0,0,0.5,0.5,1423,1547
2022-06-06,South Korea,Chile,2,0,2,1.0,0.0,2019,1978
2022-06-06,Japan,Brazil,0,1,1,0.0,1.0,2030,2250
2022-06-07,Eswatini,Burkina Faso,1,3,2,0.0,1.0,1568,1791
2022-06-07,Cape Verde,Togo,2,0,2,1.0,0.0,1740,1655
2022-06-07,Zambia,Comoros,2,1,1,1.0,0.0,1726,1568
2022-06-07,Senegal,Rwanda,1,0,1,1.0,0.0,1950,1635
2022-06-07,Jamaica,Suriname,3,1,2,1.0,0.0,1795,1636
2022-06-07,Grenada,El Salvador,2,2,0,0.5,0.5,1517,1750
2022-06-07,Guyana,Bermuda,2,1,1,1.0,0.0,1597,1585
2022-06-07,Haiti,Montserrat,3,2,1,1.0,0.0,1743,1457
2022-06-07,Germany,England,1,1,0,0.5,0.5,2123,2144
2022-06-07,Italy,Hungary,2,1,1,1.0,0.0,2114,1891
2022-06-07,Finland,Montenegro,2,0,2,1.0,0.0,1858,1758
2022-06-07,Bosnia and Herzegovina,Romania,1,0,1,1.0,0.0,1861,1868
2022-06-07,Faroe Islands,Luxembourg,0,1,1,0.0,1.0,1521,1622
2022-06-07,Lithuania,Turkey,0,6,6,0.0,1.0,1607,1940
2022-06-07,United Arab Emirates,Australia,1,2,1,0.0,1.0,1846,1963
2022-06-08,Kuwait,Indonesia,1,2,1,0.0,1.0,1717,1649
2022-06-08,Jordan,Nepal,2,0,2,1.0,0.0,1818,1451
2022-06-08,Philippines,Yemen,0,0,0,0.5,0.5,1586,1554
2022-06-08,Mongolia,Palestine,0,1,1,0.0,1.0,1393,1696
2022-06-08,Thailand,Maldives,3,0,3,1.0,0.0,1789,1446
2022-06-08,Uzbekistan,Sri Lanka,3,0,3,1.0,0.0,1842,1319
2022-06-08,Hong Kong,Afghanistan,2,1,1,1.0,0.0,1601,1521
2022-06-08,India,Cambodia,2,0,2,1.0,0.0,1621,1393
2022-06-08,Bahrain,Bangladesh,2,0,2,1.0,0.0,1847,1417
2022-06-08,Malaysia,Turkmenistan,3,1,2,1.0,0.0,1633,1615
2022-06-08,Tajikistan,Myanmar,4,0,4,1.0,0.0,1625,1510
2022-06-08,Kyrgyzstan,Singapore,2,1,1,1.0,0.0,1616,1595
2022-06-08,Uganda,Niger,1,1,0,0.5,0.5,1719,1591
2022-06-08,Tanzania,Algeria,0,2,2,0.0,1.0,1636,1940
2022-06-08,Congo,Gambia,1,0,1,1.0,0.0,1642,1663
2022-06-08,Gabon,Mauritania,0,0,0,0.5,0.5,1729,1648
2022-06-08,Sudan,DR Congo,2,1,1,1.0,0.0,1605,1724
2022-06-08,Benin,Mozambique,0,1,1,0.0,1.0,1708,1643
2022-06-08,Wales,Netherlands,1,2,1,0.0,1.0,1950,2105
2022-06-08,Belgium,Poland,6,1,5,1.0,0.0,2137,1979
2022-06-08,Republic of Ireland,Ukraine,0,1,1,0.0,1.0,1882,1987
2022-06-08,Scotland,Armenia,2,0,2,1.0,0.0,1907,1735
2022-06-09,Guinea-Bissau,São Tomé and Príncipe,5,1,4,1.0,0.0,1606,1437
2022-06-09,Nigeria,Sierra Leone,2,1,1,1.0,0.0,1883,1633
2022-06-09,Burundi,Cameroon,0,1,1,0.0,1.0,1613,1893
2022-06-09,Ethiopia,Egypt,2,0,2,1.0,0.0,1651,1915
2022-06-09,Guinea,Malawi,1,0,1,1.0,0.0,1725,1647
2022-06-09,South Sudan,Mali,1,3,2,0.0,1.0,1471,1814
2022-06-09,Lesotho,Ivory Coast,0,0,0,0.5,0.5,1563,1903
2022-06-09,Morocco,South Africa,2,1,1,1.0,0.0,1937,1836
2022-06-09,Panama,Martinique,5,0,5,1.0,0.0,1869,1682
2022-06-09,Canada,Curaçao,4,0,4,1.0,0.0,1900,1648
2022-06-09,Barbados,Guadeloupe,0,1,1,0.0,1.0,1491,1627
2022-06-09,Antigua and Barbuda,Cuba,0,2,2,0.0,1.0,1588,1605
2022-06-09,Belize,French Guiana,1,1,0,0.5,0.5,1495,1626
2022-06-09,Aruba,Saint Kitts and Nevis,2,3,1,0.0,1.0,1412,1579
2022-06-09,Dominica,Saint Lucia,0,1,1,0.0,1.0,1454,1489
2022-06-09,Cayman Islands,Puerto Rico,0,3,3,0.0,1.0,1408,1466
2022-06-09,Portugal,Czech Republic,2,0,2,1.0,0.0,2123,1954
2022-06-09,Switzerland,Spain,0,1,1,0.0,1.0,2009,2169
2022-06-09,Norway,Slovenia,0,0,0,0.5,0.5,1918,1807
2022-06-09,Sweden,Serbia,0,1,1,0.0,1.0,1979,1972
2022-06-09,Kosovo,Northern Ireland,3,2,1,1.0,0.0,1704,1797
2022-06-09,Greece,Cyprus,3,0,3,1.0,0.0,1889,1624
2022-06-09,Gibraltar,Bulgaria,1,1,0,0.5,0.5,1493,1772
2022-06-09,North Macedonia,Georgia,0,3,3,0.0,1.0,1808,1794
2022-06-09,Malta,Estonia,1,2,1,0.0,1.0,1539,1699
2022-06-09,New Zealand,Oman,0,0,0,0.5,0.5,1786,1846
2022-06-09,San Marino,Iceland,0,1,1,0.0,1.0,1282,1819
2022-06-09,Saudi Arabia,Venezuela,0,1,1,0.0,1.0,1885,1884
2022-06-10,United States,Grenada,5,0,5,1.0,0.0,2044,1517
2022-06-10,Saint Vincent and the Grenadines,Trinidad and Tobago,0,2,2,0.0,1.0,1509,1693
2022-06-10,Bahamas,Nicaragua,0,2,2,0.0,1.0,1458,1565
2022-06-10,Dominican Republic,Guatemala,1,1,0,0.5,0.5,1572,1761
2022-06-10,Austria,France,1,1,0,0.5,0.5,1927,2176
2022-06-10,Denmark,Croatia,0,1,1,0.0,1.0,2044,2013
2022-06-10,Albania,Israel,1,2,1,0.0,1.0,1773,1809
2022-06-10,Azerbaijan,Slovakia,0,1,1,0.0,1.0,1601,1880
2022-06-10,Belarus,Kazakhstan,1,1,0,0.5,0.5,1731,1653
2022-06-10,Moldova,Latvia,2,4,2,0.0,1.0,1541,1638
2022-06-10,Andorra,Liechtenstein,2,1,1,1.0,0.0,1431,1412
2022-06-10,South Korea,Paraguay,2,2,0,0.5,0.5,2017,1895
2022-06-10,Chile,Tunisia,0,2,2,0.0,1.0,1968,1890
2022-06-10,Japan,Ghana,4,1,3,1.0,0.0,2035,1838
2022-06-11,Kuwait,Nepal,4,1,3,1.0,0.0,1720,1449
2022-06-11,Indonesia,Jordan,0,1,1,0.0,1.0,1645,1823
2022-06-11,Mongolia,Philippines,0,1,1,0.0,1.0,1390,1590
2022-06-11,Yemen,Palestine,0,5,5,0.0,1.0,1550,1701
2022-06-11,Sri Lanka,Thailand,0,2,2,0.0,1.0,1318,1791
2022-06-11,Uzbekistan,Maldives,4,0,4,1.0,0.0,1844,1445
2022-06-11,Cambodia,Hong Kong,0,3,3,0.0,1.0,1390,1605
2022-06-11,India,Afghanistan,2,1,1,1.0,0.0,1627,1516
2022-06-11,Bangladesh,Turkmenistan,1,2,1,0.0,1.0,1414,1619
2022-06-11,Malaysia,Bahrain,1,2,1,0.0,1.0,1630,1851
2022-06-11,Singapore,Tajikistan,0,1,1,0.0,1.0,1588,1633
2022-06-11,Kyrgyzstan,Myanmar,2,0,2,1.0,0.0,1622,1505
2022-06-11,Mexico,Suriname,3,0,3,1.0,0.0,2045,1635
2022-06-11,Guyana,Haiti,2,6,4,0.0,1.0,1593,1748
2022-06-11,Montserrat,Bermuda,3,2,1,1.0,0.0,1468,1575
2022-06-11,United States Virgin Islands,Bonaire,0,2,2,0.0,1.0,1354,1491
2022-06-11,Sint Maarten,Turks and Caicos Islands,8,2,6,1.0,0.0,1450,1401
2022-06-11,England,Italy,0,0,0,0.5,0.5,2144,2115
2022-06-11,Hungary,Germany,1,1,0,0.5,0.5,1896,2119
2022-06-11,Wales,Belgium,1,1,0,0.5,0.5,1954,2134
2022-06-11,Netherlands,Poland,2,2,0,0.5,0.5,2103,1982
2022-06-11,Ukraine,Armenia,3,0,3,1.0,0.0,1991,1732
2022-06-11,Republic of Ireland,Scotland,3,0,3,1.0,0.0,1891,1899
2022-06-11,Montenegro,Bosnia and Herzegovina,1,1,0,0.5,0.5,1761,1859
2022-06-11,Romania,Finland,1,0,1,1.0,0.0,1876,1851
2022-06-11,Faroe Islands,Lithuania,2,1,1,1.0,0.0,1531,1598
2022-06-11,Luxembourg,Turkey,0,2,2,0.0,1.0,1620,1943
2022-06-11,Ecuador,Cape Verde,1,0,1,1.0,0.0,1983,1737
2022-06-11,Uruguay,Panama,5,0,5,1.0,0.0,2064,1866
2022-06-12,Martinique,Panama,0,0,0,0.5,0.5,1686,1863
2022-06-12,Cuba,Antigua and Barbuda,3,1,2,1.0,0.0,1613,1581
2022-06-12,Guadeloupe,Barbados,2,1,1,1.0,0.0,1633,1486
2022-06-12,Saint Kitts and Nevis,Saint Martin,1,1,0,0.5,0.5,1576,1420
2022-06-12,Saint Lucia,Anguilla,2,0,2,1.0,0.0,1493,1286
2022-06-12,Puerto Rico,British Virgin Islands,6,0,6,1.0,0.0,1471,1318
2022-06-12,Spain,Czech Republic,2,0,2,1.0,0.0,2173,1951
2022-06-12,Switzerland,Portugal,1,0,1,1.0,0.0,2020,2113
2022-06-12,Norway,Sweden,3,2,1,1.0,0.0,1928,1970
2022-06-12,Slovenia,Serbia,2,2,0,0.5,0.5,1811,1969
2022-06-12,Northern Ireland,Cyprus,2,2,0,0.5,0.5,1794,1628
2022-06-12,Greece,Kosovo,2,0,2,1.0,0.0,1894,1700
2022-06-12,North Macedonia,Gibraltar,4,0,4,1.0,0.0,1811,1491
2022-06-12,Georgia,Bulgaria,0,0,0,0.5,0.5,1794,1773
2022-06-12,Malta,San Marino,1,0,1,1.0,0.0,1542,1280
2022-06-12,Iran,Algeria,1,2,1,0.0,1.0,2033,1951
2022-06-13,Australia,Peru,0,0,0,0.5,0.5,1964,1994
2022-06-13,São Tomé and Príncipe,Nigeria,0,10,10,0.0,1.0,1436,1885
2022-06-13,Sierra Leone,Guinea-Bissau,2,2,0,0.5,0.5,1633,1607
2022-06-13,Morocco,Liberia,2,0,2,1.0,0.0,1939,1593
2022-06-13,Honduras,Canada,2,1,1,1.0,0.0,1781,1890
2022-06-13,Nicaragua,Bahamas,4,0,4,1.0,0.0,1571,1453
2022-06-13,Trinidad and Tobago,Saint Vincent and the Grenadines,4,1,3,1.0,0.0,1698,1505
2022-06-13,Guatemala,Dominican Republic,2,0,2,1.0,0.0,1766,1568
2022-06-13,Denmark,Austria,2,0,2,1.0,0.0,2050,1922
2022-06-13,France,Croatia,0,1,1,0.0,1.0,2165,2025
2022-06-13,Iceland,Israel,2,2,0,0.5,0.5,1819,1810
2022-06-13,Azerbaijan,Belarus,2,0,2,1.0,0.0,1612,1721
2022-06-13,Kazakhstan,Slovakia,2,1,1,1.0,0.0,1666,1868
2022-06-13,Albania,Estonia,0,0,0,0.5,0.5,1772,1701
2022-06-14,Costa Rica,New Zealand,1,0,1,1.0,0.0,1902,1781
2022-06-14,Kuwait,Jordan,0,3,3,0.0,1.0,1715,1829
2022-06-14,Indonesia,Nepal,7,0,7,1.0,0.0,1649,1446
2022-06-14,Palestine,Philippines,4,0,4,1.0,0.0,1707,1585
2022-06-14,Mongolia,Yemen,2,0,2,1.0,0.0,1402,1539
2022-06-14,Maldives,Sri Lanka,1,0,1,1.0,0.0,1451,1313
2022-06-14,Uzbekistan,Thailand,2,0,2,1.0,0.0,1851,1785
2022-06-14,Afghanistan,Cambodia,2,2,0,0.5,0.5,1514,1393
2022-06-14,India,Hong Kong,4,0,4,1.0,0.0,1635,1598
2022-06-14,Bahrain,Turkmenistan,1,0,1,1.0,0.0,1855,1616
2022-06-14,Malaysia,Bangladesh,4,1,3,1.0,0.0,1634,1411
2022-06-14,Myanmar,Singapore,2,6,4,0.0,1.0,1499,1595
2022-06-14,Kyrgyzstan,Tajikistan,0,0,0,0.5,0.5,1623,1633
2022-06-14,Jamaica,Mexico,1,1,0,0.5,0.5,1800,2041
2022-06-14,El Salvador,United States,1,1,0,0.5,0.5,1756,2039
2022-06-14,Haiti,Guyana,6,0,6,1.0,0.0,1753,1589
2022-06-14,French Guiana,Belize,1,0,1,1.0,0.0,1632,1490
2022-06-14,Bonaire,United States Virgin Islands,2,0,2,1.0,0.0,1496,1350
2022-06-14,Turks and Caicos Islands,Sint Maarten,2,0,2,1.0,0.0,1411,1441
2022-06-14,England,Hungary,0,4,4,0.0,1.0,2132,1909
2022-06-14,Germany,Italy,5,2,3,1.0,0.0,2127,2108
2022-06-14,Netherlands,Wales,3,2,1,1.0,0.0,2108,1950
2022-06-14,Poland,Belgium,0,1,1,0.0,1.0,1978,2139
2022-06-14,Armenia,Scotland,1,4,3,0.0,1.0,1728,1904
2022-06-14,Ukraine,Republic of Ireland,1,1,0,0.5,0.5,1989,1894
2022-06-14,Bosnia and Herzegovina,Finland,3,2,1,1.0,0.0,1867,1844
2022-06-14,Romania,Montenegro,0,3,3,0.0,1.0,1866,1772
2022-06-14,Luxembourg,Faroe Islands,2,2,0,0.5,0.5,1618,1534
2022-06-14,Turkey,Lithuania,2,0,2,1.0,0.0,1945,1597
2022-06-14,Moldova,Andorra,2,1,1,1.0,0.0,1547,1426
2022-06-14,Liechtenstein,Latvia,0,2,2,0.0,1.0,1409,1642
2022-06-14,Chile,Ghana,0,0,0,0.5,0.5,1966,1841
2022-06-14,Japan,Tunisia,0,3,3,0.0,1.0,2024,1902
2022-06-14,South Korea,Egypt,4,1,3,1.0,0.0,2023,1910
2022-06-17,Mapuche,Maule Sur,0,1,1,0.0,1.0,1492,1508
2022-06-18,Mapuche,Aymara,3,1,2,1.0,0.0,1501,1492
2022-06-19,Aymara,Maule Sur,0,1,1,0.0,1.0,1485,1516
2022-07-05,Seychelles,Botswana,0,1,1,0.0,1.0,1390,1632
2022-07-05,Angola,Comoros,3,1,2,1.0,0.0,1698,1563
2022-07-06,Mauritius,Eswatini,0,3,3,0.0,1.0,1456,1574
2022-07-06,Lesotho,Malawi,2,1,1,1.0,0.0,1573,1638
2022-07-07,Comoros,Botswana,0,1,1,0.0,1.0,1557,1639
2022-07-07,Angola,Seychelles,3,0,3,1.0,0.0,1701,1388
2022-07-08,Malawi,Eswatini,1,1,0,0.5,0.5,1637,1576
2022-07-08,Lesotho,Mauritius,2,1,1,1.0,0.0,1579,1451
2022-07-10,Seychelles,Comoros,1,2,1,0.0,1.0,1384,1562
2022-07-10,Botswana,Angola,1,0,1,1.0,0.0,1649,1692
2022-07-10,Mauritius,Malawi,0,2,2,0.0,1.0,1447,1642
2022-07-10,Eswatini,Lesotho,2,0,2,1.0,0.0,1585,1571
2022-07-12,Madagascar,Namibia,0,2,2,0.0,1.0,1606,1671
2022-07-12,Zambia,Botswana,1,1,0,0.5,0.5,1725,1651
2022-07-13,South Africa,Mozambique,0,0,0,0.5,0.5,1832,1648
2022-07-13,Senegal,Eswatini,1,1,0,0.5,0.5,1944,1592
2022-07-15,South Africa,Madagascar,2,1,1,1.0,0.0,1836,1603
2022-07-15,Botswana,Eswatini,2,0,2,1.0,0.0,1658,1586
2022-07-15,Namibia,Mozambique,1,0,1,1.0,0.0,1679,1641
2022-07-15,Zambia,Senegal,4,3,1,1.0,0.0,1738,1932
2022-07-16,Elba Island,Raetia,5,0,5,1.0,0.0,1507,1435
2022-07-17,South Africa,Botswana,2,1,1,1.0,0.0,1841,1654
2022-07-17,Mozambique,Senegal,1,1,0,0.5,0.5,1647,1927
2022-07-17,Namibia,Zambia,0,1,1,0.0,1.0,1673,1745
2022-07-19,Japan,Hong Kong,6,0,6,1.0,0.0,2026,1597
2022-07-20,China PR,South Korea,0,3,3,0.0,1.0,1824,2027
2022-07-24,South Korea,Hong Kong,3,0,3,1.0,0.0,2029,1596
2022-07-24,Japan,China PR,0,0,0,0.5,0.5,2022,1829
2022-07-27,China PR,Hong Kong,1,0,1,1.0,0.0,1833,1593
2022-07-27,Japan,South Korea,3,0,3,1.0,0.0,2031,2021
2022-08-07,Raetia,Tibet,3,3,0,0.5,0.5,1435,1425
2022-08-31,Mexico,Paraguay,0,1,1,0.0,1.0,2030,1907
2022-09-17,Fiji,New Caledonia,1,0,1,1.0,0.0,1670,1637
2022-09-21,Solomon Islands,New Caledonia,1,0,1,1.0,0.0,1651,1630
2022-09-21,Brunei,Maldives,0,3,3,0.0,1.0,1265,1456
2022-09-21,Hong Kong,Myanmar,2,0,2,1.0,0.0,1599,1494
2022-09-21,Libya,Uganda,0,0,0,0.5,0.5,1677,1719
2022-09-21,San Marino,Seychelles,0,0,0,0.5,0.5,1283,1382
2022-09-21,Vietnam,Singapore,4,0,4,1.0,0.0,1752,1591
2022-09-21,Scotland,Ukraine,3,0,3,1.0,0.0,1914,1980
2022-09-22,Australia,New Zealand,1,0,1,1.0,0.0,1969,1777
2022-09-22,Cambodia,Bangladesh,0,1,1,0.0,1.0,1386,1419
2022-09-22,Comoros,Tunisia,0,1,1,0.0,1.0,1561,1904
2022-09-22,Iceland,Venezuela,1,0,1,1.0,0.0,1829,1875
2022-09-22,Suriname,Nicaragua,2,1,1,1.0,0.0,1642,1565
2022-09-22,Thailand,Malaysia,1,1,0,0.5,0.5,1782,1638
2022-09-22,Trinidad and Tobago,Tajikistan,1,2,1,0.0,1.0,1689,1643
2022-09-22,Croatia,Denmark,2,1,1,1.0,0.0,2034,2042
2022-09-22,France,Austria,2,0,2,1.0,0.0,2169,1919
2022-09-22,Belgium,Wales,2,1,1,1.0,0.0,2144,1946
2022-09-22,Poland,Netherlands,0,2,2,0.0,1.0,1973,2114
2022-09-22,Lithuania,Faroe Islands,1,1,0,0.5,0.5,1596,1536
2022-09-22,Turkey,Luxembourg,3,3,0,0.5,0.5,1940,1624
2022-09-22,Kazakhstan,Belarus,2,1,1,1.0,0.0,1676,1712
2022-09-22,Slovakia,Azerbaijan,1,2,1,0.0,1.0,1855,1626
2022-09-22,Latvia,Moldova,1,2,1,0.0,1.0,1632,1558
2022-09-22,Liechtenstein,Andorra,0,2,2,0.0,1.0,1402,1434
2022-09-23,Japan,United States,2,0,2,1.0,0.0,2040,2031
2022-09-23,Algeria,Guinea,1,0,1,1.0,0.0,1955,1722
2022-09-23,Argentina,Honduras,3,0,3,1.0,0.0,2191,1780
2022-09-23,Bahrain,Cape Verde,1,2,1,0.0,1.0,1845,1748
2022-09-23,Brazil,Ghana,3,0,3,1.0,0.0,2252,1840
2022-09-23,Cameroon,Uzbekistan,0,2,2,0.0,1.0,1885,1860
2022-09-23,Canada,Qatar,2,0,2,1.0,0.0,1899,1894
2022-09-23,DR Congo,Burkina Faso,0,1,1,0.0,1.0,1718,1798
2022-09-23,Egypt,Niger,3,0,3,1.0,0.0,1913,1589
2022-09-23,Iran,Uruguay,1,0,1,1.0,0.0,2042,2056
2022-09-23,Iraq,Oman,1,1,0,0.5,0.5,1879,1847
2022-09-23,Jordan,Syria,2,0,2,1.0,0.0,1836,1760
2022-09-23,South Korea,Costa Rica,2,2,0,0.5,0.5,2019,1905
2022-09-23,Mali,Zambia,1,0,1,1.0,0.0,1821,1739
2022-09-23,Morocco,Chile,2,0,2,1.0,0.0,1948,1958
2022-09-23,Paraguay,United Arab Emirates,1,0,1,1.0,0.0,1914,1840
2022-09-23,Rwanda,Equatorial Guinea,0,0,0,0.5,0.5,1636,1653
2022-09-23,Saudi Arabia,Ecuador,0,0,0,0.5,0.5,1888,1981
2022-09-23,Germany,Hungary,0,1,1,0.0,1.0,2115,1922
2022-09-23,Italy,England,1,0,1,1.0,0.0,2117,2124
2022-09-23,Bosnia and Herzegovina,Montenegro,1,0,1,1.0,0.0,1873,1767
2022-09-23,Finland,Romania,1,1,0,0.5,0.5,1845,1866
2022-09-23,Georgia,North Macedonia,2,0,2,1.0,0.0,1803,1803
2022-09-23,Bulgaria,Gibraltar,5,1,4,1.0,0.0,1776,1489
2022-09-23,Estonia,Malta,2,1,1,1.0,0.0,1706,1538
2022-09-24,Bolivia,Senegal,0,2,2,0.0,1.0,1780,1932
2022-09-24,Colombia,Guatemala,4,1,3,1.0,0.0,2068,1764
2022-09-24,Fiji,Solomon Islands,2,2,0,0.5,0.5,1670,1652
2022-09-24,Grenada,Saint Vincent and the Grenadines,1,3,2,0.0,1.0,1509,1514
2022-09-24,Hong Kong,Myanmar,0,0,0,0.5,0.5,1597,1497
2022-09-24,India,Singapore,1,1,0,0.5,0.5,1634,1593
2022-09-24,Indonesia,Curaçao,3,2,1,1.0,0.0,1657,1641
2022-09-24,Ivory Coast,Togo,2,1,1,1.0,0.0,1907,1652
2022-09-24,Laos,Maldives,1,3,2,0.0,1.0,1352,1462
2022-09-24,Madagascar,Congo,3,3,0,0.5,0.5,1604,1642
2022-09-24,Mauritania,Benin,1,0,1,1.0,0.0,1658,1699
2022-09-24,Mexico,Peru,1,0,1,1.0,0.0,2038,1987
2022-09-24,South Africa,Sierra Leone,4,0,4,1.0,0.0,1845,1630
2022-09-24,Tanzania,Uganda,1,0,1,1.0,0.0,1646,1710
2022-09-24,Kyrgyzstan,Russia,1,2,1,0.0,1.0,1621,1963
2022-09-24,Vanuatu,Papua New Guinea,0,1,1,0.0,1.0,1607,1568
2022-09-24,Czech Republic,Portugal,0,4,4,0.0,1.0,1947,2118
2022-09-24,Spain,Switzerland,1,2,1,0.0,1.0,2162,2032
2022-09-24,Armenia,Ukraine,0,5,5,0.0,1.0,1725,1984
2022-09-24,Scotland,Republic of Ireland,2,1,1,1.0,0.0,1922,1887
2022-09-24,Israel,Albania,2,1,1,1.0,0.0,1818,1765
2022-09-24,Slovenia,Norway,2,1,1,1.0,0.0,1822,1918
2022-09-24,Serbia,Sweden,4,1,3,1.0,0.0,1978,1962
2022-09-24,Northern Ireland,Kosovo,2,1,1,1.0,0.0,1800,1695
2022-09-24,Cyprus,Greece,1,0,1,1.0,0.0,1642,1881
2022-09-25,Thailand,Trinidad and Tobago,2,1,1,1.0,0.0,1788,1684
2022-09-25,Malaysia,Tajikistan,0,0,0,0.5,0.5,1639,1643
2022-09-25,New Zealand,Australia,0,2,2,0.0,1.0,1774,1973
2022-09-25,Niger,Liberia,0,0,0,0.5,0.5,1590,1593
2022-09-25,Austria,Croatia,1,3,2,0.0,1.0,1914,2040
2022-09-25,Denmark,France,2,0,2,1.0,0.0,2053,2159
2022-09-25,Wales,Poland,0,1,1,0.0,1.0,1939,1981
2022-09-25,Netherlands,Belgium,1,0,1,1.0,0.0,2123,2136
2022-09-25,Faroe Islands,Turkey,2,1,1,1.0,0.0,1551,1926
2022-09-25,Luxembourg,Lithuania,1,0,1,1.0,0.0,1632,1589
2022-09-25,Slovakia,Belarus,1,1,0,0.5,0.5,1852,1716
2022-09-25,Azerbaijan,Kazakhstan,3,0,3,1.0,0.0,1636,1667
2022-09-25,Andorra,Latvia,1,1,0,0.5,0.5,1439,1628
2022-09-25,Moldova,Liechtenstein,2,0,2,1.0,0.0,1563,1398
2022-09-26,Ethiopia,Sudan,2,2,0,0.5,0.5,1650,1607
2022-09-26,Iraq,Syria,1,0,1,1.0,0.0,1885,1755
2022-09-26,Jordan,Oman,1,0,1,1.0,0.0,1845,1839
2022-09-26,England,Germany,3,3,0,0.5,0.5,2124,2116
2022-09-26,Hungary,Italy,0,2,2,0.0,1.0,1919,2121
2022-09-26,Montenegro,Finland,0,2,2,0.0,1.0,1761,1852
2022-09-26,Romania,Bosnia and Herzegovina,4,1,3,1.0,0.0,1875,1865
2022-09-26,Gibraltar,Georgia,1,2,1,0.0,1.0,1487,1806
2022-09-26,North Macedonia,Bulgaria,0,1,1,0.0,1.0,1795,1785
2022-09-26,San Marino,Estonia,0,4,4,0.0,1.0,1282,1708
2022-09-27,Fiji,Papua New Guinea,0,1,1,0.0,1.0,1660,1579
2022-09-27,Algeria,Nigeria,2,1,1,1.0,0.0,1962,1879
2022-09-27,Argentina,Jamaica,3,0,3,1.0,0.0,2193,1799
2022-09-27,Bahrain,Panama,0,2,2,0.0,1.0,1838,1871
2022-09-27,Brazil,Tunisia,5,1,4,1.0,0.0,2254,1903
2022-09-27,Brunei,Laos,1,0,1,1.0,0.0,1275,1343
2022-09-27,Burkina Faso,Comoros,2,1,1,1.0,0.0,1802,1558
2022-09-27,Canada,Uruguay,0,2,2,0.0,1.0,1895,2061
2022-09-27,DR Congo,Sierra Leone,3,0,3,1.0,0.0,1725,1624
2022-09-27,Costa Rica,Uzbekistan,2,1,1,1.0,0.0,1912,1854
2022-09-27,Ecuador,Japan,0,0,0,0.5,0.5,1983,2039
2022-09-27,Egypt,Liberia,3,0,3,1.0,0.0,1916,1591
2022-09-27,Equatorial Guinea,Togo,2,2,0,0.5,0.5,1653,1653
2022-09-27,Ghana,Nicaragua,1,0,1,1.0,0.0,1843,1563
2022-09-27,Honduras,Guatemala,2,1,1,1.0,0.0,1788,1757
2022-09-27,Indonesia,Curaçao,2,1,1,1.0,0.0,1665,1634
2022-09-27,Iran,Senegal,1,1,0,0.5,0.5,2040,1935
2022-09-27,Ivory Coast,Guinea,3,1,2,1.0,0.0,1912,1718
2022-09-27,South Korea,Cameroon,1,0,1,1.0,0.0,2025,1880
2022-09-27,Libya,Tanzania,2,1,1,1.0,0.0,1685,1639
2022-09-27,Madagascar,Benin,3,1,2,1.0,0.0,1615,1689
2022-09-27,Malta,Israel,2,1,1,1.0,0.0,1552,1805
2022-09-27,Mauritania,Congo,2,0,2,1.0,0.0,1666,1635
2022-09-27,Mexico,Colombia,2,3,1,0.0,1.0,2031,2076
2022-09-27,Nepal,Bangladesh,3,1,2,1.0,0.0,1454,1412
2022-09-27,Paraguay,Morocco,0,0,0,0.5,0.5,1915,1948
2022-09-27,Peru,El Salvador,4,1,3,1.0,0.0,1991,1753
2022-09-27,Qatar,Chile,2,2,0,0.5,0.5,1896,1957
2022-09-27,Saudi Arabia,United States,0,0,0,0.5,0.5,1892,2028
2022-09-27,South Africa,Botswana,1,0,1,1.0,0.0,1849,1651
2022-09-27,United Arab Emirates,Venezuela,0,4,4,0.0,1.0,1833,1883
2022-09-27,Vietnam,India,3,0,3,1.0,0.0,1758,1629
2022-09-27,Portugal,Spain,0,1,1,0.0,1.0,2112,2169
2022-09-27,Switzerland,Czech Republic,2,1,1,1.0,0.0,2039,1941
2022-09-27,Republic of Ireland,Armenia,3,2,1,1.0,0.0,1892,1721
2022-09-27,Ukraine,Scotland,0,0,0,0.5,0.5,1983,1924
2022-09-27,Albania,Iceland,1,1,0,0.5,0.5,1767,1828
2022-09-27,Norway,Serbia,0,2,2,0.0,1.0,1912,1985
2022-09-27,Sweden,Slovenia,1,1,0,0.5,0.5,1959,1826
2022-09-27,Kosovo,Cyprus,5,1,4,1.0,0.0,1702,1636
2022-09-27,Greece,Northern Ireland,3,1,2,1.0,0.0,1888,1794
2022-09-30,Fiji,Solomon Islands,1,0,1,1.0,0.0,1668,1645
2022-10-01,Saint Vincent and the Grenadines,Grenada,1,5,4,0.0,1.0,1506,1518
2022-10-22,Saudi Arabia,North Macedonia,1,0,1,1.0,0.0,1898,1790
2022-10-23,Qatar,Guatemala,2,0,2,1.0,0.0,1901,1753
2022-10-26,Saudi Arabia,Albania,1,1,0,0.5,0.5,1896,1770
2022-10-27,Qatar,Honduras,1,0,1,1.0,0.0,1907,1783
2022-10-30,Saudi Arabia,Honduras,0,0,0,0.5,0.5,1894,1786
2022-11-05,Brunei,Timor-Leste,6,2,4,1.0,0.0,1283,1264
2022-11-06,Saudi Arabia,Iceland,1,0,1,1.0,0.0,1901,1822
2022-11-07,Qatar,Panama,2,1,1,1.0,0.0,1915,1864
2022-11-08,Brunei,Timor-Leste,0,1,1,0.0,1.0,1275,1273
2022-11-09,Albania,Qatar,0,1,1,0.0,1.0,1766,1920
2022-11-09,Cameroon,Jamaica,1,1,0,0.5,0.5,1879,1801
2022-11-09,Costa Rica,Nigeria,2,0,2,1.0,0.0,1920,1872
2022-11-09,Mexico,Iraq,4,0,4,1.0,0.0,2036,1881
2022-11-10,Iran,Nicaragua,1,0,1,1.0,0.0,2041,1563
2022-11-10,Saudi Arabia,Panama,1,1,0,0.5,0.5,1901,1865
2022-11-11,Bahrain,Canada,2,2,0,0.5,0.5,1840,1894
2022-11-11,South Korea,Iceland,1,0,1,1.0,0.0,2029,1819
2022-11-12,Iraq,Ecuador,0,0,0,0.5,0.5,1884,1981
2022-11-13,Syria,Algeria,0,1,1,0.0,1.0,1752,1966
2022-11-13,West Papua,Raetia,1,1,0,0.5,0.5,1499,1437
2022-11-15,Venezuela,Panama,2,2,0,0.5,0.5,1883,1866
2022-11-16,Albania,Italy,1,3,2,0.0,1.0,1765,2123
2022-11-16,Algeria,Mali,1,1,0,0.5,0.5,1963,1825
2022-11-16,Andorra,Austria,0,1,1,0.0,1.0,1439,1915
2022-11-16,Cyprus,Bulgaria,0,2,2,0.0,1.0,1632,1790
2022-11-16,Czech Republic,Faroe Islands,5,0,5,1.0,0.0,1943,1550
2022-11-16,Dominican Republic,Cuba,2,4,2,0.0,1.0,1562,1620
2022-11-16,Gibraltar,Liechtenstein,2,0,2,1.0,0.0,1493,1393
2022-11-16,Iran,Tunisia,0,2,2,0.0,1.0,2030,1915
2022-11-16,Ivory Coast,Burundi,4,0,4,1.0,0.0,1915,1611
2022-11-16,Kosovo,Armenia,2,2,0,0.5,0.5,1703,1721
2022-11-16,Mexico,Sweden,1,2,1,0.0,1.0,2027,1969
2022-11-16,Moldova,Azerbaijan,1,2,1,0.0,1.0,1557,1643
2022-11-16,Nepal,Pakistan,1,0,1,1.0,0.0,1461,1360
2022-11-16,Nicaragua,El Salvador,1,0,1,1.0,0.0,1575,1742
2022-11-16,Oman,Germany,0,1,1,0.0,1.0,1837,2119
2022-11-16,Peru,Paraguay,1,0,1,1.0,0.0,1998,1909
2022-11-16,Poland,Chile,1,0,1,1.0,0.0,1989,1950
2022-11-16,Saudi Arabia,Croatia,0,1,1,0.0,1.0,1897,2045
2022-11-16,Turkey,Scotland,2,1,1,1.0,0.0,1934,1917
2022-11-16,United Arab Emirates,Argentina,0,5,5,0.0,1.0,1832,2195
2022-11-16,Uzbekistan,Kazakhstan,2,0,2,1.0,0.0,1859,1663
2022-11-16,Lithuania,Iceland,0,0,0,0.5,0.5,1594,1815
2022-11-16,Latvia,Estonia,1,1,0,0.5,0.5,1630,1707
2022-11-17,Angola,Botswana,1,0,1,1.0,0.0,1700,1644
2022-11-17,Gabon,Guinea-Bissau,3,1,2,1.0,0.0,1735,1602
2022-11-17,Israel,Zambia,4,2,2,1.0,0.0,1812,1733
2022-11-17,Japan,Canada,1,2,1,0.0,1.0,2028,1906
2022-11-17,Jordan,Spain,1,3,2,0.0,1.0,1843,2172
2022-11-17,Luxembourg,Hungary,2,2,0,0.5,0.5,1638,1914
2022-11-17,Malta,Greece,2,2,0,0.5,0.5,1558,1883
2022-11-17,Montenegro,Slovakia,2,2,0,0.5,0.5,1764,1850
2022-11-17,Morocco,Georgia,3,0,3,1.0,0.0,1953,1802
2022-11-17,Niger,Libya,2,3,1,0.0,1.0,1585,1691
2022-11-17,North Macedonia,Finland,1,1,0,0.5,0.5,1792,1851
2022-11-17,Portugal,Nigeria,4,0,4,1.0,0.0,2116,1869
2022-11-17,Republic of Ireland,Norway,1,2,1,0.0,1.0,1885,1920
2022-11-17,Romania,Slovenia,1,2,1,0.0,1.0,1866,1836
2022-11-17,Rwanda,Sudan,0,0,0,0.5,0.5,1636,1608
2022-11-17,South Africa,Mozambique,2,1,1,1.0,0.0,1853,1644
2022-11-17,Saint Lucia,San Marino,1,1,0,0.5,0.5,1489,1287
2022-11-17,Switzerland,Ghana,0,2,2,0.0,1.0,2027,1856
2022-11-17,Syria,Belarus,0,1,1,0.0,1.0,1744,1725
2022-11-17,Tajikistan,Russia,0,0,0,0.5,0.5,1649,1958
2022-11-18,Bahrain,Serbia,1,5,4,0.0,1.0,1836,1990
2022-11-18,Cameroon,Panama,1,1,0,0.5,0.5,1879,1867
2022-11-18,Dominican Republic,Cuba,1,1,0,0.5,0.5,1564,1619
2022-11-18,Egypt,Belgium,2,1,1,1.0,0.0,1929,2124
2022-11-19,Albania,Armenia,2,0,2,1.0,0.0,1772,1715
2022-11-19,Colombia,Paraguay,2,0,2,1.0,0.0,2081,1905
2022-11-19,Gibraltar,Andorra,1,0,1,1.0,0.0,1500,1433
2022-11-19,Guatemala,Nicaragua,3,1,2,1.0,0.0,1758,1571
2022-11-19,Ivory Coast,Burkina Faso,1,2,1,0.0,1.0,1905,1813
2022-11-19,Kosovo,Faroe Islands,1,1,0,0.5,0.5,1700,1554
2022-11-19,Kuwait,Lebanon,2,0,2,1.0,0.0,1723,1693
2022-11-19,Peru,Bolivia,1,0,1,1.0,0.0,2002,1777
2022-11-19,Rwanda,Sudan,1,0,1,1.0,0.0,1644,1601
2022-11-19,Sweden,Algeria,2,0,2,1.0,0.0,1977,1956
2022-11-19,Turkey,Czech Republic,2,1,1,1.0,0.0,1943,1935
2022-11-19,United Arab Emirates,Kazakhstan,2,1,1,1.0,0.0,1837,1659
2022-11-19,Estonia,Lithuania,2,0,2,1.0,0.0,1713,1589
2022-11-19,Latvia,Iceland,1,1,0,0.5,0.5,1634,1812
2022-11-20,Austria,Italy,2,0,2,1.0,0.0,1928,2111
2022-11-20,Gambia,Guinea-Bissau,0,0,0,0.5,0.5,1662,1604
2022-11-20,Hungary,Greece,2,1,1,1.0,0.0,1922,1876
2022-11-20,Israel,Cyprus,2,3,1,0.0,1.0,1801,1644
2022-11-20,Luxembourg,Bulgaria,0,0,0,0.5,0.5,1642,1787
2022-11-20,Malta,Republic of Ireland,0,1,1,0.0,1.0,1556,1888
2022-11-20,Moldova,Romania,0,5,5,0.0,1.0,1555,1869
2022-11-20,Niger,Gabon,1,3,2,0.0,1.0,1581,1740
2022-11-20,North Macedonia,Azerbaijan,1,3,2,0.0,1.0,1781,1655
2022-11-20,Norway,Finland,1,1,0,0.5,0.5,1919,1853
2022-11-20,Oman,Belarus,2,0,2,1.0,0.0,1843,1720
2022-11-20,Slovakia,Chile,0,0,0,0.5,0.5,1853,1948
2022-11-20,Slovenia,Montenegro,1,0,1,1.0,0.0,1843,1758
2022-11-20,South Africa,Angola,1,1,0,0.5,0.5,1850,1704
2022-11-20,Saint Lucia,San Marino,1,0,1,1.0,0.0,1493,1284
2022-11-20,Syria,Venezuela,1,2,1,0.0,1.0,1740,1888
2022-11-20,Uzbekistan,Russia,0,0,0,0.5,0.5,1862,1956
2022-11-20,Qatar,Ecuador,0,2,2,0.0,1.0,1914,1988
2022-11-21,Senegal,Netherlands,0,2,2,0.0,1.0,1931,2128
2022-11-21,England,Iran,6,2,4,1.0,0.0,2130,2025
2022-11-21,United States,Wales,1,1,0,0.5,0.5,2026,1942
2022-11-22,Argentina,Saudi Arabia,1,2,1,0.0,1.0,2182,1911
2022-11-22,Mexico,Poland,0,0,0,0.5,0.5,2027,1990
2022-11-22,Denmark,Tunisia,0,0,0,0.5,0.5,2050,1919
2022-11-22,France,Australia,4,1,3,1.0,0.0,2164,1969
2022-11-23,Germany,Japan,1,2,1,0.0,1.0,2109,2039
2022-11-23,Spain,Costa Rica,7,0,7,1.0,0.0,2176,1917
2022-11-23,Morocco,Croatia,0,0,0,0.5,0.5,1956,2043
2022-11-23,Belgium,Canada,1,0,1,1.0,0.0,2128,1903
2022-11-24,Switzerland,Cameroon,1,0,1,1.0,0.0,2032,1875
2022-11-24,Brazil,Serbia,2,0,2,1.0,0.0,2257,1988
2022-11-24,Uruguay,South Korea,0,0,0,0.5,0.5,2061,2030
2022-11-24,Portugal,Ghana,3,2,1,1.0,0.0,2119,1854
2022-11-25,Qatar,Senegal,1,3,2,0.0,1.0,1907,1939
2022-11-25,Netherlands,Ecuador,1,1,0,0.5,0.5,2125,1992
2022-11-25,Wales,Iran,0,2,2,0.0,1.0,1936,2032
2022-11-25,England,United States,0,0,0,0.5,0.5,2128,2029
2022-11-26,Poland,Saudi Arabia,2,0,2,1.0,0.0,1997,1905
2022-11-26,Argentina,Mexico,2,0,2,1.0,0.0,2187,2023
2022-11-26,Tunisia,Australia,0,1,1,0.0,1.0,1913,1976
2022-11-26,France,Denmark,2,1,1,1.0,0.0,2170,2045
2022-11-27,Japan,Costa Rica,0,1,1,0.0,1.0,2029,1928
2022-11-27,Spain,Germany,1,1,0,0.5,0.5,2175,2111
2022-11-27,Belgium,Morocco,0,2,2,0.0,1.0,2117,1968
2022-11-27,Croatia,Canada,4,1,3,1.0,0.0,2048,1899
2022-11-28,Cameroon,Serbia,3,3,0,0.5,0.5,1878,1986
2022-11-28,Brazil,Switzerland,1,0,1,1.0,0.0,2261,2029
2022-11-28,South Korea,Ghana,2,3,1,0.0,1.0,2019,1866
2022-11-28,Portugal,Uruguay,2,0,2,1.0,0.0,2126,2055
2022-11-29,Ecuador,Senegal,1,2,1,0.0,1.0,1983,1949
2022-11-29,Qatar,Netherlands,0,2,2,0.0,1.0,1904,2129
2022-11-29,Wales,England,0,3,3,0.0,1.0,1933,2132
2022-11-29,Iran,United States,0,1,1,0.0,1.0,2024,2038
2022-11-30,Poland,Argentina,0,2,2,0.0,1.0,1993,2192
2022-11-30,Saudi Arabia,Mexico,1,2,1,0.0,1.0,1900,2029
2022-11-30,Australia,Denmark,1,0,1,1.0,0.0,1986,2036
2022-11-30,Tunisia,France,1,0,1,1.0,0.0,1927,2157
2022-12-01,Japan,Spain,2,1,1,1.0,0.0,2041,2164
2022-12-01,Costa Rica,Germany,2,4,2,0.0,1.0,1924,2116
2022-12-01,Croatia,Belgium,0,0,0,0.5,0.5,2050,2116
2022-12-01,Canada,Morocco,1,2,1,0.0,1.0,1893,1975
2022-12-02,Serbia,Switzerland,2,3,1,0.0,1.0,1979,2037
2022-12-02,Cameroon,Brazil,1,0,1,1.0,0.0,1893,2247
2022-12-02,Ghana,Uruguay,0,2,2,0.0,1.0,1862,2060
2022-12-02,South Korea,Portugal,2,1,1,1.0,0.0,2030,2116
2022-12-03,Netherlands,United States,3,1,2,1.0,0.0,2135,2033
2022-12-03,Argentina,Australia,2,1,1,1.0,0.0,2196,1983
2022-12-04,France,Poland,3,1,2,1.0,0.0,2162,1989
2022-12-04,England,Senegal,3,0,3,1.0,0.0,2137,1945
2022-12-05,Japan,Croatia,1,1,0,0.5,0.5,2042,2050
2022-12-05,Brazil,South Korea,4,1,3,1.0,0.0,2251,2027
2022-12-06,Morocco,Spain,0,0,0,0.5,0.5,1979,2161
2022-12-06,Portugal,Switzerland,6,1,5,1.0,0.0,2123,2031
2022-12-09,Croatia,Brazil,1,1,0,0.5,0.5,2055,2247
2022-12-09,Netherlands,Argentina,2,2,0,0.5,0.5,2137,2195
2022-12-09,Malaysia,Cambodia,4,0,4,1.0,0.0,1643,1383
2022-12-10,Morocco,Portugal,1,0,1,1.0,0.0,1991,2112
2022-12-10,England,France,1,2,1,0.0,1.0,2130,2170
2022-12-11,Thailand,Myanmar,6,0,6,1.0,0.0,1791,1495
2022-12-13,Argentina,Croatia,3,0,3,1.0,0.0,2200,2051
2022-12-14,France,Morocco,2,0,2,1.0,0.0,2175,1987
2022-12-14,Malaysia,Maldives,3,0,3,1.0,0.0,1648,1458
2022-12-14,Thailand,Taiwan,0,1,1,0.0,1.0,1777,1465
2022-12-14,Vietnam,Philippines,1,0,1,1.0,0.0,1763,1581
2022-12-17,Croatia,Morocco,2,1,1,1.0,0.0,2058,1981
2022-12-17,Singapore,Maldives,3,1,2,1.0,0.0,1599,1453
2022-12-18,Argentina,France,3,3,0,0.5,0.5,2200,2176
2022-12-20,Cambodia,Philippines,3,2,1,1.0,0.0,1396,1569
2022-12-20,Brunei,Thailand,0,5,5,0.0,1.0,1275,1778
2022-12-21,Myanmar,Malaysia,0,1,1,0.0,1.0,1491,1653
2022-12-21,Laos,Vietnam,0,6,6,0.0,1.0,1342,1765
2022-12-23,Oman,Syria,2,1,1,1.0,0.0,1849,1735
2022-12-23,Philippines,Brunei,5,1,4,1.0,0.0,1572,1273
2022-12-23,Indonesia,Cambodia,2,1,1,1.0,0.0,1668,1394
2022-12-24,Singapore,Myanmar,3,2,1,1.0,0.0,1605,1486
2022-12-24,Malaysia,Laos,5,0,5,1.0,0.0,1656,1340
2022-12-26,Brunei,Indonesia,0,7,7,0.0,1.0,1272,1670
2022-12-26,Thailand,Philippines,4,0,4,1.0,0.0,1782,1569
2022-12-27,Laos,Singapore,0,2,2,0.0,1.0,1338,1608
2022-12-27,Vietnam,Malaysia,3,0,3,1.0,0.0,1771,1651
2022-12-29,Cambodia,Brunei,5,1,4,1.0,0.0,1400,1267
2022-12-29,Indonesia,Thailand,1,1,0,0.5,0.5,1673,1780
2022-12-30,Iraq,Kuwait,1,0,1,1.0,0.0,1889,1719
2022-12-30,Oman,Syria,1,0,1,1.0,0.0,1855,1730
2022-12-30,United Arab Emirates,Lebanon,1,0,1,1.0,0.0,1842,1689
2022-12-30,Myanmar,Laos,2,2,0,0.5,0.5,1483,1342
2022-12-30,Singapore,Vietnam,0,0,0,0.5,0.5,1612,1768
2023-01-02,Thailand,Cambodia,3,1,2,1.0,0.0,1782,1399
2023-01-02,Philippines,Indonesia,1,2,1,0.0,1.0,1564,1679
2023-01-03,Vietnam,Myanmar,3,0,3,1.0,0.0,1771,1481
2023-01-03,Malaysia,Singapore,4,1,3,1.0,0.0,1659,1605
2023-01-06,Iraq,Oman,0,0,0,0.5,0.5,1889,1856
2023-01-06,Yemen,Saudi Arabia,0,2,2,0.0,1.0,1538,1902
2023-01-06,Indonesia,Vietnam,0,0,0,0.5,0.5,1682,1769
2023-01-07,Bahrain,United Arab Emirates,2,1,1,1.0,0.0,1845,1834
2023-01-07,Kuwait,Qatar,0,2,2,0.0,1.0,1715,1909
2023-01-07,Malaysia,Thailand,1,0,1,1.0,0.0,1670,1772
2023-01-08,Iceland,Estonia,1,1,0,0.5,0.5,1810,1716
2023-01-09,Sweden,Finland,2,0,2,1.0,0.0,1983,1848
2023-01-09,Oman,Yemen,3,2,1,1.0,0.0,1859,1536
2023-01-09,Iraq,Saudi Arabia,2,0,2,1.0,0.0,1898,1894
2023-01-09,Vietnam,Indonesia,2,0,2,1.0,0.0,1776,1676
2023-01-10,United Arab Emirates,Kuwait,0,1,1,0.0,1.0,1824,1726
2023-01-10,Qatar,Bahrain,1,2,1,0.0,1.0,1900,1855
2023-01-10,Thailand,Malaysia,3,0,3,1.0,0.0,1778,1665
2023-01-12,Finland,Estonia,0,1,1,0.0,1.0,1838,1727
2023-01-12,Sweden,Iceland,2,1,1,1.0,0.0,1988,1806
2023-01-12,Iraq,Yemen,5,0,5,1.0,0.0,1900,1535
2023-01-12,Saudi Arabia,Oman,1,2,1,0.0,1.0,1886,1868
2023-01-13,Bahrain,Kuwait,1,1,0,0.5,0.5,1853,1729
2023-01-13,Qatar,United Arab Emirates,1,1,0,0.5,0.5,1899,1826
2023-01-13,Vietnam,Thailand,2,2,0,0.5,0.5,1777,1778
2023-01-16,Iraq,Qatar,2,1,1,1.0,0.0,1908,1892
2023-01-16,Bahrain,Oman,0,1,1,0.0,1.0,1846,1876
2023-01-16,Thailand,Vietnam,1,0,1,1.0,0.0,1786,1770
2023-01-19,Iraq,Oman,3,2,1,1.0,0.0,1916,1869
2023-01-25,United States,Serbia,1,2,1,0.0,1.0,2024,1989
2023-01-28,United States,Colombia,0,0,0,0.5,0.5,2026,2080
2023-02-22,Grenada,Barbados,1,1,0,0.5,0.5,1518,1487
2023-02-26,Grenada,Barbados,2,2,0,0.5,0.5,1518,1488
2023-03-03,Grenada,Saint Lucia,1,2,1,0.0,1.0,1510,1502
2023-03-04,Saint Barthélemy,Sint Maarten,5,1,4,1.0,0.0,1494,1435
2023-03-05,Grenada,Saint Lucia,2,0,2,1.0,0.0,1518,1495
2023-03-10,Saint Martin,Saint Barthélemy,3,2,1,1.0,0.0,1430,1485
2023-03-11,Jamaica,Trinidad and Tobago,0,1,1,0.0,1.0,1791,1695
2023-03-12,Guatemala,Panama,1,1,0,0.5,0.5,1761,1865
2023-03-14,Jamaica,Trinidad and Tobago,0,0,0,0.5,0.5,1789,1698
2023-03-15,Bangladesh,Malawi,1,1,0,0.5,0.5,1417,1638
2023-03-19,Ethiopia,Rwanda,1,0,1,1.0,0.0,1658,1637
2023-03-20,Fiji,Vanuatu,1,2,1,0.0,1.0,1659,1617
2023-03-21,Maldives,Pakistan,1,0,1,1.0,0.0,1459,1355
2023-03-21,Tahiti,New Caledonia,0,2,2,0.0,1.0,1627,1639
2023-03-22,Honduras,El Salvador,1,0,1,1.0,0.0,1793,1736
2023-03-22,India,Myanmar,1,0,1,1.0,0.0,1634,1477
2023-03-22,Nepal,Laos,2,0,2,1.0,0.0,1467,1337
2023-03-22,Republic of Ireland,Latvia,3,2,1,1.0,0.0,1892,1631
2023-03-22,Sierra Leone,São Tomé and Príncipe,2,2,0,0.5,0.5,1621,1440
2023-03-22,Benin,Rwanda,1,1,0,0.5,0.5,1688,1639
2023-03-23,Argentina,Panama,2,0,2,1.0,0.0,2203,1863
2023-03-23,Hong Kong,Singapore,1,1,0,0.5,0.5,1598,1605
2023-03-23,Hungary,Estonia,1,0,1,1.0,0.0,1926,1724
2023-03-23,Iran,Russia,1,1,0,0.5,0.5,2023,1958
2023-03-23,Malaysia,Turkmenistan,1,0,1,1.0,0.0,1672,1610
2023-03-23,New Zealand,China PR,0,0,0,0.5,0.5,1776,1832
2023-03-23,Solomon Islands,Vanuatu,2,0,2,1.0,0.0,1653,1610
2023-03-23,Madagascar,Central African Republic,0,3,3,0.0,1.0,1606,1555
2023-03-23,Ghana,Angola,1,0,1,1.0,0.0,1867,1700
2023-03-23,Algeria,Niger,2,1,1,1.0,0.0,1958,1580
2023-03-23,Congo,South Sudan,1,2,1,0.0,1.0,1624,1483
2023-03-23,Zambia,Lesotho,3,1,2,1.0,0.0,1738,1567
2023-03-23,Gabon,Sudan,1,0,1,1.0,0.0,1745,1597
2023-03-23,Italy,England,1,2,1,0.0,1.0,2104,2138
2023-03-23,North Macedonia,Malta,2,1,1,1.0,0.0,1785,1553
2023-03-23,Denmark,Finland,3,1,2,1.0,0.0,2040,1835
2023-03-23,San Marino,Northern Ireland,0,2,2,0.0,1.0,1284,1795
2023-03-23,Kazakhstan,Slovenia,1,2,1,0.0,1.0,1655,1848
2023-03-23,Portugal,Liechtenstein,4,0,4,1.0,0.0,2113,1393
2023-03-23,Bosnia and Herzegovina,Iceland,3,0,3,1.0,0.0,1872,1800
2023-03-23,Slovakia,Luxembourg,0,0,0,0.5,0.5,1849,1647
2023-03-23,Suriname,Mexico,0,2,2,0.0,1.0,1641,2031
2023-03-23,Barbados,Cuba,0,1,1,0.0,1.0,1483,1625
2023-03-23,Guadeloupe,Antigua and Barbuda,0,1,1,0.0,1.0,1624,1591
2023-03-23,French Guiana,Dominican Republic,1,1,0,0.5,0.5,1631,1566
2023-03-23,Saint Martin,Saint Kitts and Nevis,1,3,2,0.0,1.0,1426,1581
2023-03-23,British Virgin Islands,Puerto Rico,1,3,2,0.0,1.0,1314,1476
2023-03-24,Australia,Ecuador,3,1,2,1.0,0.0,1991,1975
2023-03-24,Japan,Uruguay,1,1,0,0.5,0.5,2043,2060
2023-03-24,South Korea,Colombia,2,2,0,0.5,0.5,2029,2079
2023-03-24,Kuwait,Philippines,2,0,2,1.0,0.0,1734,1560
2023-03-24,Saudi Arabia,Venezuela,1,2,1,0.0,1.0,1879,1896
2023-03-24,Tahiti,New Caledonia,2,1,1,1.0,0.0,1636,1631
2023-03-24,Uzbekistan,Bolivia,1,0,1,1.0,0.0,1869,1771
2023-03-24,Nigeria,Guinea-Bissau,0,1,1,0.0,1.0,1856,1618
2023-03-24,Cape Verde,Eswatini,0,0,0,0.5,0.5,1745,1590
2023-03-24,Burkina Faso,Togo,1,0,1,1.0,0.0,1818,1649
2023-03-24,Cameroon,Namibia,1,1,0,0.5,0.5,1889,1678
2023-03-24,Guinea,Ethiopia,2,0,2,1.0,0.0,1725,1652
2023-03-24,Egypt,Malawi,2,0,2,1.0,0.0,1932,1636
2023-03-24,Uganda,Tanzania,0,1,1,0.0,1.0,1701,1649
2023-03-24,Mali,Gambia,2,0,2,1.0,0.0,1830,1658
2023-03-24,Ivory Coast,Comoros,3,1,2,1.0,0.0,1907,1557
2023-03-24,DR Congo,Mauritania,3,1,2,1.0,0.0,1732,1660
2023-03-24,Equatorial Guinea,Botswana,2,0,2,1.0,0.0,1661,1637
2023-03-24,Tunisia,Libya,3,0,3,1.0,0.0,1931,1688
2023-03-24,South Africa,Liberia,2,2,0,0.5,0.5,1845,1597
2023-03-24,Senegal,Mozambique,5,1,4,1.0,0.0,1948,1642
2023-03-24,Gibraltar,Greece,0,3,3,0.0,1.0,1499,1878
2023-03-24,France,Netherlands,4,0,4,1.0,0.0,2184,2130
2023-03-24,Czech Republic,Poland,3,1,2,1.0,0.0,1945,1980
2023-03-24,Moldova,Faroe Islands,1,1,0,0.5,0.5,1555,1555
2023-03-24,Austria,Azerbaijan,4,1,3,1.0,0.0,1931,1653
2023-03-24,Sweden,Belgium,0,3,3,0.0,1.0,1983,2122
2023-03-24,Bulgaria,Montenegro,0,1,1,0.0,1.0,1779,1767
2023-03-24,Serbia,Lithuania,2,0,2,1.0,0.0,1991,1588
2023-03-24,Grenada,United States,1,7,6,0.0,1.0,1518,2027
2023-03-24,Bahamas,Trinidad and Tobago,0,3,3,0.0,1.0,1450,1702
2023-03-24,Nicaragua,Saint Vincent and the Grenadines,4,1,3,1.0,0.0,1578,1500
2023-03-24,Belize,Guatemala,1,2,1,0.0,1.0,1488,1764
2023-03-24,Anguilla,Saint Lucia,1,2,1,0.0,1.0,1283,1499
2023-03-25,Bahrain,Palestine,1,2,1,0.0,1.0,1835,1719
2023-03-25,Bangladesh,Seychelles,1,0,1,1.0,0.0,1425,1375
2023-03-25,Bhutan,Laos,1,2,1,0.0,1.0,1239,1343
2023-03-25,Georgia,Mongolia,6,1,5,1.0,0.0,1804,1401
2023-03-25,Germany,Peru,2,0,2,1.0,0.0,2122,1997
2023-03-25,Indonesia,Burundi,3,1,2,1.0,0.0,1683,1605
2023-03-25,Morocco,Brazil,2,1,1,1.0,0.0,1995,2234
2023-03-25,Myanmar,Kyrgyzstan,1,1,0,0.5,0.5,1481,1618
2023-03-25,Thailand,Syria,1,3,2,0.0,1.0,1777,1740
2023-03-25,United Arab Emirates,Tajikistan,0,0,0,0.5,0.5,1823,1653
2023-03-25,Scotland,Cyprus,3,0,3,1.0,0.0,1920,1642
2023-03-25,Spain,Norway,3,0,3,1.0,0.0,2165,1916
2023-03-25,Croatia,Wales,1,1,0,0.5,0.5,2056,1936
2023-03-25,Armenia,Turkey,1,2,1,0.0,1.0,1712,1947
2023-03-25,Belarus,Switzerland,0,5,5,0.0,1.0,1718,2034
2023-03-25,Israel,Kosovo,1,1,0,0.5,0.5,1799,1703
2023-03-25,Andorra,Romania,0,2,2,0.0,1.0,1432,1871
2023-03-25,Martinique,Costa Rica,1,2,1,0.0,1.0,1683,1928
2023-03-25,Curaçao,Canada,0,2,2,0.0,1.0,1632,1896
2023-03-25,Bermuda,Guyana,0,2,2,0.0,1.0,1568,1597
2023-03-25,Montserrat,Haiti,0,4,4,0.0,1.0,1466,1756
2023-03-25,Sint Maarten,Bonaire,6,1,5,1.0,0.0,1445,1487
2023-03-25,Turks and Caicos Islands,United States Virgin Islands,1,0,1,1.0,0.0,1418,1344
2023-03-26,Fiji,Solomon Islands,0,2,2,0.0,1.0,1651,1662
2023-03-26,Macau,Singapore,0,1,1,0.0,1.0,1321,1608
2023-03-26,New Zealand,China PR,2,1,1,1.0,0.0,1786,1823
2023-03-26,Russia,Iraq,2,0,2,1.0,0.0,1966,1909
2023-03-26,São Tomé and Príncipe,Sierra Leone,0,2,2,0.0,1.0,1436,1626
2023-03-26,Lesotho,Zambia,0,2,2,0.0,1.0,1563,1743
2023-03-26,England,Ukraine,2,0,2,1.0,0.0,2143,1979
2023-03-26,Malta,Italy,0,2,2,0.0,1.0,1553,2105
2023-03-26,Slovenia,San Marino,2,0,2,1.0,0.0,1849,1284
2023-03-26,Kazakhstan,Denmark,3,2,1,1.0,0.0,1670,2026
2023-03-26,Northern Ireland,Finland,0,1,1,0.0,1.0,1788,1843
2023-03-26,Liechtenstein,Iceland,0,7,7,0.0,1.0,1392,1802
2023-03-26,Luxembourg,Portugal,0,6,6,0.0,1.0,1646,2115
2023-03-26,Slovakia,Bosnia and Herzegovina,2,0,2,1.0,0.0,1858,1864
2023-03-26,Mexico,Jamaica,2,2,0,0.5,0.5,2027,1794
2023-03-26,Antigua and Barbuda,Barbados,1,2,1,0.0,1.0,1581,1494
2023-03-26,Cuba,Guadeloupe,1,0,1,1.0,0.0,1633,1617
2023-03-26,Puerto Rico,Cayman Islands,5,1,4,1.0,0.0,1483,1402
2023-03-27,Chile,Paraguay,3,2,1,1.0,0.0,1956,1898
2023-03-27,Greece,Lithuania,0,0,0,0.5,0.5,1873,1594
2023-03-27,North Macedonia,Faroe Islands,1,0,1,1.0,0.0,1789,1552
2023-03-27,Oman,Lebanon,2,0,2,1.0,0.0,1874,1685
2023-03-27,Guinea-Bissau,Nigeria,0,1,1,0.0,1.0,1615,1860
2023-03-27,Ethiopia,Guinea,2,3,1,0.0,1.0,1646,1732
2023-03-27,Central African Republic,Madagascar,2,0,2,1.0,0.0,1565,1597
2023-03-27,Angola,Ghana,1,1,0,0.5,0.5,1704,1864
2023-03-27,Niger,Algeria,0,1,1,0.0,1.0,1579,1960
2023-03-27,South Sudan,Congo,0,1,1,0.0,1.0,1479,1629
2023-03-27,Sudan,Gabon,1,0,1,1.0,0.0,1609,1734
2023-03-27,Republic of Ireland,France,0,1,1,0.0,1.0,1890,2187
2023-03-27,Netherlands,Gibraltar,3,0,3,1.0,0.0,2131,1499
2023-03-27,Poland,Albania,1,0,1,1.0,0.0,1984,1769
2023-03-27,Moldova,Czech Republic,0,0,0,0.5,0.5,1562,1939
2023-03-27,Austria,Estonia,2,1,1,1.0,0.0,1935,1721
2023-03-27,Sweden,Azerbaijan,5,0,5,1.0,0.0,1986,1651
2023-03-27,Hungary,Bulgaria,3,0,3,1.0,0.0,1931,1775
2023-03-27,Montenegro,Serbia,0,2,2,0.0,1.0,1764,1995
2023-03-27,United States,El Salvador,1,0,1,1.0,0.0,2030,1734
2023-03-27,Saint Vincent and the Grenadines,Bahamas,1,1,0,0.5,0.5,1499,1452
2023-03-27,Trinidad and Tobago,Nicaragua,1,1,0,0.5,0.5,1700,1581
2023-03-27,Dominican Republic,Belize,2,0,2,1.0,0.0,1573,1482
2023-03-27,Guatemala,French Guiana,4,0,4,1.0,0.0,1770,1626
2023-03-27,Saint Kitts and Nevis,Aruba,2,0,2,1.0,0.0,1586,1408
2023-03-27,Saint Lucia,Dominica,3,1,2,1.0,0.0,1506,1448
2023-03-28,Argentina,Curaçao,7,0,7,1.0,0.0,2204,1632
2023-03-28,Armenia,Cyprus,2,2,0,0.5,0.5,1711,1644
2023-03-28,Australia,Ecuador,1,2,1,0.0,1.0,1983,1984
2023-03-28,Bahrain,Syria,1,0,1,1.0,0.0,1841,1735
2023-03-28,Bangladesh,Seychelles,0,1,1,0.0,1.0,1416,1385
2023-03-28,Germany,Belgium,2,3,1,0.0,1.0,2114,2130
2023-03-28,India,Kyrgyzstan,2,0,2,1.0,0.0,1642,1611
2023-03-28,Indonesia,Burundi,2,2,0,0.5,0.5,1682,1607
2023-03-28,Iran,Kenya,2,1,1,1.0,0.0,2026,1705
2023-03-28,Japan,Colombia,1,2,1,0.0,1.0,2036,2087
2023-03-28,Jordan,Philippines,4,0,4,1.0,0.0,1846,1558
2023-03-28,South Korea,Uruguay,1,2,1,0.0,1.0,2022,2068
2023-03-28,Kuwait,Tajikistan,2,1,1,1.0,0.0,1741,1647
2023-03-28,Malaysia,Hong Kong,2,0,2,1.0,0.0,1679,1592
2023-03-28,Morocco,Peru,0,0,0,0.5,0.5,1996,1997
2023-03-28,Nepal,Bhutan,1,1,0,0.5,0.5,1463,1244
2023-03-28,Saudi Arabia,Bolivia,1,2,1,0.0,1.0,1869,1782
2023-03-28,United Arab Emirates,Thailand,2,0,2,1.0,0.0,1830,1771
2023-03-28,Uzbekistan,Venezuela,1,1,0,0.5,0.5,1870,1896
2023-03-28,Eswatini,Cape Verde,0,1,1,0.0,1.0,1586,1750
2023-03-28,Togo,Burkina Faso,1,1,0,0.5,0.5,1653,1815
2023-03-28,Namibia,Cameroon,2,1,1,1.0,0.0,1691,1877
2023-03-28,Malawi,Egypt,0,4,4,0.0,1.0,1634,1935
2023-03-28,Tanzania,Uganda,0,1,1,0.0,1.0,1643,1708
2023-03-28,Gambia,Mali,1,0,1,1.0,0.0,1670,1819
2023-03-28,Comoros,Ivory Coast,0,2,2,0.0,1.0,1556,1909
2023-03-28,Mauritania,DR Congo,1,1,0,0.5,0.5,1662,1731
2023-03-28,Botswana,Equatorial Guinea,2,3,1,0.0,1.0,1630,1669
2023-03-28,Libya,Tunisia,0,1,1,0.0,1.0,1685,1935
2023-03-28,Liberia,South Africa,1,2,1,0.0,1.0,1594,1849
2023-03-28,Mozambique,Senegal,0,1,1,0.0,1.0,1640,1951
2023-03-28,Scotland,Spain,2,0,2,1.0,0.0,1933,2153
2023-03-28,Georgia,Norway,1,1,0,0.5,0.5,1807,1914
2023-03-28,Wales,Latvia,1,0,1,1.0,0.0,1939,1629
2023-03-28,Turkey,Croatia,0,2,2,0.0,1.0,1942,2062
2023-03-28,Kosovo,Andorra,1,1,0,0.5,0.5,1698,1438
2023-03-28,Switzerland,Israel,3,0,3,1.0,0.0,2038,1796
2023-03-28,Romania,Belarus,2,1,1,1.0,0.0,1876,1714
2023-03-28,Costa Rica,Panama,0,1,1,0.0,1.0,1919,1873
2023-03-28,Canada,Honduras,4,1,3,1.0,0.0,1902,1788
2023-03-28,Haiti,Bermuda,3,1,2,1.0,0.0,1761,1564
2023-03-28,Guyana,Montserrat,0,0,0,0.5,0.5,1595,1469
2023-03-28,Bonaire,Turks and Caicos Islands,1,2,1,0.0,1.0,1478,1428
2023-03-28,United States Virgin Islands,Sint Maarten,1,2,1,0.0,1.0,1339,1451
2023-03-29,Rwanda,Benin,1,1,0,0.5,0.5,1641,1687
2023-03-31,Nepal,Laos,2,1,1,1.0,0.0,1469,1338
2023-04-19,United States,Mexico,1,1,0,0.5,0.5,2030,2028
2023-06-07,Mexico,Guatemala,2,0,2,1.0,0.0,2031,1768
2023-06-09,Luxembourg,Malta,0,1,1,0.0,1.0,1636,1564
2023-06-10,Mexico,Cameroon,2,2,0,0.5,0.5,2028,1881
2023-06-10,Panama,Nicaragua,3,2,1,1.0,0.0,1876,1579
2023-06-11,Chile,Cuba,3,0,3,1.0,0.0,1959,1631
2023-06-11,Guatemala,Trinidad and Tobago,0,1,1,0.0,1.0,1759,1710
2023-06-11,Tajikistan,Turkmenistan,1,1,0,0.5,0.5,1647,1611
2023-06-11,Uzbekistan,Oman,3,0,3,1.0,0.0,1879,1866
2023-06-11,Mauritius,Pakistan,3,0,3,1.0,0.0,1453,1350
2023-06-12,Germany,Ukraine,3,3,0,0.5,0.5,2112,1982
2023-06-12,Morocco,Cape Verde,0,0,0,0.5,0.5,1992,1755
2023-06-13,Iran,Afghanistan,6,1,5,1.0,0.0,2027,1514
2023-06-13,Curaçao,Costa Rica,0,0,0,0.5,0.5,1638,1914
2023-06-14,DR Congo,Uganda,1,0,1,1.0,0.0,1739,1701
2023-06-14,Indonesia,Palestine,0,0,0,0.5,0.5,1683,1719
2023-06-14,Malaysia,Solomon Islands,4,1,3,1.0,0.0,1687,1655
2023-06-14,Mozambique,Malawi,1,1,0,0.5,0.5,1640,1635
2023-06-14,Togo,Lesotho,2,0,2,1.0,0.0,1659,1558
2023-06-14,Uruguay,Nicaragua,4,1,3,1.0,0.0,2069,1579
2023-06-14,Netherlands,Croatia,2,4,2,0.0,1.0,2122,2072
2023-06-14,Oman,Tajikistan,1,1,0,0.5,0.5,1862,1652
2023-06-14,Uzbekistan,Turkmenistan,2,0,2,1.0,0.0,1882,1609
2023-06-14,Pakistan,Kenya,0,1,1,0.0,1.0,1349,1707
2023-06-14,Mauritius,Djibouti,1,3,2,0.0,1.0,1443,1330
2023-06-14,Guinea-Bissau,São Tomé and Príncipe,1,0,1,1.0,0.0,1620,1432
2023-06-14,Guinea,Egypt,1,2,1,0.0,1.0,1729,1939
2023-06-14,South Sudan,Gambia,2,3,1,0.0,1.0,1476,1674
2023-06-15,Panama,Canada,0,2,2,0.0,1.0,1869,1910
2023-06-15,United States,Mexico,3,0,3,1.0,0.0,2038,2021
2023-06-15,Argentina,Australia,2,0,2,1.0,0.0,2208,1980
2023-06-15,Cambodia,Bangladesh,0,1,1,0.0,1.0,1392,1424
2023-06-15,Costa Rica,Guatemala,0,1,1,0.0,1.0,1903,1771
2023-06-15,Honduras,Venezuela,0,1,1,0.0,1.0,1783,1902
2023-06-15,Jamaica,Qatar,1,2,1,0.0,1.0,1789,1898
2023-06-15,Japan,El Salvador,6,0,6,1.0,0.0,2039,1732
2023-06-15,Philippines,Nepal,1,0,1,1.0,0.0,1564,1464
2023-06-15,Vietnam,Hong Kong,1,0,1,1.0,0.0,1775,1588
2023-06-15,Spain,Italy,2,1,1,1.0,0.0,2160,2099
2023-06-16,Antigua and Barbuda,Guadeloupe,0,5,5,0.0,1.0,1574,1625
2023-06-16,Martinique,Saint Lucia,3,1,2,1.0,0.0,1688,1502
2023-06-16,Curaçao,Saint Kitts and Nevis,1,1,0,0.5,0.5,1637,1588
2023-06-16,Chile,Dominican Republic,5,0,5,1.0,0.0,1961,1572
2023-06-16,China PR,Myanmar,4,0,4,1.0,0.0,1825,1480
2023-06-16,Taiwan,Thailand,2,2,0,0.5,0.5,1471,1766
2023-06-16,Colombia,Iraq,1,0,1,1.0,0.0,2092,1905
2023-06-16,South Korea,Peru,0,1,1,0.0,1.0,2014,2006
2023-06-16,Poland,Germany,1,0,1,1.0,0.0,1995,2102
2023-06-16,Serbia,Jordan,3,2,1,1.0,0.0,2000,1842
2023-06-16,Singapore,Papua New Guinea,2,2,0,0.5,0.5,1608,1580
2023-06-16,Sweden,New Zealand,4,1,3,1.0,0.0,1990,1783
2023-06-16,Gibraltar,France,0,3,3,0.0,1.0,1499,2188
2023-06-16,Greece,Republic of Ireland,2,1,1,1.0,0.0,1882,1882
2023-06-16,Malta,England,0,4,4,0.0,1.0,1564,2144
2023-06-16,North Macedonia,Ukraine,2,3,1,0.0,1.0,1786,1986
2023-06-16,Wales,Armenia,2,4,2,0.0,1.0,1927,1724
2023-06-16,Latvia,Turkey,2,3,1,0.0,1.0,1627,1945
2023-06-16,Finland,Slovenia,2,0,2,1.0,0.0,1852,1841
2023-06-16,Denmark,Northern Ireland,1,0,1,1.0,0.0,2030,1785
2023-06-16,San Marino,Kazakhstan,0,3,3,0.0,1.0,1283,1672
2023-06-16,Andorra,Switzerland,1,2,1,0.0,1.0,1438,2039
2023-06-16,Belarus,Israel,1,2,1,0.0,1.0,1708,1803
2023-06-16,Kosovo,Romania,0,0,0,0.5,0.5,1702,1873
2023-06-16,Kyrgyzstan,Iran,1,5,4,0.0,1.0,1610,2029
2023-06-17,Guyana,Grenada,1,1,0,0.5,0.5,1594,1520
2023-06-17,Suriname,Puerto Rico,0,0,0,0.5,0.5,1638,1487
2023-06-17,French Guiana,Sint Maarten,4,1,3,1.0,0.0,1631,1447
2023-06-17,Brazil,Guinea,4,1,3,1.0,0.0,2235,1729
2023-06-17,Ecuador,Bolivia,1,0,1,1.0,0.0,1988,1779
2023-06-17,Norway,Scotland,1,2,1,0.0,1.0,1907,1941
2023-06-17,Cyprus,Georgia,1,2,1,0.0,1.0,1640,1812
2023-06-17,Faroe Islands,Czech Republic,0,3,3,0.0,1.0,1551,1941
2023-06-17,Albania,Moldova,2,0,2,1.0,0.0,1773,1559
2023-06-17,Azerbaijan,Estonia,1,1,0,0.5,0.5,1653,1720
2023-06-17,Belgium,Austria,1,1,0,0.5,0.5,2126,1940
2023-06-17,Lithuania,Bulgaria,1,1,0,0.5,0.5,1598,1772
2023-06-17,Montenegro,Hungary,0,0,0,0.5,0.5,1768,1928
2023-06-17,Luxembourg,Liechtenstein,2,0,2,1.0,0.0,1640,1389
2023-06-17,Iceland,Slovakia,1,2,1,0.0,1.0,1796,1865
2023-06-17,Portugal,Bosnia and Herzegovina,3,0,3,1.0,0.0,2119,1861
2023-06-17,Ticino,Raetia,1,8,7,0.0,1.0,1491,1447
2023-06-17,Turkmenistan,Oman,0,2,2,0.0,1.0,1606,1866
2023-06-17,Uzbekistan,Tajikistan,5,1,4,1.0,0.0,1886,1649
2023-06-17,Djibouti,Pakistan,3,1,2,1.0,0.0,1339,1341
2023-06-17,Central African Republic,Angola,1,2,1,0.0,1.0,1561,1709
2023-06-17,Zambia,Ivory Coast,3,0,3,1.0,0.0,1755,1898
2023-06-17,Lesotho,Comoros,0,1,1,0.0,1.0,1550,1565
2023-06-17,Equatorial Guinea,Tunisia,1,0,1,1.0,0.0,1683,1922
2023-06-17,Botswana,Libya,1,0,1,1.0,0.0,1640,1676
2023-06-17,South Africa,Morocco,2,1,1,1.0,0.0,1861,1981
2023-06-17,Benin,Senegal,1,1,0,0.5,0.5,1693,1946
2023-06-18,Panama,Mexico,0,1,1,0.0,1.0,1865,2026
2023-06-18,United States,Canada,2,0,2,1.0,0.0,2044,1905
2023-06-18,Egypt,South Sudan,3,0,3,1.0,0.0,1941,1475
2023-06-18,Guatemala,Venezuela,0,1,1,0.0,1.0,1766,1908
2023-06-18,Paraguay,Nicaragua,2,0,2,1.0,0.0,1901,1577
2023-06-18,Singapore,Solomon Islands,1,1,0,0.5,0.5,1610,1654
2023-06-18,Netherlands,Italy,2,3,1,0.0,1.0,2114,2108
2023-06-18,Croatia,Spain,0,0,0,0.5,0.5,2074,2159
2023-06-18,Mauritius,Kenya,1,0,1,1.0,0.0,1457,1694
2023-06-18,Sierra Leone,Nigeria,2,3,1,0.0,1.0,1623,1864
2023-06-18,Cape Verde,Burkina Faso,3,1,2,1.0,0.0,1765,1806
2023-06-18,Eswatini,Togo,0,2,2,0.0,1.0,1580,1666
2023-06-18,Madagascar,Ghana,0,0,0,0.5,0.5,1603,1859
2023-06-18,Tanzania,Niger,1,0,1,1.0,0.0,1650,1573
2023-06-18,Uganda,Algeria,1,2,1,0.0,1.0,1699,1963
2023-06-18,Congo,Mali,0,2,2,0.0,1.0,1625,1824
2023-06-18,Gabon,DR Congo,0,2,2,0.0,1.0,1727,1747
2023-06-18,Rwanda,Mozambique,0,2,2,0.0,1.0,1633,1649
2023-06-19,Hong Kong,Thailand,0,1,1,0.0,1.0,1584,1771
2023-06-19,Indonesia,Argentina,0,2,2,0.0,1.0,1683,2209
2023-06-19,Jamaica,Jordan,1,2,1,0.0,1.0,1783,1849
2023-06-19,Macau,Myanmar,0,2,2,0.0,1.0,1317,1485
2023-06-19,Philippines,Taiwan,2,3,1,0.0,1.0,1554,1482
2023-06-19,Republic of Ireland,Gibraltar,3,0,3,1.0,0.0,1884,1498
2023-06-19,France,Greece,1,0,1,1.0,0.0,2191,1880
2023-06-19,Ukraine,Malta,1,0,1,1.0,0.0,1988,1563
2023-06-19,England,North Macedonia,7,0,7,1.0,0.0,2146,1785
2023-06-19,Armenia,Latvia,2,1,1,1.0,0.0,1730,1622
2023-06-19,Turkey,Wales,2,0,2,1.0,0.0,1953,1920
2023-06-19,Finland,San Marino,6,0,6,1.0,0.0,1853,1283
2023-06-19,Northern Ireland,Kazakhstan,0,1,1,0.0,1.0,1775,1683
2023-06-19,Slovenia,Denmark,1,1,0,0.5,0.5,1845,2027
2023-06-19,Belarus,Kosovo,2,1,1,1.0,0.0,1716,1695
2023-06-19,Switzerland,Romania,2,2,0,0.5,0.5,2036,1877
2023-06-19,Israel,Andorra,2,1,1,1.0,0.0,1805,1437
2023-06-20,Guadeloupe,Guyana,2,0,2,1.0,0.0,1633,1587
2023-06-20,Martinique,Puerto Rico,2,0,2,1.0,0.0,1692,1484
2023-06-20,Saint Kitts and Nevis,French Guiana,1,1,0,0.5,0.5,1589,1631
2023-06-20,Algeria,Tunisia,1,1,0,0.5,0.5,1963,1923
2023-06-20,Bolivia,Chile,0,0,0,0.5,0.5,1783,1958
2023-06-20,Brazil,Senegal,2,4,2,0.0,1.0,2222,1960
2023-06-20,China PR,Palestine,2,0,2,1.0,0.0,1831,1714
2023-06-20,Ecuador,Costa Rica,3,1,2,1.0,0.0,1995,1897
2023-06-20,Germany,Colombia,0,2,2,0.0,1.0,2094,2101
2023-06-20,Haiti,Trinidad and Tobago,0,0,0,0.5,0.5,1760,1712
2023-06-20,Japan,Peru,4,1,3,1.0,0.0,2047,1999
2023-06-20,South Korea,El Salvador,1,1,0,0.5,0.5,2009,1738
2023-06-20,Malaysia,Papua New Guinea,10,0,10,1.0,0.0,1693,1575
2023-06-20,Montenegro,Czech Republic,1,4,3,0.0,1.0,1764,1946
2023-06-20,Uruguay,Cuba,2,0,2,1.0,0.0,2071,1630
2023-06-20,Vietnam,Syria,1,0,1,1.0,0.0,1783,1728
2023-06-20,Scotland,Georgia,2,0,2,1.0,0.0,1947,1807
2023-06-20,Norway,Cyprus,3,1,2,1.0,0.0,1910,1638
2023-06-20,Faroe Islands,Albania,1,3,2,0.0,1.0,1548,1777
2023-06-20,Moldova,Poland,3,2,1,1.0,0.0,1574,1981
2023-06-20,Austria,Sweden,2,0,2,1.0,0.0,1950,1981
2023-06-20,Estonia,Belgium,0,3,3,0.0,1.0,1719,2128
2023-06-20,Hungary,Lithuania,2,0,2,1.0,0.0,1931,1596
2023-06-20,Bulgaria,Serbia,1,1,0,0.5,0.5,1777,1996
2023-06-20,Iceland,Portugal,0,1,1,0.0,1.0,1794,2122
2023-06-20,Bosnia and Herzegovina,Luxembourg,0,2,2,0.0,1.0,1849,1653
2023-06-20,Liechtenstein,Slovakia,0,1,1,0.0,1.0,1389,1866
2023-06-20,Kyrgyzstan,Oman,0,1,1,0.0,1.0,1608,1869
2023-06-20,Uzbekistan,Iran,0,1,1,0.0,1.0,1882,2034
2023-06-20,Burundi,Namibia,3,2,1,1.0,0.0,1617,1682
2023-06-20,Ethiopia,Malawi,0,0,0,0.5,0.5,1646,1636
2023-06-20,Sudan,Mauritania,0,3,3,0.0,1.0,1603,1669
2023-06-21,Kuwait,Nepal,3,1,2,1.0,0.0,1744,1462
2023-06-21,India,Pakistan,4,0,4,1.0,0.0,1645,1339
2023-06-22,Lebanon,Bangladesh,2,0,2,1.0,0.0,1688,1422
2023-06-22,Maldives,Bhutan,2,0,2,1.0,0.0,1463,1241
2023-06-24,Pakistan,Kuwait,0,4,4,0.0,1.0,1338,1746
2023-06-24,India,Nepal,2,0,2,1.0,0.0,1650,1458
2023-06-24,United States,Jamaica,1,1,0,0.5,0.5,2039,1789
2023-06-25,Bangladesh,Maldives,3,1,2,1.0,0.0,1431,1455
2023-06-25,Bhutan,Lebanon,1,4,3,0.0,1.0,1240,1690
2023-06-25,Trinidad and Tobago,Saint Kitts and Nevis,3,0,3,1.0,0.0,1718,1584
2023-06-25,Haiti,Qatar,2,1,1,1.0,0.0,1772,1887
2023-06-25,Mexico,Honduras,4,0,4,1.0,0.0,2030,1780
2023-06-26,El Salvador,Martinique,1,2,1,0.0,1.0,1729,1702
2023-06-26,Costa Rica,Panama,1,2,1,0.0,1.0,1889,1874
2023-06-27,Nepal,Pakistan,1,0,1,1.0,0.0,1464,1333
2023-06-27,India,Kuwait,1,1,0,0.5,0.5,1653,1744
2023-06-27,Canada,Guadeloupe,2,2,0,0.5,0.5,1900,1639
2023-06-27,Guatemala,Cuba,1,0,1,1.0,0.0,1772,1625
2023-06-28,Lebanon,Maldives,1,0,1,1.0,0.0,1694,1452
2023-06-28,Bhutan,Bangladesh,1,3,2,0.0,1.0,1237,1435
2023-06-28,Jamaica,Trinidad and Tobago,4,1,3,1.0,0.0,1796,1712
2023-06-28,United States,Saint Kitts and Nevis,6,0,6,1.0,0.0,2041,1583
2023-06-29,Qatar,Honduras,1,1,0,0.5,0.5,1885,1783
2023-06-29,Haiti,Mexico,1,3,2,0.0,1.0,1770,2033
2023-06-30,Székely Land,Chameria,3,2,1,1.0,0.0,1481,1505
2023-06-30,Martinique,Panama,1,2,1,0.0,1.0,1698,1879
2023-06-30,El Salvador,Costa Rica,0,0,0,0.5,0.5,1733,1886
2023-07-01,Chameria,Two Sicilies,3,1,2,1.0,0.0,1513,1480
2023-07-01,India,Lebanon,0,0,0,0.5,0.5,1654,1694
2023-07-01,Kuwait,Bangladesh,1,0,1,1.0,0.0,1747,1433
2023-07-01,Cuba,Guadeloupe,1,4,3,0.0,1.0,1618,1647
2023-07-01,Guatemala,Canada,0,0,0,0.5,0.5,1775,1898
2023-07-02,Székely Land,Two Sicilies,7,0,7,1.0,0.0,1489,1473
2023-07-02,United States,Trinidad and Tobago,6,0,6,1.0,0.0,2044,1710
2023-07-02,Jamaica,Saint Kitts and Nevis,5,0,5,1.0,0.0,1800,1580
2023-07-02,Honduras,Haiti,2,1,1,1.0,0.0,1791,1763
2023-07-02,Mexico,Qatar,0,1,1,0.0,1.0,2022,1897
2023-07-04,India,Kuwait,1,1,0,0.5,0.5,1657,1745
2023-07-04,Costa Rica,Martinique,6,4,2,1.0,0.0,1891,1694
2023-07-04,Panama,El Salvador,2,2,0,0.5,0.5,1876,1737
2023-07-04,Guadeloupe,Guatemala,2,3,1,0.0,1.0,1642,1781
2023-07-04,Canada,Cuba,4,2,2,1.0,0.0,1901,1616
2023-07-05,Eswatini,Botswana,0,1,1,0.0,1.0,1574,1647
2023-07-05,South Africa,Namibia,1,1,0,0.5,0.5,1858,1686
2023-07-06,Seychelles,Comoros,0,3,3,0.0,1.0,1381,1570
2023-07-06,Zambia,Malawi,0,1,1,0.0,1.0,1745,1647
2023-07-07,Mauritius,Lesotho,0,2,2,0.0,1.0,1452,1556
2023-07-07,Mozambique,Angola,1,1,0,0.5,0.5,1651,1708
2023-07-08,Panama,Qatar,4,0,4,1.0,0.0,1885,1889
2023-07-08,Mexico,Costa Rica,2,0,2,1.0,0.0,2028,1886
2023-07-08,South Africa,Botswana,2,1,1,1.0,0.0,1862,1644
2023-07-08,Namibia,Eswatini,1,2,1,0.0,1.0,1676,1585
2023-07-09,Guatemala,Jamaica,0,1,1,0.0,1.0,1774,1808
2023-07-09,United States,Canada,2,2,0,0.5,0.5,2041,1905
2023-07-09,Åland Islands,Isle of Wight,0,2,2,0.0,1.0,1547,1601
2023-07-09,Guernsey,Western Isles,1,0,1,1.0,0.0,1727,1489
2023-07-09,Isle of Man,Falkland Islands,3,0,3,1.0,0.0,1632,1404
2023-07-09,Ynys Môn,Shetland,2,0,2,1.0,0.0,1622,1488
2023-07-09,Orkney,Greenland,2,2,0,0.5,0.5,1449,1502
2023-07-09,Jersey,Gozo,1,0,1,1.0,0.0,1766,1482
2023-07-09,Menorca,Saint Helena,5,0,5,1.0,0.0,1566,1470
2023-07-09,Zambia,Comoros,2,1,1,1.0,0.0,1750,1566
2023-07-09,Malawi,Seychelles,2,0,2,1.0,0.0,1650,1379
2023-07-10,Western Isles,Isle of Wight,0,1,1,0.0,1.0,1484,1607
2023-07-10,Guernsey,Åland Islands,4,1,3,1.0,0.0,1732,1543
2023-07-10,Falkland Islands,Ynys Môn,1,5,4,0.0,1.0,1401,1626
2023-07-10,Shetland,Isle of Man,3,2,1,1.0,0.0,1500,1621
2023-07-10,Greenland,Frøya,2,0,2,1.0,0.0,1509,1411
2023-07-10,Gozo,Saint Helena,3,0,3,1.0,0.0,1490,1463
2023-07-10,Jersey,Menorca,4,0,4,1.0,0.0,1770,1563
2023-07-10,Angola,Mauritius,0,1,1,0.0,1.0,1695,1466
2023-07-10,Mozambique,Lesotho,0,1,1,0.0,1.0,1641,1567
2023-07-11,Guernsey,Isle of Wight,1,2,1,0.0,1.0,1722,1618
2023-07-11,Åland Islands,Western Isles,0,2,2,0.0,1.0,1534,1494
2023-07-11,Falkland Islands,Shetland,1,4,3,0.0,1.0,1396,1506
2023-07-11,Isle of Man,Ynys Môn,1,2,1,0.0,1.0,1614,1634
2023-07-11,Frøya,Orkney,2,3,1,0.0,1.0,1404,1457
2023-07-11,Menorca,Gozo,0,1,1,0.0,1.0,1554,1500
2023-07-11,Saint Helena,Jersey,0,5,5,0.0,1.0,1461,1773
2023-07-11,Namibia,Botswana,0,0,0,0.5,0.5,1676,1645
2023-07-11,South Africa,Eswatini,2,1,1,1.0,0.0,1865,1583
2023-07-11,Malawi,Comoros,2,0,2,1.0,0.0,1657,1560
2023-07-11,Seychelles,Zambia,2,4,2,0.0,1.0,1378,1752
2023-07-12,United States,Panama,1,1,0,0.5,0.5,2038,1889
2023-07-12,Jamaica,Mexico,0,3,3,0.0,1.0,1805,2032
2023-07-12,Angola,Lesotho,4,2,2,1.0,0.0,1701,1562
2023-07-12,Mauritius,Mozambique,0,1,1,0.0,1.0,1462,1646
2023-07-13,Frøya,Saint Helena,4,2,2,1.0,0.0,1414,1452
2023-07-13,Åland Islands,Falkland Islands,1,1,0,0.5,0.5,1531,1400
2023-07-13,Western Isles,Menorca,2,1,1,1.0,0.0,1504,1545
2023-07-13,Orkney,Isle of Man,0,1,1,0.0,1.0,1453,1619
2023-07-13,Shetland,Greenland,5,1,4,1.0,0.0,1515,1501
2023-07-13,Guernsey,Gozo,1,0,1,1.0,0.0,1726,1497
2023-07-13,Isle of Wight,Jersey,2,3,1,0.0,1.0,1614,1778
2023-07-14,Ynys Môn,Jersey,2,5,3,0.0,1.0,1630,1783
2023-07-14,Malawi,Lesotho,1,1,0,0.5,0.5,1655,1565
2023-07-14,South Africa,Zambia,1,2,1,0.0,1.0,1855,1763
2023-07-16,Kernow,Sápmi,2,1,1,1.0,0.0,1568,1489
2023-07-16,Mexico,Panama,1,0,1,1.0,0.0,2037,1885
2023-07-16,South Africa,Malawi,0,0,0,0.5,0.5,1851,1660
2023-07-16,Lesotho,Zambia,0,1,1,0.0,1.0,1562,1767
2023-08-02,Ethiopia,Guyana,2,0,2,1.0,0.0,1653,1581
2023-08-04,Tamil Eelam,Hmong,3,0,3,1.0,0.0,1498,1492
2023-08-05,Hmong,Tibet,5,4,1,1.0,0.0,1499,1419
2023-08-06,Tibet,Tamil Eelam,1,3,2,0.0,1.0,1413,1505
2023-08-06,Raetia,Ticino,5,1,4,1.0,0.0,1457,1482
2023-08-08,Tamil Eelam,Hmong,3,1,2,1.0,0.0,1513,1492
2023-08-24,Comoros,Mayotte,0,0,0,0.5,0.5,1560,1526
2023-08-24,Madagascar,Seychelles,1,0,1,1.0,0.0,1607,1375
2023-08-26,Réunion,Mayotte,0,0,0,0.5,0.5,1649,1529
2023-08-26,Madagascar,Mauritius,1,1,0,0.5,0.5,1604,1466
2023-08-27,Bolivia,Panama,1,2,1,0.0,1.0,1778,1891
2023-08-28,Tahiti,Cook Islands,9,1,8,1.0,0.0,1640,1431
2023-08-28,Comoros,Réunion,1,1,0,0.5,0.5,1563,1647
2023-08-28,Mauritius,Seychelles,1,0,1,1.0,0.0,1472,1370
2023-08-31,Tahiti,Cook Islands,3,0,3,1.0,0.0,1644,1428
2023-08-31,Madagascar,Comoros,4,2,2,1.0,0.0,1612,1556
2023-08-31,Réunion,Mauritius,2,1,1,1.0,0.0,1652,1468
2023-09-02,Comoros,Mauritius,0,2,2,0.0,1.0,1547,1478
2023-09-02,Madagascar,Réunion,1,0,1,1.0,0.0,1621,1644
2023-09-03,Bangladesh,Afghanistan,0,0,0,0.5,0.5,1435,1513
2023-09-03,Guatemala,Honduras,0,0,0,0.5,0.5,1775,1791
2023-09-04,Mozambique,Benin,3,2,1,1.0,0.0,1656,1684
2023-09-06,Macau,Bhutan,0,1,1,0.0,1.0,1308,1247
2023-09-06,Malta,Gibraltar,1,0,1,1.0,0.0,1570,1492
2023-09-06,Oman,Palestine,2,1,1,1.0,0.0,1874,1710
2023-09-06,Syria,Malaysia,2,2,0,0.5,0.5,1728,1694
2023-09-06,Libya,Equatorial Guinea,1,1,0,0.5,0.5,1677,1683
2023-09-07,Trinidad and Tobago,Curaçao,1,0,1,1.0,0.0,1717,1631
2023-09-07,Panama,Martinique,3,0,3,1.0,0.0,1895,1691
2023-09-07,Guatemala,El Salvador,2,0,2,1.0,0.0,1783,1730
2023-09-07,Sint Maarten,Saint Lucia,1,5,4,0.0,1.0,1441,1509
2023-09-07,Saint Kitts and Nevis,Guadeloupe,1,2,1,0.0,1.0,1574,1649
2023-09-07,Anguilla,Saint Martin,0,6,6,0.0,1.0,1279,1431
2023-09-07,United States Virgin Islands,Cayman Islands,2,2,0,0.5,0.5,1341,1401
2023-09-07,Colombia,Venezuela,1,0,1,1.0,0.0,2105,1905
2023-09-07,Paraguay,Peru,0,0,0,0.5,0.5,1904,1997
2023-09-07,Argentina,Ecuador,1,0,1,1.0,0.0,2213,1992
2023-09-07,Austria,Moldova,1,1,0,0.5,0.5,1944,1581
2023-09-07,Bahrain,Kuwait,1,3,2,0.0,1.0,1831,1756
2023-09-07,Bangladesh,Afghanistan,1,1,0,0.5,0.5,1437,1512
2023-09-07,Bulgaria,Iran,0,1,1,0.0,1.0,1775,2037
2023-09-07,Cambodia,Hong Kong,1,1,0,0.5,0.5,1397,1580
2023-09-07,Norway,Jordan,6,0,6,1.0,0.0,1917,1843
2023-09-07,Qatar,Kenya,1,2,1,0.0,1.0,1877,1707
2023-09-07,Wales,South Korea,0,0,0,0.5,0.5,1923,2007
2023-09-07,Ghana,Central African Republic,2,1,1,1.0,0.0,1862,1559
2023-09-07,Angola,Madagascar,0,0,0,0.5,0.5,1700,1623
2023-09-07,Algeria,Tanzania,0,0,0,0.5,0.5,1958,1656
2023-09-07,Niger,Uganda,0,2,2,0.0,1.0,1568,1705
2023-09-07,Tunisia,Botswana,3,0,3,1.0,0.0,1926,1643
2023-09-07,France,Republic of Ireland,2,0,2,1.0,0.0,2194,1882
2023-09-07,Netherlands,Greece,3,0,3,1.0,0.0,2118,1877
2023-09-07,Czech Republic,Albania,1,1,0,0.5,0.5,1943,1781
2023-09-07,Poland,Faroe Islands,2,0,2,1.0,0.0,1983,1547
2023-09-07,Serbia,Hungary,1,2,1,0.0,1.0,1987,1941
2023-09-07,Lithuania,Montenegro,2,2,0,0.5,0.5,1600,1761
2023-09-07,Kazakhstan,Finland,0,1,1,0.0,1.0,1679,1858
2023-09-07,Denmark,San Marino,4,0,4,1.0,0.0,2028,1283
2023-09-07,Slovenia,Northern Ireland,4,2,2,1.0,0.0,1852,1769
2023-09-07,Iraq,India,2,2,0,0.5,0.5,1901,1662
2023-09-07,Thailand,Lebanon,2,1,1,1.0,0.0,1778,1688
2023-09-08,Haiti,Cuba,0,0,0,0.5,0.5,1760,1620
2023-09-08,Grenada,Suriname,1,1,0,0.5,0.5,1523,1636
2023-09-08,Jamaica,Honduras,1,0,1,1.0,0.0,1813,1784
2023-09-08,Barbados,Montserrat,2,3,1,0.0,1.0,1486,1478
2023-09-08,Dominican Republic,Nicaragua,0,2,2,0.0,1.0,1565,1585
2023-09-08,Bermuda,French Guiana,0,0,0,0.5,0.5,1566,1630
2023-09-08,Belize,Saint Vincent and the Grenadines,1,2,1,0.0,1.0,1475,1507
2023-09-08,Uruguay,Chile,3,1,2,1.0,0.0,2077,1953
2023-09-08,Brazil,Bolivia,5,1,4,1.0,0.0,2224,1777
2023-09-08,Taiwan,Philippines,1,1,0,0.5,0.5,1484,1553
2023-09-08,Costa Rica,Saudi Arabia,3,1,2,1.0,0.0,1894,1862
2023-09-08,Indonesia,Turkmenistan,2,0,2,1.0,0.0,1690,1600
2023-09-08,Myanmar,Nepal,0,0,0,0.5,0.5,1485,1465
2023-09-08,Singapore,Tajikistan,0,2,2,0.0,1.0,1603,1657
2023-09-08,Burkina Faso,Eswatini,0,0,0,0.5,0.5,1802,1588
2023-09-08,Egypt,Ethiopia,1,0,1,1.0,0.0,1944,1651
2023-09-08,Mali,South Sudan,4,0,4,1.0,0.0,1826,1474
2023-09-08,Georgia,Spain,1,7,6,0.0,1.0,1806,2161
2023-09-08,Cyprus,Scotland,0,3,3,0.0,1.0,1636,1950
2023-09-08,Croatia,Latvia,5,0,5,1.0,0.0,2076,1621
2023-09-08,Turkey,Armenia,1,1,0,0.5,0.5,1949,1735
2023-09-08,Bosnia and Herzegovina,Liechtenstein,2,1,1,1.0,0.0,1851,1388
2023-09-08,Luxembourg,Iceland,3,1,2,1.0,0.0,1665,1783
2023-09-08,Slovakia,Portugal,0,1,1,0.0,1.0,1864,2125
2023-09-09,Antigua and Barbuda,Guyana,1,5,4,0.0,1.0,1567,1589
2023-09-09,Bahamas,Puerto Rico,1,6,5,0.0,1.0,1445,1492
2023-09-09,British Virgin Islands,Turks and Caicos Islands,3,1,2,1.0,0.0,1325,1418
2023-09-09,China PR,Malaysia,1,1,0,0.5,0.5,1828,1698
2023-09-09,Germany,Japan,1,4,3,0.0,1.0,2085,2057
2023-09-09,Mexico,Australia,2,2,0,0.5,0.5,2036,1982
2023-09-09,South Africa,Namibia,0,0,0,0.5,0.5,1848,1680
2023-09-09,United States,Uzbekistan,3,0,3,1.0,0.0,2043,1878
2023-09-09,Malawi,Guinea,2,2,0,0.5,0.5,1662,1728
2023-09-09,Ivory Coast,Lesotho,1,0,1,1.0,0.0,1901,1560
2023-09-09,Comoros,Zambia,1,1,0,0.5,0.5,1552,1763
2023-09-09,Mauritania,Gabon,2,1,1,1.0,0.0,1679,1718
2023-09-09,DR Congo,Sudan,2,0,2,1.0,0.0,1752,1599
2023-09-09,Rwanda,Senegal,1,1,0,0.5,0.5,1639,1955
2023-09-09,Ukraine,England,1,1,0,0.5,0.5,1992,2143
2023-09-09,North Macedonia,Italy,1,1,0,0.5,0.5,1791,2103
2023-09-09,Azerbaijan,Belgium,0,1,1,0.0,1.0,1653,2129
2023-09-09,Estonia,Sweden,0,5,5,0.0,1.0,1717,1984
2023-09-09,Andorra,Belarus,0,0,0,0.5,0.5,1443,1711
2023-09-09,Kosovo,Switzerland,2,2,0,0.5,0.5,1702,2030
2023-09-09,Romania,Israel,1,1,0,0.5,0.5,1876,1807
2023-09-10,Guatemala,Panama,1,1,0,0.5,0.5,1786,1893
2023-09-10,El Salvador,Trinidad and Tobago,2,3,1,0.0,1.0,1722,1726
2023-09-10,Martinique,Curaçao,1,0,1,1.0,0.0,1698,1625
2023-09-10,Guadeloupe,Sint Maarten,4,0,4,1.0,0.0,1653,1438
2023-09-10,Saint Lucia,Saint Kitts and Nevis,2,0,2,1.0,0.0,1519,1565
2023-09-10,Hungary,Czech Republic,1,1,0,0.5,0.5,1942,1943
2023-09-10,Nigeria,São Tomé and Príncipe,6,0,6,1.0,0.0,1866,1431
2023-09-10,Togo,Cape Verde,3,2,1,1.0,0.0,1677,1755
2023-09-10,Gambia,Congo,2,2,0,0.5,0.5,1673,1627
2023-09-10,Republic of Ireland,Netherlands,1,2,1,0.0,1.0,1879,2122
2023-09-10,Greece,Gibraltar,5,0,5,1.0,0.0,1879,1491
2023-09-10,Faroe Islands,Moldova,0,1,1,0.0,1.0,1540,1589
2023-09-10,Albania,Poland,2,0,2,1.0,0.0,1794,1971
2023-09-10,Montenegro,Bulgaria,2,1,1,1.0,0.0,1770,1767
2023-09-10,Lithuania,Serbia,1,3,2,0.0,1.0,1599,1989
2023-09-10,Finland,Denmark,0,1,1,0.0,1.0,1854,2033
2023-09-10,Kazakhstan,Northern Ireland,1,0,1,1.0,0.0,1690,1759
2023-09-10,San Marino,Slovenia,0,4,4,0.0,1.0,1283,1853
2023-09-10,Lebanon,India,1,0,1,1.0,0.0,1696,1655
2023-09-10,Thailand,Iraq,2,2,0,0.5,0.5,1781,1899
2023-09-11,Dominican Republic,Montserrat,3,0,3,1.0,0.0,1572,1472
2023-09-11,Nicaragua,Barbados,5,1,4,1.0,0.0,1591,1481
2023-09-11,Saint Martin,Bonaire,2,1,1,1.0,0.0,1441,1469
2023-09-11,Cayman Islands,Aruba,1,2,1,0.0,1.0,1394,1416
2023-09-11,Cambodia,Macau,4,0,4,1.0,0.0,1403,1303
2023-09-11,Hong Kong,Brunei,10,0,10,1.0,0.0,1583,1265
2023-09-11,Kuwait,Kyrgyzstan,1,3,2,0.0,1.0,1745,1620
2023-09-11,Myanmar,Nepal,1,0,1,1.0,0.0,1493,1458
2023-09-11,Vietnam,Palestine,2,0,2,1.0,0.0,1790,1704
2023-09-11,Guinea-Bissau,Sierra Leone,2,1,1,1.0,0.0,1629,1615
2023-09-11,Armenia,Croatia,0,1,1,0.0,1.0,1734,2078
2023-09-11,Latvia,Wales,0,2,2,0.0,1.0,1619,1926
2023-09-11,Iceland,Bosnia and Herzegovina,1,0,1,1.0,0.0,1793,1842
2023-09-11,Portugal,Luxembourg,9,0,9,1.0,0.0,2127,1664
2023-09-11,Slovakia,Liechtenstein,3,0,3,1.0,0.0,1865,1388
2023-09-12,Cuba,Suriname,1,0,1,1.0,0.0,1629,1628
2023-09-12,Jamaica,Haiti,2,2,0,0.5,0.5,1812,1762
2023-09-12,Honduras,Grenada,4,0,4,1.0,0.0,1787,1521
2023-09-12,Saint Vincent and the Grenadines,Bermuda,4,3,1,1.0,0.0,1517,1557
2023-09-12,French Guiana,Belize,0,2,2,0.0,1.0,1619,1487
2023-09-12,Guyana,Bahamas,3,2,1,1.0,0.0,1594,1441
2023-09-12,Puerto Rico,Antigua and Barbuda,5,0,5,1.0,0.0,1502,1558
2023-09-12,Turks and Caicos Islands,Dominica,0,3,3,0.0,1.0,1411,1456
2023-09-12,Bolivia,Argentina,0,3,3,0.0,1.0,1776,2215
2023-09-12,Ecuador,Uruguay,2,1,1,1.0,0.0,2002,2068
2023-09-12,Venezuela,Paraguay,1,0,1,1.0,0.0,1913,1897
2023-09-12,Peru,Brazil,0,1,1,0.0,1.0,1994,2228
2023-09-12,Chile,Colombia,0,0,0,0.5,0.5,1957,2102
2023-09-12,Azerbaijan,Jordan,2,1,1,1.0,0.0,1665,1832
2023-09-12,Bahrain,Turkmenistan,1,1,0,0.5,0.5,1827,1605
2023-09-12,China PR,Syria,0,1,1,0.0,1.0,1818,1739
2023-09-12,Egypt,Tunisia,1,3,2,0.0,1.0,1936,1935
2023-09-12,Germany,France,2,1,1,1.0,0.0,2096,2184
2023-09-12,Qatar,Russia,1,1,0,0.5,0.5,1880,1964
2023-09-12,Ghana,Liberia,3,1,2,1.0,0.0,1865,1592
2023-09-12,Iran,Angola,4,0,4,1.0,0.0,2040,1698
2023-09-12,Japan,Turkey,4,2,2,1.0,0.0,2063,1944
2023-09-12,Kenya,South Sudan,0,1,1,0.0,1.0,1695,1487
2023-09-12,South Korea,Saudi Arabia,1,0,1,1.0,0.0,2012,1858
2023-09-12,Mexico,Uzbekistan,3,3,0,0.5,0.5,2033,1882
2023-09-12,Morocco,Burkina Faso,1,0,1,1.0,0.0,1986,1798
2023-09-12,Philippines,Afghanistan,2,1,1,1.0,0.0,1561,1505
2023-09-12,Scotland,England,1,3,2,0.0,1.0,1947,2147
2023-09-12,Senegal,Algeria,0,1,1,0.0,1.0,1948,1966
2023-09-12,Singapore,Taiwan,3,1,2,1.0,0.0,1609,1479
2023-09-12,South Africa,DR Congo,1,0,1,1.0,0.0,1854,1747
2023-09-12,United Arab Emirates,Costa Rica,4,1,3,1.0,0.0,1840,1885
2023-09-12,United States,Oman,4,0,4,1.0,0.0,2048,1870
2023-09-12,Cameroon,Burundi,3,0,3,1.0,0.0,1884,1615
2023-09-12,Norway,Georgia,2,1,1,1.0,0.0,1923,1801
2023-09-12,Spain,Cyprus,6,0,6,1.0,0.0,2162,1636
2023-09-12,Italy,Ukraine,2,1,1,1.0,0.0,2109,1987
2023-09-12,Malta,North Macedonia,0,2,2,0.0,1.0,1567,1795
2023-09-12,Belgium,Estonia,5,0,5,1.0,0.0,2131,1716
2023-09-12,Sweden,Austria,1,3,2,0.0,1.0,1976,1953
2023-09-12,Switzerland,Andorra,3,0,3,1.0,0.0,2031,1443
2023-09-12,Israel,Belarus,1,0,1,1.0,0.0,1813,1706
2023-09-12,Romania,Kosovo,2,0,2,1.0,0.0,1881,1698
2023-10-08,Papua New Guinea,Solomon Islands,1,3,2,0.0,1.0,1569,1661
2023-10-08,New Caledonia,Vanuatu,4,0,4,1.0,0.0,1639,1603
2023-10-10,China PR,Vietnam,2,0,2,1.0,0.0,1826,1783
2023-10-11,Wales,Gibraltar,4,0,4,1.0,0.0,1928,1490
2023-10-11,Solomon Islands,Vanuatu,1,0,1,1.0,0.0,1668,1597
2023-10-11,New Caledonia,Papua New Guinea,3,1,2,1.0,0.0,1646,1563
2023-10-12,Suriname,Haiti,1,1,0,0.5,0.5,1631,1760
2023-10-12,Grenada,Jamaica,1,4,3,0.0,1.0,1519,1815
2023-10-12,Cuba,Honduras,0,0,0,0.5,0.5,1633,1784
2023-10-12,Sint Maarten,Saint Kitts and Nevis,2,3,1,0.0,1.0,1433,1571
2023-10-12,Saint Lucia,Guadeloupe,2,1,1,1.0,0.0,1530,1643
2023-10-12,Bonaire,Anguilla,2,0,2,1.0,0.0,1474,1275
2023-10-12,Dominica,British Virgin Islands,1,1,0,0.5,0.5,1454,1328
2023-10-12,Colombia,Uruguay,2,2,0,0.5,0.5,2102,2069
2023-10-12,Bolivia,Ecuador,1,2,1,0.0,1.0,1773,2006
2023-10-12,Argentina,Paraguay,1,0,1,1.0,0.0,2218,1895
2023-10-12,Brazil,Venezuela,1,1,0,0.5,0.5,2223,1919
2023-10-12,Chile,Peru,2,0,2,1.0,0.0,1966,1986
2023-10-12,Afghanistan,Mongolia,1,0,1,1.0,0.0,1511,1396
2023-10-12,Cambodia,Pakistan,0,0,0,0.5,0.5,1402,1335
2023-10-12,Taiwan,Timor-Leste,4,0,4,1.0,0.0,1483,1270
2023-10-12,Hong Kong,Bhutan,4,0,4,1.0,0.0,1586,1245
2023-10-12,Indonesia,Brunei,6,0,6,1.0,0.0,1692,1264
2023-10-12,Maldives,Bangladesh,1,1,0,0.5,0.5,1452,1438
2023-10-12,Myanmar,Macau,5,1,4,1.0,0.0,1498,1299
2023-10-12,Nepal,Laos,1,1,0,0.5,0.5,1456,1341
2023-10-12,Singapore,Guam,2,1,1,1.0,0.0,1613,1363
2023-10-12,Yemen,Sri Lanka,3,0,3,1.0,0.0,1539,1310
2023-10-12,Algeria,Cape Verde,5,1,4,1.0,0.0,1970,1752
2023-10-12,Bahrain,Kyrgyzstan,2,0,2,1.0,0.0,1831,1617
2023-10-12,Egypt,Zambia,1,0,1,1.0,0.0,1941,1759
2023-10-12,Georgia,Thailand,8,0,8,1.0,0.0,1809,1774
2023-10-12,Montenegro,Lebanon,3,2,1,1.0,0.0,1777,1690
2023-10-12,Russia,Cameroon,1,0,1,1.0,0.0,1971,1878
2023-10-12,Sweden,Moldova,3,1,2,1.0,0.0,1978,1588
2023-10-12,Spain,Scotland,2,0,2,1.0,0.0,2166,1944
2023-10-12,Cyprus,Norway,0,4,4,0.0,1.0,1634,1926
2023-10-12,Latvia,Armenia,2,0,2,1.0,0.0,1630,1724
2023-10-12,Croatia,Turkey,0,1,1,0.0,1.0,2068,1955
2023-10-12,Faroe Islands,Poland,0,2,2,0.0,1.0,1539,1973
2023-10-12,Albania,Czech Republic,3,0,3,1.0,0.0,1806,1932
2023-10-12,Andorra,Kosovo,0,3,3,0.0,1.0,1441,1701
2023-10-12,Belarus,Romania,0,0,0,0.5,0.5,1710,1878
2023-10-13,Curaçao,Panama,1,2,1,0.0,1.0,1623,1896
2023-10-13,Martinique,El Salvador,1,0,1,1.0,0.0,1707,1714
2023-10-13,Trinidad and Tobago,Guatemala,3,2,1,1.0,0.0,1736,1777
2023-10-13,Montserrat,Nicaragua,0,3,3,0.0,1.0,1467,1597
2023-10-13,Barbados,Dominican Republic,0,5,5,0.0,1.0,1476,1578
2023-10-13,Saint Vincent and the Grenadines,French Guiana,1,4,3,0.0,1.0,1512,1625
2023-10-13,Belize,Bermuda,0,1,1,0.0,1.0,1481,1564
2023-10-13,DR Congo,New Zealand,1,1,0,0.5,0.5,1748,1783
2023-10-13,England,Australia,1,0,1,1.0,0.0,2152,1978
2023-10-13,Equatorial Guinea,Burkina Faso,0,0,0,0.5,0.5,1686,1796
2023-10-13,Guinea,Guinea-Bissau,1,0,1,1.0,0.0,1734,1624
2023-10-13,Iraq,Qatar,0,0,0,0.5,0.5,1899,1881
2023-10-13,Japan,Canada,4,1,3,1.0,0.0,2068,1901
2023-10-13,South Korea,Tunisia,4,0,4,1.0,0.0,2019,1929
2023-10-13,Mali,Uganda,1,0,1,1.0,0.0,1832,1700
2023-10-13,Nigeria,Saudi Arabia,2,2,0,0.5,0.5,1866,1859
2023-10-13,South Africa,Eswatini,0,0,0,0.5,0.5,1849,1594
2023-10-13,Vietnam,Uzbekistan,0,2,2,0.0,1.0,1778,1888
2023-10-13,Republic of Ireland,Greece,0,2,2,0.0,1.0,1871,1887
2023-10-13,Netherlands,France,1,2,1,0.0,1.0,2116,2191
2023-10-13,Estonia,Azerbaijan,0,2,2,0.0,1.0,1707,1675
2023-10-13,Austria,Belgium,2,3,1,0.0,1.0,1949,2136
2023-10-13,Iceland,Luxembourg,1,1,0,0.5,0.5,1791,1667
2023-10-13,Portugal,Slovakia,3,2,1,1.0,0.0,2130,1863
2023-10-13,Liechtenstein,Bosnia and Herzegovina,0,2,2,0.0,1.0,1387,1844
2023-10-13,Angola,Mozambique,1,1,0,0.5,0.5,1698,1657
2023-10-14,Puerto Rico,Guyana,1,3,2,0.0,1.0,1497,1600
2023-10-14,Bahamas,Antigua and Barbuda,1,4,3,0.0,1.0,1436,1564
2023-10-14,Aruba,United States Virgin Islands,3,1,2,1.0,0.0,1423,1335
2023-10-14,Ivory Coast,Morocco,1,1,0,0.5,0.5,1903,1985
2023-10-14,Liberia,Libya,2,3,1,0.0,1.0,1586,1684
2023-10-14,Mauritania,Madagascar,2,1,1,1.0,0.0,1686,1617
2023-10-14,Mexico,Ghana,2,0,2,1.0,0.0,2038,1861
2023-10-14,Niger,Somalia,3,0,3,1.0,0.0,1572,1316
2023-10-14,Sierra Leone,Benin,1,1,0,0.5,0.5,1617,1683
2023-10-14,United States,Germany,1,3,2,0.0,1.0,2042,2103
2023-10-14,Ukraine,North Macedonia,2,0,2,1.0,0.0,1991,1792
2023-10-14,Italy,Malta,4,0,4,1.0,0.0,2110,1567
2023-10-14,Bulgaria,Lithuania,0,2,2,0.0,1.0,1756,1611
2023-10-14,Hungary,Serbia,2,1,1,1.0,0.0,1952,1980
2023-10-14,Northern Ireland,San Marino,3,0,3,1.0,0.0,1760,1283
2023-10-14,Slovenia,Finland,3,0,3,1.0,0.0,1862,1846
2023-10-14,Denmark,Kazakhstan,3,1,2,1.0,0.0,2035,1689
2023-10-14,Papua New Guinea,Vanuatu,0,1,1,0.0,1.0,1556,1605
2023-10-14,New Caledonia,Solomon Islands,0,1,1,0.0,1.0,1639,1676
2023-10-15,Honduras,Cuba,4,0,4,1.0,0.0,1789,1629
2023-10-15,Haiti,Jamaica,2,3,1,0.0,1.0,1754,1822
2023-10-15,Suriname,Grenada,4,0,4,1.0,0.0,1637,1514
2023-10-15,Guadeloupe,Saint Lucia,2,0,2,1.0,0.0,1649,1525
2023-10-15,Saint Kitts and Nevis,Sint Maarten,0,1,1,0.0,1.0,1560,1445
2023-10-15,Kyrgyzstan,Philippines,0,1,1,0.0,1.0,1608,1571
2023-10-15,Sudan,Tanzania,1,1,0,0.5,0.5,1601,1655
2023-10-15,Georgia,Cyprus,4,0,4,1.0,0.0,1814,1630
2023-10-15,Norway,Spain,0,1,1,0.0,1.0,1923,2170
2023-10-15,Wales,Croatia,2,1,1,1.0,0.0,1940,2057
2023-10-15,Turkey,Latvia,4,0,4,1.0,0.0,1958,1628
2023-10-15,Czech Republic,Faroe Islands,1,0,1,1.0,0.0,1934,1538
2023-10-15,Poland,Moldova,1,1,0,0.5,0.5,1967,1595
2023-10-15,Switzerland,Belarus,3,3,0,0.5,0.5,2026,1716
2023-10-15,Romania,Andorra,4,0,4,1.0,0.0,1880,1440
2023-10-16,Dominican Republic,Barbados,5,2,3,1.0,0.0,1584,1471
2023-10-16,Nicaragua,Montserrat,3,0,3,1.0,0.0,1603,1462
2023-10-16,French Guiana,Saint Vincent and the Grenadines,3,2,1,1.0,0.0,1631,1507
2023-10-16,Saint Martin,Anguilla,8,0,8,1.0,0.0,1446,1271
2023-10-16,Turks and Caicos Islands,British Virgin Islands,2,2,0,0.5,0.5,1410,1330
2023-10-16,Algeria,Egypt,1,1,0,0.5,0.5,1970,1942
2023-10-16,Botswana,Eswatini,2,1,1,1.0,0.0,1650,1588
2023-10-16,Kenya,Russia,2,2,0,0.5,0.5,1701,1966
2023-10-16,China PR,Uzbekistan,1,2,1,0.0,1.0,1820,1895
2023-10-16,Mozambique,Nigeria,2,3,1,0.0,1.0,1654,1870
2023-10-16,Senegal,Cameroon,1,0,1,1.0,0.0,1955,1872
2023-10-16,Gibraltar,Republic of Ireland,0,4,4,0.0,1.0,1489,1873
2023-10-16,Greece,Netherlands,0,1,1,0.0,1.0,1884,2120
2023-10-16,Azerbaijan,Austria,0,1,1,0.0,1.0,1673,1952
2023-10-16,Belgium,Sweden,1,1,0,0.5,0.5,2133,1982
2023-10-16,Iceland,Liechtenstein,4,0,4,1.0,0.0,1793,1386
2023-10-16,Bosnia and Herzegovina,Portugal,0,5,5,0.0,1.0,1842,2133
2023-10-16,Luxembourg,Slovakia,0,1,1,0.0,1.0,1664,1867
2023-10-17,El Salvador,Martinique,0,0,0,0.5,0.5,1714,1708
2023-10-17,Panama,Guatemala,3,0,3,1.0,0.0,1902,1772
2023-10-17,Curaçao,Trinidad and Tobago,5,3,2,1.0,0.0,1634,1726
2023-10-17,Bermuda,Belize,1,1,0,0.5,0.5,1563,1483
2023-10-17,Antigua and Barbuda,Bahamas,2,2,0,0.5,0.5,1562,1439
2023-10-17,Guyana,Puerto Rico,3,1,2,1.0,0.0,1606,1492
2023-10-17,Cayman Islands,United States Virgin Islands,2,1,1,1.0,0.0,1401,1329
2023-10-17,Venezuela,Chile,3,0,3,1.0,0.0,1929,1957
2023-10-17,Ecuador,Colombia,0,0,0,0.5,0.5,2009,2100
2023-10-17,Paraguay,Bolivia,1,0,1,1.0,0.0,1901,1768
2023-10-17,Peru,Argentina,0,2,2,0.0,1.0,1983,2222
2023-10-17,Uruguay,Brazil,2,0,2,1.0,0.0,2081,2212
2023-10-17,Bangladesh,Maldives,2,1,1,1.0,0.0,1447,1444
2023-10-17,Bhutan,Hong Kong,2,0,2,1.0,0.0,1260,1572
2023-10-17,Brunei,Indonesia,0,6,6,0.0,1.0,1263,1694
2023-10-17,Guam,Singapore,0,1,1,0.0,1.0,1360,1617
2023-10-17,Laos,Nepal,0,1,1,0.0,1.0,1336,1462
2023-10-17,Macau,Myanmar,0,0,0,0.5,0.5,1304,1494
2023-10-17,Mongolia,Afghanistan,0,1,1,0.0,1.0,1391,1517
2023-10-17,Pakistan,Cambodia,1,0,1,1.0,0.0,1345,1393
2023-10-17,Sri Lanka,Yemen,1,1,0,0.5,0.5,1315,1535
2023-10-17,Taiwan,Timor-Leste,3,0,3,1.0,0.0,1487,1267
2023-10-17,Albania,Bulgaria,2,0,2,1.0,0.0,1813,1750
2023-10-17,Angola,DR Congo,0,0,0,0.5,0.5,1700,1747
2023-10-17,Australia,New Zealand,2,0,2,1.0,0.0,1982,1780
2023-10-17,Bahrain,Philippines,1,0,1,1.0,0.0,1834,1569
2023-10-17,Benin,Madagascar,1,2,1,0.0,1.0,1674,1627
2023-10-17,Burkina Faso,Mauritania,2,1,1,1.0,0.0,1802,1681
2023-10-17,Cape Verde,Comoros,1,2,1,0.0,1.0,1740,1565
2023-10-17,Estonia,Thailand,1,1,0,0.5,0.5,1709,1773
2023-10-17,France,Scotland,4,1,3,1.0,0.0,2195,1941
2023-10-17,Guinea,Gabon,1,1,0,0.5,0.5,1734,1719
2023-10-17,Ivory Coast,South Africa,1,1,0,0.5,0.5,1902,1851
2023-10-17,South Korea,Vietnam,6,0,6,1.0,0.0,2023,1775
2023-10-17,Libya,Niger,1,1,0,0.5,0.5,1682,1575
2023-10-17,Mali,Saudi Arabia,3,1,2,1.0,0.0,1841,1851
2023-10-17,Mexico,Germany,2,2,0,0.5,0.5,2040,2102
2023-10-17,North Macedonia,Armenia,3,1,2,1.0,0.0,1799,1718
2023-10-17,Somalia,Sierra Leone,0,2,2,0.0,1.0,1314,1620
2023-10-17,Sudan,Chad,1,0,1,1.0,0.0,1608,1514
2023-10-17,Syria,Kuwait,1,2,1,0.0,1.0,1732,1753
2023-10-17,United Arab Emirates,Lebanon,2,1,1,1.0,0.0,1845,1686
2023-10-17,United States,Ghana,4,0,4,1.0,0.0,2047,1857
2023-10-17,Zambia,Uganda,3,0,3,1.0,0.0,1766,1694
2023-10-17,Morocco,Liberia,3,0,3,1.0,0.0,1987,1585
2023-10-17,England,Italy,3,1,2,1.0,0.0,2160,2103
2023-10-17,Malta,Ukraine,1,3,2,0.0,1.0,1566,1993
2023-10-17,Serbia,Montenegro,3,1,2,1.0,0.0,1984,1774
2023-10-17,Lithuania,Hungary,2,2,0,0.5,0.5,1618,1946
2023-10-17,Finland,Kazakhstan,1,2,1,0.0,1.0,1835,1701
2023-10-17,Northern Ireland,Slovenia,0,1,1,0.0,1.0,1755,1868
2023-10-17,San Marino,Denmark,1,2,1,0.0,1.0,1283,2036
2023-10-23,United Arab Emirates,Kuwait,1,0,1,1.0,0.0,1851,1748
2023-11-11,Guatemala,Jamaica,0,0,0,0.5,0.5,1774,1821
2023-11-12,Kosovo,Israel,1,0,1,1.0,0.0,1712,1803
2023-11-15,Ethiopia,Sierra Leone,0,0,0,0.5,0.5,1651,1621
2023-11-15,DR Congo,Mauritania,2,0,2,1.0,0.0,1754,1675
2023-11-15,Rwanda,Zimbabwe,0,0,0,0.5,0.5,1641,1686
2023-11-15,Equatorial Guinea,Namibia,1,0,1,1.0,0.0,1694,1673
2023-11-15,Belgium,Serbia,1,0,1,1.0,0.0,2138,1980
2023-11-15,Israel,Switzerland,1,1,0,0.5,0.5,1808,2022
2023-11-16,Sint Maarten,Guadeloupe,0,2,2,0.0,1.0,1442,1653
2023-11-16,Saint Kitts and Nevis,Saint Lucia,0,0,0,0.5,0.5,1560,1526
2023-11-16,United States Virgin Islands,Aruba,1,4,3,0.0,1.0,1324,1429
2023-11-16,British Virgin Islands,Dominica,1,2,1,0.0,1.0,1325,1460
2023-11-16,Costa Rica,Panama,0,3,3,0.0,1.0,1878,1910
2023-11-16,United States,Trinidad and Tobago,3,0,3,1.0,0.0,2050,1724
2023-11-16,Bolivia,Peru,2,0,2,1.0,0.0,1781,1971
2023-11-16,Venezuela,Ecuador,0,0,0,0.5,0.5,1931,2008
2023-11-16,Colombia,Brazil,2,1,1,1.0,0.0,2111,2202
2023-11-16,Argentina,Uruguay,0,2,2,0.0,1.0,2211,2093
2023-11-16,Chile,Paraguay,0,0,0,0.5,0.5,1956,1903
2023-11-16,Qatar,Afghanistan,8,1,7,1.0,0.0,1883,1516
2023-11-16,Kuwait,India,0,1,1,0.0,1.0,1738,1666
2023-11-16,Japan,Myanmar,5,0,5,1.0,0.0,2069,1494
2023-11-16,Syria,North Korea,1,0,1,1.0,0.0,1741,1750
2023-11-16,Thailand,China PR,1,2,1,0.0,1.0,1767,1827
2023-11-16,South Korea,Singapore,5,0,5,1.0,0.0,2025,1616
2023-11-16,Oman,Taiwan,3,0,3,1.0,0.0,1872,1486
2023-11-16,Malaysia,Kyrgyzstan,4,3,1,1.0,0.0,1704,1603
2023-11-16,Iran,Hong Kong,4,0,4,1.0,0.0,2042,1571
2023-11-16,Turkmenistan,Uzbekistan,1,3,2,0.0,1.0,1603,1898
2023-11-16,Iraq,Indonesia,5,1,4,1.0,0.0,1903,1691
2023-11-16,Philippines,Vietnam,0,2,2,0.0,1.0,1566,1779
2023-11-16,Tajikistan,Jordan,1,1,0,0.5,0.5,1661,1829
2023-11-16,Saudi Arabia,Pakistan,4,0,4,1.0,0.0,1852,1345
2023-11-16,United Arab Emirates,Nepal,4,0,4,1.0,0.0,1853,1461
2023-11-16,Yemen,Bahrain,0,2,2,0.0,1.0,1533,1837
2023-11-16,Lebanon,Palestine,0,0,0,0.5,0.5,1687,1704
2023-11-16,Australia,Bangladesh,7,0,7,1.0,0.0,1983,1447
2023-11-16,Egypt,Djibouti,6,0,6,1.0,0.0,1943,1339
2023-11-16,Sudan,Togo,1,1,0,0.5,0.5,1610,1676
2023-11-16,Nigeria,Lesotho,1,1,0,0.5,0.5,1865,1566
2023-11-16,Cape Verde,Angola,0,0,0,0.5,0.5,1740,1701
2023-11-16,Burundi,Gambia,3,2,1,1.0,0.0,1625,1664
2023-11-16,Gabon,Kenya,2,1,1,1.0,0.0,1727,1694
2023-11-16,Botswana,Mozambique,2,3,1,0.0,1.0,1643,1662
2023-11-16,Algeria,Somalia,3,1,2,1.0,0.0,1971,1314
2023-11-16,Curaçao,El Salvador,1,1,0,0.5,0.5,1636,1713
2023-11-16,Norway,Faroe Islands,2,0,2,1.0,0.0,1925,1537
2023-11-16,Cyprus,Spain,1,3,2,0.0,1.0,1630,2171
2023-11-16,Georgia,Scotland,2,2,0,0.5,0.5,1817,1939
2023-11-16,Estonia,Austria,0,2,2,0.0,1.0,1706,1956
2023-11-16,Azerbaijan,Sweden,3,0,3,1.0,0.0,1687,1969
2023-11-16,Bulgaria,Hungary,2,2,0,0.5,0.5,1755,1942
2023-11-16,Montenegro,Lithuania,2,0,2,1.0,0.0,1779,1614
2023-11-16,Liechtenstein,Portugal,0,2,2,0.0,1.0,1386,2134
2023-11-16,Luxembourg,Bosnia and Herzegovina,4,1,3,1.0,0.0,1676,1831
2023-11-16,Slovakia,Iceland,4,2,2,1.0,0.0,1874,1787
2023-11-17,Montserrat,Dominican Republic,2,1,1,1.0,0.0,1473,1574
2023-11-17,Barbados,Nicaragua,0,4,4,0.0,1.0,1466,1609
2023-11-17,Bermuda,Saint Vincent and the Grenadines,3,1,2,1.0,0.0,1570,1501
2023-11-17,Belize,French Guiana,1,0,1,1.0,0.0,1495,1620
2023-11-17,Honduras,Mexico,2,0,2,1.0,0.0,1802,2028
2023-11-17,Burkina Faso,Guinea-Bissau,1,1,0,0.5,0.5,1799,1628
2023-11-17,Eswatini,Libya,0,1,1,0.0,1.0,1583,1688
2023-11-17,Cameroon,Mauritius,3,0,3,1.0,0.0,1874,1477
2023-11-17,Zambia,Congo,4,2,2,1.0,0.0,1771,1623
2023-11-17,Ivory Coast,Seychelles,9,0,9,1.0,0.0,1903,1370
2023-11-17,Guinea,Uganda,2,1,1,1.0,0.0,1742,1687
2023-11-17,Liberia,Malawi,0,1,1,0.0,1.0,1579,1669
2023-11-17,Tunisia,São Tomé and Príncipe,4,0,4,1.0,0.0,1930,1431
2023-11-17,Comoros,Central African Republic,4,2,2,1.0,0.0,1573,1552
2023-11-17,Ghana,Madagascar,1,0,1,1.0,0.0,1861,1624
2023-11-17,Mali,Chad,3,1,2,1.0,0.0,1844,1512
2023-11-17,Greece,New Zealand,2,0,2,1.0,0.0,1890,1775
2023-11-17,England,Malta,2,0,2,1.0,0.0,2161,1566
2023-11-17,Italy,North Macedonia,5,2,3,1.0,0.0,2106,1797
2023-11-17,Moldova,Albania,1,1,0,0.5,0.5,1600,1809
2023-11-17,Poland,Czech Republic,1,1,0,0.5,0.5,1967,1935
2023-11-17,Finland,Northern Ireland,4,0,4,1.0,0.0,1842,1749
2023-11-17,Denmark,Slovenia,2,1,1,1.0,0.0,2041,1864
2023-11-17,Kazakhstan,San Marino,3,1,2,1.0,0.0,1703,1282
2023-11-17,Papua New Guinea,Tuvalu,3,0,3,1.0,0.0,1562,1424
2023-11-17,Solomon Islands,Samoa,1,0,1,1.0,0.0,1680,1450
2023-11-18,Antigua and Barbuda,Puerto Rico,2,3,1,0.0,1.0,1553,1502
2023-11-18,Anguilla,Bonaire,0,3,3,0.0,1.0,1268,1478
2023-11-18,Jamaica,Canada,1,2,1,0.0,1.0,1815,1908
2023-11-18,Senegal,South Sudan,4,0,4,1.0,0.0,1957,1486
2023-11-18,South Africa,Benin,2,1,1,1.0,0.0,1856,1670
2023-11-18,Niger,Tanzania,0,1,1,0.0,1.0,1569,1662
2023-11-18,Germany,Turkey,2,3,1,0.0,1.0,2091,1970
2023-11-18,France,Gibraltar,14,0,14,1.0,0.0,2196,1489
2023-11-18,Netherlands,Republic of Ireland,1,0,1,1.0,0.0,2124,1870
2023-11-18,Armenia,Wales,1,1,0,0.5,0.5,1723,1936
2023-11-18,Latvia,Croatia,0,2,2,0.0,1.0,1627,2059
2023-11-18,Belarus,Andorra,1,0,1,1.0,0.0,1719,1438
2023-11-18,Switzerland,Kosovo,1,1,0,0.5,0.5,2017,1718
2023-11-18,Israel,Romania,1,2,1,0.0,1.0,1802,1887
2023-11-18,New Caledonia,Tonga,7,0,7,1.0,0.0,1643,1389
2023-11-18,Fiji,Northern Mariana Islands,10,0,10,1.0,0.0,1654,1348
2023-11-19,Guadeloupe,Saint Kitts and Nevis,5,0,5,1.0,0.0,1659,1555
2023-11-19,Saint Lucia,Sint Maarten,1,2,1,0.0,1.0,1517,1452
2023-11-19,Sierra Leone,Egypt,0,2,2,0.0,1.0,1619,1946
2023-11-19,Sudan,DR Congo,1,0,1,1.0,0.0,1622,1743
2023-11-19,Zimbabwe,Nigeria,1,1,0,0.5,0.5,1690,1862
2023-11-19,Burundi,Gabon,1,2,1,0.0,1.0,1620,1733
2023-11-19,Mozambique,Algeria,0,2,2,0.0,1.0,1660,1974
2023-11-19,Cyprus,Lithuania,1,0,1,1.0,0.0,1638,1607
2023-11-19,Scotland,Norway,3,3,0,0.5,0.5,1939,1926
2023-11-19,Spain,Georgia,3,1,2,1.0,0.0,2173,1816
2023-11-19,Belgium,Azerbaijan,5,0,5,1.0,0.0,2140,1686
2023-11-19,Sweden,Estonia,2,0,2,1.0,0.0,1972,1704
2023-11-19,Hungary,Montenegro,3,1,2,1.0,0.0,1947,1775
2023-11-19,Serbia,Bulgaria,2,2,0,0.5,0.5,1976,1760
2023-11-19,Portugal,Iceland,2,0,2,1.0,0.0,2136,1786
2023-11-19,Bosnia and Herzegovina,Slovakia,1,2,1,0.0,1.0,1824,1882
2023-11-19,Liechtenstein,Luxembourg,0,1,1,0.0,1.0,1384,1679
2023-11-20,Montserrat,Barbados,4,2,2,1.0,0.0,1481,1459
2023-11-20,Aruba,Cayman Islands,5,1,4,1.0,0.0,1437,1394
2023-11-20,Dominica,Turks and Caicos Islands,2,0,2,1.0,0.0,1467,1404
2023-11-20,Panama,Costa Rica,3,1,2,1.0,0.0,1918,1871
2023-11-20,Trinidad and Tobago,United States,2,1,1,1.0,0.0,1738,2037
2023-11-20,Djibouti,Guinea-Bissau,0,1,1,0.0,1.0,1337,1631
2023-11-20,Gambia,Ivory Coast,0,2,2,0.0,1.0,1661,1907
2023-11-20,Seychelles,Kenya,0,5,5,0.0,1.0,1368,1697
2023-11-20,Liberia,Equatorial Guinea,0,1,1,0.0,1.0,1574,1700
2023-11-20,Mali,Central African Republic,1,1,0,0.5,0.5,1839,1558
2023-11-20,Chad,Madagascar,0,3,3,0.0,1.0,1507,1630
2023-11-20,Curaçao,El Salvador,1,1,0,0.5,0.5,1638,1712
2023-11-20,Russia,Cuba,8,0,8,1.0,0.0,1969,1627
2023-11-20,North Macedonia,England,1,1,0,0.5,0.5,1804,2155
2023-11-20,Ukraine,Italy,0,0,0,0.5,0.5,1996,2104
2023-11-20,Albania,Faroe Islands,0,0,0,0.5,0.5,1804,1543
2023-11-20,Czech Republic,Moldova,3,0,3,1.0,0.0,1938,1598
2023-11-20,Northern Ireland,Denmark,2,0,2,1.0,0.0,1763,2028
2023-11-20,San Marino,Finland,1,2,1,0.0,1.0,1282,1843
2023-11-20,Slovenia,Kazakhstan,2,1,1,1.0,0.0,1869,1699
2023-11-20,Tuvalu,Vanuatu,0,6,6,0.0,1.0,1420,1610
2023-11-20,Samoa,American Samoa,10,0,10,1.0,0.0,1456,1349
2023-11-21,Nicaragua,Dominican Republic,0,0,0,0.5,0.5,1609,1575
2023-11-21,French Guiana,Bermuda,3,0,3,1.0,0.0,1627,1564
2023-11-21,Saint Vincent and the Grenadines,Belize,3,0,3,1.0,0.0,1509,1488
2023-11-21,Guyana,Antigua and Barbuda,6,0,6,1.0,0.0,1613,1547
2023-11-21,Puerto Rico,Bahamas,6,1,5,1.0,0.0,1509,1433
2023-11-21,Bonaire,Saint Martin,0,4,4,0.0,1.0,1470,1455
2023-11-21,Canada,Jamaica,2,3,1,0.0,1.0,1898,1826
2023-11-21,Mexico,Honduras,2,0,2,1.0,0.0,2032,1799
2023-11-21,Ecuador,Chile,1,0,1,1.0,0.0,2015,1950
2023-11-21,Paraguay,Colombia,0,1,1,0.0,1.0,1900,2115
2023-11-21,Uruguay,Bolivia,3,0,3,1.0,0.0,2096,1779
2023-11-21,Peru,Venezuela,1,1,0,0.5,0.5,1971,1932
2023-11-21,Brazil,Argentina,0,1,1,0.0,1.0,2195,2219
2023-11-21,India,Qatar,0,3,3,0.0,1.0,1663,1887
2023-11-21,Afghanistan,Kuwait,0,4,4,0.0,1.0,1513,1742
2023-11-21,Myanmar,North Korea,1,6,5,0.0,1.0,1492,1753
2023-11-21,Syria,Japan,0,5,5,0.0,1.0,1739,2072
2023-11-21,China PR,South Korea,0,3,3,0.0,1.0,1824,2029
2023-11-21,Singapore,Thailand,1,3,2,0.0,1.0,1612,1772
2023-11-21,Taiwan,Malaysia,0,1,1,0.0,1.0,1483,1708
2023-11-21,Kyrgyzstan,Oman,1,0,1,1.0,0.0,1617,1859
2023-11-21,Uzbekistan,Iran,2,2,0,0.5,0.5,1902,2039
2023-11-21,Hong Kong,Turkmenistan,2,2,0,0.5,0.5,1572,1603
2023-11-21,Philippines,Indonesia,1,1,0,0.5,0.5,1569,1689
2023-11-21,Vietnam,Iraq,0,1,1,0.0,1.0,1774,1909
2023-11-21,Pakistan,Tajikistan,1,6,5,0.0,1.0,1343,1664
2023-11-21,Jordan,Saudi Arabia,0,2,2,0.0,1.0,1822,1860
2023-11-21,Bahrain,United Arab Emirates,0,2,2,0.0,1.0,1830,1861
2023-11-21,Nepal,Yemen,0,2,2,0.0,1.0,1455,1540
2023-11-21,Palestine,Australia,0,1,1,0.0,1.0,1702,1986
2023-11-21,Bangladesh,Lebanon,1,1,0,0.5,0.5,1452,1683
2023-11-21,Ethiopia,Burkina Faso,0,3,3,0.0,1.0,1647,1804
2023-11-21,South Sudan,Mauritania,0,0,0,0.5,0.5,1490,1672
2023-11-21,Togo,Senegal,0,0,0,0.5,0.5,1682,1952
2023-11-21,Lesotho,Benin,0,0,0,0.5,0.5,1569,1668
2023-11-21,Rwanda,South Africa,2,0,2,1.0,0.0,1654,1844
2023-11-21,Eswatini,Cape Verde,0,2,2,0.0,1.0,1579,1745
2023-11-21,Libya,Cameroon,1,1,0,0.5,0.5,1692,1871
2023-11-21,Mauritius,Angola,0,0,0,0.5,0.5,1482,1697
2023-11-21,Niger,Zambia,2,1,1,1.0,0.0,1582,1759
2023-11-21,Tanzania,Morocco,0,2,2,0.0,1.0,1660,1990
2023-11-21,Somalia,Uganda,0,1,1,0.0,1.0,1313,1689
2023-11-21,Botswana,Guinea,1,0,1,1.0,0.0,1654,1732
2023-11-21,Malawi,Tunisia,0,1,1,0.0,1.0,1667,1933
2023-11-21,São Tomé and Príncipe,Namibia,0,2,2,0.0,1.0,1428,1677
2023-11-21,Comoros,Ghana,1,0,1,1.0,0.0,1587,1848
2023-11-21,Austria,Germany,2,0,2,1.0,0.0,1967,2081
2023-11-21,Poland,Latvia,2,0,2,1.0,0.0,1969,1626
2023-11-21,Republic of Ireland,New Zealand,1,1,0,0.5,0.5,1868,1778
2023-11-21,Gibraltar,Netherlands,0,6,6,0.0,1.0,1489,2125
2023-11-21,Greece,France,2,2,0,0.5,0.5,1896,2191
2023-11-21,Wales,Turkey,1,1,0,0.5,0.5,1937,1970
2023-11-21,Croatia,Armenia,1,0,1,1.0,0.0,2062,1721
2023-11-21,Andorra,Israel,0,2,2,0.0,1.0,1437,1804
2023-11-21,Kosovo,Belarus,0,1,1,0.0,1.0,1711,1727
2023-11-21,Romania,Switzerland,1,0,1,1.0,0.0,1898,2007
2023-11-21,Tonga,Cook Islands,1,2,1,0.0,1.0,1382,1436
2023-11-21,Fiji,Tahiti,0,0,0,0.5,0.5,1654,1645
2023-11-23,Vanuatu,Papua New Guinea,1,1,0,0.5,0.5,1609,1564
2023-11-23,Solomon Islands,American Samoa,11,0,11,1.0,0.0,1683,1347
2023-11-24,Cook Islands,New Caledonia,0,8,8,0.0,1.0,1433,1647
2023-11-24,Northern Mariana Islands,Tahiti,0,5,5,0.0,1.0,1346,1648
2023-11-27,Northern Mariana Islands,American Samoa,4,0,4,1.0,0.0,1355,1339
2023-11-27,Tonga,Tuvalu,0,4,4,0.0,1.0,1375,1428
2023-11-27,Tahiti,Samoa,2,1,1,1.0,0.0,1652,1453
2023-11-27,Cook Islands,Papua New Guinea,0,3,3,0.0,1.0,1428,1570
2023-11-28,New Caledonia,Vanuatu,1,0,1,1.0,0.0,1655,1602
2023-11-28,Solomon Islands,Fiji,2,0,2,1.0,0.0,1691,1647
2023-11-30,American Samoa,Tonga,2,6,4,0.0,1.0,1332,1383
2023-11-30,Northern Mariana Islands,Tuvalu,1,4,3,0.0,1.0,1349,1435
2023-11-30,Samoa,Cook Islands,3,0,3,1.0,0.0,1461,1421
2023-11-30,Tahiti,Papua New Guinea,2,0,2,1.0,0.0,1659,1564
2023-12-01,Vanuatu,Fiji,2,4,2,0.0,1.0,1596,1654
2023-12-02,Solomon Islands,New Caledonia,2,2,0,0.5,0.5,1691,1656
2023-12-16,Mexico,Colombia,2,3,1,0.0,1.0,2026,2122
2024-01-01,Japan,Thailand,5,0,5,1.0,0.0,2075,1770
2024-01-01,China PR,Hong Kong,1,2,1,0.0,1.0,1812,1585
2024-01-02,Indonesia,Libya,0,4,4,0.0,1.0,1682,1700
2024-01-04,Tajikistan,Hong Kong,2,1,1,1.0,0.0,1671,1579
2024-01-04,Saudi Arabia,Lebanon,1,0,1,1.0,0.0,1865,1679
2024-01-05,Indonesia,Libya,1,2,1,0.0,1.0,1675,1708
2024-01-05,Iran,Burkina Faso,2,1,1,1.0,0.0,2043,1801
2024-01-05,Kyrgyzstan,Syria,1,1,0,0.5,0.5,1620,1737
2024-01-05,Qatar,Jordan,1,2,1,0.0,1.0,1878,1832
2024-01-05,Togo,Algeria,0,3,3,0.0,1.0,1680,1977
2024-01-06,DR Congo,Angola,0,0,0,0.5,0.5,1742,1699
2024-01-06,Iraq,South Korea,0,1,1,0.0,1.0,1904,2035
2024-01-06,Bahrain,Australia,0,2,2,0.0,1.0,1826,1991
2024-01-06,Mozambique,Lesotho,2,0,2,1.0,0.0,1666,1564
2024-01-06,United Arab Emirates,Oman,0,1,1,0.0,1.0,1853,1868
2024-01-06,Ivory Coast,Sierra Leone,5,1,4,1.0,0.0,1910,1617
2024-01-06,Tunisia,Mauritania,0,0,0,0.5,0.5,1928,1678
2024-01-06,Mali,Guinea-Bissau,6,2,4,1.0,0.0,1843,1628
2024-01-07,Uzbekistan,Palestine,1,0,1,1.0,0.0,1906,1699
2024-01-07,Egypt,Tanzania,2,0,2,1.0,0.0,1949,1658
2024-01-08,Nigeria,Guinea,0,2,2,0.0,1.0,1852,1743
2024-01-08,Botswana,Mozambique,1,1,0,0.5,0.5,1655,1666
2024-01-08,Syria,Malaysia,2,2,0,0.5,0.5,1737,1709
2024-01-08,Senegal,Niger,1,0,1,1.0,0.0,1954,1581
2024-01-08,Ghana,Namibia,0,0,0,0.5,0.5,1845,1681
2024-01-09,Japan,Jordan,6,1,5,1.0,0.0,2079,1829
2024-01-09,Kyrgyzstan,Vietnam,2,1,1,1.0,0.0,1632,1763
2024-01-09,Zambia,Cameroon,1,1,0,0.5,0.5,1762,1869
2024-01-09,Equatorial Guinea,Djibouti,1,1,0,0.5,0.5,1694,1344
2024-01-09,Saudi Arabia,Palestine,0,0,0,0.5,0.5,1862,1703
2024-01-09,Burundi,Algeria,0,4,4,0.0,1.0,1619,1979
2024-01-09,Indonesia,Iran,0,5,5,0.0,1.0,1674,2045
2024-01-10,South Africa,Lesotho,0,0,0,0.5,0.5,1839,1570
2024-01-10,DR Congo,Burkina Faso,1,2,1,0.0,1.0,1736,1808
2024-01-10,Bahrain,Angola,0,3,3,0.0,1.0,1816,1710
2024-01-10,Saudi Arabia,Hong Kong,2,0,2,1.0,0.0,1865,1577
2024-01-10,Tunisia,Cape Verde,2,0,2,1.0,0.0,1933,1741
2024-01-11,Morocco,Sierra Leone,3,1,2,1.0,0.0,1992,1616
2024-01-12,Qatar,Lebanon,3,0,3,1.0,0.0,1882,1676
2024-01-12,Kuwait,Libya,1,3,2,0.0,1.0,1734,1717
2024-01-12,Sweden,Estonia,2,1,1,1.0,0.0,1975,1702
2024-01-13,China PR,Tajikistan,0,0,0,0.5,0.5,1809,1675
2024-01-13,Australia,India,2,0,2,1.0,0.0,1994,1661
2024-01-13,Uzbekistan,Syria,0,0,0,0.5,0.5,1903,1741
2024-01-13,Ivory Coast,Guinea-Bissau,2,0,2,1.0,0.0,1913,1626
2024-01-13,Guatemala,Iceland,0,1,1,0.0,1.0,1767,1794
2024-01-14,United Arab Emirates,Hong Kong,3,1,2,1.0,0.0,1856,1575
2024-01-14,Iran,Palestine,4,1,3,1.0,0.0,2047,1702
2024-01-14,Japan,Vietnam,4,2,2,1.0,0.0,2082,1761
2024-01-14,Nigeria,Equatorial Guinea,1,1,0,0.5,0.5,1849,1698
2024-01-14,Egypt,Mozambique,2,2,0,0.5,0.5,1944,1672
2024-01-14,Ghana,Cape Verde,1,2,1,0.0,1.0,1835,1752
2024-01-15,Indonesia,Iraq,1,3,2,0.0,1.0,1671,1908
2024-01-15,South Korea,Bahrain,3,1,2,1.0,0.0,2039,1813
2024-01-15,Malaysia,Jordan,0,4,4,0.0,1.0,1704,1835
2024-01-15,Senegal,Gambia,3,0,3,1.0,0.0,1957,1659
2024-01-15,Cameroon,Guinea,1,1,0,0.5,0.5,1867,1746
2024-01-15,Algeria,Angola,1,1,0,0.5,0.5,1974,1716
2024-01-16,Thailand,Kyrgyzstan,2,0,2,1.0,0.0,1775,1628
2024-01-16,Saudi Arabia,Oman,2,1,1,1.0,0.0,1874,1860
2024-01-16,Burkina Faso,Mauritania,1,0,1,1.0,0.0,1814,1673
2024-01-16,Tunisia,Namibia,0,1,1,0.0,1.0,1921,1694
2024-01-16,Mali,South Africa,2,0,2,1.0,0.0,1851,1832
2024-01-17,Lebanon,China PR,0,0,0,0.5,0.5,1679,1807
2024-01-17,Qatar,Tajikistan,1,0,1,1.0,0.0,1886,1672
2024-01-17,Morocco,Tanzania,3,0,3,1.0,0.0,1995,1656
2024-01-17,DR Congo,Zambia,1,1,0,0.5,0.5,1737,1762
2024-01-17,Honduras,Iceland,0,2,2,0.0,1.0,1791,1803
2024-01-18,Syria,Australia,0,1,1,0.0,1.0,1738,1998
2024-01-18,India,Uzbekistan,0,3,3,0.0,1.0,1658,1907
2024-01-18,Palestine,United Arab Emirates,1,1,0,0.5,0.5,1706,1853
2024-01-18,Equatorial Guinea,Guinea-Bissau,4,2,2,1.0,0.0,1705,1620
2024-01-18,Ivory Coast,Nigeria,0,1,1,0.0,1.0,1904,1859
2024-01-18,Egypt,Ghana,2,2,0,0.5,0.5,1942,1838
2024-01-19,Hong Kong,Iran,0,1,1,0.0,1.0,1575,2048
2024-01-19,Iraq,Japan,2,1,1,1.0,0.0,1920,2071
2024-01-19,Vietnam,Indonesia,0,1,1,0.0,1.0,1751,1682
2024-01-19,Cape Verde,Mozambique,3,0,3,1.0,0.0,1759,1666
2024-01-19,Senegal,Cameroon,3,1,2,1.0,0.0,1963,1862
2024-01-19,Guinea,Gambia,1,0,1,1.0,0.0,1753,1653
2024-01-19,Kuwait,Uganda,0,2,2,0.0,1.0,1725,1699
2024-01-20,Jordan,South Korea,2,2,0,0.5,0.5,1840,2035
2024-01-20,Bahrain,Malaysia,1,0,1,1.0,0.0,1819,1699
2024-01-20,Algeria,Burkina Faso,2,2,0,0.5,0.5,1971,1818
2024-01-20,Mauritania,Angola,2,3,1,0.0,1.0,1666,1724
2024-01-20,Tunisia,Mali,1,1,0,0.5,0.5,1920,1853
2024-01-20,United States,Slovenia,0,1,1,0.0,1.0,2026,1881
2024-01-21,Oman,Thailand,0,0,0,0.5,0.5,1859,1777
2024-01-21,Kyrgyzstan,Saudi Arabia,0,2,2,0.0,1.0,1625,1878
2024-01-21,South Africa,Namibia,4,0,4,1.0,0.0,1837,1690
2024-01-21,Morocco,DR Congo,1,1,0,0.5,0.5,1990,1743
2024-01-21,Zambia,Tanzania,1,1,0,0.5,0.5,1760,1659
2024-01-22,Qatar,China PR,1,0,1,1.0,0.0,1893,1801
2024-01-22,Tajikistan,Lebanon,2,1,1,1.0,0.0,1681,1671
2024-01-22,Guinea-Bissau,Nigeria,0,1,1,0.0,1.0,1617,1863
2024-01-22,Ivory Coast,Equatorial Guinea,0,4,4,0.0,1.0,1892,1718
2024-01-22,Cape Verde,Egypt,2,2,0,0.5,0.5,1763,1939
2024-01-22,Mozambique,Ghana,2,2,0,0.5,0.5,1670,1835
2024-01-23,Australia,Uzbekistan,1,1,0,0.5,0.5,1996,1910
2024-01-23,Syria,India,1,0,1,1.0,0.0,1745,1652
2024-01-23,Hong Kong,Palestine,0,3,3,0.0,1.0,1570,1712
2024-01-23,Iran,United Arab Emirates,2,1,1,1.0,0.0,2052,1850
2024-01-23,Gambia,Cameroon,2,3,1,0.0,1.0,1650,1866
2024-01-23,Guinea,Senegal,0,2,2,0.0,1.0,1750,1967
2024-01-23,Angola,Burkina Faso,2,0,2,1.0,0.0,1735,1808
2024-01-23,Mauritania,Algeria,1,0,1,1.0,0.0,1680,1958
2024-01-24,Iraq,Vietnam,3,2,1,1.0,0.0,1925,1747
2024-01-24,Japan,Indonesia,3,1,2,1.0,0.0,2073,1681
2024-01-24,Namibia,Mali,0,0,0,0.5,0.5,1694,1850
2024-01-24,South Africa,Tunisia,0,0,0,0.5,0.5,1839,1919
2024-01-24,Tanzania,DR Congo,0,0,0,0.5,0.5,1661,1742
2024-01-24,Zambia,Morocco,0,1,1,0.0,1.0,1757,1994
2024-01-25,Jordan,Bahrain,0,1,1,0.0,1.0,1832,1828
2024-01-25,South Korea,Malaysia,3,3,0,0.5,0.5,2030,1705
2024-01-25,Kyrgyzstan,Oman,1,1,0,0.5,0.5,1630,1855
2024-01-25,Saudi Arabia,Thailand,0,0,0,0.5,0.5,1876,1780
2024-01-27,Angola,Namibia,3,0,3,1.0,0.0,1743,1687
2024-01-27,Nigeria,Cameroon,2,0,2,1.0,0.0,1872,1858
2024-01-28,Australia,Indonesia,4,0,4,1.0,0.0,1999,1679
2024-01-28,Tajikistan,United Arab Emirates,1,1,0,0.5,0.5,1685,1847
2024-01-28,Egypt,DR Congo,1,1,0,0.5,0.5,1935,1747
2024-01-28,Equatorial Guinea,Guinea,0,1,1,0.0,1.0,1711,1758
2024-01-29,Iraq,Jordan,2,3,1,0.0,1.0,1915,1843
2024-01-29,Qatar,Palestine,2,1,1,1.0,0.0,1898,1708
2024-01-29,Cape Verde,Mauritania,1,0,1,1.0,0.0,1770,1674
2024-01-29,Ivory Coast,Senegal,1,1,0,0.5,0.5,1894,1966
2024-01-30,Saudi Arabia,South Korea,1,1,0,0.5,0.5,1880,2027
2024-01-30,Uzbekistan,Thailand,2,1,1,1.0,0.0,1916,1775
2024-01-30,Mali,Burkina Faso,2,1,1,1.0,0.0,1858,1801
2024-01-30,Morocco,South Africa,0,2,2,0.0,1.0,1983,1851
2024-01-31,Bahrain,Japan,1,3,2,0.0,1.0,1825,2077
2024-01-31,Iran,Syria,1,1,0,0.5,0.5,2047,1751
2024-02-02,Australia,South Korea,1,2,1,0.0,1.0,1992,2035
2024-02-02,Tajikistan,Jordan,0,1,1,0.0,1.0,1681,1848
2024-02-02,DR Congo,Guinea,3,1,2,1.0,0.0,1756,1750
2024-02-02,Nigeria,Angola,1,0,1,1.0,0.0,1878,1738
2024-02-03,Iran,Japan,2,1,1,1.0,0.0,2056,2069
2024-02-03,Qatar,Uzbekistan,1,1,0,0.5,0.5,1899,1916
2024-02-03,Cape Verde,South Africa,0,0,0,0.5,0.5,1772,1850
2024-02-03,Ivory Coast,Mali,2,1,1,1.0,0.0,1902,1851
2024-02-03,Costa Rica,El Salvador,2,0,2,1.0,0.0,1876,1708
2024-02-06,Jordan,South Korea,2,0,2,1.0,0.0,1860,2024
2024-02-07,Qatar,Iran,3,2,1,1.0,0.0,1911,2045
2024-02-07,Ivory Coast,DR Congo,1,0,1,1.0,0.0,1907,1752
2024-02-07,Nigeria,South Africa,1,1,0,0.5,0.5,1878,1851
2024-02-10,Qatar,Jordan,3,1,2,1.0,0.0,1918,1854
2024-02-10,South Africa,DR Congo,0,0,0,0.5,0.5,1849,1755
2024-02-11,Ivory Coast,Nigeria,2,1,1,1.0,0.0,1915,1871
2024-03-01,Trinidad and Tobago,Jamaica,0,1,1,0.0,1.0,1732,1833
2024-03-03,Trinidad and Tobago,Jamaica,0,0,0,0.5,0.5,1735,1831
2024-03-14,Kazakhstan,Turkmenistan,2,0,2,1.0,0.0,1705,1598
2024-03-18,Solomon Islands,Fiji,2,1,1,1.0,0.0,1699,1647
2024-03-20,Bonaire,El Salvador,1,1,0,0.5,0.5,1475,1704
2024-03-20,San Marino,Saint Kitts and Nevis,1,3,2,0.0,1.0,1280,1558
2024-03-20,Djibouti,Liberia,0,2,2,0.0,1.0,1341,1578
2024-03-20,Somalia,Eswatini,0,3,3,0.0,1.0,1311,1582
2024-03-20,Tonga,Samoa,1,4,3,0.0,1.0,1377,1468
2024-03-21,South Africa,Andorra,1,1,0,0.5,0.5,1843,1444
2024-03-21,Cape Verde,Guyana,1,0,1,1.0,0.0,1777,1609
2024-03-21,Guinea,Vanuatu,6,0,6,1.0,0.0,1755,1592
2024-03-21,Panama,Mexico,0,3,3,0.0,1.0,1913,2032
2024-03-21,United States,Jamaica,3,1,2,1.0,0.0,2030,1828
2024-03-21,Gibraltar,Lithuania,0,1,1,0.0,1.0,1484,1613
2024-03-21,Poland,Estonia,5,1,4,1.0,0.0,1972,1700
2024-03-21,Wales,Finland,4,1,3,1.0,0.0,1943,1838
2024-03-21,Israel,Iceland,1,4,3,0.0,1.0,1796,1812
2024-03-21,Bosnia and Herzegovina,Ukraine,1,2,1,0.0,1.0,1820,2001
2024-03-21,Georgia,Luxembourg,2,0,2,1.0,0.0,1821,1675
2024-03-21,Greece,Kazakhstan,5,0,5,1.0,0.0,1900,1702
2024-03-21,Qatar,Kuwait,3,0,3,1.0,0.0,1922,1722
2024-03-21,Afghanistan,India,0,0,0,0.5,0.5,1517,1649
2024-03-21,Myanmar,Syria,1,1,0,0.5,0.5,1498,1746
2024-03-21,Japan,North Korea,1,0,1,1.0,0.0,2072,1751
2024-03-21,South Korea,Thailand,1,1,0,0.5,0.5,2020,1780
2024-03-21,Singapore,China PR,2,2,0,0.5,0.5,1616,1798
2024-03-21,Taiwan,Kyrgyzstan,0,2,2,0.0,1.0,1479,1635
2024-03-21,Oman,Malaysia,2,0,2,1.0,0.0,1860,1701
2024-03-21,Iran,Turkmenistan,5,0,5,1.0,0.0,2047,1597
2024-03-21,Hong Kong,Uzbekistan,0,2,2,0.0,1.0,1569,1918
2024-03-21,Indonesia,Vietnam,1,0,1,1.0,0.0,1689,1738
2024-03-21,Iraq,Philippines,1,0,1,1.0,0.0,1917,1568
2024-03-21,Pakistan,Jordan,0,3,3,0.0,1.0,1343,1855
2024-03-21,Saudi Arabia,Tajikistan,1,0,1,1.0,0.0,1884,1678
2024-03-21,Bahrain,Nepal,5,0,5,1.0,0.0,1827,1454
2024-03-21,United Arab Emirates,Yemen,2,1,1,1.0,0.0,1850,1538
2024-03-21,Australia,Lebanon,2,0,2,1.0,0.0,1995,1669
2024-03-21,Palestine,Bangladesh,5,0,5,1.0,0.0,1711,1450
2024-03-21,Belize,Puerto Rico,1,1,0,0.5,0.5,1489,1509
2024-03-21,Cyprus,Latvia,1,1,0,0.5,0.5,1638,1627
2024-03-21,Ecuador,Guatemala,2,0,2,1.0,0.0,2019,1764
2024-03-21,Ethiopia,Lesotho,1,2,1,0.0,1.0,1638,1580
2024-03-21,Malta,Slovenia,2,2,0,0.5,0.5,1572,1876
2024-03-21,Montenegro,Belarus,2,0,2,1.0,0.0,1782,1721
2024-03-21,Portugal,Sweden,5,2,3,1.0,0.0,2141,1971
2024-03-21,Solomon Islands,Fiji,0,2,2,0.0,1.0,1690,1657
2024-03-21,Venezuela,Italy,1,2,1,0.0,1.0,1928,2109
2024-03-22,Algeria,Bolivia,3,2,1,1.0,0.0,1963,1775
2024-03-22,Azerbaijan,Mongolia,1,0,1,1.0,0.0,1689,1389
2024-03-22,Bulgaria,Tanzania,1,0,1,1.0,0.0,1766,1656
2024-03-22,Egypt,New Zealand,1,0,1,1.0,0.0,1940,1774
2024-03-22,Equatorial Guinea,Cambodia,2,0,2,1.0,0.0,1714,1391
2024-03-22,Brunei,Bermuda,0,2,2,0.0,1.0,1261,1567
2024-03-22,Central African Republic,Bhutan,6,0,6,1.0,0.0,1561,1258
2024-03-22,Sri Lanka,Papua New Guinea,0,0,0,0.5,0.5,1320,1560
2024-03-22,Anguilla,Turks and Caicos Islands,0,0,0,0.5,0.5,1271,1402
2024-03-22,United States Virgin Islands,British Virgin Islands,1,1,0,0.5,0.5,1325,1325
2024-03-22,Albania,Chile,0,3,3,0.0,1.0,1800,1955
2024-03-22,Argentina,El Salvador,3,0,3,1.0,0.0,2220,1704
2024-03-22,Armenia,Kosovo,0,1,1,0.0,1.0,1713,1720
2024-03-22,Burkina Faso,Libya,1,2,1,0.0,1.0,1792,1727
2024-03-22,Comoros,Uganda,4,0,4,1.0,0.0,1598,1689
2024-03-22,Hungary,Turkey,1,0,1,1.0,0.0,1956,1962
2024-03-22,Liechtenstein,Faroe Islands,0,4,4,0.0,1.0,1380,1548
2024-03-22,Mauritania,Mali,0,2,2,0.0,1.0,1670,1856
2024-03-22,Morocco,Angola,1,0,1,1.0,0.0,1987,1735
2024-03-22,Netherlands,Scotland,4,0,4,1.0,0.0,2130,1935
2024-03-22,Niger,Togo,1,2,1,0.0,1.0,1576,1686
2024-03-22,Nigeria,Ghana,2,1,1,1.0,0.0,1879,1828
2024-03-22,North Macedonia,Moldova,1,1,0,0.5,0.5,1800,1603
2024-03-22,Norway,Czech Republic,1,2,1,0.0,1.0,1919,1946
2024-03-22,Peru,Nicaragua,2,0,2,1.0,0.0,1973,1608
2024-03-22,Romania,Northern Ireland,1,1,0,0.5,0.5,1896,1766
2024-03-22,Senegal,Gabon,3,0,3,1.0,0.0,1970,1730
2024-03-22,Spain,Colombia,0,1,1,0.0,1.0,2164,2132
2024-03-22,Chad,Mauritius,1,0,1,1.0,0.0,1515,1475
2024-03-22,São Tomé and Príncipe,South Sudan,1,1,0,0.5,0.5,1430,1489
2024-03-23,Tunisia,Croatia,0,0,0,0.5,0.5,1923,2059
2024-03-23,Canada,Trinidad and Tobago,2,0,2,1.0,0.0,1903,1731
2024-03-23,Costa Rica,Honduras,3,1,2,1.0,0.0,1883,1785
2024-03-23,Denmark,Switzerland,0,0,0,0.5,0.5,2028,2008
2024-03-23,Dominican Republic,Aruba,2,0,2,1.0,0.0,1580,1433
2024-03-23,England,Brazil,0,1,1,0.0,1.0,2148,2203
2024-03-23,France,Germany,0,2,2,0.0,1.0,2181,2092
2024-03-23,Ivory Coast,Benin,2,2,0,0.5,0.5,1911,1673
2024-03-23,Republic of Ireland,Belgium,0,0,0,0.5,0.5,1874,2135
2024-03-23,Slovakia,Austria,0,2,2,0.0,1.0,1876,1974
2024-03-23,Samoa,Cook Islands,1,0,1,1.0,0.0,1475,1415
2024-03-24,Jamaica,Panama,1,0,1,1.0,0.0,1838,1904
2024-03-24,United States,Mexico,2,0,2,1.0,0.0,2039,2024
2024-03-24,Belize,Puerto Rico,3,0,3,1.0,0.0,1498,1501
2024-03-24,Ecuador,Italy,0,2,2,0.0,1.0,2014,2115
2024-03-24,Ethiopia,Lesotho,2,1,1,1.0,0.0,1645,1574
2024-03-24,Guatemala,Venezuela,0,0,0,0.5,0.5,1768,1925
2024-03-24,San Marino,Saint Kitts and Nevis,0,0,0,0.5,0.5,1286,1553
2024-03-24,Suriname,Martinique,1,1,0,0.5,0.5,1639,1707
2024-03-25,Bolivia,Andorra,1,0,1,1.0,0.0,1778,1442
2024-03-25,Azerbaijan,Bulgaria,1,1,0,0.5,0.5,1691,1765
2024-03-25,Tanzania,Mongolia,3,0,3,1.0,0.0,1659,1387
2024-03-25,Cape Verde,Equatorial Guinea,1,0,1,1.0,0.0,1784,1708
2024-03-25,Bermuda,Guinea,1,5,4,0.0,1.0,1563,1760
2024-03-25,Central African Republic,Papua New Guinea,4,0,4,1.0,0.0,1569,1553
2024-03-25,Sri Lanka,Bhutan,2,0,2,1.0,0.0,1327,1252
2024-03-25,Comoros,Angola,0,0,0,0.5,0.5,1602,1732
2024-03-25,Cyprus,Serbia,0,1,1,0.0,1.0,1636,1979
2024-03-25,Gabon,Congo,1,1,0,0.5,0.5,1728,1626
2024-03-25,Montenegro,North Macedonia,1,0,1,1.0,0.0,1791,1792
2024-03-25,Sweden,Albania,1,0,1,1.0,0.0,1976,1796
2024-03-26,Algeria,South Africa,3,3,0,0.5,0.5,1961,1846
2024-03-26,Egypt,Croatia,2,4,2,0.0,1.0,1935,2065
2024-03-26,New Zealand,Tunisia,0,0,0,0.5,0.5,1778,1920
2024-03-26,Cambodia,Guyana,1,4,3,0.0,1.0,1388,1613
2024-03-26,Brunei,Vanuatu,3,2,1,1.0,0.0,1275,1579
2024-03-26,Lithuania,Gibraltar,1,0,1,1.0,0.0,1619,1479
2024-03-26,Wales,Poland,0,0,0,0.5,0.5,1944,1972
2024-03-26,Ukraine,Iceland,2,1,1,1.0,0.0,2006,1808
2024-03-26,Georgia,Greece,0,0,0,0.5,0.5,1823,1899
2024-03-26,India,Afghanistan,1,2,1,0.0,1.0,1639,1528
2024-03-26,Kuwait,Qatar,1,2,1,0.0,1.0,1719,1926
2024-03-26,Syria,Myanmar,7,0,7,1.0,0.0,1750,1495
2024-03-26,Thailand,South Korea,0,3,3,0.0,1.0,1777,2024
2024-03-26,China PR,Singapore,4,1,3,1.0,0.0,1803,1612
2024-03-26,Kyrgyzstan,Taiwan,5,1,4,1.0,0.0,1640,1475
2024-03-26,Malaysia,Oman,0,2,2,0.0,1.0,1697,1865
2024-03-26,Uzbekistan,Hong Kong,3,0,3,1.0,0.0,1920,1568
2024-03-26,Turkmenistan,Iran,0,1,1,0.0,1.0,1596,2049
2024-03-26,Philippines,Iraq,0,5,5,0.0,1.0,1567,1919
2024-03-26,Vietnam,Indonesia,0,3,3,0.0,1.0,1729,1699
2024-03-26,Tajikistan,Saudi Arabia,1,1,0,0.5,0.5,1683,1880
2024-03-26,Jordan,Pakistan,7,0,7,1.0,0.0,1856,1343
2024-03-26,Bahrain,Nepal,3,0,3,1.0,0.0,1829,1453
2024-03-26,Yemen,United Arab Emirates,0,3,3,0.0,1.0,1536,1853
2024-03-26,Bangladesh,Palestine,0,1,1,0.0,1.0,1448,1714
2024-03-26,Australia,Lebanon,5,0,5,1.0,0.0,1998,1667
2024-03-26,British Virgin Islands,United States Virgin Islands,0,0,0,0.5,0.5,1325,1325
2024-03-26,Turks and Caicos Islands,Anguilla,1,1,0,0.5,0.5,1400,1274
2024-03-26,Argentina,Costa Rica,3,1,2,1.0,0.0,2223,1881
2024-03-26,Austria,Turkey,6,1,5,1.0,0.0,1982,1955
2024-03-26,Colombia,Romania,3,2,1,1.0,0.0,2136,1893
2024-03-26,Czech Republic,Armenia,2,1,1,1.0,0.0,1950,1710
2024-03-26,Denmark,Faroe Islands,2,0,2,1.0,0.0,2029,1548
2024-03-26,El Salvador,Honduras,1,1,0,0.5,0.5,1706,1784
2024-03-26,England,Belgium,2,2,0,0.5,0.5,2148,2136
2024-03-26,France,Chile,3,2,1,1.0,0.0,2185,1952
2024-03-26,Germany,Netherlands,2,1,1,1.0,0.0,2101,2122
2024-03-26,Hungary,Kosovo,2,0,2,1.0,0.0,1960,1717
2024-03-26,Ivory Coast,Uruguay,2,1,1,1.0,0.0,1923,2085
2024-03-26,Latvia,Liechtenstein,1,1,0,0.5,0.5,1623,1385
2024-03-26,Malta,Belarus,0,0,0,0.5,0.5,1576,1718
2024-03-26,Morocco,Mauritania,0,0,0,0.5,0.5,1982,1676
2024-03-26,Nicaragua,Cuba,0,1,1,0.0,1.0,1601,1635
2024-03-26,Norway,Slovakia,1,1,0,0.5,0.5,1919,1877
2024-03-26,Peru,Dominican Republic,4,1,3,1.0,0.0,1975,1579
2024-03-26,Republic of Ireland,Switzerland,0,1,1,0.0,1.0,1869,2014
2024-03-26,Scotland,Northern Ireland,0,1,1,0.0,1.0,1924,1778
2024-03-26,Senegal,Benin,1,0,1,1.0,0.0,1973,1671
2024-03-26,Slovenia,Portugal,2,0,2,1.0,0.0,1890,2128
2024-03-26,Spain,Brazil,3,3,0,0.5,0.5,2165,2203
2024-03-26,Finland,Estonia,2,1,1,1.0,0.0,1843,1696
2024-03-26,Liberia,Djibouti,0,0,0,0.5,0.5,1574,1346
2024-03-26,Eswatini,Somalia,2,2,0,0.5,0.5,1577,1317
2024-03-26,Mauritius,Chad,1,2,1,0.0,1.0,1468,1523
2024-03-26,South Sudan,São Tomé and Príncipe,0,0,0,0.5,0.5,1488,1432
2024-03-26,Tonga,Cook Islands,0,1,1,0.0,1.0,1370,1423
2024-04-06,Northern Mariana Islands,Guam,2,2,0,0.5,0.5,1350,1360
2024-04-07,Northern Mariana Islands,Guam,2,1,1,1.0,0.0,1359,1352
2024-04-14,Trinidad and Tobago,Guyana,2,1,1,1.0,0.0,1737,1608
2024-04-16,Trinidad and Tobago,Guyana,2,0,2,1.0,0.0,1743,1603
2024-04-26,Grenada,Saint Vincent and the Grenadines,0,3,3,0.0,1.0,1506,1518
2024-04-26,Guatemala,Nicaragua,1,1,0,0.5,0.5,1765,1605
2024-05-31,Bolivia,Mexico,0,1,1,0.0,1.0,1775,2028
2024-05-31,Costa Rica,Uruguay,0,0,0,0.5,0.5,1886,2081
2024-06-02,Indonesia,Tanzania,0,0,0,0.5,0.5,1699,1660
2024-06-03,Albania,Liechtenstein,3,0,3,1.0,0.0,1798,1384
2024-06-03,Croatia,North Macedonia,3,0,3,1.0,0.0,2068,1790
2024-06-03,England,Bosnia and Herzegovina,3,0,3,1.0,0.0,2151,1818
2024-06-03,Germany,Ukraine,0,0,0,0.5,0.5,2099,2009
2024-06-03,Gibraltar,Scotland,0,2,2,0.0,1.0,1478,1926
2024-06-04,Austria,Serbia,2,1,1,1.0,0.0,1990,1972
2024-06-04,Italy,Turkey,0,0,0,0.5,0.5,2112,1959
2024-06-04,Portugal,Finland,4,2,2,1.0,0.0,2131,1841
2024-06-04,Republic of Ireland,Hungary,2,1,1,1.0,0.0,1880,1950
2024-06-04,Romania,Bulgaria,0,0,0,0.5,0.5,1891,1768
2024-06-04,Slovenia,Armenia,2,1,1,1.0,0.0,1895,1706
2024-06-04,Switzerland,Estonia,4,0,4,1.0,0.0,2017,1694
2024-06-05,Belgium,Montenegro,2,0,2,1.0,0.0,2138,1790
2024-06-05,Denmark,Sweden,2,1,1,1.0,0.0,2036,1970
2024-06-05,France,Luxembourg,3,0,3,1.0,0.0,2186,1675
2024-06-05,Mexico,Uruguay,0,4,4,0.0,1.0,2022,2088
2024-06-05,Norway,Kosovo,3,0,3,1.0,0.0,1923,1714
2024-06-05,San Marino,Slovakia,0,4,4,0.0,1.0,1286,1878
2024-06-05,Spain,Andorra,5,0,5,1.0,0.0,2166,1442
2024-06-05,Sierra Leone,Djibouti,2,1,1,1.0,0.0,1619,1344
2024-06-05,Togo,South Sudan,1,1,0,0.5,0.5,1682,1493
2024-06-05,Namibia,Liberia,1,1,0,0.5,0.5,1685,1577
2024-06-05,Tunisia,Equatorial Guinea,1,0,1,1.0,0.0,1924,1705
2024-06-05,Central African Republic,Chad,1,0,1,1.0,0.0,1576,1517
2024-06-05,Antigua and Barbuda,Bermuda,1,1,0,0.5,0.5,1548,1563
2024-06-05,Trinidad and Tobago,Grenada,2,2,0,0.5,0.5,1739,1511
2024-06-05,Curaçao,Barbados,4,1,3,1.0,0.0,1643,1455
2024-06-05,Nicaragua,Montserrat,4,1,3,1.0,0.0,1611,1476
2024-06-05,Guatemala,Dominica,6,0,6,1.0,0.0,1768,1465
2024-06-05,Suriname,Saint Vincent and the Grenadines,4,1,3,1.0,0.0,1645,1513
2024-06-06,Gibraltar,Wales,0,0,0,0.5,0.5,1485,1938
2024-06-06,Netherlands,Canada,4,0,4,1.0,0.0,2126,1900
2024-06-06,Guinea-Bissau,Ethiopia,0,0,0,0.5,0.5,1618,1645
2024-06-06,Egypt,Burkina Faso,2,1,1,1.0,0.0,1940,1788
2024-06-06,Mauritania,Sudan,0,2,2,0.0,1.0,1667,1632
2024-06-06,Senegal,DR Congo,1,1,0,0.5,0.5,1969,1760
2024-06-06,Benin,Rwanda,1,0,1,1.0,0.0,1679,1647
2024-06-06,Libya,Mauritius,2,1,1,1.0,0.0,1730,1466
2024-06-06,Algeria,Guinea,1,2,1,0.0,1.0,1949,1773
2024-06-06,Malawi,São Tomé and Príncipe,3,1,2,1.0,0.0,1671,1429
2024-06-06,Mali,Ghana,1,2,1,0.0,1.0,1848,1837
2024-06-06,Afghanistan,Qatar,0,0,0,0.5,0.5,1535,1920
2024-06-06,India,Kuwait,0,0,0,0.5,0.5,1641,1718
2024-06-06,Myanmar,Japan,0,5,5,0.0,1.0,1495,2073
2024-06-06,North Korea,Syria,1,0,1,1.0,0.0,1759,1743
2024-06-06,China PR,Thailand,1,1,0,0.5,0.5,1803,1778
2024-06-06,Singapore,South Korea,0,7,7,0.0,1.0,1611,2026
2024-06-06,Taiwan,Oman,0,3,3,0.0,1.0,1474,1867
2024-06-06,Kyrgyzstan,Malaysia,1,1,0,0.5,0.5,1642,1696
2024-06-06,Uzbekistan,Turkmenistan,3,1,2,1.0,0.0,1923,1594
2024-06-06,Hong Kong,Iran,2,4,2,0.0,1.0,1568,2050
2024-06-06,Indonesia,Iraq,0,2,2,0.0,1.0,1696,1923
2024-06-06,Vietnam,Philippines,3,2,1,1.0,0.0,1734,1563
2024-06-06,Jordan,Tajikistan,3,0,3,1.0,0.0,1861,1679
2024-06-06,Pakistan,Saudi Arabia,0,3,3,0.0,1.0,1343,1881
2024-06-06,Nepal,United Arab Emirates,0,4,4,0.0,1.0,1452,1855
2024-06-06,Bahrain,Yemen,0,0,0,0.5,0.5,1824,1542
2024-06-06,Bangladesh,Australia,0,2,2,0.0,1.0,1448,1999
2024-06-06,Palestine,Lebanon,0,0,0,0.5,0.5,1713,1669
2024-06-06,Honduras,Cuba,3,1,2,1.0,0.0,1789,1631
2024-06-06,Costa Rica,Saint Kitts and Nevis,4,0,4,1.0,0.0,1889,1551
2024-06-06,Haiti,Saint Lucia,2,1,1,1.0,0.0,1758,1514
2024-06-06,Panama,Guyana,2,0,2,1.0,0.0,1907,1601
2024-06-06,Jamaica,Dominican Republic,1,0,1,1.0,0.0,1841,1577
2024-06-06,El Salvador,Puerto Rico,0,0,0,0.5,0.5,1702,1506
2024-06-07,Albania,Azerbaijan,3,1,2,1.0,0.0,1804,1686
2024-06-07,Armenia,Kazakhstan,2,1,1,1.0,0.0,1714,1695
2024-06-07,Belarus,Russia,0,4,4,0.0,1.0,1715,1973
2024-06-07,Cambodia,Mongolia,2,0,2,1.0,0.0,1396,1380
2024-06-07,Czech Republic,Malta,7,1,6,1.0,0.0,1952,1575
2024-06-07,England,Iceland,0,1,1,0.0,1.0,2137,1823
2024-06-07,Germany,Greece,2,1,1,1.0,0.0,2103,1896
2024-06-07,Peru,Paraguay,0,0,0,0.5,0.5,1974,1902
2024-06-07,Poland,Ukraine,3,1,2,1.0,0.0,1981,2001
2024-06-07,Romania,Liechtenstein,0,0,0,0.5,0.5,1884,1392
2024-06-07,Scotland,Finland,2,2,0,0.5,0.5,1925,1843
2024-06-07,Zimbabwe,Lesotho,0,2,2,0.0,1.0,1680,1585
2024-06-07,Nigeria,South Africa,1,1,0,0.5,0.5,1879,1847
2024-06-07,Angola,Eswatini,1,0,1,1.0,0.0,1737,1573
2024-06-07,Morocco,Zambia,2,1,1,1.0,0.0,1986,1754
2024-06-07,Kenya,Burundi,1,1,0,0.5,0.5,1696,1621
2024-06-07,Ivory Coast,Gabon,1,0,1,1.0,0.0,1927,1725
2024-06-07,Mozambique,Somalia,2,1,1,1.0,0.0,1672,1316
2024-06-07,Uganda,Botswana,1,0,1,1.0,0.0,1697,1648
2024-06-07,Madagascar,Comoros,2,1,1,1.0,0.0,1638,1595
2024-06-08,Brunei,Sri Lanka,1,0,1,1.0,0.0,1285,1318
2024-06-08,Latvia,Lithuania,0,2,2,0.0,1.0,1615,1628
2024-06-08,Estonia,Faroe Islands,4,1,3,1.0,0.0,1699,1544
2024-06-08,Belgium,Luxembourg,3,0,3,1.0,0.0,2140,1674
2024-06-08,Denmark,Norway,3,1,2,1.0,0.0,2042,1918
2024-06-08,Hungary,Israel,3,0,3,1.0,0.0,1955,1792
2024-06-08,Mexico,Brazil,2,3,1,0.0,1.0,2018,2208
2024-06-08,Moldova,Cyprus,3,2,1,1.0,0.0,1612,1628
2024-06-08,Portugal,Croatia,1,2,1,0.0,1.0,2122,2078
2024-06-08,Slovenia,Bulgaria,1,1,0,0.5,0.5,1893,1771
2024-06-08,Spain,Northern Ireland,5,1,4,1.0,0.0,2168,1777
2024-06-08,Sweden,Serbia,0,3,3,0.0,1.0,1963,1980
2024-06-08,Switzerland,Austria,1,1,0,0.5,0.5,2017,1991
2024-06-08,United States,Colombia,1,5,4,0.0,1.0,2034,2142
2024-06-08,Cameroon,Cape Verde,4,1,3,1.0,0.0,1865,1778
2024-06-08,Gambia,Seychelles,5,1,4,1.0,0.0,1653,1366
2024-06-08,Cayman Islands,Antigua and Barbuda,1,0,1,1.0,0.0,1406,1537
2024-06-08,Bahamas,Trinidad and Tobago,1,7,6,0.0,1.0,1431,1742
2024-06-08,Aruba,Curaçao,0,2,2,0.0,1.0,1430,1647
2024-06-08,Belize,Nicaragua,0,4,4,0.0,1.0,1493,1617
2024-06-08,British Virgin Islands,Guatemala,0,3,3,0.0,1.0,1324,1770
2024-06-08,Anguilla,Suriname,0,4,4,0.0,1.0,1273,1647
2024-06-09,Argentina,Ecuador,1,0,1,1.0,0.0,2227,2011
2024-06-09,France,Canada,0,0,0,0.5,0.5,2181,1906
2024-06-09,Italy,Bosnia and Herzegovina,1,0,1,1.0,0.0,2115,1816
2024-06-09,Montenegro,Georgia,1,3,2,0.0,1.0,1783,1831
2024-06-09,Slovakia,Wales,4,0,4,1.0,0.0,1888,1929
2024-06-09,Djibouti,Ethiopia,1,1,0,0.5,0.5,1350,1640
2024-06-09,Mauritania,Senegal,0,1,1,0.0,1.0,1665,1972
2024-06-09,DR Congo,Togo,1,0,1,1.0,0.0,1767,1676
2024-06-09,São Tomé and Príncipe,Liberia,0,1,1,0.0,1.0,1425,1582
2024-06-09,Namibia,Tunisia,0,0,0,0.5,0.5,1690,1920
2024-06-09,Bermuda,Honduras,1,6,5,0.0,1.0,1560,1793
2024-06-09,Grenada,Costa Rica,0,3,3,0.0,1.0,1510,1891
2024-06-09,Barbados,Haiti,1,3,2,0.0,1.0,1453,1761
2024-06-09,Montserrat,Panama,1,3,2,0.0,1.0,1475,1909
2024-06-09,Dominica,Jamaica,2,3,1,0.0,1.0,1464,1843
2024-06-09,Saint Vincent and the Grenadines,El Salvador,1,3,2,0.0,1.0,1509,1707
2024-06-10,Czech Republic,North Macedonia,2,1,1,1.0,0.0,1957,1786
2024-06-10,Netherlands,Iceland,4,0,4,1.0,0.0,2129,1821
2024-06-10,Poland,Turkey,2,1,1,1.0,0.0,1989,1952
2024-06-10,Guinea-Bissau,Egypt,1,1,0,0.5,0.5,1624,1935
2024-06-10,Burkina Faso,Sierra Leone,2,2,0,0.5,0.5,1785,1623
2024-06-10,Benin,Nigeria,2,1,1,1.0,0.0,1692,1867
2024-06-10,Somalia,Botswana,1,3,2,0.0,1.0,1314,1651
2024-06-10,Uganda,Algeria,1,2,1,0.0,1.0,1694,1953
2024-06-10,Guinea,Mozambique,0,1,1,0.0,1.0,1763,1683
2024-06-10,Equatorial Guinea,Malawi,1,0,1,1.0,0.0,1713,1664
2024-06-10,Ghana,Central African Republic,4,3,1,1.0,0.0,1840,1574
2024-06-11,Latvia,Faroe Islands,1,0,1,1.0,0.0,1622,1538
2024-06-11,Lithuania,Estonia,1,1,0,0.5,0.5,1630,1698
2024-06-11,Brunei,Sri Lanka,1,0,1,1.0,0.0,1294,1310
2024-06-11,Andorra,Northern Ireland,0,2,2,0.0,1.0,1440,1780
2024-06-11,Azerbaijan,Kazakhstan,3,2,1,1.0,0.0,1695,1687
2024-06-11,Chile,Paraguay,3,0,3,1.0,0.0,1959,1896
2024-06-11,Greece,Malta,2,0,2,1.0,0.0,1899,1573
2024-06-11,Israel,Belarus,4,0,4,1.0,0.0,1799,1709
2024-06-11,Moldova,Ukraine,0,4,4,0.0,1.0,1611,2003
2024-06-11,Mongolia,Cambodia,2,1,1,1.0,0.0,1389,1388
2024-06-11,Portugal,Republic of Ireland,3,0,3,1.0,0.0,2126,1877
2024-06-11,San Marino,Cyprus,1,4,3,0.0,1.0,1285,1630
2024-06-11,South Sudan,Sudan,0,3,3,0.0,1.0,1489,1637
2024-06-11,Lesotho,Rwanda,0,1,1,0.0,1.0,1579,1654
2024-06-11,South Africa,Zimbabwe,3,1,2,1.0,0.0,1852,1676
2024-06-11,Cape Verde,Libya,1,0,1,1.0,0.0,1785,1724
2024-06-11,Mauritius,Eswatini,2,1,1,1.0,0.0,1477,1563
2024-06-11,Angola,Cameroon,1,1,0,0.5,0.5,1740,1863
2024-06-11,Zambia,Tanzania,0,1,1,0.0,1.0,1744,1671
2024-06-11,Morocco,Congo,6,0,6,1.0,0.0,1988,1625
2024-06-11,Kenya,Ivory Coast,0,0,0,0.5,0.5,1701,1923
2024-06-11,Gabon,Gambia,3,2,1,1.0,0.0,1732,1647
2024-06-11,Seychelles,Burundi,1,3,2,0.0,1.0,1364,1624
2024-06-11,Madagascar,Mali,0,0,0,0.5,0.5,1643,1844
2024-06-11,Chad,Comoros,0,2,2,0.0,1.0,1511,1602
2024-06-11,Kuwait,Afghanistan,1,0,1,1.0,0.0,1723,1531
2024-06-11,Qatar,India,2,1,1,1.0,0.0,1923,1639
2024-06-11,Japan,Syria,5,0,5,1.0,0.0,2076,1741
2024-06-11,North Korea,Myanmar,4,1,3,1.0,0.0,1762,1493
2024-06-11,Thailand,Singapore,3,1,2,1.0,0.0,1783,1607
2024-06-11,South Korea,China PR,1,0,1,1.0,0.0,2030,1800
2024-06-11,Oman,Kyrgyzstan,1,1,0,0.5,0.5,1863,1647
2024-06-11,Malaysia,Taiwan,3,1,2,1.0,0.0,1700,1471
2024-06-11,Turkmenistan,Hong Kong,0,0,0,0.5,0.5,1594,1569
2024-06-11,Iran,Uzbekistan,0,0,0,0.5,0.5,2048,1926
2024-06-11,Indonesia,Philippines,2,0,2,1.0,0.0,1702,1558
2024-06-11,Iraq,Vietnam,3,1,2,1.0,0.0,1928,1730
2024-06-11,Tajikistan,Pakistan,3,0,3,1.0,0.0,1682,1341
2024-06-11,Saudi Arabia,Jordan,1,2,1,0.0,1.0,1873,1870
2024-06-11,United Arab Emirates,Bahrain,1,1,0,0.5,0.5,1855,1825
2024-06-11,Yemen,Nepal,2,2,0,0.5,0.5,1540,1455
2024-06-11,Lebanon,Bangladesh,4,0,4,1.0,0.0,1673,1445
2024-06-11,Australia,Palestine,5,0,5,1.0,0.0,2002,1711
2024-06-11,Cuba,Cayman Islands,3,0,3,1.0,0.0,1635,1403
2024-06-11,Saint Kitts and Nevis,Bahamas,1,0,1,1.0,0.0,1557,1426
2024-06-11,Saint Lucia,Aruba,2,2,0,0.5,0.5,1513,1432
2024-06-11,Guyana,Belize,3,1,2,1.0,0.0,1607,1488
2024-06-11,Dominican Republic,British Virgin Islands,4,0,4,1.0,0.0,1581,1321
2024-06-11,Puerto Rico,Anguilla,8,0,8,1.0,0.0,1510,1270
2024-06-12,Ecuador,Bolivia,3,1,2,1.0,0.0,2015,1772
2024-06-12,United States,Brazil,1,1,0,0.5,0.5,2038,2205
2024-06-14,Germany,Scotland,5,1,4,1.0,0.0,2108,1921
2024-06-14,Argentina,Guatemala,4,1,3,1.0,0.0,2229,1769
2024-06-14,El Salvador,Peru,0,1,1,0.0,1.0,1705,1977
2024-06-15,Hungary,Switzerland,1,3,2,0.0,1.0,1949,2024
2024-06-15,Spain,Croatia,3,0,3,1.0,0.0,2174,2073
2024-06-15,Italy,Albania,2,1,1,1.0,0.0,2118,1802
2024-06-15,Colombia,Bolivia,3,0,3,1.0,0.0,2144,1771
2024-06-15,Vanuatu,Solomon Islands,1,0,1,1.0,0.0,1590,1680
2024-06-16,Ecuador,Honduras,2,1,1,1.0,0.0,2019,1790
2024-06-16,Slovenia,Denmark,1,1,0,0.5,0.5,1897,2039
2024-06-16,Serbia,England,0,1,1,0.0,1.0,1976,2142
2024-06-16,Poland,Netherlands,1,2,1,0.0,1.0,1985,2134
2024-06-16,Panama,Paraguay,0,1,1,0.0,1.0,1901,1905
2024-06-16,Tahiti,Samoa,2,0,2,1.0,0.0,1664,1471
2024-06-16,Fiji,Papua New Guinea,5,1,4,1.0,0.0,1663,1548
2024-06-17,Austria,France,0,1,1,0.0,1.0,1987,2186
2024-06-17,Romania,Ukraine,3,0,3,1.0,0.0,1895,1993
2024-06-17,Belgium,Slovakia,0,1,1,0.0,1.0,2128,1901
2024-06-18,Turkey,Georgia,3,1,2,1.0,0.0,1958,1826
2024-06-18,Portugal,Czech Republic,2,1,1,1.0,0.0,2131,1953
2024-06-18,New Zealand,Solomon Islands,3,0,3,1.0,0.0,1784,1675
2024-06-19,Germany,Hungary,2,0,2,1.0,0.0,2113,1945
2024-06-19,Scotland,Switzerland,1,1,0,0.5,0.5,1924,2022
2024-06-19,Croatia,Albania,2,2,0,0.5,0.5,2068,1808
2024-06-19,Papua New Guinea,Tahiti,1,1,0,0.5,0.5,1551,1662
2024-06-19,Fiji,Samoa,9,1,8,1.0,0.0,1667,1468
2024-06-20,Spain,Italy,1,0,1,1.0,0.0,2181,2112
2024-06-20,Slovenia,Serbia,1,1,0,0.5,0.5,1899,1975
2024-06-20,Denmark,England,1,1,0,0.5,0.5,2042,2140
2024-06-20,Argentina,Canada,2,0,2,1.0,0.0,2232,1904
2024-06-21,Poland,Austria,1,3,2,0.0,1.0,1978,1995
2024-06-21,Netherlands,France,0,0,0,0.5,0.5,2136,2185
2024-06-21,Slovakia,Ukraine,1,2,1,0.0,1.0,1896,1999
2024-06-21,Vanuatu,New Zealand,0,4,4,0.0,1.0,1587,1788
2024-06-21,Peru,Chile,0,0,0,0.5,0.5,1977,1960
2024-06-22,Belgium,Romania,2,0,2,1.0,0.0,2132,1892
2024-06-22,Georgia,Czech Republic,1,1,0,0.5,0.5,1829,1951
2024-06-22,Turkey,Portugal,0,3,3,0.0,1.0,1954,2136
2024-06-22,Samoa,Papua New Guinea,1,2,1,0.0,1.0,1462,1558
2024-06-22,Fiji,Tahiti,1,0,1,1.0,0.0,1675,1655
2024-06-22,Ecuador,Venezuela,1,2,1,0.0,1.0,2009,1936
2024-06-22,Mexico,Jamaica,1,0,1,1.0,0.0,2023,1839
2024-06-23,Germany,Switzerland,1,1,0,0.5,0.5,2111,2025
2024-06-23,Scotland,Hungary,0,1,1,0.0,1.0,1917,1953
2024-06-23,United States,Bolivia,2,0,2,1.0,0.0,2041,1769
2024-06-23,Uruguay,Panama,3,1,2,1.0,0.0,2093,1897
2024-06-24,Albania,Spain,0,1,1,0.0,1.0,1807,2183
2024-06-24,Croatia,Italy,1,1,0,0.5,0.5,2070,2111
2024-06-24,Colombia,Paraguay,2,1,1,1.0,0.0,2148,1902
2024-06-24,Brazil,Costa Rica,0,0,0,0.5,0.5,2200,1897
2024-06-25,England,Slovenia,0,0,0,0.5,0.5,2136,1904
2024-06-25,Denmark,Serbia,0,0,0,0.5,0.5,2041,1977
2024-06-25,Netherlands,Austria,2,3,1,0.0,1.0,2125,2007
2024-06-25,France,Poland,1,1,0,0.5,0.5,2181,1983
2024-06-25,Peru,Canada,0,1,1,0.0,1.0,1968,1914
2024-06-25,Chile,Argentina,0,1,1,0.0,1.0,1958,2235
2024-06-26,Slovakia,Romania,1,1,0,0.5,0.5,1896,1893
2024-06-26,Ukraine,Belgium,0,0,0,0.5,0.5,2002,2130
2024-06-26,Georgia,Portugal,2,0,2,1.0,0.0,1843,2123
2024-06-26,Czech Republic,Turkey,1,2,1,0.0,1.0,1944,1962
2024-06-26,Ecuador,Jamaica,3,1,2,1.0,0.0,2014,1835
2024-06-26,Venezuela,Mexico,1,0,1,1.0,0.0,1946,2014
2024-06-27,Vanuatu,Fiji,2,1,1,1.0,0.0,1597,1666
2024-06-27,New Zealand,Tahiti,5,0,5,1.0,0.0,1794,1650
2024-06-27,United States,Panama,1,2,1,0.0,1.0,2030,1909
2024-06-27,Uruguay,Bolivia,4,0,4,1.0,0.0,2096,1767
2024-06-28,Colombia,Costa Rica,3,0,3,1.0,0.0,2152,1894
2024-06-28,Paraguay,Brazil,1,4,3,0.0,1.0,1900,2203
2024-06-29,Switzerland,Italy,2,0,2,1.0,0.0,2035,2102
2024-06-29,Germany,Denmark,2,0,2,1.0,0.0,2118,2035
2024-06-29,Argentina,Peru,2,0,2,1.0,0.0,2238,1966
2024-06-29,Canada,Chile,0,0,0,0.5,0.5,1916,1957
2024-06-30,England,Slovakia,2,1,1,1.0,0.0,2140,1893
2024-06-30,Spain,Georgia,4,1,3,1.0,0.0,2185,1842
2024-06-30,Tahiti,Fiji,2,1,1,1.0,0.0,1659,1658
2024-06-30,Vanuatu,New Zealand,0,3,3,0.0,1.0,1594,1798
2024-06-30,Mexico,Ecuador,0,0,0,0.5,0.5,2014,2014
2024-06-30,Jamaica,Venezuela,0,3,3,0.0,1.0,1830,1952
2024-07-01,France,Belgium,1,0,1,1.0,0.0,2188,2124
2024-07-01,Portugal,Slovenia,0,0,0,0.5,0.5,2119,1909
2024-07-01,United States,Uruguay,0,1,1,0.0,1.0,2024,2103
2024-07-01,Bolivia,Panama,1,3,2,0.0,1.0,1763,1914
2024-07-02,Romania,Netherlands,0,3,3,0.0,1.0,1890,2129
2024-07-02,Austria,Turkey,1,2,1,0.0,1.0,1998,1972
2024-07-02,Brazil,Colombia,1,1,0,0.5,0.5,2202,2154
2024-07-02,Costa Rica,Paraguay,2,1,1,1.0,0.0,1903,1892
2024-07-04,Argentina,Ecuador,1,1,0,0.5,0.5,2234,2019
2024-07-05,Germany,Spain,1,2,1,0.0,1.0,2112,2192
2024-07-05,Portugal,France,0,0,0,0.5,0.5,2121,2187
2024-07-05,Venezuela,Canada,1,1,0,0.5,0.5,1952,1917
2024-07-06,England,Switzerland,1,1,0,0.5,0.5,2138,2038
2024-07-06,Netherlands,Turkey,2,1,1,1.0,0.0,2134,1968
2024-07-06,Uruguay,Brazil,0,0,0,0.5,0.5,2106,2200
2024-07-06,Colombia,Panama,5,0,5,1.0,0.0,2158,1911
2024-07-09,Spain,France,2,1,1,1.0,0.0,2200,2180
2024-07-09,Argentina,Canada,2,0,2,1.0,0.0,2237,1915
2024-07-10,Netherlands,England,1,2,1,0.0,1.0,2127,2146
2024-07-10,Uruguay,Colombia,0,1,1,0.0,1.0,2100,2165
2024-07-13,Canada,Uruguay,2,2,0,0.5,0.5,1919,2097
2024-07-14,Spain,England,2,1,1,1.0,0.0,2207,2140
2024-07-14,Argentina,Colombia,1,0,1,1.0,0.0,2244,2159
2024-07-27,Guatemala,El Salvador,0,1,1,0.0,1.0,1760,1715
2024-07-27,Jordan,North Korea,0,0,0,0.5,0.5,1868,1765
2024-08-29,Jordan,North Korea,2,1,1,1.0,0.0,1874,1760
2024-09-01,Guatemala,Uruguay,1,1,0,0.5,0.5,1766,2092
2024-09-02,Fiji,Solomon Islands,1,0,1,1.0,0.0,1667,1667
2024-09-02,Fiji,Hong Kong,1,1,0,0.5,0.5,1665,1572
2024-09-03,India,Mauritius,0,0,0,0.5,0.5,1636,1481
2024-09-04,Gibraltar,Andorra,1,0,1,1.0,0.0,1492,1434
2024-09-04,Lebanon,Tajikistan,1,0,1,1.0,0.0,1682,1674
2024-09-04,Malaysia,Philippines,2,1,1,1.0,0.0,1705,1554
2024-09-04,Comoros,Gambia,1,1,0,0.5,0.5,1604,1646
2024-09-04,Libya,Rwanda,1,1,0,0.5,0.5,1723,1656
2024-09-04,Sudan,Niger,1,0,1,1.0,0.0,1644,1570
2024-09-04,Tanzania,Ethiopia,0,0,0,0.5,0.5,1671,1641
2024-09-04,United States Virgin Islands,Bahamas,3,3,0,0.5,0.5,1328,1424
2024-09-04,Turks and Caicos Islands,Anguilla,0,2,2,0.0,1.0,1390,1281
2024-09-04,Cayman Islands,British Virgin Islands,1,0,1,1.0,0.0,1410,1315
2024-09-05,Hong Kong,Solomon Islands,3,0,3,1.0,0.0,1583,1657
2024-09-05,Bhutan,Bangladesh,0,1,1,0.0,1.0,1249,1449
2024-09-05,Vietnam,Russia,0,3,3,0.0,1.0,1727,1977
2024-09-05,Sri Lanka,Cambodia,0,0,0,0.5,0.5,1312,1387
2024-09-05,Timor-Leste,Mongolia,4,1,3,1.0,0.0,1278,1379
2024-09-05,Tunisia,Madagascar,1,0,1,1.0,0.0,1923,1641
2024-09-05,Central African Republic,Lesotho,3,1,2,1.0,0.0,1583,1571
2024-09-05,Algeria,Equatorial Guinea,2,0,2,1.0,0.0,1957,1710
2024-09-05,Ghana,Angola,0,1,1,0.0,1.0,1830,1751
2024-09-05,Guinea-Bissau,Eswatini,1,0,1,1.0,0.0,1631,1557
2024-09-05,Congo,South Sudan,1,0,1,1.0,0.0,1631,1484
2024-09-05,Malawi,Burundi,2,3,1,0.0,1.0,1656,1633
2024-09-05,Guyana,Suriname,1,3,2,0.0,1.0,1600,1655
2024-09-05,Costa Rica,Guadeloupe,3,0,3,1.0,0.0,1907,1656
2024-09-05,Guatemala,Martinique,3,1,2,1.0,0.0,1773,1701
2024-09-05,Montserrat,El Salvador,1,4,3,0.0,1.0,1472,1719
2024-09-05,Bonaire,Saint Vincent and the Grenadines,1,1,0,0.5,0.5,1476,1509
2024-09-05,Portugal,Croatia,2,1,1,1.0,0.0,2128,2064
2024-09-05,Scotland,Poland,2,3,1,0.0,1.0,1911,1990
2024-09-05,Denmark,Switzerland,2,0,2,1.0,0.0,2044,2030
2024-09-05,Serbia,Spain,0,0,0,0.5,0.5,1982,2203
2024-09-05,Azerbaijan,Sweden,1,3,2,0.0,1.0,1693,1966
2024-09-05,Estonia,Slovakia,0,1,1,0.0,1.0,1695,1897
2024-09-05,Northern Ireland,Luxembourg,2,0,2,1.0,0.0,1786,1669
2024-09-05,Belarus,Bulgaria,0,0,0,0.5,0.5,1711,1770
2024-09-05,San Marino,Liechtenstein,1,0,1,1.0,0.0,1296,1382
2024-09-05,Bolivia,Venezuela,4,0,4,1.0,0.0,1775,1941
2024-09-05,Argentina,Chile,3,0,3,1.0,0.0,2247,1955
2024-09-05,Qatar,United Arab Emirates,1,3,2,0.0,1.0,1914,1865
2024-09-05,Uzbekistan,North Korea,1,0,1,1.0,0.0,1931,1756
2024-09-05,Iran,Kyrgyzstan,1,0,1,1.0,0.0,2050,1646
2024-09-05,Iraq,Oman,1,0,1,1.0,0.0,1935,1857
2024-09-05,South Korea,Palestine,0,0,0,0.5,0.5,2025,1717
2024-09-05,Jordan,Kuwait,1,1,0,0.5,0.5,1871,1727
2024-09-05,Japan,China PR,7,0,7,1.0,0.0,2079,1798
2024-09-05,Australia,Bahrain,0,1,1,0.0,1.0,1991,1837
2024-09-05,Saudi Arabia,Indonesia,1,1,0,0.5,0.5,1870,1706
2024-09-06,Syria,Mauritius,2,0,2,1.0,0.0,1744,1479
2024-09-06,Brunei,Macau,3,0,3,1.0,0.0,1303,1296
2024-09-06,Morocco,Gabon,4,1,3,1.0,0.0,1991,1730
2024-09-06,Egypt,Cape Verde,3,0,3,1.0,0.0,1940,1781
2024-09-06,Togo,Liberia,1,1,0,0.5,0.5,1674,1585
2024-09-06,Sierra Leone,Chad,0,0,0,0.5,0.5,1621,1514
2024-09-06,Ivory Coast,Zambia,2,0,2,1.0,0.0,1928,1740
2024-09-06,DR Congo,Guinea,1,0,1,1.0,0.0,1775,1756
2024-09-06,Mali,Mozambique,1,1,0,0.5,0.5,1841,1687
2024-09-06,Kenya,Zimbabwe,0,0,0,0.5,0.5,1701,1677
2024-09-06,South Africa,Uganda,2,2,0,0.5,0.5,1849,1698
2024-09-06,Senegal,Burkina Faso,1,1,0,0.5,0.5,1969,1789
2024-09-06,French Guiana,Nicaragua,0,1,1,0.0,1.0,1619,1626
2024-09-06,Jamaica,Cuba,0,0,0,0.5,0.5,1826,1640
2024-09-06,Honduras,Trinidad and Tobago,4,0,4,1.0,0.0,1797,1736
2024-09-06,Saint Lucia,Curaçao,2,1,1,1.0,0.0,1524,1637
2024-09-06,Grenada,Saint Martin,2,0,2,1.0,0.0,1517,1449
2024-09-06,Sint Maarten,Aruba,2,0,2,1.0,0.0,1460,1425
2024-09-06,Puerto Rico,Haiti,1,4,3,0.0,1.0,1507,1765
2024-09-06,Belgium,Israel,3,1,2,1.0,0.0,2127,1797
2024-09-06,France,Italy,1,3,2,0.0,1.0,2171,2112
2024-09-06,Kazakhstan,Norway,0,0,0,0.5,0.5,1692,1914
2024-09-06,Slovenia,Austria,1,1,0,0.5,0.5,1912,1996
2024-09-06,Iceland,Montenegro,2,0,2,1.0,0.0,1829,1776
2024-09-06,Wales,Turkey,0,0,0,0.5,0.5,1930,1968
2024-09-06,Kosovo,Romania,0,3,3,0.0,1.0,1710,1895
2024-09-06,Lithuania,Cyprus,0,1,1,0.0,1.0,1622,1638
2024-09-06,Cook Islands,Tonga,1,3,2,0.0,1.0,1414,1380
2024-09-06,Samoa,American Samoa,2,0,2,1.0,0.0,1468,1327
2024-09-06,Peru,Colombia,1,1,0,0.5,0.5,1971,2155
2024-09-06,Uruguay,Paraguay,0,0,0,0.5,0.5,2088,1897
2024-09-06,Brazil,Ecuador,1,0,1,1.0,0.0,2205,2015
2024-09-07,Mexico,New Zealand,3,0,3,1.0,0.0,2018,1795
2024-09-07,United States,Canada,1,2,1,0.0,1.0,2014,1930
2024-09-07,Mauritania,Botswana,1,0,1,1.0,0.0,1673,1644
2024-09-07,Nigeria,Benin,3,0,3,1.0,0.0,1872,1688
2024-09-07,Cameroon,Namibia,1,0,1,1.0,0.0,1868,1686
2024-09-07,Bermuda,Dominican Republic,2,3,1,0.0,1.0,1553,1589
2024-09-07,Antigua and Barbuda,Dominica,1,2,1,0.0,1.0,1528,1474
2024-09-07,Bahamas,Barbados,2,3,1,0.0,1.0,1417,1461
2024-09-07,Turks and Caicos Islands,Belize,0,4,4,0.0,1.0,1385,1494
2024-09-07,Cayman Islands,Saint Kitts and Nevis,1,4,3,0.0,1.0,1406,1562
2024-09-07,Germany,Hungary,5,0,5,1.0,0.0,2117,1949
2024-09-07,Netherlands,Bosnia and Herzegovina,5,2,3,1.0,0.0,2130,1814
2024-09-07,Georgia,Czech Republic,4,1,3,1.0,0.0,1853,1934
2024-09-07,Ukraine,Albania,1,2,1,0.0,1.0,1990,1820
2024-09-07,Republic of Ireland,England,0,2,2,0.0,1.0,1875,2143
2024-09-07,Greece,Finland,3,0,3,1.0,0.0,1906,1837
2024-09-07,Faroe Islands,North Macedonia,1,1,0,0.5,0.5,1543,1782
2024-09-07,Armenia,Latvia,4,1,3,1.0,0.0,1720,1617
2024-09-07,Moldova,Malta,2,0,2,1.0,0.0,1619,1566
2024-09-08,Bhutan,Bangladesh,1,0,1,1.0,0.0,1262,1437
2024-09-08,Tajikistan,Philippines,0,0,0,0.5,0.5,1672,1557
2024-09-08,Malaysia,Lebanon,1,0,1,1.0,0.0,1713,1675
2024-09-08,Gambia,Tunisia,1,2,1,0.0,1.0,1644,1926
2024-09-08,Saint Vincent and the Grenadines,Montserrat,2,0,2,1.0,0.0,1517,1465
2024-09-08,Bonaire,El Salvador,1,2,1,0.0,1.0,1473,1723
2024-09-08,Portugal,Scotland,2,1,1,1.0,0.0,2132,1908
2024-09-08,Croatia,Poland,1,0,1,1.0,0.0,2071,1984
2024-09-08,Denmark,Serbia,2,0,2,1.0,0.0,2051,1976
2024-09-08,Switzerland,Spain,1,4,3,0.0,1.0,2026,2208
2024-09-08,Slovakia,Azerbaijan,2,0,2,1.0,0.0,1901,1690
2024-09-08,Sweden,Estonia,3,0,3,1.0,0.0,1969,1693
2024-09-08,Luxembourg,Belarus,0,1,1,0.0,1.0,1662,1719
2024-09-08,Bulgaria,Northern Ireland,1,0,1,1.0,0.0,1779,1778
2024-09-08,Gibraltar,Liechtenstein,2,2,0,0.5,0.5,1490,1385
2024-09-09,India,Syria,0,3,3,0.0,1.0,1631,1750
2024-09-09,Madagascar,Comoros,1,1,0,0.5,0.5,1641,1605
2024-09-09,Morocco,Lesotho,1,0,1,1.0,0.0,1993,1570
2024-09-09,Equatorial Guinea,Togo,2,2,0,0.5,0.5,1710,1675
2024-09-09,Niger,Ghana,1,1,0,0.5,0.5,1576,1825
2024-09-09,Angola,Sudan,2,1,1,1.0,0.0,1757,1639
2024-09-09,Ethiopia,DR Congo,0,2,2,0.0,1.0,1636,1781
2024-09-09,Uganda,Congo,2,0,2,1.0,0.0,1705,1625
2024-09-09,Burundi,Senegal,0,1,1,0.0,1.0,1631,1972
2024-09-09,Guadeloupe,Suriname,1,0,1,1.0,0.0,1664,1648
2024-09-09,Martinique,Guyana,2,2,0,0.5,0.5,1699,1603
2024-09-09,Guatemala,Costa Rica,0,0,0,0.5,0.5,1776,1905
2024-09-09,Curaçao,Saint Martin,4,0,4,1.0,0.0,1642,1445
2024-09-09,Grenada,Saint Lucia,1,2,1,0.0,1.0,1510,1532
2024-09-09,Haiti,Sint Maarten,6,0,6,1.0,0.0,1768,1458
2024-09-09,Puerto Rico,Aruba,1,0,1,1.0,0.0,1514,1419
2024-09-09,France,Belgium,2,0,2,1.0,0.0,2178,2121
2024-09-09,Israel,Italy,1,2,1,0.0,1.0,1795,2115
2024-09-09,Norway,Austria,2,1,1,1.0,0.0,1924,1987
2024-09-09,Slovenia,Kazakhstan,3,0,3,1.0,0.0,1916,1689
2024-09-09,Montenegro,Wales,1,2,1,0.0,1.0,1772,1935
2024-09-09,Turkey,Iceland,3,1,2,1.0,0.0,1973,1825
2024-09-09,Cyprus,Kosovo,0,4,4,0.0,1.0,1632,1717
2024-09-09,Romania,Lithuania,3,1,2,1.0,0.0,1898,1620
2024-09-09,Samoa,Tonga,2,1,1,1.0,0.0,1475,1374
2024-09-10,Mexico,Canada,0,0,0,0.5,0.5,2017,1932
2024-09-10,Moldova,San Marino,1,0,1,1.0,0.0,1622,1294
2024-09-10,United States,New Zealand,1,1,0,0.5,0.5,2010,1800
2024-09-10,Vietnam,Thailand,1,2,1,0.0,1.0,1721,1790
2024-09-10,Cambodia,Sri Lanka,2,2,0,0.5,0.5,1386,1314
2024-09-10,Macau,Brunei,0,1,1,0.0,1.0,1289,1311
2024-09-10,Mongolia,Timor-Leste,2,0,2,1.0,0.0,1385,1273
2024-09-10,Gabon,Central African Republic,2,0,2,1.0,0.0,1735,1579
2024-09-10,Botswana,Egypt,0,4,4,0.0,1.0,1642,1943
2024-09-10,Cape Verde,Mauritania,2,0,2,1.0,0.0,1787,1668
2024-09-10,Rwanda,Nigeria,0,0,0,0.5,0.5,1661,1868
2024-09-10,Benin,Libya,2,1,1,1.0,0.0,1697,1715
2024-09-10,Liberia,Algeria,0,3,3,0.0,1.0,1584,1959
2024-09-10,Zambia,Sierra Leone,3,2,1,1.0,0.0,1746,1616
2024-09-10,Chad,Ivory Coast,0,2,2,0.0,1.0,1513,1930
2024-09-10,Guinea,Tanzania,1,2,1,0.0,1.0,1747,1681
2024-09-10,Mozambique,Guinea-Bissau,2,1,1,1.0,0.0,1694,1625
2024-09-10,Eswatini,Mali,0,1,1,0.0,1.0,1555,1844
2024-09-10,Namibia,Kenya,1,2,1,0.0,1.0,1679,1709
2024-09-10,South Sudan,South Africa,2,3,1,0.0,1.0,1483,1851
2024-09-10,Burkina Faso,Malawi,3,1,2,1.0,0.0,1795,1651
2024-09-10,Cuba,Nicaragua,1,1,0,0.5,0.5,1640,1627
2024-09-10,Trinidad and Tobago,French Guiana,0,0,0,0.5,0.5,1734,1622
2024-09-10,Honduras,Jamaica,1,2,1,0.0,1.0,1790,1834
2024-09-10,Dominican Republic,Dominica,2,0,2,1.0,0.0,1595,1469
2024-09-10,Antigua and Barbuda,Bermuda,0,1,1,0.0,1.0,1521,1561
2024-09-10,United States Virgin Islands,Barbados,0,3,3,0.0,1.0,1323,1467
2024-09-10,Belize,Anguilla,1,0,1,1.0,0.0,1498,1278
2024-09-10,Saint Kitts and Nevis,British Virgin Islands,2,0,2,1.0,0.0,1566,1312
2024-09-10,Hungary,Bosnia and Herzegovina,0,0,0,0.5,0.5,1947,1817
2024-09-10,Netherlands,Germany,2,2,0,0.5,0.5,2130,2118
2024-09-10,Albania,Georgia,0,1,1,0.0,1.0,1813,1861
2024-09-10,Czech Republic,Ukraine,3,2,1,1.0,0.0,1944,1981
2024-09-10,England,Finland,2,0,2,1.0,0.0,2146,1835
2024-09-10,Republic of Ireland,Greece,0,2,2,0.0,1.0,1868,1914
2024-09-10,Latvia,Faroe Islands,1,0,1,1.0,0.0,1624,1537
2024-09-10,North Macedonia,Armenia,2,0,2,1.0,0.0,1789,1714
2024-09-10,Andorra,Malta,0,1,1,0.0,1.0,1429,1572
2024-09-10,Colombia,Argentina,2,1,1,1.0,0.0,2166,2237
2024-09-10,Ecuador,Peru,1,0,1,1.0,0.0,2022,1965
2024-09-10,Chile,Bolivia,1,2,1,0.0,1.0,1944,1787
2024-09-10,Venezuela,Uruguay,0,0,0,0.5,0.5,1945,2085
2024-09-10,Paraguay,Brazil,1,0,1,1.0,0.0,1911,2192
2024-09-10,North Korea,Qatar,2,2,0,0.5,0.5,1760,1911
2024-09-10,Kyrgyzstan,Uzbekistan,2,3,1,0.0,1.0,1644,1934
2024-09-10,United Arab Emirates,Iran,0,1,1,0.0,1.0,1861,2055
2024-09-10,Oman,South Korea,1,3,2,0.0,1.0,1853,2030
2024-09-10,Kuwait,Iraq,0,0,0,0.5,0.5,1732,1931
2024-09-10,Palestine,Jordan,1,3,2,0.0,1.0,1713,1876
2024-09-10,Bahrain,Japan,0,5,5,0.0,1.0,1834,2083
2024-09-10,Indonesia,Australia,0,0,0,0.5,0.5,1712,1986
2024-09-10,China PR,Saudi Arabia,1,2,1,0.0,1.0,1792,1877
2024-10-09,Barbados,United States Virgin Islands,5,0,5,1.0,0.0,1472,1319
2024-10-09,Belize,Anguilla,1,0,1,1.0,0.0,1502,1275
2024-10-09,Saint Kitts and Nevis,British Virgin Islands,3,1,2,1.0,0.0,1570,1309
2024-10-10,Liechtenstein,Hong Kong,1,0,1,1.0,0.0,1398,1571
2024-10-10,Myanmar,Sri Lanka,2,0,2,1.0,0.0,1498,1310
2024-10-10,Cape Verde,Botswana,0,1,1,0.0,1.0,1776,1654
2024-10-10,Algeria,Togo,5,1,4,1.0,0.0,1962,1673
2024-10-10,Ghana,Sudan,0,0,0,0.5,0.5,1822,1643
2024-10-10,DR Congo,Tanzania,1,0,1,1.0,0.0,1787,1676
2024-10-10,Namibia,Zimbabwe,0,1,1,0.0,1.0,1671,1686
2024-10-10,Burkina Faso,Burundi,4,1,3,1.0,0.0,1800,1627
2024-10-10,Cuba,Trinidad and Tobago,2,2,0,0.5,0.5,1643,1732
2024-10-10,French Guiana,Honduras,2,3,1,0.0,1.0,1618,1795
2024-10-10,Nicaragua,Jamaica,0,2,2,0.0,1.0,1624,1838
2024-10-10,Bonaire,Montserrat,0,1,1,0.0,1.0,1465,1474
2024-10-10,Saint Vincent and the Grenadines,El Salvador,2,3,1,0.0,1.0,1514,1727
2024-10-10,Israel,France,1,4,3,0.0,1.0,1794,2180
2024-10-10,Italy,Belgium,2,2,0,0.5,0.5,2116,2121
2024-10-10,England,Greece,1,2,1,0.0,1.0,2134,1927
2024-10-10,Finland,Republic of Ireland,1,2,1,0.0,1.0,1828,1876
2024-10-10,Austria,Kazakhstan,4,0,4,1.0,0.0,1990,1687
2024-10-10,Norway,Slovenia,3,0,3,1.0,0.0,1932,1909
2024-10-10,Latvia,North Macedonia,0,3,3,0.0,1.0,1620,1794
2024-10-10,Faroe Islands,Armenia,2,2,0,0.5,0.5,1541,1711
2024-10-10,Gibraltar,San Marino,1,0,1,1.0,0.0,1494,1291
2024-10-10,Moldova,Andorra,2,0,2,1.0,0.0,1626,1426
2024-10-10,Bolivia,Colombia,1,0,1,1.0,0.0,1802,2152
2024-10-10,Ecuador,Paraguay,0,0,0,0.5,0.5,2020,1914
2024-10-10,Venezuela,Argentina,1,1,0,0.5,0.5,1951,2232
2024-10-10,Chile,Brazil,1,2,1,0.0,1.0,1941,2196
2024-10-10,Papua New Guinea,New Caledonia,1,3,2,0.0,1.0,1553,1662
2024-10-10,Fiji,Solomon Islands,1,0,1,1.0,0.0,1673,1650
2024-10-10,Qatar,Kyrgyzstan,3,1,2,1.0,0.0,1914,1642
2024-10-10,Uzbekistan,Iran,0,0,0,0.5,0.5,1937,2053
2024-10-10,United Arab Emirates,North Korea,1,1,0,0.5,0.5,1859,1763
2024-10-10,Jordan,South Korea,0,2,2,0.0,1.0,1872,2035
2024-10-10,Oman,Kuwait,4,0,4,1.0,0.0,1859,1727
2024-10-10,Iraq,Palestine,1,0,1,1.0,0.0,1935,1710
2024-10-10,Bahrain,Indonesia,2,2,0,0.5,0.5,1832,1715
2024-10-10,Australia,China PR,3,1,2,1.0,0.0,1990,1789
2024-10-10,Saudi Arabia,Japan,0,2,2,0.0,1.0,1874,2087
2024-10-11,Cambodia,Taiwan,3,2,1,1.0,0.0,1396,1462
2024-10-11,Madagascar,Gambia,1,1,0,0.5,0.5,1642,1644
2024-10-11,Tunisia,Comoros,0,1,1,0.0,1.0,1913,1619
2024-10-11,Gabon,Lesotho,0,0,0,0.5,0.5,1732,1574
2024-10-11,Egypt,Mauritania,2,0,2,1.0,0.0,1946,1666
2024-10-11,Benin,Rwanda,3,0,3,1.0,0.0,1705,1654
2024-10-11,Nigeria,Libya,1,0,1,1.0,0.0,1873,1711
2024-10-11,Equatorial Guinea,Liberia,1,0,1,1.0,0.0,1716,1579
2024-10-11,Angola,Niger,2,0,2,1.0,0.0,1762,1572
2024-10-11,Zambia,Chad,0,0,0,0.5,0.5,1742,1518
2024-10-11,Ivory Coast,Sierra Leone,4,1,3,1.0,0.0,1933,1614
2024-10-11,Mozambique,Eswatini,1,1,0,0.5,0.5,1691,1559
2024-10-11,Mali,Guinea-Bissau,1,0,1,1.0,0.0,1848,1622
2024-10-11,Cameroon,Kenya,4,1,3,1.0,0.0,1873,1705
2024-10-11,Uganda,South Sudan,1,0,1,1.0,0.0,1709,1480
2024-10-11,South Africa,Congo,5,0,5,1.0,0.0,1855,1622
2024-10-11,Senegal,Malawi,4,0,4,1.0,0.0,1975,1649
2024-10-11,Guadeloupe,Martinique,0,1,1,0.0,1.0,1657,1707
2024-10-11,Suriname,Costa Rica,1,1,0,0.5,0.5,1654,1900
2024-10-11,Guyana,Guatemala,1,3,2,0.0,1.0,1599,1781
2024-10-11,Grenada,Curaçao,0,0,0,0.5,0.5,1513,1640
2024-10-11,Saint Lucia,Saint Martin,2,1,1,1.0,0.0,1539,1439
2024-10-11,Sint Maarten,Puerto Rico,3,2,1,1.0,0.0,1468,1505
2024-10-11,Aruba,Haiti,1,3,2,0.0,1.0,1418,1770
2024-10-11,Bosnia and Herzegovina,Germany,1,2,1,0.0,1.0,1815,2121
2024-10-11,Hungary,Netherlands,1,1,0,0.5,0.5,1951,2127
2024-10-11,Czech Republic,Albania,2,0,2,1.0,0.0,1950,1808
2024-10-11,Ukraine,Georgia,1,0,1,1.0,0.0,1987,1856
2024-10-11,Iceland,Wales,2,2,0,0.5,0.5,1828,1933
2024-10-11,Turkey,Montenegro,1,0,1,1.0,0.0,1977,1769
2024-10-11,Estonia,Azerbaijan,3,1,2,1.0,0.0,1701,1683
2024-10-11,Slovakia,Sweden,2,2,0,0.5,0.5,1903,1968
2024-10-11,Peru,Uruguay,1,0,1,1.0,0.0,1976,2075
2024-10-11,New Zealand,Tahiti,3,0,3,1.0,0.0,1805,1655
2024-10-12,United States,Panama,2,0,2,1.0,0.0,2016,1906
2024-10-12,Vietnam,India,1,1,0,0.5,0.5,1719,1634
2024-10-12,Morocco,Central African Republic,5,0,5,1.0,0.0,1995,1578
2024-10-12,Guinea,Ethiopia,4,1,3,1.0,0.0,1753,1631
2024-10-12,Antigua and Barbuda,Dominican Republic,0,5,5,0.0,1.0,1515,1602
2024-10-12,Bermuda,Dominica,6,1,5,1.0,0.0,1567,1464
2024-10-12,Bahamas,United States Virgin Islands,3,1,2,1.0,0.0,1423,1314
2024-10-12,Turks and Caicos Islands,Anguilla,2,1,1,1.0,0.0,1391,1270
2024-10-12,Cayman Islands,British Virgin Islands,1,0,1,1.0,0.0,1412,1304
2024-10-12,Croatia,Scotland,2,1,1,1.0,0.0,2076,1904
2024-10-12,Poland,Portugal,1,3,2,0.0,1.0,1980,2137
2024-10-12,Serbia,Switzerland,2,0,2,1.0,0.0,1986,2017
2024-10-12,Spain,Denmark,1,0,1,1.0,0.0,2213,2047
2024-10-12,Lithuania,Kosovo,1,2,1,0.0,1.0,1615,1723
2024-10-12,Cyprus,Romania,0,3,3,0.0,1.0,1630,1901
2024-10-12,Bulgaria,Luxembourg,0,0,0,0.5,0.5,1777,1665
2024-10-12,Belarus,Northern Ireland,0,0,0,0.5,0.5,1721,1777
2024-10-12,Vanuatu,Samoa,4,1,3,1.0,0.0,1600,1470
2024-10-13,Andorra,San Marino,2,0,2,1.0,0.0,1432,1286
2024-10-13,Myanmar,Sri Lanka,0,0,0,0.5,0.5,1495,1314
2024-10-13,Burundi,Burkina Faso,0,2,2,0.0,1.0,1623,1805
2024-10-13,Montserrat,Bonaire,0,1,1,0.0,1.0,1466,1474
2024-10-13,Saint Vincent and the Grenadines,El Salvador,2,1,1,1.0,0.0,1527,1715
2024-10-13,Finland,England,1,3,2,0.0,1.0,1826,2137
2024-10-13,Greece,Republic of Ireland,2,0,2,1.0,0.0,1934,1870
2024-10-13,Kazakhstan,Slovenia,0,1,1,0.0,1.0,1684,1913
2024-10-13,Austria,Norway,5,1,4,1.0,0.0,1997,1926
2024-10-13,Faroe Islands,Latvia,1,1,0,0.5,0.5,1543,1619
2024-10-13,Armenia,North Macedonia,0,2,2,0.0,1.0,1705,1801
2024-10-13,Liechtenstein,Gibraltar,0,0,0,0.5,0.5,1401,1492
2024-10-13,Malta,Moldova,1,0,1,1.0,0.0,1582,1617
2024-10-14,New Zealand,Malaysia,4,0,4,1.0,0.0,1811,1708
2024-10-14,Gambia,Madagascar,1,0,1,1.0,0.0,1652,1635
2024-10-14,Liberia,Equatorial Guinea,1,2,1,0.0,1.0,1575,1721
2024-10-14,Togo,Algeria,0,1,1,0.0,1.0,1671,1965
2024-10-14,Eswatini,Mozambique,0,3,3,0.0,1.0,1554,1697
2024-10-14,Kenya,Cameroon,0,1,1,0.0,1.0,1701,1878
2024-10-14,Zimbabwe,Namibia,3,1,2,1.0,0.0,1694,1664
2024-10-14,Nicaragua,French Guiana,3,2,1,1.0,0.0,1632,1611
2024-10-14,Jamaica,Honduras,0,0,0,0.5,0.5,1838,1796
2024-10-14,Trinidad and Tobago,Cuba,3,1,2,1.0,0.0,1738,1638
2024-10-14,Curaçao,Grenada,1,0,1,1.0,0.0,1646,1508
2024-10-14,Saint Lucia,Saint Martin,0,4,4,0.0,1.0,1529,1450
2024-10-14,Puerto Rico,Sint Maarten,2,1,1,1.0,0.0,1513,1461
2024-10-14,Aruba,Haiti,3,5,2,0.0,1.0,1417,1772
2024-10-14,Belgium,France,1,2,1,0.0,1.0,2115,2187
2024-10-14,Italy,Israel,4,1,3,1.0,0.0,2119,1792
2024-10-14,Bosnia and Herzegovina,Hungary,0,2,2,0.0,1.0,1810,1957
2024-10-14,Germany,Netherlands,1,0,1,1.0,0.0,2130,2119
2024-10-14,Georgia,Albania,0,1,1,0.0,1.0,1847,1818
2024-10-14,Ukraine,Czech Republic,1,1,0,0.5,0.5,1987,1951
2024-10-14,Iceland,Turkey,2,4,2,0.0,1.0,1824,1982
2024-10-14,Wales,Montenegro,1,0,1,1.0,0.0,1938,1765
2024-10-14,Azerbaijan,Slovakia,1,3,2,0.0,1.0,1680,1907
2024-10-14,Estonia,Sweden,0,3,3,0.0,1.0,1699,1971
2024-10-15,Canada,Panama,2,1,1,1.0,0.0,1940,1899
2024-10-15,Hong Kong,Cambodia,3,0,3,1.0,0.0,1576,1392
2024-10-15,Mexico,United States,2,0,2,1.0,0.0,2025,2009
2024-10-15,Comoros,Tunisia,1,1,0,0.5,0.5,1625,1908
2024-10-15,Lesotho,Gabon,0,2,2,0.0,1.0,1570,1737
2024-10-15,Morocco,Central African Republic,4,0,4,1.0,0.0,1997,1577
2024-10-15,Mauritania,Egypt,0,1,1,0.0,1.0,1664,1949
2024-10-15,Botswana,Cape Verde,1,0,1,1.0,0.0,1665,1766
2024-10-15,Rwanda,Benin,2,1,1,1.0,0.0,1664,1696
2024-10-15,Sudan,Ghana,2,0,2,1.0,0.0,1655,1811
2024-10-15,Niger,Angola,0,1,1,0.0,1.0,1568,1767
2024-10-15,Chad,Zambia,0,1,1,0.0,1.0,1515,1746
2024-10-15,Sierra Leone,Ivory Coast,1,0,1,1.0,0.0,1628,1920
2024-10-15,Tanzania,DR Congo,0,2,2,0.0,1.0,1671,1793
2024-10-15,Ethiopia,Guinea,0,3,3,0.0,1.0,1626,1759
2024-10-15,Guinea-Bissau,Mali,0,0,0,0.5,0.5,1627,1844
2024-10-15,South Sudan,Uganda,1,2,1,0.0,1.0,1477,1713
2024-10-15,Congo,South Africa,1,1,0,0.5,0.5,1627,1851
2024-10-15,Malawi,Senegal,0,1,1,0.0,1.0,1647,1978
2024-10-15,Costa Rica,Guatemala,3,0,3,1.0,0.0,1906,1776
2024-10-15,Guadeloupe,Martinique,0,0,0,0.5,0.5,1659,1706
2024-10-15,Suriname,Guyana,5,1,4,1.0,0.0,1661,1593
2024-10-15,Dominican Republic,Antigua and Barbuda,5,0,5,1.0,0.0,1609,1509
2024-10-15,Bermuda,Dominica,3,2,1,1.0,0.0,1573,1459
2024-10-15,Barbados,Bahamas,6,2,4,1.0,0.0,1479,1417
2024-10-15,Belize,Turks and Caicos Islands,3,0,3,1.0,0.0,1508,1386
2024-10-15,Saint Kitts and Nevis,Cayman Islands,1,1,0,0.5,0.5,1567,1416
2024-10-15,Scotland,Portugal,0,0,0,0.5,0.5,1909,2133
2024-10-15,Poland,Croatia,3,3,0,0.5,0.5,1983,2074
2024-10-15,Spain,Serbia,3,0,3,1.0,0.0,2217,1983
2024-10-15,Switzerland,Denmark,2,2,0,0.5,0.5,2018,2047
2024-10-15,Kosovo,Cyprus,3,0,3,1.0,0.0,1729,1625
2024-10-15,Lithuania,Romania,1,2,1,0.0,1.0,1613,1904
2024-10-15,Northern Ireland,Bulgaria,5,0,5,1.0,0.0,1785,1769
2024-10-15,Belarus,Luxembourg,1,1,0,0.5,0.5,1720,1667
2024-10-15,Colombia,Chile,4,0,4,1.0,0.0,2156,1938
2024-10-15,Paraguay,Venezuela,2,1,1,1.0,0.0,1923,1943
2024-10-15,Uruguay,Ecuador,0,0,0,0.5,0.5,2074,2022
2024-10-15,Argentina,Bolivia,6,0,6,1.0,0.0,2234,1801
2024-10-15,Brazil,Peru,4,0,4,1.0,0.0,2200,1973
2024-10-15,Uzbekistan,United Arab Emirates,1,0,1,1.0,0.0,1944,1853
2024-10-15,Iran,Qatar,4,1,3,1.0,0.0,2058,1910
2024-10-15,Kyrgyzstan,North Korea,1,0,1,1.0,0.0,1653,1753
2024-10-15,Jordan,Oman,4,0,4,1.0,0.0,1880,1852
2024-10-15,Palestine,Kuwait,2,2,0,0.5,0.5,1711,1727
2024-10-15,South Korea,Iraq,3,2,1,1.0,0.0,2041,1930
2024-10-15,Japan,Australia,1,1,0,0.5,0.5,2085,1993
2024-10-15,China PR,Indonesia,2,1,1,1.0,0.0,1796,1709
2024-10-15,Saudi Arabia,Bahrain,0,0,0,0.5,0.5,1874,1833
2024-11-13,Bangladesh,Maldives,0,1,1,0.0,1.0,1430,1452
2024-11-13,Tajikistan,Nepal,4,0,4,1.0,0.0,1676,1452
2024-11-14,Belgium,Italy,0,1,1,0.0,1.0,2108,2127
2024-11-14,France,Israel,0,0,0,0.5,0.5,2181,1799
2024-11-14,Republic of Ireland,Finland,1,0,1,1.0,0.0,1877,1820
2024-11-14,Greece,England,0,3,3,0.0,1.0,1931,2141
2024-11-14,Kazakhstan,Austria,0,2,2,0.0,1.0,1682,2000
2024-11-14,Slovenia,Norway,1,4,3,0.0,1.0,1906,1934
2024-11-14,North Macedonia,Latvia,1,0,1,1.0,0.0,1806,1615
2024-11-14,Armenia,Faroe Islands,0,1,1,0.0,1.0,1694,1555
2024-11-14,Montserrat,Saint Vincent and the Grenadines,1,2,1,0.0,1.0,1460,1534
2024-11-14,El Salvador,Bonaire,1,0,1,1.0,0.0,1719,1471
2024-11-14,Belize,French Guiana,2,1,1,1.0,0.0,1519,1601
2024-11-14,Saint Kitts and Nevis,Cuba,2,1,1,1.0,0.0,1577,1629
2024-11-14,Costa Rica,Panama,0,1,1,0.0,1.0,1898,1908
2024-11-14,Jamaica,United States,0,1,1,0.0,1.0,1834,2014
2024-11-14,Hong Kong,Philippines,3,1,2,1.0,0.0,1584,1550
2024-11-14,Malaysia,Laos,3,1,2,1.0,0.0,1710,1335
2024-11-14,Malta,Liechtenstein,2,0,2,1.0,0.0,1587,1397
2024-11-14,Singapore,Myanmar,3,2,1,1.0,0.0,1613,1490
2024-11-14,Thailand,Lebanon,0,0,0,0.5,0.5,1788,1678
2024-11-14,Venezuela,Brazil,1,1,0,0.5,0.5,1949,2195
2024-11-14,Ecuador,Bolivia,4,0,4,1.0,0.0,2026,1798
2024-11-14,Paraguay,Argentina,2,1,1,1.0,0.0,1937,2221
2024-11-14,Solomon Islands,New Caledonia,2,3,1,0.0,1.0,1643,1670
2024-11-14,Papua New Guinea,Fiji,3,3,0,0.5,0.5,1556,1671
2024-11-14,North Korea,Iran,2,3,1,0.0,1.0,1751,2061
2024-11-14,Qatar,Uzbekistan,3,2,1,1.0,0.0,1919,1936
2024-11-14,United Arab Emirates,Kyrgyzstan,3,0,3,1.0,0.0,1857,1650
2024-11-14,Kuwait,South Korea,1,3,2,0.0,1.0,1725,2044
2024-11-14,Iraq,Jordan,0,0,0,0.5,0.5,1929,1882
2024-11-14,Oman,Palestine,1,0,1,1.0,0.0,1857,1707
2024-11-14,Bahrain,China PR,0,1,1,0.0,1.0,1825,1805
2024-11-14,Australia,Saudi Arabia,0,0,0,0.5,0.5,1991,1877
2024-11-15,Portugal,Poland,5,1,4,1.0,0.0,2138,1979
2024-11-15,Scotland,Croatia,1,0,1,1.0,0.0,1921,2063
2024-11-15,Denmark,Spain,1,2,1,0.0,1.0,2043,2222
2024-11-15,Switzerland,Serbia,1,1,0,0.5,0.5,2018,1984
2024-11-15,Cyprus,Lithuania,2,1,1,1.0,0.0,1633,1606
2024-11-15,Romania,Kosovo,0,0,0,0.5,0.5,1901,1733
2024-11-15,Northern Ireland,Belarus,2,0,2,1.0,0.0,1792,1714
2024-11-15,Luxembourg,Bulgaria,0,1,1,0.0,1.0,1662,1775
2024-11-15,San Marino,Gibraltar,1,1,0,0.5,0.5,1291,1488
2024-11-15,Saint Lucia,Grenada,0,4,4,0.0,1.0,1521,1517
2024-11-15,Curaçao,Saint Martin,5,0,5,1.0,0.0,1650,1447
2024-11-15,Puerto Rico,Aruba,5,1,4,1.0,0.0,1519,1412
2024-11-15,Sint Maarten,Haiti,0,8,8,0.0,1.0,1459,1775
2024-11-15,Barbados,Guyana,1,4,3,0.0,1.0,1474,1599
2024-11-15,Cayman Islands,Guadeloupe,0,6,6,0.0,1.0,1413,1663
2024-11-15,Honduras,Mexico,2,0,2,1.0,0.0,1809,2013
2024-11-15,Suriname,Canada,0,1,1,0.0,1.0,1659,1943
2024-11-15,Peru,Chile,0,0,0,0.5,0.5,1973,1939
2024-11-15,Uruguay,Colombia,3,2,1,1.0,0.0,2084,2147
2024-11-15,Samoa,Tahiti,0,3,3,0.0,1.0,1466,1660
2024-11-15,New Zealand,Vanuatu,8,1,7,1.0,0.0,1815,1597
2024-11-15,Indonesia,Japan,0,4,4,0.0,1.0,1708,2087
2024-11-15,Russia,Brunei,2,1,1,1.0,0.0,1978,1311
2024-11-16,Germany,Bosnia and Herzegovina,7,0,7,1.0,0.0,2133,1808
2024-11-16,Netherlands,Hungary,4,0,4,1.0,0.0,2124,1953
2024-11-16,Albania,Czech Republic,0,0,0,0.5,0.5,1821,1949
2024-11-16,Georgia,Ukraine,1,1,0,0.5,0.5,1851,1984
2024-11-16,Montenegro,Iceland,0,2,2,0.0,1.0,1759,1831
2024-11-16,Turkey,Wales,0,0,0,0.5,0.5,1981,1940
2024-11-16,Azerbaijan,Estonia,0,0,0,0.5,0.5,1681,1699
2024-11-16,Sweden,Slovakia,2,1,1,1.0,0.0,1978,1901
2024-11-16,Andorra,Moldova,0,1,1,0.0,1.0,1428,1622
2024-11-16,Bermuda,Antigua and Barbuda,2,1,1,1.0,0.0,1580,1503
2024-11-16,Dominican Republic,Dominica,6,1,5,1.0,0.0,1614,1455
2024-11-16,Bangladesh,Maldives,2,1,1,1.0,0.0,1439,1444
2024-11-16,Nepal,Afghanistan,2,0,2,1.0,0.0,1462,1522
2024-11-16,Sri Lanka,Yemen,1,0,1,1.0,0.0,1327,1528
2024-11-17,Israel,Belgium,1,0,1,1.0,0.0,1813,2095
2024-11-17,Italy,France,1,3,2,0.0,1.0,2121,2188
2024-11-17,England,Republic of Ireland,5,0,5,1.0,0.0,2144,1875
2024-11-17,Finland,Greece,0,2,2,0.0,1.0,1815,1937
2024-11-17,Norway,Kazakhstan,5,0,5,1.0,0.0,1938,1679
2024-11-17,Austria,Slovenia,1,1,0,0.5,0.5,1998,1909
2024-11-17,North Macedonia,Faroe Islands,1,0,1,1.0,0.0,1810,1552
2024-11-17,Latvia,Armenia,1,2,1,0.0,1.0,1609,1701
2024-11-17,Saint Vincent and the Grenadines,Bonaire,3,1,2,1.0,0.0,1541,1465
2024-11-17,El Salvador,Montserrat,1,0,1,1.0,0.0,1722,1458
2024-11-17,Thailand,Laos,1,1,0,0.5,0.5,1782,1342
2024-11-17,Fiji,New Caledonia,1,1,0,0.5,0.5,1671,1671
2024-11-17,Papua New Guinea,Solomon Islands,1,2,1,0.0,1.0,1550,1650
2024-11-18,Croatia,Portugal,1,1,0,0.5,0.5,2065,2137
2024-11-18,Poland,Scotland,1,2,1,0.0,1.0,1970,1931
2024-11-18,Serbia,Denmark,0,0,0,0.5,0.5,1986,2042
2024-11-18,Spain,Switzerland,3,2,1,1.0,0.0,2226,2015
2024-11-18,Kosovo,Lithuania,1,0,1,1.0,0.0,1739,1601
2024-11-18,Romania,Cyprus,4,1,3,1.0,0.0,1904,1631
2024-11-18,Luxembourg,Northern Ireland,2,2,0,0.5,0.5,1665,1790
2024-11-18,Bulgaria,Belarus,1,1,0,0.5,0.5,1774,1716
2024-11-18,Liechtenstein,San Marino,1,3,2,0.0,1.0,1387,1302
2024-11-18,Grenada,Saint Martin,0,3,3,0.0,1.0,1508,1457
2024-11-18,Saint Lucia,Curaçao,1,4,3,0.0,1.0,1516,1656
2024-11-18,Aruba,Sint Maarten,0,1,1,0.0,1.0,1406,1466
2024-11-18,Puerto Rico,Haiti,0,3,3,0.0,1.0,1517,1778
2024-11-18,Cuba,Saint Kitts and Nevis,4,0,4,1.0,0.0,1636,1571
2024-11-18,Panama,Costa Rica,2,2,0,0.5,0.5,1908,1899
2024-11-18,United States,Jamaica,4,2,2,1.0,0.0,2019,1830
2024-11-18,India,Malaysia,1,1,0,0.5,0.5,1636,1709
2024-11-18,Singapore,Taiwan,2,3,1,0.0,1.0,1602,1474
2024-11-18,Tahiti,Vanuatu,2,0,2,1.0,0.0,1667,1591
2024-11-18,New Zealand,Samoa,8,0,8,1.0,0.0,1817,1465
2024-11-19,Bosnia and Herzegovina,Netherlands,1,1,0,0.5,0.5,1814,2119
2024-11-19,Hungary,Germany,1,1,0,0.5,0.5,1957,2130
2024-11-19,Albania,Ukraine,1,2,1,0.0,1.0,1817,1989
2024-11-19,Czech Republic,Georgia,2,1,1,1.0,0.0,1955,1846
2024-11-19,Wales,Iceland,4,1,3,1.0,0.0,1946,1826
2024-11-19,Montenegro,Turkey,3,1,2,1.0,0.0,1772,1969
2024-11-19,Slovakia,Estonia,1,0,1,1.0,0.0,1905,1696
2024-11-19,Sweden,Azerbaijan,6,0,6,1.0,0.0,1981,1679
2024-11-19,Malta,Andorra,0,0,0,0.5,0.5,1584,1432
2024-11-19,Antigua and Barbuda,Dominica,0,0,0,0.5,0.5,1502,1457
2024-11-19,Dominican Republic,Bermuda,6,1,5,1.0,0.0,1622,1573
2024-11-19,French Guiana,Belize,2,2,0,0.5,0.5,1600,1521
2024-11-19,Guadeloupe,Cayman Islands,1,0,1,1.0,0.0,1667,1410
2024-11-19,Guyana,Barbados,5,3,2,1.0,0.0,1605,1469
2024-11-19,Canada,Suriname,3,0,3,1.0,0.0,1946,1657
2024-11-19,Mexico,Honduras,4,0,4,1.0,0.0,2017,1806
2024-11-19,Gibraltar,Moldova,1,1,0,0.5,0.5,1491,1620
2024-11-19,Hong Kong,Mauritius,1,0,1,1.0,0.0,1590,1474
2024-11-19,Myanmar,Lebanon,2,3,1,0.0,1.0,1486,1683
2024-11-19,Russia,Syria,4,0,4,1.0,0.0,1982,1747
2024-11-19,Sri Lanka,Yemen,0,2,2,0.0,1.0,1324,1532
2024-11-19,Tajikistan,Afghanistan,3,1,2,1.0,0.0,1681,1518
2024-11-19,Bolivia,Paraguay,2,2,0,0.5,0.5,1802,1934
2024-11-19,Colombia,Ecuador,0,1,1,0.0,1.0,2137,2037
2024-11-19,Argentina,Peru,1,0,1,1.0,0.0,2225,1970
2024-11-19,Chile,Venezuela,4,2,2,1.0,0.0,1948,1941
2024-11-19,Brazil,Uruguay,1,1,0,0.5,0.5,2193,2087
2024-11-19,North Korea,Uzbekistan,0,1,1,0.0,1.0,1747,1941
2024-11-19,Kyrgyzstan,Iran,2,3,1,0.0,1.0,1649,2063
2024-11-19,United Arab Emirates,Qatar,5,0,5,1.0,0.0,1867,1910
2024-11-19,Palestine,South Korea,1,1,0,0.5,0.5,1713,2039
2024-11-19,Oman,Iraq,0,1,1,0.0,1.0,1851,1936
2024-11-19,Kuwait,Jordan,1,1,0,0.5,0.5,1729,1879
2024-11-19,Bahrain,Australia,2,2,0,0.5,0.5,1829,1988
2024-11-19,Indonesia,Saudi Arabia,2,0,2,1.0,0.0,1720,1866
2024-11-19,China PR,Japan,1,3,2,0.0,1.0,1803,2090
